dteday,season,year,month,hour,weekday,workingday,weather_situation,temp,average_temp,humidity,windspeed,casual,registered,total,total_customers,recency,monetary_value_x,R,F,M,RFM_Score,cluster,frequency,monetary_value_y,r_score,monetary_value
2011-01-01,spring,2011,January,0,Saturday,Holiday,Clear,0.24,0.2879,0.81,0.0,3,13,16,16,730,16,1,1,1,111,1,726,39130,1,16
2011-01-01,spring,2011,January,1,Saturday,Holiday,Clear,0.22,0.2727,0.8,0.0,8,32,40,40,730,40,1,1,1,111,1,724,24164,1,40
2011-01-01,spring,2011,January,2,Saturday,Holiday,Clear,0.22,0.2727,0.8,0.0,5,27,32,32,730,32,1,1,1,111,1,715,16352,1,32
2011-01-01,spring,2011,January,3,Saturday,Holiday,Clear,0.24,0.2879,0.75,0.0,3,10,13,13,730,13,1,1,1,111,1,697,8174,1,13
2011-01-01,spring,2011,January,4,Saturday,Holiday,Clear,0.24,0.2879,0.75,0.0,0,1,1,1,730,1,1,1,1,111,1,697,4428,1,1
2011-01-01,spring,2011,January,5,Saturday,Holiday,Mist,0.24,0.2576,0.75,0.0896,0,1,1,1,730,1,1,1,1,111,1,717,14261,1,1
2011-01-01,spring,2011,January,6,Saturday,Holiday,Clear,0.22,0.2727,0.8,0.0,2,0,2,2,730,2,1,1,1,111,1,725,55132,1,2
2011-01-01,spring,2011,January,7,Saturday,Holiday,Clear,0.2,0.2576,0.86,0.0,1,2,3,3,730,3,1,1,1,111,1,727,154171,1,3
2011-01-01,spring,2011,January,8,Saturday,Holiday,Clear,0.24,0.2879,0.75,0.0,1,7,8,8,730,8,1,1,1,111,1,727,261001,1,8
2011-01-01,spring,2011,January,9,Saturday,Holiday,Clear,0.32,0.3485,0.76,0.0,8,6,14,14,730,14,1,1,2,112,1,727,159438,1,14
2011-01-01,spring,2011,January,10,Saturday,Holiday,Clear,0.38,0.3939,0.76,0.2537,12,24,36,36,730,36,1,1,2,112,1,727,126257,1,36
2011-01-01,spring,2011,January,11,Saturday,Holiday,Clear,0.36,0.3333,0.81,0.2836,26,30,56,56,730,56,1,2,1,121,1,727,151320,1,56
2011-01-01,spring,2011,January,12,Saturday,Holiday,Clear,0.42,0.4242,0.77,0.2836,29,55,84,84,730,84,1,2,2,122,1,728,184414,1,84
2011-01-01,spring,2011,January,13,Saturday,Holiday,Mist,0.46,0.4545,0.72,0.2985,47,47,94,94,730,94,1,2,2,122,0,729,184919,1,94
2011-01-01,spring,2011,January,14,Saturday,Holiday,Mist,0.46,0.4545,0.72,0.2836,35,71,106,106,730,106,1,2,2,122,0,729,175652,1,106
2011-01-01,spring,2011,January,15,Saturday,Holiday,Mist,0.44,0.4394,0.77,0.2985,40,70,110,110,730,110,1,2,2,122,0,729,183149,1,110
2011-01-01,spring,2011,January,16,Saturday,Holiday,Mist,0.42,0.4242,0.82,0.2985,41,52,93,93,730,93,1,2,2,122,0,730,227748,1,93
2011-01-01,spring,2011,January,17,Saturday,Holiday,Mist,0.44,0.4394,0.82,0.2836,15,52,67,67,730,67,1,2,2,122,0,730,336860,1,67
2011-01-01,spring,2011,January,18,Saturday,Holiday,Light Snow,0.42,0.4242,0.88,0.2537,9,26,35,35,730,35,1,1,2,112,0,728,309772,1,35
2011-01-01,spring,2011,January,19,Saturday,Holiday,Light Snow,0.42,0.4242,0.88,0.2537,6,31,37,37,730,37,1,1,2,112,0,728,226789,1,37
2011-01-01,spring,2011,January,20,Saturday,Holiday,Mist,0.4,0.4091,0.87,0.2537,11,25,36,36,730,36,1,1,2,112,0,728,164550,1,36
2011-01-01,spring,2011,January,21,Saturday,Holiday,Mist,0.4,0.4091,0.87,0.194,3,31,34,34,730,34,1,1,2,112,0,728,125445,1,34
2011-01-01,spring,2011,January,22,Saturday,Holiday,Mist,0.4,0.4091,0.94,0.2239,11,17,28,28,730,28,1,1,2,112,0,728,95612,1,28
2011-01-01,spring,2011,January,23,Saturday,Holiday,Mist,0.46,0.4545,0.88,0.2985,15,24,39,39,730,39,1,1,2,112,0,728,63941,1,39
2011-01-02,spring,2011,January,0,Sunday,Holiday,Mist,0.46,0.4545,0.88,0.2985,4,13,17,17,729,17,1,1,2,112,0,726,39130,1,17
2011-01-02,spring,2011,January,1,Sunday,Holiday,Mist,0.44,0.4394,0.94,0.2537,1,16,17,17,729,17,1,1,2,112,0,724,24164,1,17
2011-01-02,spring,2011,January,2,Sunday,Holiday,Mist,0.42,0.4242,1.0,0.2836,1,8,9,9,729,9,1,1,2,112,0,715,16352,1,9
2011-01-02,spring,2011,January,3,Sunday,Holiday,Mist,0.46,0.4545,0.94,0.194,2,4,6,6,729,6,1,1,2,112,0,697,8174,1,6
2011-01-02,spring,2011,January,4,Sunday,Holiday,Mist,0.46,0.4545,0.94,0.194,2,1,3,3,729,3,1,1,2,112,0,697,4428,1,3
2011-01-02,spring,2011,January,6,Sunday,Holiday,Light Snow,0.42,0.4242,0.77,0.2985,0,2,2,2,729,2,1,1,2,112,1,725,55132,1,2
2011-01-02,spring,2011,January,7,Sunday,Holiday,Mist,0.4,0.4091,0.76,0.194,0,1,1,1,729,1,1,1,2,112,0,727,154171,1,1
2011-01-02,spring,2011,January,8,Sunday,Holiday,Light Snow,0.4,0.4091,0.71,0.2239,0,8,8,8,729,8,1,1,2,112,1,727,261001,1,8
2011-01-02,spring,2011,January,9,Sunday,Holiday,Mist,0.38,0.3939,0.76,0.2239,1,19,20,20,729,20,1,1,2,112,1,727,159438,1,20
2011-01-02,spring,2011,January,10,Sunday,Holiday,Mist,0.36,0.3485,0.81,0.2239,7,46,53,53,729,53,1,2,2,122,1,727,126257,1,53
2011-01-02,spring,2011,January,11,Sunday,Holiday,Mist,0.36,0.3333,0.71,0.2537,16,54,70,70,729,70,1,2,1,121,1,727,151320,1,70
2011-01-02,spring,2011,January,12,Sunday,Holiday,Mist,0.36,0.3333,0.66,0.2985,20,73,93,93,729,93,1,2,1,121,1,728,184414,1,93
2011-01-02,spring,2011,January,13,Sunday,Holiday,Mist,0.36,0.3485,0.66,0.1343,11,64,75,75,729,75,1,2,2,122,1,729,184919,1,75
2011-01-02,spring,2011,January,14,Sunday,Holiday,Light Snow,0.36,0.3485,0.76,0.194,4,55,59,59,729,59,1,2,2,122,1,729,175652,1,59
2011-01-02,spring,2011,January,15,Sunday,Holiday,Light Snow,0.34,0.3333,0.81,0.1642,19,55,74,74,729,74,1,2,1,121,1,729,183149,1,74
2011-01-02,spring,2011,January,16,Sunday,Holiday,Light Snow,0.34,0.3333,0.71,0.1642,9,67,76,76,729,76,1,2,1,121,1,730,227748,1,76
2011-01-02,spring,2011,January,17,Sunday,Holiday,Clear,0.34,0.3333,0.57,0.194,7,58,65,65,729,65,1,2,1,121,1,730,336860,1,65
2011-01-02,spring,2011,January,18,Sunday,Holiday,Mist,0.36,0.3333,0.46,0.3284,10,43,53,53,729,53,1,2,1,121,1,728,309772,1,53
2011-01-02,spring,2011,January,19,Sunday,Holiday,Clear,0.32,0.2879,0.42,0.4478,1,29,30,30,729,30,1,1,1,111,1,728,226789,1,30
2011-01-02,spring,2011,January,20,Sunday,Holiday,Clear,0.3,0.2727,0.39,0.3582,5,17,22,22,729,22,1,1,1,111,1,728,164550,1,22
2011-01-02,spring,2011,January,21,Sunday,Holiday,Clear,0.26,0.2273,0.44,0.3284,11,20,31,31,729,31,1,1,1,111,1,728,125445,1,31
2011-01-02,spring,2011,January,22,Sunday,Holiday,Clear,0.24,0.2121,0.44,0.2985,0,9,9,9,729,9,1,1,1,111,1,728,95612,1,9
2011-01-02,spring,2011,January,23,Sunday,Holiday,Clear,0.22,0.2273,0.47,0.1642,0,8,8,8,729,8,1,1,1,111,1,728,63941,1,8
2011-01-03,spring,2011,January,0,Monday,Workingday,Clear,0.22,0.197,0.44,0.3582,0,5,5,5,728,5,1,1,1,111,1,726,39130,1,5
2011-01-03,spring,2011,January,1,Monday,Workingday,Clear,0.2,0.1667,0.44,0.4179,0,2,2,2,728,2,1,1,1,111,1,724,24164,1,2
2011-01-03,spring,2011,January,4,Monday,Workingday,Clear,0.16,0.1364,0.47,0.3881,0,1,1,1,728,1,1,1,1,111,1,697,4428,1,1
2011-01-03,spring,2011,January,5,Monday,Workingday,Clear,0.16,0.1364,0.47,0.2836,0,3,3,3,728,3,1,1,1,111,1,717,14261,1,3
2011-01-03,spring,2011,January,6,Monday,Workingday,Clear,0.14,0.1061,0.5,0.3881,0,30,30,30,728,30,1,1,1,111,1,725,55132,1,30
2011-01-03,spring,2011,January,7,Monday,Workingday,Clear,0.14,0.1364,0.5,0.194,1,63,64,64,728,64,1,2,1,121,1,727,154171,1,64
2011-01-03,spring,2011,January,8,Monday,Workingday,Clear,0.14,0.1212,0.5,0.2836,1,153,154,154,728,154,1,3,1,131,1,727,261001,1,154
2011-01-03,spring,2011,January,9,Monday,Workingday,Clear,0.16,0.1364,0.43,0.3881,7,81,88,88,728,88,1,2,1,121,1,727,159438,1,88
2011-01-03,spring,2011,January,10,Monday,Workingday,Clear,0.18,0.1667,0.43,0.2537,11,33,44,44,728,44,1,2,1,121,1,727,126257,1,44
2011-01-03,spring,2011,January,11,Monday,Workingday,Clear,0.2,0.1818,0.4,0.3284,10,41,51,51,728,51,1,2,1,121,1,727,151320,1,51
2011-01-03,spring,2011,January,12,Monday,Workingday,Clear,0.22,0.2121,0.35,0.2985,13,48,61,61,728,61,1,2,1,121,1,728,184414,1,61
2011-01-03,spring,2011,January,13,Monday,Workingday,Clear,0.24,0.2121,0.35,0.2836,8,53,61,61,728,61,1,2,1,121,1,729,184919,1,61
2011-01-03,spring,2011,January,14,Monday,Workingday,Clear,0.26,0.2424,0.3,0.2836,11,66,77,77,728,77,1,2,1,121,1,729,175652,1,77
2011-01-03,spring,2011,January,15,Monday,Workingday,Clear,0.26,0.2424,0.3,0.2537,14,58,72,72,728,72,1,2,1,121,1,729,183149,1,72
2011-01-03,spring,2011,January,16,Monday,Workingday,Clear,0.26,0.2424,0.3,0.2537,9,67,76,76,728,76,1,2,1,121,1,730,227748,1,76
2011-01-03,spring,2011,January,17,Monday,Workingday,Clear,0.24,0.2273,0.3,0.2239,11,146,157,157,728,157,1,3,1,131,1,730,336860,1,157
2011-01-03,spring,2011,January,18,Monday,Workingday,Clear,0.24,0.2576,0.32,0.1045,9,148,157,157,728,157,1,3,1,131,1,728,309772,1,157
2011-01-03,spring,2011,January,19,Monday,Workingday,Clear,0.2,0.2576,0.47,0.0,8,102,110,110,728,110,1,2,1,121,1,728,226789,1,110
2011-01-03,spring,2011,January,20,Monday,Workingday,Clear,0.2,0.2273,0.47,0.1045,3,49,52,52,728,52,1,2,1,121,1,728,164550,1,52
2011-01-03,spring,2011,January,21,Monday,Workingday,Clear,0.18,0.197,0.64,0.1343,3,49,52,52,728,52,1,2,1,121,1,728,125445,1,52
2011-01-03,spring,2011,January,22,Monday,Workingday,Clear,0.14,0.1515,0.69,0.1343,0,20,20,20,728,20,1,1,1,111,1,728,95612,1,20
2011-01-03,spring,2011,January,23,Monday,Workingday,Clear,0.18,0.2121,0.55,0.1045,1,11,12,12,728,12,1,1,1,111,1,728,63941,1,12
2011-01-04,spring,2011,January,0,Tuesday,Workingday,Clear,0.16,0.1818,0.55,0.1045,0,5,5,5,727,5,1,1,1,111,1,726,39130,1,5
2011-01-04,spring,2011,January,1,Tuesday,Workingday,Clear,0.16,0.1818,0.59,0.1045,0,2,2,2,727,2,1,1,1,111,1,724,24164,1,2
2011-01-04,spring,2011,January,2,Tuesday,Workingday,Clear,0.14,0.1515,0.63,0.1343,0,1,1,1,727,1,1,1,1,111,1,715,16352,1,1
2011-01-04,spring,2011,January,4,Tuesday,Workingday,Clear,0.14,0.1818,0.63,0.0896,0,2,2,2,727,2,1,1,1,111,1,697,4428,1,2
2011-01-04,spring,2011,January,5,Tuesday,Workingday,Clear,0.12,0.1515,0.68,0.1045,0,4,4,4,727,4,1,1,1,111,1,717,14261,1,4
2011-01-04,spring,2011,January,6,Tuesday,Workingday,Clear,0.12,0.1515,0.74,0.1045,0,36,36,36,727,36,1,1,1,111,1,725,55132,1,36
2011-01-04,spring,2011,January,7,Tuesday,Workingday,Clear,0.12,0.1515,0.74,0.1343,2,92,94,94,727,94,1,2,1,121,1,727,154171,1,94
2011-01-04,spring,2011,January,8,Tuesday,Workingday,Clear,0.14,0.1515,0.69,0.1642,2,177,179,179,727,179,1,3,1,131,1,727,261001,1,179
2011-01-04,spring,2011,January,9,Tuesday,Workingday,Clear,0.16,0.1515,0.64,0.2239,2,98,100,100,727,100,1,2,1,121,1,727,159438,1,100
2011-01-04,spring,2011,January,10,Tuesday,Workingday,Mist,0.16,0.1364,0.69,0.3284,5,37,42,42,727,42,1,2,1,121,1,727,126257,1,42
2011-01-04,spring,2011,January,11,Tuesday,Workingday,Clear,0.22,0.2121,0.51,0.2985,7,50,57,57,727,57,1,2,1,121,1,727,151320,1,57
2011-01-04,spring,2011,January,12,Tuesday,Workingday,Clear,0.22,0.2273,0.51,0.1642,12,66,78,78,727,78,1,2,1,121,1,728,184414,1,78
2011-01-04,spring,2011,January,13,Tuesday,Workingday,Clear,0.24,0.2273,0.56,0.194,18,79,97,97,727,97,1,2,1,121,1,729,184919,1,97
2011-01-04,spring,2011,January,14,Tuesday,Workingday,Clear,0.26,0.2576,0.52,0.2239,9,54,63,63,727,63,1,2,1,121,1,729,175652,1,63
2011-01-04,spring,2011,January,15,Tuesday,Workingday,Clear,0.28,0.2727,0.52,0.2537,17,48,65,65,727,65,1,2,1,121,1,729,183149,1,65
2011-01-04,spring,2011,January,16,Tuesday,Workingday,Clear,0.3,0.2879,0.49,0.2537,15,68,83,83,727,83,1,2,1,121,1,730,227748,1,83
2011-01-04,spring,2011,January,17,Tuesday,Workingday,Clear,0.28,0.2727,0.48,0.2239,10,202,212,212,727,212,1,3,1,131,1,730,336860,1,212
2011-01-04,spring,2011,January,18,Tuesday,Workingday,Clear,0.26,0.2576,0.48,0.194,3,179,182,182,727,182,1,3,1,131,1,728,309772,1,182
2011-01-04,spring,2011,January,19,Tuesday,Workingday,Clear,0.24,0.2576,0.48,0.1045,2,110,112,112,727,112,1,2,1,121,1,728,226789,1,112
2011-01-04,spring,2011,January,20,Tuesday,Workingday,Clear,0.24,0.2576,0.48,0.1045,1,53,54,54,727,54,1,2,1,121,1,728,164550,1,54
2011-01-04,spring,2011,January,21,Tuesday,Workingday,Clear,0.22,0.2727,0.64,0.0,0,48,48,48,727,48,1,2,1,121,1,728,125445,1,48
2011-01-04,spring,2011,January,22,Tuesday,Workingday,Clear,0.22,0.2576,0.64,0.0896,1,34,35,35,727,35,1,1,1,111,1,728,95612,1,35
2011-01-04,spring,2011,January,23,Tuesday,Workingday,Clear,0.2,0.2273,0.69,0.0896,2,9,11,11,727,11,1,1,1,111,1,728,63941,1,11
2011-01-05,spring,2011,January,0,Wednesday,Workingday,Clear,0.2,0.2576,0.64,0.0,0,6,6,6,726,6,1,1,1,111,1,726,39130,1,6
2011-01-05,spring,2011,January,1,Wednesday,Workingday,Clear,0.16,0.197,0.74,0.0896,0,6,6,6,726,6,1,1,1,111,1,724,24164,1,6
2011-01-05,spring,2011,January,2,Wednesday,Workingday,Clear,0.16,0.197,0.74,0.0896,0,2,2,2,726,2,1,1,1,111,1,715,16352,1,2
2011-01-05,spring,2011,January,4,Wednesday,Workingday,Clear,0.24,0.2273,0.48,0.2239,0,2,2,2,726,2,1,1,1,111,1,697,4428,1,2
2011-01-05,spring,2011,January,5,Wednesday,Workingday,Clear,0.22,0.2273,0.47,0.1642,0,3,3,3,726,3,1,1,1,111,1,717,14261,1,3
2011-01-05,spring,2011,January,6,Wednesday,Workingday,Clear,0.2,0.197,0.47,0.2239,0,33,33,33,726,33,1,1,1,111,1,725,55132,1,33
2011-01-05,spring,2011,January,7,Wednesday,Workingday,Clear,0.18,0.1818,0.43,0.194,1,87,88,88,726,88,1,2,1,121,1,727,154171,1,88
2011-01-05,spring,2011,January,8,Wednesday,Workingday,Clear,0.2,0.1818,0.4,0.2985,3,192,195,195,726,195,1,3,1,131,1,727,261001,1,195
2011-01-05,spring,2011,January,9,Wednesday,Workingday,Clear,0.22,0.197,0.37,0.3284,6,109,115,115,726,115,1,2,1,121,1,727,159438,1,115
2011-01-05,spring,2011,January,10,Wednesday,Workingday,Clear,0.22,0.197,0.37,0.3284,4,53,57,57,726,57,1,2,1,121,1,727,126257,1,57
2011-01-05,spring,2011,January,11,Wednesday,Workingday,Clear,0.26,0.2273,0.33,0.3284,12,34,46,46,726,46,1,2,1,121,1,727,151320,1,46
2011-01-05,spring,2011,January,12,Wednesday,Workingday,Clear,0.26,0.2273,0.33,0.3284,5,74,79,79,726,79,1,2,1,121,1,728,184414,1,79
2011-01-05,spring,2011,January,13,Wednesday,Workingday,Clear,0.28,0.2576,0.3,0.2985,6,65,71,71,726,71,1,2,1,121,1,729,184919,1,71
2011-01-05,spring,2011,January,14,Wednesday,Workingday,Clear,0.3,0.2879,0.28,0.194,10,52,62,62,726,62,1,2,1,121,1,729,175652,1,62
2011-01-05,spring,2011,January,15,Wednesday,Workingday,Clear,0.3,0.2879,0.28,0.194,7,55,62,62,726,62,1,2,1,121,1,729,183149,1,62
2011-01-05,spring,2011,January,16,Wednesday,Workingday,Clear,0.3,0.3182,0.28,0.0896,4,85,89,89,726,89,1,2,1,121,1,730,227748,1,89
2011-01-05,spring,2011,January,17,Wednesday,Workingday,Clear,0.24,0.2273,0.38,0.194,4,186,190,190,726,190,1,3,1,131,1,730,336860,1,190
2011-01-05,spring,2011,January,18,Wednesday,Workingday,Clear,0.24,0.2424,0.38,0.1343,3,166,169,169,726,169,1,3,1,131,1,728,309772,1,169
2011-01-05,spring,2011,January,19,Wednesday,Workingday,Clear,0.24,0.2576,0.38,0.1045,5,127,132,132,726,132,1,2,1,121,1,728,226789,1,132
2011-01-05,spring,2011,January,20,Wednesday,Workingday,Clear,0.22,0.2273,0.47,0.1642,7,82,89,89,726,89,1,2,1,121,1,728,164550,1,89
2011-01-05,spring,2011,January,21,Wednesday,Workingday,Clear,0.2,0.197,0.51,0.194,3,40,43,43,726,43,1,2,1,121,1,728,125445,1,43
2011-01-05,spring,2011,January,22,Wednesday,Workingday,Clear,0.18,0.197,0.55,0.1343,1,41,42,42,726,42,1,2,1,121,1,728,95612,1,42
2011-01-05,spring,2011,January,23,Wednesday,Workingday,Clear,0.2,0.2576,0.47,0.0,1,18,19,19,726,19,1,1,1,111,1,728,63941,1,19
2011-01-06,spring,2011,January,0,Thursday,Workingday,Clear,0.18,0.2424,0.55,0.0,0,11,11,11,725,11,1,1,1,111,1,726,39130,1,11
2011-01-06,spring,2011,January,1,Thursday,Workingday,Clear,0.16,0.2273,0.64,0.0,0,4,4,4,725,4,1,1,1,111,1,724,24164,1,4
2011-01-06,spring,2011,January,2,Thursday,Workingday,Clear,0.16,0.2273,0.64,0.0,0,2,2,2,725,2,1,1,1,111,1,715,16352,1,2
2011-01-06,spring,2011,January,4,Thursday,Workingday,Mist,0.16,0.197,0.64,0.0896,0,1,1,1,725,1,1,1,1,111,1,697,4428,1,1
2011-01-06,spring,2011,January,5,Thursday,Workingday,Mist,0.14,0.1818,0.69,0.0896,0,4,4,4,725,4,1,1,1,111,1,717,14261,1,4
2011-01-06,spring,2011,January,6,Thursday,Workingday,Mist,0.14,0.1667,0.63,0.1045,0,36,36,36,725,36,1,1,1,111,1,725,55132,1,36
2011-01-06,spring,2011,January,7,Thursday,Workingday,Mist,0.16,0.2273,0.59,0.0,0,95,95,95,725,95,1,2,1,121,1,727,154171,1,95
2011-01-06,spring,2011,January,8,Thursday,Workingday,Clear,0.16,0.2273,0.59,0.0,3,216,219,219,725,219,1,3,1,131,1,727,261001,1,219
2011-01-06,spring,2011,January,9,Thursday,Workingday,Mist,0.18,0.2424,0.51,0.0,6,116,122,122,725,122,1,2,1,121,1,727,159438,1,122
2011-01-06,spring,2011,January,10,Thursday,Workingday,Clear,0.2,0.2576,0.47,0.0,3,42,45,45,725,45,1,2,1,121,1,727,126257,1,45
2011-01-06,spring,2011,January,11,Thursday,Workingday,Clear,0.22,0.2576,0.44,0.0896,2,57,59,59,725,59,1,2,1,121,1,727,151320,1,59
2011-01-06,spring,2011,January,12,Thursday,Workingday,Clear,0.26,0.2879,0.35,0.0,6,78,84,84,725,84,1,2,1,121,1,728,184414,1,84
2011-01-06,spring,2011,January,13,Thursday,Workingday,Clear,0.26,0.2727,0.35,0.1045,12,55,67,67,725,67,1,2,1,121,1,729,184919,1,67
2011-01-06,spring,2011,January,14,Thursday,Workingday,Clear,0.28,0.2727,0.36,0.1642,11,59,70,70,725,70,1,2,1,121,1,729,175652,1,70
2011-01-06,spring,2011,January,15,Thursday,Workingday,Clear,0.28,0.2727,0.36,0.0,8,54,62,62,725,62,1,2,1,121,1,729,183149,1,62
2011-01-06,spring,2011,January,16,Thursday,Workingday,Clear,0.26,0.2576,0.38,0.1642,12,74,86,86,725,86,1,2,1,121,1,730,227748,1,86
2011-01-06,spring,2011,January,17,Thursday,Workingday,Clear,0.22,0.2273,0.51,0.1642,9,163,172,172,725,172,1,3,1,131,1,730,336860,1,172
2011-01-06,spring,2011,January,18,Thursday,Workingday,Clear,0.22,0.2273,0.51,0.1343,5,158,163,163,725,163,1,3,1,131,1,728,309772,1,163
2011-01-06,spring,2011,January,19,Thursday,Workingday,Clear,0.22,0.2576,0.55,0.0896,3,109,112,112,725,112,1,2,1,121,1,728,226789,1,112
2011-01-06,spring,2011,January,20,Thursday,Workingday,Clear,0.2,0.2121,0.51,0.1642,3,66,69,69,725,69,1,2,1,121,1,728,164550,1,69
2011-01-06,spring,2011,January,21,Thursday,Workingday,Mist,0.22,0.2121,0.55,0.2239,0,48,48,48,725,48,1,2,1,121,1,728,125445,1,48
2011-01-06,spring,2011,January,22,Thursday,Workingday,Mist,0.22,0.2121,0.51,0.2836,1,51,52,52,725,52,1,2,1,121,1,728,95612,1,52
2011-01-06,spring,2011,January,23,Thursday,Workingday,Mist,0.2,0.197,0.59,0.194,4,19,23,23,725,23,1,1,1,111,1,728,63941,1,23
2011-01-07,spring,2011,January,0,Friday,Workingday,Mist,0.2,0.197,0.64,0.194,4,13,17,17,724,17,1,1,1,111,1,726,39130,1,17
2011-01-07,spring,2011,January,1,Friday,Workingday,Mist,0.2,0.197,0.69,0.2239,2,5,7,7,724,7,1,1,1,111,1,724,24164,1,7
2011-01-07,spring,2011,January,2,Friday,Workingday,Mist,0.2,0.197,0.69,0.2239,0,1,1,1,724,1,1,1,1,111,1,715,16352,1,1
2011-01-07,spring,2011,January,4,Friday,Workingday,Mist,0.2,0.2121,0.69,0.1343,0,1,1,1,724,1,1,1,1,111,1,697,4428,1,1
2011-01-07,spring,2011,January,5,Friday,Workingday,Light Snow,0.22,0.2727,0.55,0.0,0,5,5,5,724,5,1,1,1,111,1,717,14261,1,5
2011-01-07,spring,2011,January,6,Friday,Workingday,Mist,0.2,0.2576,0.69,0.0,8,26,34,34,724,34,1,1,1,111,1,725,55132,1,34
2011-01-07,spring,2011,January,7,Friday,Workingday,Clear,0.2,0.2121,0.69,0.1343,8,76,84,84,724,84,1,2,1,121,1,727,154171,1,84
2011-01-07,spring,2011,January,8,Friday,Workingday,Clear,0.2,0.197,0.51,0.2537,20,190,210,210,724,210,1,3,1,131,1,727,261001,1,210
2011-01-07,spring,2011,January,9,Friday,Workingday,Clear,0.2,0.1818,0.47,0.2985,9,125,134,134,724,134,1,2,1,121,1,727,159438,1,134
2011-01-07,spring,2011,January,10,Friday,Workingday,Clear,0.22,0.197,0.37,0.3284,16,47,63,63,724,63,1,2,1,121,1,727,126257,1,63
2011-01-07,spring,2011,January,11,Friday,Workingday,Mist,0.2,0.197,0.4,0.2239,19,48,67,67,724,67,1,2,1,121,1,727,151320,1,67
2011-01-07,spring,2011,January,12,Friday,Workingday,Mist,0.2,0.197,0.37,0.2537,9,50,59,59,724,59,1,2,1,121,1,728,184414,1,59
2011-01-07,spring,2011,January,13,Friday,Workingday,Mist,0.2,0.1818,0.37,0.2836,9,64,73,73,724,73,1,2,1,121,1,729,184919,1,73
2011-01-07,spring,2011,January,14,Friday,Workingday,Mist,0.2,0.197,0.4,0.2537,7,43,50,50,724,50,1,2,1,121,1,729,175652,1,50
2011-01-07,spring,2011,January,15,Friday,Workingday,Mist,0.2,0.2121,0.37,0.1642,9,63,72,72,724,72,1,2,1,121,1,729,183149,1,72
2011-01-07,spring,2011,January,16,Friday,Workingday,Mist,0.2,0.2121,0.37,0.1642,5,82,87,87,724,87,1,2,1,121,1,730,227748,1,87
2011-01-07,spring,2011,January,17,Friday,Workingday,Mist,0.2,0.2576,0.37,0.0,9,178,187,187,724,187,1,3,1,131,1,730,336860,1,187
2011-01-07,spring,2011,January,18,Friday,Workingday,Clear,0.2,0.2273,0.4,0.0896,7,116,123,123,724,123,1,2,1,121,1,728,309772,1,123
2011-01-07,spring,2011,January,19,Friday,Workingday,Clear,0.16,0.197,0.55,0.0896,3,92,95,95,724,95,1,2,1,121,1,728,226789,1,95
2011-01-07,spring,2011,January,20,Friday,Workingday,Clear,0.18,0.2121,0.47,0.1045,1,50,51,51,724,51,1,2,1,121,1,728,164550,1,51
2011-01-07,spring,2011,January,21,Friday,Workingday,Clear,0.18,0.197,0.47,0.1343,0,39,39,39,724,39,1,1,1,111,1,728,125445,1,39
2011-01-07,spring,2011,January,22,Friday,Workingday,Mist,0.18,0.197,0.43,0.1642,2,34,36,36,724,36,1,1,1,111,1,728,95612,1,36
2011-01-07,spring,2011,January,23,Friday,Workingday,Mist,0.18,0.197,0.51,0.1642,1,14,15,15,724,15,1,1,1,111,1,728,63941,1,15
2011-01-08,spring,2011,January,0,Saturday,Holiday,Mist,0.18,0.197,0.51,0.1642,1,24,25,25,723,25,1,1,1,111,1,726,39130,1,25
2011-01-08,spring,2011,January,1,Saturday,Holiday,Mist,0.18,0.2121,0.55,0.0896,1,15,16,16,723,16,1,1,1,111,1,724,24164,1,16
2011-01-08,spring,2011,January,2,Saturday,Holiday,Mist,0.18,0.2424,0.55,0.0,3,13,16,16,723,16,1,1,1,111,1,715,16352,1,16
2011-01-08,spring,2011,January,3,Saturday,Holiday,Light Snow,0.18,0.197,0.55,0.1642,0,7,7,7,723,7,1,1,1,111,1,697,8174,1,7
2011-01-08,spring,2011,January,4,Saturday,Holiday,Light Snow,0.18,0.197,0.55,0.1642,0,1,1,1,723,1,1,1,1,111,1,697,4428,1,1
2011-01-08,spring,2011,January,5,Saturday,Holiday,Mist,0.16,0.1667,0.74,0.1642,0,5,5,5,723,5,1,1,1,111,1,717,14261,1,5
2011-01-08,spring,2011,January,6,Saturday,Holiday,Mist,0.16,0.1667,0.74,0.1642,0,2,2,2,723,2,1,1,1,111,1,725,55132,1,2
2011-01-08,spring,2011,January,7,Saturday,Holiday,Mist,0.16,0.1818,0.74,0.1045,1,8,9,9,723,9,1,1,1,111,1,727,154171,1,9
2011-01-08,spring,2011,January,8,Saturday,Holiday,Light Snow,0.16,0.1818,0.93,0.1045,0,15,15,15,723,15,1,1,1,111,1,727,261001,1,15
2011-01-08,spring,2011,January,9,Saturday,Holiday,Light Snow,0.16,0.1818,0.93,0.1045,0,20,20,20,723,20,1,1,1,111,1,727,159438,1,20
2011-01-08,spring,2011,January,10,Saturday,Holiday,Mist,0.18,0.197,0.8,0.1642,5,56,61,61,723,61,1,2,1,121,1,727,126257,1,61
2011-01-08,spring,2011,January,11,Saturday,Holiday,Mist,0.2,0.1818,0.69,0.3881,2,60,62,62,723,62,1,2,1,121,1,727,151320,1,62
2011-01-08,spring,2011,January,12,Saturday,Holiday,Mist,0.2,0.1818,0.59,0.3582,8,90,98,98,723,98,1,2,1,121,1,728,184414,1,98
2011-01-08,spring,2011,January,13,Saturday,Holiday,Clear,0.2,0.1818,0.44,0.3284,7,95,102,102,723,102,1,2,1,121,1,729,184919,1,102
2011-01-08,spring,2011,January,14,Saturday,Holiday,Clear,0.2,0.1667,0.32,0.4925,12,83,95,95,723,95,1,2,1,121,1,729,175652,1,95
2011-01-08,spring,2011,January,15,Saturday,Holiday,Clear,0.2,0.1667,0.32,0.4478,5,69,74,74,723,74,1,2,1,121,1,729,183149,1,74
2011-01-08,spring,2011,January,16,Saturday,Holiday,Clear,0.18,0.1364,0.29,0.4478,8,68,76,76,723,76,1,2,1,121,1,730,227748,1,76
2011-01-08,spring,2011,January,17,Saturday,Holiday,Clear,0.16,0.1212,0.37,0.5522,5,64,69,69,723,69,1,2,1,121,1,730,336860,1,69
2011-01-08,spring,2011,January,18,Saturday,Holiday,Clear,0.14,0.1212,0.39,0.2985,3,52,55,55,723,55,1,2,1,121,1,728,309772,1,55
2011-01-08,spring,2011,January,19,Saturday,Holiday,Clear,0.14,0.1212,0.36,0.2537,4,26,30,30,723,30,1,1,1,111,1,728,226789,1,30
2011-01-08,spring,2011,January,20,Saturday,Holiday,Clear,0.12,0.1212,0.36,0.2537,0,28,28,28,723,28,1,1,1,111,1,728,164550,1,28
2011-01-08,spring,2011,January,21,Saturday,Holiday,Clear,0.12,0.1061,0.39,0.3582,2,35,37,37,723,37,1,1,1,111,1,728,125445,1,37
2011-01-08,spring,2011,January,22,Saturday,Holiday,Clear,0.12,0.1061,0.36,0.3881,1,33,34,34,723,34,1,1,1,111,1,728,95612,1,34
2011-01-08,spring,2011,January,23,Saturday,Holiday,Clear,0.1,0.0606,0.39,0.4478,0,22,22,22,723,22,1,1,1,111,1,728,63941,1,22
2011-01-09,spring,2011,January,0,Sunday,Holiday,Clear,0.1,0.0758,0.42,0.3881,1,24,25,25,722,25,1,1,1,111,1,726,39130,1,25
2011-01-09,spring,2011,January,1,Sunday,Holiday,Clear,0.1,0.0606,0.42,0.4627,0,12,12,12,722,12,1,1,1,111,1,724,24164,1,12
2011-01-09,spring,2011,January,2,Sunday,Holiday,Clear,0.1,0.0606,0.46,0.4627,0,11,11,11,722,11,1,1,1,111,1,715,16352,1,11
2011-01-09,spring,2011,January,3,Sunday,Holiday,Clear,0.1,0.0758,0.46,0.4179,0,4,4,4,722,4,1,1,1,111,1,697,8174,1,4
2011-01-09,spring,2011,January,4,Sunday,Holiday,Clear,0.08,0.0909,0.53,0.194,0,1,1,1,722,1,1,1,1,111,1,697,4428,1,1
2011-01-09,spring,2011,January,5,Sunday,Holiday,Clear,0.08,0.0909,0.53,0.194,0,1,1,1,722,1,1,1,1,111,1,717,14261,1,1
2011-01-09,spring,2011,January,6,Sunday,Holiday,Clear,0.1,0.0909,0.49,0.2836,0,1,1,1,722,1,1,1,1,111,1,725,55132,1,1
2011-01-09,spring,2011,January,7,Sunday,Holiday,Clear,0.08,0.0909,0.53,0.194,1,5,6,6,722,6,1,1,1,111,1,727,154171,1,6
2011-01-09,spring,2011,January,8,Sunday,Holiday,Clear,0.1,0.0909,0.49,0.2836,0,10,10,10,722,10,1,1,1,111,1,727,261001,1,10
2011-01-09,spring,2011,January,9,Sunday,Holiday,Clear,0.12,0.0758,0.46,0.5224,0,19,19,19,722,19,1,1,1,111,1,727,159438,1,19
2011-01-09,spring,2011,January,10,Sunday,Holiday,Clear,0.14,0.1061,0.43,0.3881,0,49,49,49,722,49,1,2,1,121,1,727,126257,1,49
2011-01-09,spring,2011,January,11,Sunday,Holiday,Clear,0.16,0.1212,0.4,0.5224,2,47,49,49,722,49,1,2,1,121,1,727,151320,1,49
2011-01-09,spring,2011,January,12,Sunday,Holiday,Clear,0.18,0.1364,0.37,0.4478,4,79,83,83,722,83,1,2,1,121,1,728,184414,1,83
2011-01-09,spring,2011,January,13,Sunday,Holiday,Clear,0.2,0.1667,0.34,0.4478,6,69,75,75,722,75,1,2,1,121,1,729,184919,1,75
2011-01-09,spring,2011,January,14,Sunday,Holiday,Clear,0.22,0.1818,0.32,0.4627,8,64,72,72,722,72,1,2,1,121,1,729,175652,1,72
2011-01-09,spring,2011,January,15,Sunday,Holiday,Clear,0.22,0.197,0.35,0.3582,5,77,82,82,722,82,1,2,1,121,1,729,183149,1,82
2011-01-09,spring,2011,January,16,Sunday,Holiday,Clear,0.2,0.1667,0.34,0.4478,13,79,92,92,722,92,1,2,1,121,1,730,227748,1,92
2011-01-09,spring,2011,January,17,Sunday,Holiday,Clear,0.18,0.1515,0.37,0.3881,3,59,62,62,722,62,1,2,1,121,1,730,336860,1,62
2011-01-09,spring,2011,January,18,Sunday,Holiday,Clear,0.16,0.1364,0.4,0.3284,4,44,48,48,722,48,1,2,1,121,1,728,309772,1,48
2011-01-09,spring,2011,January,19,Sunday,Holiday,Clear,0.16,0.1364,0.43,0.3284,1,40,41,41,722,41,1,2,1,121,1,728,226789,1,41
2011-01-09,spring,2011,January,20,Sunday,Holiday,Clear,0.14,0.1212,0.46,0.2537,0,38,38,38,722,38,1,1,1,111,1,728,164550,1,38
2011-01-09,spring,2011,January,21,Sunday,Holiday,Clear,0.14,0.1061,0.46,0.4179,1,19,20,20,722,20,1,1,1,111,1,728,125445,1,20
2011-01-09,spring,2011,January,22,Sunday,Holiday,Clear,0.14,0.1212,0.46,0.2985,5,10,15,15,722,15,1,1,1,111,1,728,95612,1,15
2011-01-09,spring,2011,January,23,Sunday,Holiday,Clear,0.12,0.1364,0.5,0.194,0,6,6,6,722,6,1,1,1,111,1,728,63941,1,6
2011-01-10,spring,2011,January,0,Monday,Workingday,Clear,0.12,0.1212,0.5,0.2836,2,3,5,5,721,5,1,1,1,111,1,726,39130,1,5
2011-01-10,spring,2011,January,1,Monday,Workingday,Clear,0.12,0.1212,0.5,0.2836,1,0,1,1,721,1,1,1,1,111,1,724,24164,1,1
2011-01-10,spring,2011,January,2,Monday,Workingday,Clear,0.12,0.1212,0.5,0.2239,0,3,3,3,721,3,1,1,1,111,1,715,16352,1,3
2011-01-10,spring,2011,January,3,Monday,Workingday,Clear,0.12,0.1212,0.5,0.2239,0,1,1,1,721,1,1,1,1,111,1,697,8174,1,1
2011-01-10,spring,2011,January,4,Monday,Workingday,Clear,0.1,0.1212,0.54,0.1343,1,2,3,3,721,3,1,1,1,111,1,697,4428,1,3
2011-01-10,spring,2011,January,5,Monday,Workingday,Clear,0.1,0.1061,0.54,0.2537,0,3,3,3,721,3,1,1,1,111,1,717,14261,1,3
2011-01-10,spring,2011,January,6,Monday,Workingday,Clear,0.12,0.1212,0.5,0.2836,0,31,31,31,721,31,1,1,1,111,1,725,55132,1,31
2011-01-10,spring,2011,January,7,Monday,Workingday,Clear,0.12,0.1212,0.5,0.2239,2,75,77,77,721,77,1,2,1,121,1,727,154171,1,77
2011-01-10,spring,2011,January,8,Monday,Workingday,Mist,0.12,0.1212,0.5,0.2836,4,184,188,188,721,188,1,3,1,131,1,727,261001,1,188
2011-01-10,spring,2011,January,9,Monday,Workingday,Mist,0.14,0.1212,0.5,0.2537,2,92,94,94,721,94,1,2,1,121,1,727,159438,1,94
2011-01-10,spring,2011,January,10,Monday,Workingday,Mist,0.14,0.1212,0.5,0.2985,0,31,31,31,721,31,1,1,1,111,1,727,126257,1,31
2011-01-10,spring,2011,January,11,Monday,Workingday,Mist,0.16,0.1364,0.47,0.2836,2,28,30,30,721,30,1,1,1,111,1,727,151320,1,30
2011-01-10,spring,2011,January,12,Monday,Workingday,Mist,0.2,0.1818,0.4,0.2836,5,47,52,52,721,52,1,2,1,121,1,728,184414,1,52
2011-01-10,spring,2011,January,13,Monday,Workingday,Mist,0.2,0.1818,0.4,0.2836,4,50,54,54,721,54,1,2,1,121,1,729,184919,1,54
2011-01-10,spring,2011,January,14,Monday,Workingday,Mist,0.2,0.197,0.4,0.2239,0,47,47,47,721,47,1,2,1,121,1,729,175652,1,47
2011-01-10,spring,2011,January,15,Monday,Workingday,Mist,0.2,0.197,0.4,0.2239,2,43,45,45,721,45,1,2,1,121,1,729,183149,1,45
2011-01-10,spring,2011,January,16,Monday,Workingday,Clear,0.2,0.2121,0.4,0.1343,4,70,74,74,721,74,1,2,1,121,1,730,227748,1,74
2011-01-10,spring,2011,January,17,Monday,Workingday,Clear,0.2,0.2273,0.4,0.1045,4,174,178,178,721,178,1,3,1,131,1,730,336860,1,178
2011-01-10,spring,2011,January,18,Monday,Workingday,Clear,0.2,0.197,0.4,0.2239,1,154,155,155,721,155,1,3,1,131,1,728,309772,1,155
2011-01-10,spring,2011,January,19,Monday,Workingday,Clear,0.16,0.1667,0.47,0.1642,3,92,95,95,721,95,1,2,1,121,1,728,226789,1,95
2011-01-10,spring,2011,January,20,Monday,Workingday,Clear,0.16,0.1667,0.5,0.1642,1,73,74,74,721,74,1,2,1,121,1,728,164550,1,74
2011-01-10,spring,2011,January,21,Monday,Workingday,Clear,0.14,0.1364,0.59,0.194,1,37,38,38,721,38,1,1,1,111,1,728,125445,1,38
2011-01-10,spring,2011,January,22,Monday,Workingday,Clear,0.14,0.1515,0.59,0.1642,2,22,24,24,721,24,1,1,1,111,1,728,95612,1,24
2011-01-10,spring,2011,January,23,Monday,Workingday,Clear,0.14,0.1515,0.59,0.1642,0,18,18,18,721,18,1,1,1,111,1,728,63941,1,18
2011-01-11,spring,2011,January,0,Tuesday,Workingday,Clear,0.14,0.1667,0.59,0.1045,2,10,12,12,720,12,1,1,1,111,1,726,39130,1,12
2011-01-11,spring,2011,January,1,Tuesday,Workingday,Clear,0.14,0.1515,0.59,0.1642,0,3,3,3,720,3,1,1,1,111,1,724,24164,1,3
2011-01-11,spring,2011,January,2,Tuesday,Workingday,Mist,0.16,0.1515,0.55,0.194,0,3,3,3,720,3,1,1,1,111,1,715,16352,1,3
2011-01-11,spring,2011,January,5,Tuesday,Workingday,Mist,0.16,0.1818,0.55,0.1343,0,6,6,6,720,6,1,1,1,111,1,717,14261,1,6
2011-01-11,spring,2011,January,6,Tuesday,Workingday,Mist,0.16,0.1818,0.55,0.1343,0,27,27,27,720,27,1,1,1,111,1,725,55132,1,27
2011-01-11,spring,2011,January,7,Tuesday,Workingday,Mist,0.16,0.2273,0.55,0.0,2,97,99,99,720,99,1,2,1,121,1,727,154171,1,99
2011-01-11,spring,2011,January,8,Tuesday,Workingday,Mist,0.18,0.2121,0.51,0.0896,3,214,217,217,720,217,1,3,1,131,1,727,261001,1,217
2011-01-11,spring,2011,January,9,Tuesday,Workingday,Mist,0.18,0.197,0.51,0.1642,3,127,130,130,720,130,1,2,1,121,1,727,159438,1,130
2011-01-11,spring,2011,January,10,Tuesday,Workingday,Mist,0.2,0.2121,0.51,0.1642,3,51,54,54,720,54,1,2,1,121,1,727,126257,1,54
2011-01-11,spring,2011,January,11,Tuesday,Workingday,Mist,0.2,0.2121,0.47,0.1343,4,31,35,35,720,35,1,1,1,111,1,727,151320,1,35
2011-01-11,spring,2011,January,12,Tuesday,Workingday,Mist,0.2,0.2273,0.51,0.1045,2,55,57,57,720,57,1,2,1,121,1,728,184414,1,57
2011-01-11,spring,2011,January,13,Tuesday,Workingday,Mist,0.2,0.2273,0.59,0.0896,6,46,52,52,720,52,1,2,1,121,1,729,184919,1,52
2011-01-11,spring,2011,January,14,Tuesday,Workingday,Mist,0.2,0.2273,0.59,0.0896,3,60,63,63,720,63,1,2,1,121,1,729,175652,1,63
2011-01-11,spring,2011,January,15,Tuesday,Workingday,Mist,0.16,0.197,0.8,0.0896,2,45,47,47,720,47,1,2,1,121,1,729,183149,1,47
2011-01-11,spring,2011,January,16,Tuesday,Workingday,Mist,0.16,0.1515,0.86,0.2239,4,72,76,76,720,76,1,2,1,121,1,730,227748,1,76
2011-01-11,spring,2011,January,17,Tuesday,Workingday,Mist,0.16,0.1515,0.86,0.2239,6,130,136,136,720,136,1,2,1,121,1,730,336860,1,136
2011-01-11,spring,2011,January,18,Tuesday,Workingday,Light Snow,0.16,0.1818,0.93,0.1045,1,94,95,95,720,95,1,2,1,121,1,728,309772,1,95
2011-01-11,spring,2011,January,19,Tuesday,Workingday,Light Snow,0.16,0.2273,0.93,0.0,0,51,51,51,720,51,1,2,1,121,1,728,226789,1,51
2011-01-11,spring,2011,January,20,Tuesday,Workingday,Light Snow,0.16,0.1515,0.93,0.194,0,32,32,32,720,32,1,1,1,111,1,728,164550,1,32
2011-01-11,spring,2011,January,21,Tuesday,Workingday,Light Snow,0.16,0.197,0.86,0.0896,0,20,20,20,720,20,1,1,1,111,1,728,125445,1,20
2011-01-11,spring,2011,January,22,Tuesday,Workingday,Light Snow,0.16,0.1818,0.93,0.1045,1,28,29,29,720,29,1,1,1,111,1,728,95612,1,29
2011-01-11,spring,2011,January,23,Tuesday,Workingday,Light Snow,0.16,0.197,0.93,0.0896,1,18,19,19,720,19,1,1,1,111,1,728,63941,1,19
2011-01-12,spring,2011,January,0,Wednesday,Workingday,Mist,0.16,0.197,0.86,0.0896,0,7,7,7,719,7,1,1,1,111,1,726,39130,1,7
2011-01-12,spring,2011,January,1,Wednesday,Workingday,Mist,0.16,0.1818,0.86,0.1045,0,6,6,6,719,6,1,1,1,111,1,724,24164,1,6
2011-01-12,spring,2011,January,2,Wednesday,Workingday,Clear,0.14,0.1515,0.86,0.1343,0,1,1,1,719,1,1,1,1,111,1,715,16352,1,1
2011-01-12,spring,2011,January,5,Wednesday,Workingday,Clear,0.14,0.1515,0.86,0.1642,0,5,5,5,719,5,1,1,1,111,1,717,14261,1,5
2011-01-12,spring,2011,January,6,Wednesday,Workingday,Clear,0.12,0.1515,0.93,0.1343,0,16,16,16,719,16,1,1,1,111,1,725,55132,1,16
2011-01-12,spring,2011,January,7,Wednesday,Workingday,Clear,0.14,0.1515,0.69,0.1343,0,54,54,54,719,54,1,2,1,121,1,727,154171,1,54
2011-01-12,spring,2011,January,8,Wednesday,Workingday,Clear,0.16,0.1667,0.59,0.1642,3,125,128,128,719,128,1,2,1,121,1,727,261001,1,128
2011-01-12,spring,2011,January,9,Wednesday,Workingday,Clear,0.16,0.1364,0.59,0.3284,3,78,81,81,719,81,1,2,1,121,1,727,159438,1,81
2011-01-12,spring,2011,January,10,Wednesday,Workingday,Clear,0.18,0.1818,0.55,0.2239,0,39,39,39,719,39,1,1,1,111,1,727,126257,1,39
2011-01-12,spring,2011,January,11,Wednesday,Workingday,Clear,0.2,0.1818,0.51,0.3881,3,32,35,35,719,35,1,1,1,111,1,727,151320,1,35
2011-01-12,spring,2011,January,12,Wednesday,Workingday,Clear,0.2,0.1515,0.47,0.5821,3,52,55,55,719,55,1,2,1,121,1,728,184414,1,55
2011-01-12,spring,2011,January,13,Wednesday,Workingday,Clear,0.22,0.197,0.44,0.3582,0,49,49,49,719,49,1,2,1,121,1,729,184919,1,49
2011-01-12,spring,2011,January,14,Wednesday,Workingday,Clear,0.2,0.1818,0.47,0.3284,0,44,44,44,719,44,1,2,1,121,1,729,175652,1,44
2011-01-12,spring,2011,January,15,Wednesday,Workingday,Clear,0.2,0.1667,0.47,0.4179,1,48,49,49,719,49,1,2,1,121,1,729,183149,1,49
2011-01-12,spring,2011,January,16,Wednesday,Workingday,Clear,0.22,0.197,0.44,0.3284,5,63,68,68,719,68,1,2,1,121,1,730,227748,1,68
2011-01-12,spring,2011,January,17,Wednesday,Workingday,Clear,0.2,0.1818,0.47,0.3582,0,139,139,139,719,139,1,2,1,121,1,730,336860,1,139
2011-01-12,spring,2011,January,18,Wednesday,Workingday,Clear,0.2,0.1515,0.47,0.5224,2,135,137,137,719,137,1,2,1,121,1,728,309772,1,137
2011-01-12,spring,2011,January,19,Wednesday,Workingday,Clear,0.18,0.1515,0.47,0.4179,1,82,83,83,719,83,1,2,1,121,1,728,226789,1,83
2011-01-12,spring,2011,January,20,Wednesday,Workingday,Clear,0.16,0.1364,0.5,0.3284,2,54,56,56,719,56,1,2,1,121,1,728,164550,1,56
2011-01-12,spring,2011,January,21,Wednesday,Workingday,Clear,0.16,0.1364,0.55,0.3284,0,57,57,57,719,57,1,2,1,121,1,728,125445,1,57
2011-01-12,spring,2011,January,22,Wednesday,Workingday,Clear,0.16,0.1212,0.55,0.4478,1,32,33,33,719,33,1,1,1,111,1,728,95612,1,33
2011-01-12,spring,2011,January,23,Wednesday,Workingday,Clear,0.14,0.1061,0.59,0.4179,1,19,20,20,719,20,1,1,1,111,1,728,63941,1,20
2011-01-13,spring,2011,January,0,Thursday,Workingday,Clear,0.14,0.1212,0.59,0.2836,1,6,7,7,718,7,1,1,1,111,1,726,39130,1,7
2011-01-13,spring,2011,January,1,Thursday,Workingday,Clear,0.14,0.1212,0.5,0.2836,0,2,2,2,718,2,1,1,1,111,1,724,24164,1,2
2011-01-13,spring,2011,January,2,Thursday,Workingday,Clear,0.14,0.1212,0.5,0.3582,0,2,2,2,718,2,1,1,1,111,1,715,16352,1,2
2011-01-13,spring,2011,January,3,Thursday,Workingday,Clear,0.14,0.1212,0.5,0.3284,0,3,3,3,718,3,1,1,1,111,1,697,8174,1,3
2011-01-13,spring,2011,January,4,Thursday,Workingday,Clear,0.14,0.1212,0.5,0.2537,0,4,4,4,718,4,1,1,1,111,1,697,4428,1,4
2011-01-13,spring,2011,January,5,Thursday,Workingday,Clear,0.14,0.1212,0.5,0.2985,0,3,3,3,718,3,1,1,1,111,1,717,14261,1,3
2011-01-13,spring,2011,January,6,Thursday,Workingday,Clear,0.12,0.1515,0.54,0.1343,0,28,28,28,718,28,1,1,1,111,1,725,55132,1,28
2011-01-13,spring,2011,January,7,Thursday,Workingday,Clear,0.12,0.1515,0.54,0.1343,0,72,72,72,718,72,1,2,1,121,1,727,154171,1,72
2011-01-13,spring,2011,January,8,Thursday,Workingday,Clear,0.14,0.1364,0.5,0.194,5,197,202,202,718,202,1,3,1,131,1,727,261001,1,202
2011-01-13,spring,2011,January,9,Thursday,Workingday,Clear,0.14,0.1212,0.5,0.3284,2,137,139,139,718,139,1,2,1,121,1,727,159438,1,139
2011-01-13,spring,2011,January,10,Thursday,Workingday,Mist,0.16,0.1364,0.5,0.3582,2,36,38,38,718,38,1,1,1,111,1,727,126257,1,38
2011-01-13,spring,2011,January,11,Thursday,Workingday,Mist,0.2,0.1667,0.44,0.4478,4,33,37,37,718,37,1,1,1,111,1,727,151320,1,37
2011-01-13,spring,2011,January,12,Thursday,Workingday,Clear,0.2,0.1667,0.44,0.4179,3,49,52,52,718,52,1,2,1,121,1,728,184414,1,52
2011-01-13,spring,2011,January,13,Thursday,Workingday,Clear,0.22,0.197,0.41,0.4478,2,81,83,83,718,83,1,2,1,121,1,729,184919,1,83
2011-01-13,spring,2011,January,14,Thursday,Workingday,Clear,0.22,0.197,0.41,0.3881,3,39,42,42,718,42,1,2,1,121,1,729,175652,1,42
2011-01-13,spring,2011,January,15,Thursday,Workingday,Clear,0.24,0.2121,0.38,0.2985,5,55,60,60,718,60,1,2,1,121,1,729,183149,1,60
2011-01-13,spring,2011,January,16,Thursday,Workingday,Clear,0.24,0.2121,0.38,0.3582,2,76,78,78,718,78,1,2,1,121,1,730,227748,1,78
2011-01-13,spring,2011,January,17,Thursday,Workingday,Clear,0.2,0.1818,0.4,0.2836,4,158,162,162,718,162,1,3,1,131,1,730,336860,1,162
2011-01-13,spring,2011,January,18,Thursday,Workingday,Clear,0.2,0.1818,0.4,0.3284,3,141,144,144,718,144,1,3,1,131,1,728,309772,1,144
2011-01-13,spring,2011,January,19,Thursday,Workingday,Clear,0.16,0.1515,0.47,0.2537,1,98,99,99,718,99,1,2,1,121,1,728,226789,1,99
2011-01-13,spring,2011,January,20,Thursday,Workingday,Clear,0.16,0.1515,0.47,0.2239,0,64,64,64,718,64,1,2,1,121,1,728,164550,1,64
2011-01-13,spring,2011,January,21,Thursday,Workingday,Clear,0.14,0.1212,0.46,0.2985,0,40,40,40,718,40,1,1,1,111,1,728,125445,1,40
2011-01-13,spring,2011,January,22,Thursday,Workingday,Clear,0.14,0.1212,0.46,0.3284,0,30,30,30,718,30,1,1,1,111,1,728,95612,1,30
2011-01-13,spring,2011,January,23,Thursday,Workingday,Clear,0.12,0.1364,0.5,0.194,1,14,15,15,718,15,1,1,1,111,1,728,63941,1,15
2011-01-14,spring,2011,January,0,Friday,Workingday,Clear,0.12,0.1364,0.5,0.194,0,14,14,14,717,14,1,1,1,111,1,726,39130,1,14
2011-01-14,spring,2011,January,1,Friday,Workingday,Clear,0.1,0.1212,0.54,0.1642,0,5,5,5,717,5,1,1,1,111,1,724,24164,1,5
2011-01-14,spring,2011,January,2,Friday,Workingday,Clear,0.1,0.1212,0.54,0.1343,0,1,1,1,717,1,1,1,1,111,1,715,16352,1,1
2011-01-14,spring,2011,January,3,Friday,Workingday,Clear,0.1,0.1364,0.54,0.1045,0,1,1,1,717,1,1,1,1,111,1,697,8174,1,1
2011-01-14,spring,2011,January,5,Friday,Workingday,Clear,0.1,0.1364,0.54,0.0896,0,8,8,8,717,8,1,1,1,111,1,717,14261,1,8
2011-01-14,spring,2011,January,6,Friday,Workingday,Clear,0.1,0.1818,0.54,0.0,0,17,17,17,717,17,1,1,1,111,1,725,55132,1,17
2011-01-14,spring,2011,January,7,Friday,Workingday,Clear,0.1,0.1212,0.74,0.1642,0,70,70,70,717,70,1,2,1,121,1,727,154171,1,70
2011-01-14,spring,2011,January,8,Friday,Workingday,Clear,0.12,0.1667,0.68,0.0,2,156,158,158,717,158,1,3,1,131,1,727,261001,1,158
2011-01-14,spring,2011,January,9,Friday,Workingday,Clear,0.14,0.1515,0.69,0.1343,0,117,117,117,717,117,1,2,1,121,1,727,159438,1,117
2011-01-14,spring,2011,January,10,Friday,Workingday,Clear,0.18,0.1818,0.55,0.194,4,40,44,44,717,44,1,2,1,121,1,727,126257,1,44
2011-01-14,spring,2011,January,11,Friday,Workingday,Clear,0.18,0.1667,0.51,0.2836,6,47,53,53,717,53,1,2,1,121,1,727,151320,1,53
2011-01-14,spring,2011,January,12,Friday,Workingday,Clear,0.2,0.197,0.44,0.2537,2,59,61,61,717,61,1,2,1,121,1,728,184414,1,61
2011-01-14,spring,2011,January,13,Friday,Workingday,Clear,0.22,0.197,0.37,0.3881,4,73,77,77,717,77,1,2,1,121,1,729,184919,1,77
2011-01-14,spring,2011,January,14,Friday,Workingday,Clear,0.22,0.2121,0.41,0.2836,5,59,64,64,717,64,1,2,1,121,1,729,175652,1,64
2011-01-14,spring,2011,January,15,Friday,Workingday,Clear,0.24,0.2424,0.38,0.1642,9,59,68,68,717,68,1,2,1,121,1,729,183149,1,68
2011-01-14,spring,2011,January,16,Friday,Workingday,Clear,0.22,0.2424,0.41,0.1045,3,87,90,90,717,90,1,2,1,121,1,730,227748,1,90
2011-01-14,spring,2011,January,17,Friday,Workingday,Clear,0.22,0.2273,0.41,0.1642,4,155,159,159,717,159,1,3,1,131,1,730,336860,1,159
2011-01-14,spring,2011,January,18,Friday,Workingday,Clear,0.2,0.2576,0.47,0.0,5,134,139,139,717,139,1,2,1,121,1,728,309772,1,139
2011-01-14,spring,2011,January,19,Friday,Workingday,Clear,0.16,0.197,0.59,0.0896,3,89,92,92,717,92,1,2,1,121,1,728,226789,1,92
2011-01-14,spring,2011,January,20,Friday,Workingday,Clear,0.18,0.2424,0.59,0.0,0,68,68,68,717,68,1,2,1,121,1,728,164550,1,68
2011-01-14,spring,2011,January,21,Friday,Workingday,Clear,0.16,0.2273,0.69,0.0,4,48,52,52,717,52,1,2,1,121,1,728,125445,1,52
2011-01-14,spring,2011,January,22,Friday,Workingday,Mist,0.16,0.2273,0.69,0.0,2,34,36,36,717,36,1,1,1,111,1,728,95612,1,36
2011-01-14,spring,2011,January,23,Friday,Workingday,Mist,0.18,0.2424,0.55,0.0,1,26,27,27,717,27,1,1,1,111,1,728,63941,1,27
2011-01-15,spring,2011,January,0,Saturday,Holiday,Clear,0.18,0.2424,0.55,0.0,3,25,28,28,716,28,1,1,1,111,1,726,39130,1,28
2011-01-15,spring,2011,January,1,Saturday,Holiday,Mist,0.16,0.197,0.59,0.0896,2,18,20,20,716,20,1,1,1,111,1,724,24164,1,20
2011-01-15,spring,2011,January,2,Saturday,Holiday,Mist,0.16,0.197,0.59,0.0896,0,12,12,12,716,12,1,1,1,111,1,715,16352,1,12
2011-01-15,spring,2011,January,3,Saturday,Holiday,Mist,0.16,0.2273,0.59,0.0,1,7,8,8,716,8,1,1,1,111,1,697,8174,1,8
2011-01-15,spring,2011,January,4,Saturday,Holiday,Mist,0.16,0.2273,0.59,0.0,0,5,5,5,716,5,1,1,1,111,1,697,4428,1,5
2011-01-15,spring,2011,January,5,Saturday,Holiday,Clear,0.16,0.2273,0.59,0.0,0,1,1,1,716,1,1,1,1,111,1,717,14261,1,1
2011-01-15,spring,2011,January,6,Saturday,Holiday,Clear,0.14,0.1667,0.63,0.1045,1,2,3,3,716,3,1,1,1,111,1,725,55132,1,3
2011-01-15,spring,2011,January,7,Saturday,Holiday,Clear,0.14,0.2121,0.63,0.0,1,9,10,10,716,10,1,1,1,111,1,727,154171,1,10
2011-01-15,spring,2011,January,8,Saturday,Holiday,Clear,0.14,0.1515,0.63,0.1343,1,22,23,23,716,23,1,1,1,111,1,727,261001,1,23
2011-01-15,spring,2011,January,9,Saturday,Holiday,Clear,0.16,0.1818,0.64,0.1343,2,31,33,33,716,33,1,1,1,111,1,727,159438,1,33
2011-01-15,spring,2011,January,10,Saturday,Holiday,Clear,0.18,0.197,0.59,0.1642,2,57,59,59,716,59,1,2,1,121,1,727,126257,1,59
2011-01-15,spring,2011,January,11,Saturday,Holiday,Clear,0.2,0.197,0.55,0.2239,18,54,72,72,716,72,1,2,1,121,1,727,151320,1,72
2011-01-15,spring,2011,January,12,Saturday,Holiday,Clear,0.24,0.2273,0.48,0.2239,15,74,89,89,716,89,1,2,1,121,1,728,184414,1,89
2011-01-15,spring,2011,January,13,Saturday,Holiday,Clear,0.28,0.2576,0.38,0.2985,21,80,101,101,716,101,1,2,1,121,1,729,184919,1,101
2011-01-15,spring,2011,January,14,Saturday,Holiday,Clear,0.3,0.2879,0.39,0.2836,26,92,118,118,716,118,1,2,1,121,1,729,175652,1,118
2011-01-15,spring,2011,January,15,Saturday,Holiday,Mist,0.32,0.3182,0.36,0.194,21,108,129,129,716,129,1,2,1,121,1,729,183149,1,129
2011-01-15,spring,2011,January,16,Saturday,Holiday,Mist,0.34,0.3333,0.34,0.194,33,95,128,128,716,128,1,2,1,121,1,730,227748,1,128
2011-01-15,spring,2011,January,17,Saturday,Holiday,Mist,0.32,0.303,0.36,0.2836,29,54,83,83,716,83,1,2,1,121,1,730,336860,1,83
2011-01-15,spring,2011,January,18,Saturday,Holiday,Mist,0.3,0.2879,0.45,0.2537,15,69,84,84,716,84,1,2,1,121,1,728,309772,1,84
2011-01-15,spring,2011,January,19,Saturday,Holiday,Mist,0.32,0.303,0.39,0.2537,14,60,74,74,716,74,1,2,1,121,1,728,226789,1,74
2011-01-15,spring,2011,January,20,Saturday,Holiday,Mist,0.32,0.303,0.39,0.2537,6,35,41,41,716,41,1,2,1,121,1,728,164550,1,41
2011-01-15,spring,2011,January,21,Saturday,Holiday,Mist,0.32,0.303,0.39,0.2239,6,51,57,57,716,57,1,2,1,121,1,728,125445,1,57
2011-01-15,spring,2011,January,22,Saturday,Holiday,Mist,0.3,0.3182,0.42,0.1045,0,26,26,26,716,26,1,1,1,111,1,728,95612,1,26
2011-01-15,spring,2011,January,23,Saturday,Holiday,Clear,0.3,0.2879,0.45,0.2836,5,39,44,44,716,44,1,2,1,121,1,728,63941,1,44
2011-01-16,spring,2011,January,0,Sunday,Holiday,Clear,0.26,0.303,0.56,0.0,6,33,39,39,715,39,1,1,1,111,1,726,39130,1,39
2011-01-16,spring,2011,January,1,Sunday,Holiday,Clear,0.26,0.2727,0.56,0.1343,4,19,23,23,715,23,1,1,1,111,1,724,24164,1,23
2011-01-16,spring,2011,January,2,Sunday,Holiday,Clear,0.26,0.2879,0.56,0.0896,3,13,16,16,715,16,1,1,1,111,1,715,16352,1,16
2011-01-16,spring,2011,January,3,Sunday,Holiday,Clear,0.22,0.2727,0.69,0.0,9,6,15,15,715,15,1,1,1,111,1,697,8174,1,15
2011-01-16,spring,2011,January,4,Sunday,Holiday,Clear,0.26,0.2576,0.56,0.1642,0,1,1,1,715,1,1,1,1,111,1,697,4428,1,1
2011-01-16,spring,2011,January,5,Sunday,Holiday,Mist,0.26,0.2576,0.56,0.1642,1,1,2,2,715,2,1,1,1,111,1,717,14261,1,2
2011-01-16,spring,2011,January,6,Sunday,Holiday,Mist,0.26,0.2576,0.56,0.1642,0,1,1,1,715,1,1,1,1,111,1,725,55132,1,1
2011-01-16,spring,2011,January,7,Sunday,Holiday,Mist,0.24,0.2121,0.56,0.2985,0,3,3,3,715,3,1,1,1,111,1,727,154171,1,3
2011-01-16,spring,2011,January,8,Sunday,Holiday,Clear,0.22,0.2121,0.55,0.2836,0,18,18,18,715,18,1,1,1,111,1,727,261001,1,18
2011-01-16,spring,2011,January,9,Sunday,Holiday,Clear,0.22,0.2121,0.51,0.2537,3,29,32,32,715,32,1,1,1,111,1,727,159438,1,32
2011-01-16,spring,2011,January,10,Sunday,Holiday,Clear,0.22,0.2121,0.51,0.2836,8,71,79,79,715,79,1,2,1,121,1,727,126257,1,79
2011-01-16,spring,2011,January,11,Sunday,Holiday,Clear,0.24,0.2273,0.44,0.2537,23,70,93,93,715,93,1,2,1,121,1,727,151320,1,93
2011-01-16,spring,2011,January,12,Sunday,Holiday,Clear,0.24,0.2121,0.41,0.2836,29,75,104,104,715,104,1,2,1,121,1,728,184414,1,104
2011-01-16,spring,2011,January,13,Sunday,Holiday,Clear,0.26,0.2273,0.35,0.2985,23,95,118,118,715,118,1,2,1,121,1,729,184919,1,118
2011-01-16,spring,2011,January,14,Sunday,Holiday,Clear,0.28,0.2727,0.36,0.2537,22,69,91,91,715,91,1,2,1,121,1,729,175652,1,91
2011-01-16,spring,2011,January,15,Sunday,Holiday,Clear,0.26,0.2424,0.38,0.2537,35,78,113,113,715,113,1,2,1,121,1,729,183149,1,113
2011-01-16,spring,2011,January,16,Sunday,Holiday,Clear,0.24,0.2273,0.38,0.2239,22,77,99,99,715,99,1,2,1,121,1,730,227748,1,99
2011-01-16,spring,2011,January,17,Sunday,Holiday,Clear,0.22,0.2121,0.37,0.2537,23,82,105,105,715,105,1,2,1,121,1,730,336860,1,105
2011-01-16,spring,2011,January,18,Sunday,Holiday,Clear,0.2,0.2121,0.4,0.1642,11,56,67,67,715,67,1,2,1,121,1,728,309772,1,67
2011-01-16,spring,2011,January,19,Sunday,Holiday,Clear,0.18,0.197,0.47,0.1343,14,47,61,61,715,61,1,2,1,121,1,728,226789,1,61
2011-01-16,spring,2011,January,20,Sunday,Holiday,Clear,0.18,0.197,0.47,0.1642,7,50,57,57,715,57,1,2,1,121,1,728,164550,1,57
2011-01-16,spring,2011,January,21,Sunday,Holiday,Clear,0.18,0.197,0.51,0.1642,6,22,28,28,715,28,1,1,1,111,1,728,125445,1,28
2011-01-16,spring,2011,January,22,Sunday,Holiday,Mist,0.2,0.2121,0.49,0.1343,2,19,21,21,715,21,1,1,1,111,1,728,95612,1,21
2011-01-16,spring,2011,January,23,Sunday,Holiday,Mist,0.2,0.2273,0.4,0.1045,0,18,18,18,715,18,1,1,1,111,1,728,63941,1,18
2011-01-17,spring,2011,January,0,Monday,Holiday,Mist,0.2,0.197,0.47,0.2239,1,16,17,17,714,17,1,1,1,111,1,726,39130,1,17
2011-01-17,spring,2011,January,1,Monday,Holiday,Mist,0.2,0.197,0.44,0.194,1,15,16,16,714,16,1,1,1,111,1,724,24164,1,16
2011-01-17,spring,2011,January,2,Monday,Holiday,Mist,0.18,0.1667,0.43,0.2537,0,8,8,8,714,8,1,1,1,111,1,715,16352,1,8
2011-01-17,spring,2011,January,3,Monday,Holiday,Mist,0.18,0.1818,0.43,0.194,0,2,2,2,714,2,1,1,1,111,1,697,8174,1,2
2011-01-17,spring,2011,January,4,Monday,Holiday,Mist,0.18,0.197,0.43,0.1343,1,2,3,3,714,3,1,1,1,111,1,697,4428,1,3
2011-01-17,spring,2011,January,5,Monday,Holiday,Mist,0.18,0.197,0.43,0.1642,0,1,1,1,714,1,1,1,1,111,1,717,14261,1,1
2011-01-17,spring,2011,January,6,Monday,Holiday,Mist,0.18,0.1818,0.43,0.194,0,5,5,5,714,5,1,1,1,111,1,725,55132,1,5
2011-01-17,spring,2011,January,7,Monday,Holiday,Mist,0.16,0.1818,0.5,0.1343,4,9,13,13,714,13,1,1,1,111,1,727,154171,1,13
2011-01-17,spring,2011,January,8,Monday,Holiday,Mist,0.16,0.1515,0.47,0.2239,3,30,33,33,714,33,1,1,1,111,1,727,261001,1,33
2011-01-17,spring,2011,January,9,Monday,Holiday,Mist,0.16,0.1515,0.47,0.2239,8,39,47,47,714,47,1,2,1,121,1,727,159438,1,47
2011-01-17,spring,2011,January,10,Monday,Holiday,Mist,0.16,0.1515,0.5,0.2537,7,50,57,57,714,57,1,2,1,121,1,727,126257,1,57
2011-01-17,spring,2011,January,11,Monday,Holiday,Mist,0.16,0.1515,0.55,0.194,9,55,64,64,714,64,1,2,1,121,1,727,151320,1,64
2011-01-17,spring,2011,January,12,Monday,Holiday,Mist,0.18,0.197,0.47,0.1343,10,70,80,80,714,80,1,2,1,121,1,728,184414,1,80
2011-01-17,spring,2011,January,13,Monday,Holiday,Mist,0.18,0.197,0.47,0.1343,13,80,93,93,714,93,1,2,1,121,1,729,184919,1,93
2011-01-17,spring,2011,January,14,Monday,Holiday,Mist,0.18,0.2121,0.43,0.1045,12,74,86,86,714,86,1,2,1,121,1,729,175652,1,86
2011-01-17,spring,2011,January,15,Monday,Holiday,Mist,0.2,0.2121,0.47,0.1642,21,72,93,93,714,93,1,2,1,121,1,729,183149,1,93
2011-01-17,spring,2011,January,16,Monday,Holiday,Mist,0.2,0.2121,0.47,0.1642,6,76,82,82,714,82,1,2,1,121,1,730,227748,1,82
2011-01-17,spring,2011,January,17,Monday,Holiday,Clear,0.2,0.197,0.51,0.194,4,67,71,71,714,71,1,2,1,121,1,730,336860,1,71
2011-01-17,spring,2011,January,18,Monday,Holiday,Mist,0.18,0.1667,0.55,0.2537,7,85,92,92,714,92,1,2,1,121,1,728,309772,1,92
2011-01-17,spring,2011,January,19,Monday,Holiday,Light Snow,0.18,0.1818,0.59,0.194,2,58,60,60,714,60,1,2,1,121,1,728,226789,1,60
2011-01-17,spring,2011,January,20,Monday,Holiday,Light Snow,0.16,0.1515,0.8,0.194,4,29,33,33,714,33,1,1,1,111,1,728,164550,1,33
2011-01-17,spring,2011,January,21,Monday,Holiday,Light Snow,0.16,0.1515,0.8,0.194,3,24,27,27,714,27,1,1,1,111,1,728,125445,1,27
2011-01-17,spring,2011,January,22,Monday,Holiday,Light Snow,0.14,0.1212,0.93,0.2537,0,13,13,13,714,13,1,1,1,111,1,728,95612,1,13
2011-01-17,spring,2011,January,23,Monday,Holiday,Light Snow,0.16,0.1364,0.86,0.2836,1,3,4,4,714,4,1,1,1,111,1,728,63941,1,4
2011-01-18,spring,2011,January,12,Tuesday,Workingday,Mist,0.2,0.1818,0.86,0.3284,0,3,3,3,713,3,1,1,1,111,1,728,184414,1,3
2011-01-18,spring,2011,January,13,Tuesday,Workingday,Mist,0.2,0.197,0.86,0.2239,0,22,22,22,713,22,1,1,1,111,1,729,184919,1,22
2011-01-18,spring,2011,January,14,Tuesday,Workingday,Mist,0.22,0.2273,0.8,0.1642,2,26,28,28,713,28,1,1,1,111,1,729,175652,1,28
2011-01-18,spring,2011,January,15,Tuesday,Workingday,Mist,0.22,0.2273,0.87,0.1642,3,32,35,35,713,35,1,1,1,111,1,729,183149,1,35
2011-01-18,spring,2011,January,16,Tuesday,Workingday,Mist,0.22,0.2273,0.87,0.194,0,61,61,61,713,61,1,2,1,121,1,730,227748,1,61
2011-01-18,spring,2011,January,17,Tuesday,Workingday,Mist,0.22,0.2273,0.82,0.194,1,124,125,125,713,125,1,2,1,121,1,730,336860,1,125
2011-01-18,spring,2011,January,18,Tuesday,Workingday,Mist,0.22,0.2273,0.8,0.1642,1,132,133,133,713,133,1,2,1,121,1,728,309772,1,133
2011-01-18,spring,2011,January,19,Tuesday,Workingday,Mist,0.22,0.2273,0.8,0.1343,1,98,99,99,713,99,1,2,1,121,1,728,226789,1,99
2011-01-18,spring,2011,January,20,Tuesday,Workingday,Mist,0.22,0.2727,0.87,0.0,0,83,83,83,713,83,1,2,1,121,1,728,164550,1,83
2011-01-18,spring,2011,January,21,Tuesday,Workingday,Mist,0.22,0.2424,0.93,0.1045,0,41,41,41,713,41,1,2,1,121,1,728,125445,1,41
2011-01-18,spring,2011,January,22,Tuesday,Workingday,Mist,0.22,0.2576,0.93,0.0896,0,33,33,33,713,33,1,1,1,111,1,728,95612,1,33
2011-01-18,spring,2011,January,23,Tuesday,Workingday,Mist,0.22,0.2727,0.93,0.0,1,19,20,20,713,20,1,1,1,111,1,728,63941,1,20
2011-01-19,spring,2011,January,0,Wednesday,Workingday,Mist,0.22,0.2727,0.93,0.0,0,3,3,3,712,3,1,1,1,111,1,726,39130,1,3
2011-01-19,spring,2011,January,1,Wednesday,Workingday,Light Snow,0.22,0.2273,0.93,0.1343,1,6,7,7,712,7,1,1,1,111,1,724,24164,1,7
2011-01-19,spring,2011,January,2,Wednesday,Workingday,Light Snow,0.22,0.2273,0.93,0.1343,0,3,3,3,712,3,1,1,1,111,1,715,16352,1,3
2011-01-19,spring,2011,January,4,Wednesday,Workingday,Light Snow,0.22,0.2273,0.93,0.1343,1,1,2,2,712,2,1,1,1,111,1,697,4428,1,2
2011-01-19,spring,2011,January,5,Wednesday,Workingday,Mist,0.22,0.2576,0.93,0.0896,0,7,7,7,712,7,1,1,1,111,1,717,14261,1,7
2011-01-19,spring,2011,January,6,Wednesday,Workingday,Mist,0.22,0.2576,0.93,0.0896,0,32,32,32,712,32,1,1,1,111,1,725,55132,1,32
2011-01-19,spring,2011,January,7,Wednesday,Workingday,Mist,0.24,0.2576,0.92,0.1045,1,89,90,90,712,90,1,2,1,121,1,727,154171,1,90
2011-01-19,spring,2011,January,8,Wednesday,Workingday,Mist,0.24,0.2576,0.93,0.1045,1,196,197,197,712,197,1,3,1,131,1,727,261001,1,197
2011-01-19,spring,2011,January,9,Wednesday,Workingday,Mist,0.24,0.2576,0.93,0.1045,2,107,109,109,712,109,1,2,1,121,1,727,159438,1,109
2011-01-19,spring,2011,January,10,Wednesday,Workingday,Mist,0.26,0.2727,0.93,0.1343,1,46,47,47,712,47,1,2,1,121,1,727,126257,1,47
2011-01-19,spring,2011,January,11,Wednesday,Workingday,Mist,0.28,0.303,0.87,0.0896,5,47,52,52,712,52,1,2,1,121,1,727,151320,1,52
2011-01-19,spring,2011,January,12,Wednesday,Workingday,Mist,0.3,0.3182,0.81,0.0896,5,65,70,70,712,70,1,2,1,121,1,728,184414,1,70
2011-01-19,spring,2011,January,13,Wednesday,Workingday,Clear,0.4,0.4091,0.62,0.2836,11,67,78,78,712,78,1,2,2,122,1,729,184919,1,78
2011-01-19,spring,2011,January,14,Wednesday,Workingday,Clear,0.4,0.4091,0.58,0.2537,7,68,75,75,712,75,1,2,2,122,1,729,175652,1,75
2011-01-19,spring,2011,January,15,Wednesday,Workingday,Clear,0.4,0.4091,0.54,0.2836,4,78,82,82,712,82,1,2,2,122,1,729,183149,1,82
2011-01-19,spring,2011,January,16,Wednesday,Workingday,Clear,0.38,0.3939,0.58,0.3881,10,94,104,104,712,104,1,2,2,122,1,730,227748,1,104
2011-01-19,spring,2011,January,17,Wednesday,Workingday,Clear,0.36,0.3333,0.57,0.3284,7,190,197,197,712,197,1,3,1,131,1,730,336860,1,197
2011-01-19,spring,2011,January,18,Wednesday,Workingday,Clear,0.34,0.3182,0.61,0.2836,5,156,161,161,712,161,1,3,1,131,1,728,309772,1,161
2011-01-19,spring,2011,January,19,Wednesday,Workingday,Clear,0.32,0.2879,0.57,0.4179,4,108,112,112,712,112,1,2,1,121,1,728,226789,1,112
2011-01-19,spring,2011,January,20,Wednesday,Workingday,Clear,0.32,0.303,0.49,0.2985,2,74,76,76,712,76,1,2,1,121,1,728,164550,1,76
2011-01-19,spring,2011,January,21,Wednesday,Workingday,Clear,0.32,0.2879,0.49,0.4179,4,55,59,59,712,59,1,2,1,121,1,728,125445,1,59
2011-01-19,spring,2011,January,22,Wednesday,Workingday,Clear,0.3,0.303,0.52,0.1642,6,53,59,59,712,59,1,2,1,121,1,728,95612,1,59
2011-01-19,spring,2011,January,23,Wednesday,Workingday,Clear,0.3,0.2727,0.52,0.4627,1,27,28,28,712,28,1,1,1,111,1,728,63941,1,28
2011-01-20,spring,2011,January,0,Thursday,Workingday,Clear,0.26,0.2273,0.56,0.3881,5,8,13,13,711,13,1,1,1,111,1,726,39130,1,13
2011-01-20,spring,2011,January,1,Thursday,Workingday,Clear,0.26,0.2727,0.56,0.0,2,3,5,5,711,5,1,1,1,111,1,724,24164,1,5
2011-01-20,spring,2011,January,2,Thursday,Workingday,Clear,0.26,0.2727,0.56,0.0,0,2,2,2,711,2,1,1,1,111,1,715,16352,1,2
2011-01-20,spring,2011,January,3,Thursday,Workingday,Clear,0.26,0.2576,0.56,0.1642,0,1,1,1,711,1,1,1,1,111,1,697,8174,1,1
2011-01-20,spring,2011,January,4,Thursday,Workingday,Clear,0.26,0.2576,0.56,0.1642,0,1,1,1,711,1,1,1,1,111,1,697,4428,1,1
2011-01-20,spring,2011,January,5,Thursday,Workingday,Clear,0.24,0.2273,0.6,0.2239,0,6,6,6,711,6,1,1,1,111,1,717,14261,1,6
2011-01-20,spring,2011,January,6,Thursday,Workingday,Clear,0.22,0.2121,0.6,0.2239,0,35,35,35,711,35,1,1,1,111,1,725,55132,1,35
2011-01-20,spring,2011,January,7,Thursday,Workingday,Clear,0.22,0.2121,0.55,0.2239,1,100,101,101,711,101,1,2,1,121,1,727,154171,1,101
2011-01-20,spring,2011,January,8,Thursday,Workingday,Clear,0.22,0.2121,0.55,0.2836,2,247,249,249,711,249,1,3,1,131,1,727,261001,1,249
2011-01-20,spring,2011,January,9,Thursday,Workingday,Mist,0.24,0.2273,0.52,0.2239,3,140,143,143,711,143,1,3,1,131,1,727,159438,1,143
2011-01-20,spring,2011,January,10,Thursday,Workingday,Clear,0.26,0.2273,0.48,0.2985,1,56,57,57,711,57,1,2,1,121,1,727,126257,1,57
2011-01-20,spring,2011,January,11,Thursday,Workingday,Mist,0.28,0.2727,0.45,0.1642,5,63,68,68,711,68,1,2,1,121,1,727,151320,1,68
2011-01-20,spring,2011,January,12,Thursday,Workingday,Mist,0.3,0.3333,0.42,0.0,7,77,84,84,711,84,1,2,1,121,1,728,184414,1,84
2011-01-20,spring,2011,January,13,Thursday,Workingday,Mist,0.28,0.2879,0.45,0.1045,12,86,98,98,711,98,1,2,1,121,1,729,184919,1,98
2011-01-20,spring,2011,January,14,Thursday,Workingday,Mist,0.3,0.303,0.45,0.1343,6,75,81,81,711,81,1,2,1,121,1,729,175652,1,81
2011-01-20,spring,2011,January,15,Thursday,Workingday,Mist,0.32,0.3182,0.45,0.194,8,62,70,70,711,70,1,2,1,121,1,729,183149,1,70
2011-01-20,spring,2011,January,16,Thursday,Workingday,Mist,0.3,0.303,0.49,0.1343,8,83,91,91,711,91,1,2,1,121,1,730,227748,1,91
2011-01-20,spring,2011,January,17,Thursday,Workingday,Mist,0.3,0.3182,0.49,0.1045,8,207,215,215,711,215,1,3,1,131,1,730,336860,1,215
2011-01-20,spring,2011,January,18,Thursday,Workingday,Mist,0.26,0.2576,0.56,0.194,1,184,185,185,711,185,1,3,1,131,1,728,309772,1,185
2011-01-20,spring,2011,January,19,Thursday,Workingday,Clear,0.26,0.2273,0.56,0.3284,6,146,152,152,711,152,1,3,1,131,1,728,226789,1,152
2011-01-20,spring,2011,January,20,Thursday,Workingday,Mist,0.26,0.2424,0.6,0.2836,2,124,126,126,711,126,1,2,1,121,1,728,164550,1,126
2011-01-20,spring,2011,January,21,Thursday,Workingday,Mist,0.24,0.2273,0.6,0.2537,3,54,57,57,711,57,1,2,1,121,1,728,125445,1,57
2011-01-20,spring,2011,January,22,Thursday,Workingday,Mist,0.24,0.2121,0.65,0.2836,0,56,56,56,711,56,1,2,1,121,1,728,95612,1,56
2011-01-20,spring,2011,January,23,Thursday,Workingday,Mist,0.24,0.2121,0.65,0.3284,3,28,31,31,711,31,1,1,1,111,1,728,63941,1,31
2011-01-21,spring,2011,January,0,Friday,Workingday,Mist,0.24,0.2273,0.7,0.2537,1,20,21,21,710,21,1,1,1,111,1,726,39130,1,21
2011-01-21,spring,2011,January,1,Friday,Workingday,Mist,0.24,0.2273,0.7,0.2537,0,6,6,6,710,6,1,1,1,111,1,724,24164,1,6
2011-01-21,spring,2011,January,2,Friday,Workingday,Light Snow,0.24,0.2424,0.75,0.1642,0,2,2,2,710,2,1,1,1,111,1,715,16352,1,2
2011-01-21,spring,2011,January,3,Friday,Workingday,Light Snow,0.22,0.2121,0.8,0.2985,0,1,1,1,710,1,1,1,1,111,1,697,8174,1,1
2011-01-21,spring,2011,January,4,Friday,Workingday,Mist,0.22,0.2576,0.87,0.0896,0,1,1,1,710,1,1,1,1,111,1,697,4428,1,1
2011-01-21,spring,2011,January,5,Friday,Workingday,Clear,0.24,0.197,0.6,0.4179,1,4,5,5,710,5,1,1,1,111,1,717,14261,1,5
2011-01-21,spring,2011,January,6,Friday,Workingday,Clear,0.22,0.2121,0.55,0.2537,0,27,27,27,710,27,1,1,1,111,1,725,55132,1,27
2011-01-21,spring,2011,January,7,Friday,Workingday,Clear,0.2,0.1818,0.51,0.2836,2,66,68,68,710,68,1,2,1,121,1,727,154171,1,68
2011-01-21,spring,2011,January,8,Friday,Workingday,Clear,0.2,0.1818,0.47,0.3284,7,210,217,217,710,217,1,3,1,131,1,727,261001,1,217
2011-01-21,spring,2011,January,9,Friday,Workingday,Clear,0.2,0.1818,0.51,0.3582,7,159,166,166,710,166,1,3,1,131,1,727,159438,1,166
2011-01-21,spring,2011,January,10,Friday,Workingday,Clear,0.2,0.1667,0.47,0.4627,6,57,63,63,710,63,1,2,1,121,1,727,126257,1,63
2011-01-21,spring,2011,January,11,Friday,Workingday,Clear,0.22,0.1818,0.41,0.4627,6,53,59,59,710,59,1,2,1,121,1,727,151320,1,59
2011-01-21,spring,2011,January,12,Friday,Workingday,Clear,0.22,0.1818,0.27,0.5821,11,67,78,78,710,78,1,2,1,121,1,728,184414,1,78
2011-01-21,spring,2011,January,13,Friday,Workingday,Clear,0.2,0.1515,0.21,0.5821,8,65,73,73,710,73,1,2,1,121,1,729,184919,1,73
2011-01-21,spring,2011,January,14,Friday,Workingday,Clear,0.2,0.1515,0.25,0.5224,6,56,62,62,710,62,1,2,1,121,1,729,175652,1,62
2011-01-21,spring,2011,January,15,Friday,Workingday,Clear,0.16,0.1212,0.26,0.4478,4,61,65,65,710,65,1,2,1,121,1,729,183149,1,65
2011-01-21,spring,2011,January,16,Friday,Workingday,Clear,0.16,0.1364,0.26,0.3582,0,97,97,97,710,97,1,2,1,121,1,730,227748,1,97
2011-01-21,spring,2011,January,17,Friday,Workingday,Clear,0.14,0.1212,0.28,0.3582,10,151,161,161,710,161,1,3,1,131,1,730,336860,1,161
2011-01-21,spring,2011,January,18,Friday,Workingday,Clear,0.12,0.1212,0.3,0.2537,1,119,120,120,710,120,1,2,1,121,1,728,309772,1,120
2011-01-21,spring,2011,January,19,Friday,Workingday,Clear,0.12,0.1061,0.3,0.3284,3,93,96,96,710,96,1,2,1,121,1,728,226789,1,96
2011-01-21,spring,2011,January,20,Friday,Workingday,Clear,0.1,0.0758,0.33,0.4179,1,52,53,53,710,53,1,2,1,121,1,728,164550,1,53
2011-01-21,spring,2011,January,21,Friday,Workingday,Clear,0.08,0.0758,0.38,0.2836,0,41,41,41,710,41,1,2,1,121,1,728,125445,1,41
2011-01-21,spring,2011,January,22,Friday,Workingday,Clear,0.06,0.0303,0.41,0.3881,1,33,34,34,710,34,1,1,1,111,1,728,95612,1,34
2011-01-21,spring,2011,January,23,Friday,Workingday,Clear,0.06,0.0455,0.38,0.3284,0,27,27,27,710,27,1,1,1,111,1,728,63941,1,27
2011-01-22,spring,2011,January,0,Saturday,Holiday,Clear,0.04,0.0303,0.45,0.2537,0,13,13,13,709,13,1,1,1,111,1,726,39130,1,13
2011-01-22,spring,2011,January,1,Saturday,Holiday,Mist,0.04,0.0,0.41,0.3881,3,9,12,12,709,12,1,1,1,111,1,724,24164,1,12
2011-01-22,spring,2011,January,2,Saturday,Holiday,Mist,0.04,0.0303,0.41,0.2537,0,11,11,11,709,11,1,1,1,111,1,715,16352,1,11
2011-01-22,spring,2011,January,3,Saturday,Holiday,Mist,0.04,0.0303,0.41,0.2836,1,6,7,7,709,7,1,1,1,111,1,697,8174,1,7
2011-01-22,spring,2011,January,4,Saturday,Holiday,Mist,0.02,0.0152,0.48,0.2985,0,3,3,3,709,3,1,1,1,111,1,697,4428,1,3
2011-01-22,spring,2011,January,6,Saturday,Holiday,Mist,0.02,0.0303,0.44,0.2239,0,2,2,2,709,2,1,1,1,111,1,725,55132,1,2
2011-01-22,spring,2011,January,7,Saturday,Holiday,Clear,0.02,0.0152,0.44,0.2836,0,8,8,8,709,8,1,1,1,111,1,727,154171,1,8
2011-01-22,spring,2011,January,8,Saturday,Holiday,Clear,0.02,0.0,0.44,0.3284,1,26,27,27,709,27,1,1,1,111,1,727,261001,1,27
2011-01-22,spring,2011,January,9,Saturday,Holiday,Clear,0.04,0.0303,0.41,0.2537,3,37,40,40,709,40,1,1,1,111,1,727,159438,1,40
2011-01-22,spring,2011,January,10,Saturday,Holiday,Mist,0.04,0.0606,0.41,0.1642,3,50,53,53,709,53,1,2,1,121,1,727,126257,1,53
2011-01-22,spring,2011,January,11,Saturday,Holiday,Mist,0.06,0.0758,0.38,0.1343,4,59,63,63,709,63,1,2,1,121,1,727,151320,1,63
2011-01-22,spring,2011,January,12,Saturday,Holiday,Mist,0.06,0.1061,0.38,0.1045,10,60,70,70,709,70,1,2,1,121,1,728,184414,1,70
2011-01-22,spring,2011,January,13,Saturday,Holiday,Clear,0.08,0.1667,0.35,0.0,12,72,84,84,709,84,1,2,1,121,1,729,184919,1,84
2011-01-22,spring,2011,January,14,Saturday,Holiday,Clear,0.1,0.1364,0.33,0.1045,11,64,75,75,709,75,1,2,1,121,1,729,175652,1,75
2011-01-22,spring,2011,January,15,Saturday,Holiday,Clear,0.12,0.1515,0.28,0.0,10,93,103,103,709,103,1,2,1,121,1,729,183149,1,103
2011-01-22,spring,2011,January,16,Saturday,Holiday,Clear,0.12,0.1364,0.28,0.194,11,72,83,83,709,83,1,2,1,121,1,730,227748,1,83
2011-01-22,spring,2011,January,17,Saturday,Holiday,Clear,0.12,0.197,0.28,0.0,8,59,67,67,709,67,1,2,1,121,1,730,336860,1,67
2011-01-22,spring,2011,January,18,Saturday,Holiday,Clear,0.08,0.0909,0.35,0.194,0,54,54,54,709,54,1,2,1,121,1,728,309772,1,54
2011-01-22,spring,2011,January,19,Saturday,Holiday,Clear,0.08,0.1061,0.35,0.1343,6,53,59,59,709,59,1,2,1,121,1,728,226789,1,59
2011-01-22,spring,2011,January,20,Saturday,Holiday,Clear,0.06,0.0758,0.45,0.1642,1,44,45,45,709,45,1,2,1,121,1,728,164550,1,45
2011-01-22,spring,2011,January,21,Saturday,Holiday,Clear,0.06,0.1061,0.41,0.0896,0,39,39,39,709,39,1,1,1,111,1,728,125445,1,39
2011-01-22,spring,2011,January,22,Saturday,Holiday,Clear,0.06,0.1515,0.49,0.0,7,23,30,30,709,30,1,1,1,111,1,728,95612,1,30
2011-01-22,spring,2011,January,23,Saturday,Holiday,Clear,0.04,0.0758,0.57,0.1045,2,31,33,33,709,33,1,1,1,111,1,728,63941,1,33
2011-01-23,spring,2011,January,0,Sunday,Holiday,Clear,0.04,0.0758,0.57,0.1045,2,20,22,22,708,22,1,1,1,111,1,726,39130,1,22
2011-01-23,spring,2011,January,1,Sunday,Holiday,Clear,0.04,0.0758,0.57,0.1045,1,12,13,13,708,13,1,1,1,111,1,724,24164,1,13
2011-01-23,spring,2011,January,2,Sunday,Holiday,Clear,0.02,0.0606,0.62,0.1343,3,15,18,18,708,18,1,1,1,111,1,715,16352,1,18
2011-01-23,spring,2011,January,3,Sunday,Holiday,Clear,0.02,0.0606,0.62,0.1343,1,4,5,5,708,5,1,1,1,111,1,697,8174,1,5
2011-01-23,spring,2011,January,5,Sunday,Holiday,Mist,0.04,0.0758,0.57,0.1045,0,3,3,3,708,3,1,1,1,111,1,717,14261,1,3
2011-01-23,spring,2011,January,6,Sunday,Holiday,Mist,0.04,0.0758,0.57,0.1045,0,1,1,1,708,1,1,1,1,111,1,725,55132,1,1
2011-01-23,spring,2011,January,7,Sunday,Holiday,Clear,0.08,0.1061,0.58,0.1642,1,1,2,2,708,2,1,1,1,111,1,727,154171,1,2
2011-01-23,spring,2011,January,8,Sunday,Holiday,Clear,0.06,0.0758,0.62,0.1642,2,17,19,19,708,19,1,1,1,111,1,727,261001,1,19
2011-01-23,spring,2011,January,9,Sunday,Holiday,Clear,0.1,0.0758,0.54,0.3582,3,25,28,28,708,28,1,1,1,111,1,727,159438,1,28
2011-01-23,spring,2011,January,10,Sunday,Holiday,Clear,0.14,0.1061,0.46,0.3881,7,51,58,58,708,58,1,2,1,121,1,727,126257,1,58
2011-01-23,spring,2011,January,11,Sunday,Holiday,Clear,0.14,0.1364,0.43,0.2239,22,77,99,99,708,99,1,2,1,121,1,727,151320,1,99
2011-01-23,spring,2011,January,12,Sunday,Holiday,Clear,0.16,0.1212,0.37,0.4627,24,92,116,116,708,116,1,2,1,121,1,728,184414,1,116
2011-01-23,spring,2011,January,13,Sunday,Holiday,Clear,0.14,0.1061,0.33,0.3881,12,75,87,87,708,87,1,2,1,121,1,729,184919,1,87
2011-01-23,spring,2011,January,14,Sunday,Holiday,Clear,0.16,0.1364,0.28,0.3582,17,93,110,110,708,110,1,2,1,121,1,729,175652,1,110
2011-01-23,spring,2011,January,15,Sunday,Holiday,Clear,0.16,0.1364,0.28,0.3582,13,64,77,77,708,77,1,2,1,121,1,729,183149,1,77
2011-01-23,spring,2011,January,16,Sunday,Holiday,Clear,0.16,0.1364,0.26,0.3284,9,56,65,65,708,65,1,2,1,121,1,730,227748,1,65
2011-01-23,spring,2011,January,17,Sunday,Holiday,Clear,0.14,0.1061,0.26,0.3881,5,50,55,55,708,55,1,2,1,121,1,730,336860,1,55
2011-01-23,spring,2011,January,18,Sunday,Holiday,Clear,0.12,0.1212,0.3,0.2537,5,44,49,49,708,49,1,2,1,121,1,728,309772,1,49
2011-01-23,spring,2011,January,19,Sunday,Holiday,Clear,0.12,0.1212,0.3,0.2836,5,45,50,50,708,50,1,2,1,121,1,728,226789,1,50
2011-01-23,spring,2011,January,20,Sunday,Holiday,Clear,0.1,0.1061,0.36,0.2537,4,31,35,35,708,35,1,1,1,111,1,728,164550,1,35
2011-01-23,spring,2011,January,21,Sunday,Holiday,Clear,0.1,0.1061,0.36,0.194,5,20,25,25,708,25,1,1,1,111,1,728,125445,1,25
2011-01-23,spring,2011,January,22,Sunday,Holiday,Clear,0.08,0.0909,0.38,0.194,5,23,28,28,708,28,1,1,1,111,1,728,95612,1,28
2011-01-23,spring,2011,January,23,Sunday,Holiday,Clear,0.06,0.0606,0.41,0.2239,4,17,21,21,708,21,1,1,1,111,1,728,63941,1,21
2011-01-24,spring,2011,January,0,Monday,Workingday,Clear,0.06,0.0606,0.41,0.194,0,7,7,7,707,7,1,1,1,111,1,726,39130,1,7
2011-01-24,spring,2011,January,1,Monday,Workingday,Clear,0.04,0.0455,0.45,0.194,0,1,1,1,707,1,1,1,1,111,1,724,24164,1,1
2011-01-24,spring,2011,January,3,Monday,Workingday,Clear,0.04,0.0303,0.45,0.2537,0,1,1,1,707,1,1,1,1,111,1,697,8174,1,1
2011-01-24,spring,2011,January,4,Monday,Workingday,Clear,0.02,0.0606,0.48,0.1343,0,1,1,1,707,1,1,1,1,111,1,697,4428,1,1
2011-01-24,spring,2011,January,5,Monday,Workingday,Clear,0.02,0.0606,0.48,0.1343,0,5,5,5,707,5,1,1,1,111,1,717,14261,1,5
2011-01-24,spring,2011,January,6,Monday,Workingday,Clear,0.02,0.0758,0.48,0.0896,0,15,15,15,707,15,1,1,1,111,1,725,55132,1,15
2011-01-24,spring,2011,January,7,Monday,Workingday,Clear,0.02,0.1212,0.48,0.0,5,79,84,84,707,84,1,2,1,121,1,727,154171,1,84
2011-01-24,spring,2011,January,8,Monday,Workingday,Clear,0.04,0.1364,0.49,0.0,6,171,177,177,707,177,1,3,1,131,1,727,261001,1,177
2011-01-24,spring,2011,January,9,Monday,Workingday,Clear,0.06,0.1515,0.41,0.0,4,98,102,102,707,102,1,2,1,121,1,727,159438,1,102
2011-01-24,spring,2011,January,10,Monday,Workingday,Clear,0.1,0.1364,0.42,0.0,6,34,40,40,707,40,1,1,1,111,1,727,126257,1,40
2011-01-24,spring,2011,January,11,Monday,Workingday,Clear,0.1,0.1212,0.46,0.1343,3,43,46,46,707,46,1,2,1,121,1,727,151320,1,46
2011-01-24,spring,2011,January,12,Monday,Workingday,Mist,0.12,0.1364,0.42,0.194,11,52,63,63,707,63,1,2,1,121,1,728,184414,1,63
2011-01-24,spring,2011,January,13,Monday,Workingday,Mist,0.14,0.1364,0.43,0.2239,6,54,60,60,707,60,1,2,1,121,1,729,184919,1,60
2011-01-24,spring,2011,January,14,Monday,Workingday,Mist,0.14,0.1364,0.46,0.2239,2,43,45,45,707,45,1,2,1,121,1,729,175652,1,45
2011-01-24,spring,2011,January,15,Monday,Workingday,Clear,0.16,0.1667,0.4,0.1642,7,50,57,57,707,57,1,2,1,121,1,729,183149,1,57
2011-01-24,spring,2011,January,16,Monday,Workingday,Clear,0.16,0.1515,0.47,0.2537,4,66,70,70,707,70,1,2,1,121,1,730,227748,1,70
2011-01-24,spring,2011,January,17,Monday,Workingday,Clear,0.14,0.1212,0.5,0.2537,6,178,184,184,707,184,1,3,1,131,1,730,336860,1,184
2011-01-24,spring,2011,January,18,Monday,Workingday,Clear,0.14,0.1364,0.59,0.194,8,145,153,153,707,153,1,3,1,131,1,728,309772,1,153
2011-01-24,spring,2011,January,19,Monday,Workingday,Clear,0.14,0.1515,0.54,0.1642,5,101,106,106,707,106,1,2,1,121,1,728,226789,1,106
2011-01-24,spring,2011,January,20,Monday,Workingday,Clear,0.14,0.1364,0.59,0.194,1,80,81,81,707,81,1,2,1,121,1,728,164550,1,81
2011-01-24,spring,2011,January,21,Monday,Workingday,Clear,0.14,0.1515,0.63,0.1642,6,53,59,59,707,59,1,2,1,121,1,728,125445,1,59
2011-01-24,spring,2011,January,22,Monday,Workingday,Mist,0.14,0.1364,0.63,0.2239,3,32,35,35,707,35,1,1,1,111,1,728,95612,1,35
2011-01-24,spring,2011,January,23,Monday,Workingday,Mist,0.16,0.1515,0.64,0.2537,3,21,24,24,707,24,1,1,1,111,1,728,63941,1,24
2011-01-25,spring,2011,January,0,Tuesday,Workingday,Mist,0.16,0.1364,0.69,0.2836,3,6,9,9,706,9,1,1,1,111,1,726,39130,1,9
2011-01-25,spring,2011,January,1,Tuesday,Workingday,Mist,0.16,0.1667,0.69,0.1642,0,5,5,5,706,5,1,1,1,111,1,724,24164,1,5
2011-01-25,spring,2011,January,2,Tuesday,Workingday,Clear,0.16,0.1515,0.69,0.2239,0,2,2,2,706,2,1,1,1,111,1,715,16352,1,2
2011-01-25,spring,2011,January,4,Tuesday,Workingday,Clear,0.14,0.1667,0.74,0.1045,0,1,1,1,706,1,1,1,1,111,1,697,4428,1,1
2011-01-25,spring,2011,January,5,Tuesday,Workingday,Clear,0.14,0.1364,0.74,0.2239,0,9,9,9,706,9,1,1,1,111,1,717,14261,1,9
2011-01-25,spring,2011,January,6,Tuesday,Workingday,Clear,0.16,0.1818,0.74,0.1045,1,35,36,36,706,36,1,1,1,111,1,725,55132,1,36
2011-01-25,spring,2011,January,7,Tuesday,Workingday,Clear,0.16,0.1515,0.74,0.2239,5,103,108,108,706,108,1,2,1,121,1,727,154171,1,108
2011-01-25,spring,2011,January,8,Tuesday,Workingday,Mist,0.16,0.1818,0.74,0.1343,5,233,238,238,706,238,1,3,1,131,1,727,261001,1,238
2011-01-25,spring,2011,January,9,Tuesday,Workingday,Mist,0.2,0.2273,0.64,0.0896,10,134,144,144,706,144,1,3,1,131,1,727,159438,1,144
2011-01-25,spring,2011,January,10,Tuesday,Workingday,Mist,0.22,0.2424,0.6,0.1045,6,49,55,55,706,55,1,2,1,121,1,727,126257,1,55
2011-01-25,spring,2011,January,11,Tuesday,Workingday,Mist,0.24,0.2424,0.6,0.1343,6,55,61,61,706,61,1,2,1,121,1,727,151320,1,61
2011-01-25,spring,2011,January,12,Tuesday,Workingday,Mist,0.26,0.2879,0.56,0.0896,21,85,106,106,706,106,1,2,1,121,1,728,184414,1,106
2011-01-25,spring,2011,January,13,Tuesday,Workingday,Mist,0.26,0.2727,0.56,0.1343,21,72,93,93,706,93,1,2,1,121,1,729,184919,1,93
2011-01-25,spring,2011,January,14,Tuesday,Workingday,Mist,0.3,0.3333,0.45,0.0,11,57,68,68,706,68,1,2,1,121,1,729,175652,1,68
2011-01-25,spring,2011,January,15,Tuesday,Workingday,Mist,0.32,0.3485,0.42,0.0,21,63,84,84,706,84,1,2,2,122,1,729,183149,1,84
2011-01-25,spring,2011,January,16,Tuesday,Workingday,Mist,0.32,0.3485,0.42,0.0,14,102,116,116,706,116,1,2,2,122,1,730,227748,1,116
2011-01-25,spring,2011,January,17,Tuesday,Workingday,Clear,0.3,0.3333,0.45,0.0,14,208,222,222,706,222,1,3,1,131,1,730,336860,1,222
2011-01-25,spring,2011,January,18,Tuesday,Workingday,Mist,0.3,0.3182,0.49,0.0896,7,218,225,225,706,225,1,3,1,131,1,728,309772,1,225
2011-01-25,spring,2011,January,19,Tuesday,Workingday,Mist,0.26,0.2576,0.65,0.1642,13,133,146,146,706,146,1,3,1,131,1,728,226789,1,146
2011-01-25,spring,2011,January,20,Tuesday,Workingday,Clear,0.24,0.2273,0.65,0.194,16,103,119,119,706,119,1,2,1,121,1,728,164550,1,119
2011-01-25,spring,2011,January,21,Tuesday,Workingday,Clear,0.24,0.2273,0.65,0.194,5,40,45,45,706,45,1,2,1,121,1,728,125445,1,45
2011-01-25,spring,2011,January,22,Tuesday,Workingday,Clear,0.22,0.2273,0.64,0.1642,4,49,53,53,706,53,1,2,1,121,1,728,95612,1,53
2011-01-25,spring,2011,January,23,Tuesday,Workingday,Mist,0.22,0.2273,0.64,0.1642,3,37,40,40,706,40,1,1,1,111,1,728,63941,1,40
2011-01-26,spring,2011,January,0,Wednesday,Workingday,Mist,0.22,0.2273,0.69,0.1343,3,14,17,17,705,17,1,1,1,111,1,726,39130,1,17
2011-01-26,spring,2011,January,1,Wednesday,Workingday,Mist,0.24,0.2424,0.65,0.1343,0,5,5,5,705,5,1,1,1,111,1,724,24164,1,5
2011-01-26,spring,2011,January,2,Wednesday,Workingday,Light Snow,0.22,0.2273,0.69,0.194,3,7,10,10,705,10,1,1,1,111,1,715,16352,1,10
2011-01-26,spring,2011,January,5,Wednesday,Workingday,Light Snow,0.2,0.1818,0.86,0.2836,0,1,1,1,705,1,1,1,1,111,1,717,14261,1,1
2011-01-26,spring,2011,January,6,Wednesday,Workingday,Light Snow,0.2,0.1818,0.86,0.2836,0,8,8,8,705,8,1,1,1,111,1,725,55132,1,8
2011-01-26,spring,2011,January,7,Wednesday,Workingday,Light Snow,0.22,0.2121,0.87,0.2985,1,29,30,30,705,30,1,1,1,111,1,727,154171,1,30
2011-01-26,spring,2011,January,8,Wednesday,Workingday,Light Snow,0.22,0.2121,0.87,0.2985,3,69,72,72,705,72,1,2,1,121,1,727,261001,1,72
2011-01-26,spring,2011,January,9,Wednesday,Workingday,Light Snow,0.22,0.2121,0.87,0.2985,3,55,58,58,705,58,1,2,1,121,1,727,159438,1,58
2011-01-26,spring,2011,January,10,Wednesday,Workingday,Light Snow,0.22,0.2121,0.93,0.2836,2,26,28,28,705,28,1,1,1,111,1,727,126257,1,28
2011-01-26,spring,2011,January,11,Wednesday,Workingday,Light Snow,0.22,0.197,0.93,0.3284,6,35,41,41,705,41,1,2,1,121,1,727,151320,1,41
2011-01-26,spring,2011,January,12,Wednesday,Workingday,Light Snow,0.22,0.197,0.93,0.3284,7,41,48,48,705,48,1,2,1,121,1,728,184414,1,48
2011-01-26,spring,2011,January,13,Wednesday,Workingday,Light Snow,0.22,0.197,0.93,0.3284,4,43,47,47,705,47,1,2,1,121,1,729,184919,1,47
2011-01-26,spring,2011,January,14,Wednesday,Workingday,Light Snow,0.22,0.197,0.93,0.3582,0,36,36,36,705,36,1,1,1,111,1,729,175652,1,36
2011-01-26,spring,2011,January,15,Wednesday,Workingday,Light Snow,0.22,0.1818,0.93,0.4627,1,42,43,43,705,43,1,2,1,121,1,729,183149,1,43
2011-01-26,spring,2011,January,16,Wednesday,Workingday,Heavy Rain,0.22,0.197,0.93,0.3284,1,35,36,36,705,36,1,1,1,111,1,730,227748,1,36
2011-01-26,spring,2011,January,17,Wednesday,Workingday,Light Snow,0.2,0.1818,0.93,0.3582,0,26,26,26,705,26,1,1,1,111,1,730,336860,1,26
2011-01-27,spring,2011,January,16,Thursday,Workingday,Clear,0.22,0.2273,0.55,0.194,1,23,24,24,704,24,1,1,1,111,1,730,227748,1,24
2011-01-27,spring,2011,January,17,Thursday,Workingday,Clear,0.22,0.2424,0.55,0.1045,2,82,84,84,704,84,1,2,1,121,1,730,336860,1,84
2011-01-27,spring,2011,January,18,Thursday,Workingday,Clear,0.2,0.2273,0.69,0.0896,3,101,104,104,704,104,1,2,1,121,1,728,309772,1,104
2011-01-27,spring,2011,January,19,Thursday,Workingday,Clear,0.2,0.2273,0.69,0.0896,3,76,79,79,704,79,1,2,1,121,1,728,226789,1,79
2011-01-27,spring,2011,January,20,Thursday,Workingday,Clear,0.18,0.2121,0.74,0.0896,4,55,59,59,704,59,1,2,1,121,1,728,164550,1,59
2011-01-27,spring,2011,January,21,Thursday,Workingday,Clear,0.18,0.2121,0.74,0.0896,2,36,38,38,704,38,1,1,1,111,1,728,125445,1,38
2011-01-27,spring,2011,January,22,Thursday,Workingday,Clear,0.18,0.2121,0.74,0.0896,0,27,27,27,704,27,1,1,1,111,1,728,95612,1,27
2011-01-27,spring,2011,January,23,Thursday,Workingday,Clear,0.18,0.197,0.8,0.1642,0,16,16,16,704,16,1,1,1,111,1,728,63941,1,16
2011-01-28,spring,2011,January,0,Friday,Workingday,Mist,0.2,0.2121,0.75,0.1343,0,9,9,9,703,9,1,1,1,111,1,726,39130,1,9
2011-01-28,spring,2011,January,1,Friday,Workingday,Mist,0.2,0.2121,0.75,0.1343,1,2,3,3,703,3,1,1,1,111,1,724,24164,1,3
2011-01-28,spring,2011,January,2,Friday,Workingday,Mist,0.2,0.2121,0.75,0.1642,0,2,2,2,703,2,1,1,1,111,1,715,16352,1,2
2011-01-28,spring,2011,January,3,Friday,Workingday,Mist,0.2,0.2273,0.75,0.1045,1,0,1,1,703,1,1,1,1,111,1,697,8174,1,1
2011-01-28,spring,2011,January,5,Friday,Workingday,Mist,0.18,0.2121,0.8,0.1045,0,4,4,4,703,4,1,1,1,111,1,717,14261,1,4
2011-01-28,spring,2011,January,6,Friday,Workingday,Mist,0.18,0.197,0.8,0.1343,0,16,16,16,703,16,1,1,1,111,1,725,55132,1,16
2011-01-28,spring,2011,January,7,Friday,Workingday,Mist,0.16,0.197,0.86,0.0896,2,58,60,60,703,60,1,2,1,121,1,727,154171,1,60
2011-01-28,spring,2011,January,8,Friday,Workingday,Mist,0.16,0.197,0.86,0.0896,2,155,157,157,703,157,1,3,1,131,1,727,261001,1,157
2011-01-28,spring,2011,January,9,Friday,Workingday,Light Snow,0.18,0.2121,0.86,0.0896,6,95,101,101,703,101,1,2,1,121,1,727,159438,1,101
2011-01-28,spring,2011,January,10,Friday,Workingday,Light Snow,0.18,0.2121,0.86,0.1045,0,49,49,49,703,49,1,2,1,121,1,727,126257,1,49
2011-01-28,spring,2011,January,11,Friday,Workingday,Light Snow,0.18,0.2121,0.93,0.1045,0,30,30,30,703,30,1,1,1,111,1,727,151320,1,30
2011-01-28,spring,2011,January,12,Friday,Workingday,Light Snow,0.18,0.2121,0.93,0.1045,1,28,29,29,703,29,1,1,1,111,1,728,184414,1,29
2011-01-28,spring,2011,January,13,Friday,Workingday,Light Snow,0.18,0.2121,0.93,0.1045,0,31,31,31,703,31,1,1,1,111,1,729,184919,1,31
2011-01-28,spring,2011,January,14,Friday,Workingday,Light Snow,0.22,0.2727,0.8,0.0,2,36,38,38,703,38,1,1,1,111,1,729,175652,1,38
2011-01-28,spring,2011,January,15,Friday,Workingday,Mist,0.2,0.2576,0.86,0.0,1,40,41,41,703,41,1,2,1,121,1,729,183149,1,41
2011-01-28,spring,2011,January,16,Friday,Workingday,Clear,0.22,0.2727,0.8,0.0,10,70,80,80,703,80,1,2,1,121,1,730,227748,1,80
2011-01-28,spring,2011,January,17,Friday,Workingday,Clear,0.24,0.2424,0.75,0.1343,2,147,149,149,703,149,1,3,1,131,1,730,336860,1,149
2011-01-28,spring,2011,January,18,Friday,Workingday,Clear,0.24,0.2273,0.75,0.194,2,107,109,109,703,109,1,2,1,121,1,728,309772,1,109
2011-01-28,spring,2011,January,19,Friday,Workingday,Mist,0.24,0.2424,0.75,0.1343,5,84,89,89,703,89,1,2,1,121,1,728,226789,1,89
2011-01-28,spring,2011,January,20,Friday,Workingday,Mist,0.24,0.2273,0.7,0.194,1,61,62,62,703,62,1,2,1,121,1,728,164550,1,62
2011-01-28,spring,2011,January,21,Friday,Workingday,Mist,0.22,0.2273,0.75,0.1343,1,57,58,58,703,58,1,2,1,121,1,728,125445,1,58
2011-01-28,spring,2011,January,22,Friday,Workingday,Clear,0.24,0.2121,0.65,0.3582,0,26,26,26,703,26,1,1,1,111,1,728,95612,1,26
2011-01-28,spring,2011,January,23,Friday,Workingday,Clear,0.24,0.2273,0.6,0.2239,1,22,23,23,703,23,1,1,1,111,1,728,63941,1,23
2011-01-29,spring,2011,January,0,Saturday,Holiday,Clear,0.22,0.197,0.64,0.3582,2,26,28,28,702,28,1,1,1,111,1,726,39130,1,28
2011-01-29,spring,2011,January,1,Saturday,Holiday,Clear,0.22,0.2273,0.64,0.194,0,20,20,20,702,20,1,1,1,111,1,724,24164,1,20
2011-01-29,spring,2011,January,2,Saturday,Holiday,Clear,0.22,0.2273,0.64,0.1642,0,15,15,15,702,15,1,1,1,111,1,715,16352,1,15
2011-01-29,spring,2011,January,3,Saturday,Holiday,Clear,0.2,0.2121,0.64,0.1343,3,5,8,8,702,8,1,1,1,111,1,697,8174,1,8
2011-01-29,spring,2011,January,4,Saturday,Holiday,Clear,0.16,0.1818,0.69,0.1045,1,2,3,3,702,3,1,1,1,111,1,697,4428,1,3
2011-01-29,spring,2011,January,6,Saturday,Holiday,Clear,0.16,0.1818,0.64,0.1343,0,2,2,2,702,2,1,1,1,111,1,725,55132,1,2
2011-01-29,spring,2011,January,7,Saturday,Holiday,Clear,0.16,0.1818,0.59,0.1045,1,4,5,5,702,5,1,1,1,111,1,727,154171,1,5
2011-01-29,spring,2011,January,8,Saturday,Holiday,Clear,0.18,0.197,0.55,0.1642,3,31,34,34,702,34,1,1,1,111,1,727,261001,1,34
2011-01-29,spring,2011,January,9,Saturday,Holiday,Clear,0.18,0.2121,0.59,0.0896,0,34,34,34,702,34,1,1,1,111,1,727,159438,1,34
2011-01-29,spring,2011,January,10,Saturday,Holiday,Mist,0.18,0.2121,0.64,0.1045,4,51,55,55,702,55,1,2,1,121,1,727,126257,1,55
2011-01-29,spring,2011,January,11,Saturday,Holiday,Mist,0.18,0.197,0.64,0.1343,4,60,64,64,702,64,1,2,1,121,1,727,151320,1,64
2011-01-29,spring,2011,January,12,Saturday,Holiday,Mist,0.2,0.197,0.59,0.194,12,66,78,78,702,78,1,2,1,121,1,728,184414,1,78
2011-01-29,spring,2011,January,13,Saturday,Holiday,Mist,0.22,0.2273,0.55,0.1642,9,56,65,65,702,65,1,2,1,121,1,729,184919,1,65
2011-01-29,spring,2011,January,14,Saturday,Holiday,Mist,0.22,0.2273,0.6,0.1343,10,89,99,99,702,99,1,2,1,121,1,729,175652,1,99
2011-01-29,spring,2011,January,15,Saturday,Holiday,Clear,0.22,0.2121,0.69,0.2537,22,98,120,120,702,120,1,2,1,121,1,729,183149,1,120
2011-01-29,spring,2011,January,16,Saturday,Holiday,Clear,0.24,0.2424,0.6,0.1642,19,88,107,107,702,107,1,2,1,121,1,730,227748,1,107
2011-01-29,spring,2011,January,17,Saturday,Holiday,Clear,0.24,0.2879,0.6,0.0,9,82,91,91,702,91,1,2,1,121,1,730,336860,1,91
2011-01-29,spring,2011,January,18,Saturday,Holiday,Clear,0.22,0.2273,0.69,0.1343,9,59,68,68,702,68,1,2,1,121,1,728,309772,1,68
2011-01-29,spring,2011,January,19,Saturday,Holiday,Mist,0.22,0.2121,0.69,0.2537,6,52,58,58,702,58,1,2,1,121,1,728,226789,1,58
2011-01-29,spring,2011,January,20,Saturday,Holiday,Clear,0.18,0.2121,0.74,0.0896,1,42,43,43,702,43,1,2,1,121,1,728,164550,1,43
2011-01-29,spring,2011,January,21,Saturday,Holiday,Clear,0.18,0.2121,0.74,0.0896,1,35,36,36,702,36,1,1,1,111,1,728,125445,1,36
2011-01-29,spring,2011,January,22,Saturday,Holiday,Clear,0.16,0.197,0.8,0.0896,4,28,32,32,702,32,1,1,1,111,1,728,95612,1,32
2011-01-29,spring,2011,January,23,Saturday,Holiday,Clear,0.16,0.197,0.8,0.0896,3,30,33,33,702,33,1,1,1,111,1,728,63941,1,33
2011-01-30,spring,2011,January,0,Sunday,Holiday,Clear,0.16,0.1818,0.8,0.1045,0,33,33,33,701,33,1,1,1,111,1,726,39130,1,33
2011-01-30,spring,2011,January,1,Sunday,Holiday,Clear,0.14,0.2121,0.8,0.0,7,22,29,29,701,29,1,1,1,111,1,724,24164,1,29
2011-01-30,spring,2011,January,2,Sunday,Holiday,Clear,0.16,0.2273,0.8,0.0,1,10,11,11,701,11,1,1,1,111,1,715,16352,1,11
2011-01-30,spring,2011,January,3,Sunday,Holiday,Clear,0.14,0.2121,0.93,0.0,1,7,8,8,701,8,1,1,1,111,1,697,8174,1,8
2011-01-30,spring,2011,January,4,Sunday,Holiday,Clear,0.14,0.2121,0.93,0.0,0,1,1,1,701,1,1,1,1,111,1,697,4428,1,1
2011-01-30,spring,2011,January,5,Sunday,Holiday,Clear,0.14,0.2121,0.86,0.0,0,3,3,3,701,3,1,1,1,111,1,717,14261,1,3
2011-01-30,spring,2011,January,7,Sunday,Holiday,Clear,0.14,0.2121,0.86,0.0,0,3,3,3,701,3,1,1,1,111,1,727,154171,1,3
2011-01-30,spring,2011,January,8,Sunday,Holiday,Mist,0.14,0.2121,0.86,0.0,1,11,12,12,701,12,1,1,1,111,1,727,261001,1,12
2011-01-30,spring,2011,January,9,Sunday,Holiday,Mist,0.16,0.2273,0.8,0.0,4,34,38,38,701,38,1,1,1,111,1,727,159438,1,38
2011-01-30,spring,2011,January,10,Sunday,Holiday,Mist,0.18,0.2424,0.8,0.0,7,57,64,64,701,64,1,2,1,121,1,727,126257,1,64
2011-01-30,spring,2011,January,11,Sunday,Holiday,Clear,0.22,0.2727,0.75,0.0,9,50,59,59,701,59,1,2,1,121,1,727,151320,1,59
2011-01-30,spring,2011,January,12,Sunday,Holiday,Clear,0.3,0.3182,0.52,0.1045,10,87,97,97,701,97,1,2,1,121,1,728,184414,1,97
2011-01-30,spring,2011,January,13,Sunday,Holiday,Clear,0.28,0.2879,0.61,0.1045,13,71,84,84,701,84,1,2,1,121,1,729,184919,1,84
2011-01-30,spring,2011,January,14,Sunday,Holiday,Clear,0.28,0.303,0.61,0.0896,18,104,122,122,701,122,1,2,1,121,1,729,175652,1,122
2011-01-30,spring,2011,January,15,Sunday,Holiday,Clear,0.3,0.3333,0.56,0.0,14,95,109,109,701,109,1,2,1,121,1,729,183149,1,109
2011-01-30,spring,2011,January,16,Sunday,Holiday,Clear,0.3,0.3333,0.56,0.0,19,104,123,123,701,123,1,2,1,121,1,730,227748,1,123
2011-01-30,spring,2011,January,17,Sunday,Holiday,Clear,0.3,0.2879,0.56,0.194,6,71,77,77,701,77,1,2,1,121,1,730,336860,1,77
2011-01-30,spring,2011,January,18,Sunday,Holiday,Clear,0.26,0.2576,0.65,0.1642,8,57,65,65,701,65,1,2,1,121,1,728,309772,1,65
2011-01-30,spring,2011,January,19,Sunday,Holiday,Clear,0.26,0.2576,0.65,0.194,9,46,55,55,701,55,1,2,1,121,1,728,226789,1,55
2011-01-30,spring,2011,January,20,Sunday,Holiday,Mist,0.26,0.2727,0.65,0.1045,3,30,33,33,701,33,1,1,1,111,1,728,164550,1,33
2011-01-30,spring,2011,January,21,Sunday,Holiday,Mist,0.24,0.2424,0.7,0.1642,3,25,28,28,701,28,1,1,1,111,1,728,125445,1,28
2011-01-30,spring,2011,January,22,Sunday,Holiday,Mist,0.24,0.2273,0.7,0.194,2,19,21,21,701,21,1,1,1,111,1,728,95612,1,21
2011-01-30,spring,2011,January,23,Sunday,Holiday,Mist,0.24,0.2121,0.65,0.2836,5,16,21,21,701,21,1,1,1,111,1,728,63941,1,21
2011-01-31,spring,2011,January,0,Monday,Workingday,Mist,0.24,0.2273,0.65,0.2239,1,6,7,7,700,7,1,1,1,111,1,726,39130,1,7
2011-01-31,spring,2011,January,1,Monday,Workingday,Clear,0.22,0.2121,0.64,0.2537,2,5,7,7,700,7,1,1,1,111,1,724,24164,1,7
2011-01-31,spring,2011,January,2,Monday,Workingday,Clear,0.22,0.2273,0.64,0.194,0,1,1,1,700,1,1,1,1,111,1,715,16352,1,1
2011-01-31,spring,2011,January,3,Monday,Workingday,Clear,0.22,0.2273,0.64,0.194,0,2,2,2,700,2,1,1,1,111,1,697,8174,1,2
2011-01-31,spring,2011,January,4,Monday,Workingday,Clear,0.2,0.197,0.59,0.2239,0,2,2,2,700,2,1,1,1,111,1,697,4428,1,2
2011-01-31,spring,2011,January,5,Monday,Workingday,Clear,0.18,0.1667,0.64,0.2836,0,8,8,8,700,8,1,1,1,111,1,717,14261,1,8
2011-01-31,spring,2011,January,6,Monday,Workingday,Clear,0.16,0.1364,0.69,0.3284,0,37,37,37,700,37,1,1,1,111,1,725,55132,1,37
2011-01-31,spring,2011,January,7,Monday,Workingday,Mist,0.16,0.1364,0.64,0.2836,1,71,72,72,700,72,1,2,1,121,1,727,154171,1,72
2011-01-31,spring,2011,January,8,Monday,Workingday,Mist,0.16,0.1364,0.59,0.2836,3,182,185,185,700,185,1,3,1,131,1,727,261001,1,185
2011-01-31,spring,2011,January,9,Monday,Workingday,Mist,0.16,0.1364,0.59,0.2985,0,112,112,112,700,112,1,2,1,121,1,727,159438,1,112
2011-01-31,spring,2011,January,10,Monday,Workingday,Mist,0.16,0.1515,0.59,0.194,1,68,69,69,700,69,1,2,1,121,1,727,126257,1,69
2011-01-31,spring,2011,January,11,Monday,Workingday,Mist,0.16,0.1515,0.59,0.194,2,46,48,48,700,48,1,2,1,121,1,727,151320,1,48
2011-01-31,spring,2011,January,12,Monday,Workingday,Mist,0.18,0.2121,0.55,0.1045,6,62,68,68,700,68,1,2,1,121,1,728,184414,1,68
2011-01-31,spring,2011,January,13,Monday,Workingday,Mist,0.16,0.2273,0.59,0.0,2,52,54,54,700,54,1,2,1,121,1,729,184919,1,54
2011-01-31,spring,2011,January,14,Monday,Workingday,Mist,0.18,0.197,0.55,0.1343,1,85,86,86,700,86,1,2,1,121,1,729,175652,1,86
2011-01-31,spring,2011,January,15,Monday,Workingday,Mist,0.16,0.1818,0.59,0.1343,3,41,44,44,700,44,1,2,1,121,1,729,183149,1,44
2011-01-31,spring,2011,January,16,Monday,Workingday,Mist,0.16,0.1818,0.56,0.194,3,83,86,86,700,86,1,2,1,121,1,730,227748,1,86
2011-01-31,spring,2011,January,17,Monday,Workingday,Mist,0.16,0.1515,0.59,0.194,6,155,161,161,700,161,1,3,1,131,1,730,336860,1,161
2011-01-31,spring,2011,January,18,Monday,Workingday,Mist,0.16,0.1515,0.55,0.2239,3,153,156,156,700,156,1,3,1,131,1,728,309772,1,156
2011-01-31,spring,2011,January,19,Monday,Workingday,Clear,0.3,0.3182,0.61,0.1045,3,108,111,111,700,111,1,2,1,121,1,728,226789,1,111
2011-01-31,spring,2011,January,20,Monday,Workingday,Light Snow,0.16,0.1667,0.59,0.1642,0,78,78,78,700,78,1,2,1,121,1,728,164550,1,78
2011-01-31,spring,2011,January,21,Monday,Workingday,Light Snow,0.16,0.197,0.59,0.0896,3,53,56,56,700,56,1,2,1,121,1,728,125445,1,56
2011-01-31,spring,2011,January,22,Monday,Workingday,Mist,0.16,0.1818,0.59,0.1045,0,34,34,34,700,34,1,1,1,111,1,728,95612,1,34
2011-01-31,spring,2011,January,23,Monday,Workingday,Mist,0.16,0.197,0.64,0.0896,2,15,17,17,700,17,1,1,1,111,1,728,63941,1,17
2011-02-01,spring,2011,February,0,Tuesday,Workingday,Mist,0.16,0.1818,0.64,0.1045,2,6,8,8,699,8,1,1,1,111,1,726,39130,1,8
2011-02-01,spring,2011,February,1,Tuesday,Workingday,Mist,0.16,0.1818,0.69,0.1045,0,3,3,3,699,3,1,1,1,111,1,724,24164,1,3
2011-02-01,spring,2011,February,2,Tuesday,Workingday,Mist,0.16,0.2273,0.69,0.0,0,2,2,2,699,2,1,1,1,111,1,715,16352,1,2
2011-02-01,spring,2011,February,3,Tuesday,Workingday,Mist,0.16,0.2273,0.69,0.0,0,2,2,2,699,2,1,1,1,111,1,697,8174,1,2
2011-02-01,spring,2011,February,5,Tuesday,Workingday,Light Snow,0.14,0.2121,0.93,0.0,0,3,3,3,699,3,1,1,1,111,1,717,14261,1,3
2011-02-01,spring,2011,February,6,Tuesday,Workingday,Light Snow,0.14,0.2121,0.93,0.0,0,22,22,22,699,22,1,1,1,111,1,725,55132,1,22
2011-02-01,spring,2011,February,7,Tuesday,Workingday,Light Snow,0.16,0.2273,0.93,0.0,0,52,52,52,699,52,1,2,1,121,1,727,154171,1,52
2011-02-01,spring,2011,February,8,Tuesday,Workingday,Light Snow,0.16,0.2273,0.93,0.0,3,132,135,135,699,135,1,2,1,121,1,727,261001,1,135
2011-02-01,spring,2011,February,9,Tuesday,Workingday,Mist,0.16,0.2273,0.93,0.0,2,114,116,116,699,116,1,2,1,121,1,727,159438,1,116
2011-02-01,spring,2011,February,10,Tuesday,Workingday,Mist,0.16,0.2273,0.93,0.0,0,47,47,47,699,47,1,2,1,121,1,727,126257,1,47
2011-02-01,spring,2011,February,11,Tuesday,Workingday,Mist,0.18,0.2424,0.86,0.0,2,49,51,51,699,51,1,2,1,121,1,727,151320,1,51
2011-02-01,spring,2011,February,12,Tuesday,Workingday,Mist,0.2,0.2576,0.86,0.0,2,53,55,55,699,55,1,2,1,121,1,728,184414,1,55
2011-02-01,spring,2011,February,13,Tuesday,Workingday,Mist,0.2,0.2576,0.86,0.0,3,49,52,52,699,52,1,2,1,121,1,729,184919,1,52
2011-02-01,spring,2011,February,14,Tuesday,Workingday,Mist,0.22,0.2576,0.8,0.0896,5,49,54,54,699,54,1,2,1,121,1,729,175652,1,54
2011-02-01,spring,2011,February,15,Tuesday,Workingday,Mist,0.24,0.2879,0.75,0.0,7,45,52,52,699,52,1,2,1,121,1,729,183149,1,52
2011-02-01,spring,2011,February,16,Tuesday,Workingday,Mist,0.24,0.2424,0.75,0.1343,3,61,64,64,699,64,1,2,1,121,1,730,227748,1,64
2011-02-01,spring,2011,February,17,Tuesday,Workingday,Mist,0.24,0.2879,0.75,0.0,4,172,176,176,699,176,1,3,1,131,1,730,336860,1,176
2011-02-01,spring,2011,February,18,Tuesday,Workingday,Mist,0.24,0.2576,0.81,0.1045,3,165,168,168,699,168,1,3,1,131,1,728,309772,1,168
2011-02-01,spring,2011,February,19,Tuesday,Workingday,Mist,0.24,0.2424,0.81,0.1343,3,105,108,108,699,108,1,2,1,121,1,728,226789,1,108
2011-02-01,spring,2011,February,20,Tuesday,Workingday,Mist,0.22,0.2273,0.87,0.1343,5,69,74,74,699,74,1,2,1,121,1,728,164550,1,74
2011-02-01,spring,2011,February,21,Tuesday,Workingday,Mist,0.22,0.2273,0.87,0.1343,0,64,64,64,699,64,1,2,1,121,1,728,125445,1,64
2011-02-01,spring,2011,February,22,Tuesday,Workingday,Mist,0.22,0.2576,0.87,0.0896,2,34,36,36,699,36,1,1,1,111,1,728,95612,1,36
2011-02-01,spring,2011,February,23,Tuesday,Workingday,Light Snow,0.2,0.197,0.93,0.194,1,15,16,16,699,16,1,1,1,111,1,728,63941,1,16
2011-02-02,spring,2011,February,0,Wednesday,Workingday,Light Snow,0.22,0.2424,0.93,0.1045,0,2,2,2,698,2,1,1,1,111,1,726,39130,1,2
2011-02-02,spring,2011,February,1,Wednesday,Workingday,Light Snow,0.22,0.2273,0.93,0.194,0,3,3,3,698,3,1,1,1,111,1,724,24164,1,3
2011-02-02,spring,2011,February,2,Wednesday,Workingday,Light Snow,0.22,0.2273,0.93,0.1343,4,0,4,4,698,4,1,1,1,111,1,715,16352,1,4
2011-02-02,spring,2011,February,3,Wednesday,Workingday,Light Snow,0.22,0.2273,0.93,0.1343,0,1,1,1,698,1,1,1,1,111,1,697,8174,1,1
2011-02-02,spring,2011,February,4,Wednesday,Workingday,Light Snow,0.22,0.2121,0.93,0.2836,0,1,1,1,698,1,1,1,1,111,1,697,4428,1,1
2011-02-02,spring,2011,February,5,Wednesday,Workingday,Light Snow,0.22,0.2424,0.93,0.1045,0,3,3,3,698,3,1,1,1,111,1,717,14261,1,3
2011-02-02,spring,2011,February,6,Wednesday,Workingday,Light Snow,0.22,0.2424,0.93,0.1045,1,17,18,18,698,18,1,1,1,111,1,725,55132,1,18
2011-02-02,spring,2011,February,7,Wednesday,Workingday,Light Snow,0.22,0.2121,0.93,0.2239,1,48,49,49,698,49,1,2,1,121,1,727,154171,1,49
2011-02-02,spring,2011,February,8,Wednesday,Workingday,Light Snow,0.22,0.2121,0.93,0.2239,1,154,155,155,698,155,1,3,1,131,1,727,261001,1,155
2011-02-02,spring,2011,February,9,Wednesday,Workingday,Mist,0.24,0.2576,0.93,0.0896,4,119,123,123,698,123,1,2,1,121,1,727,159438,1,123
2011-02-02,spring,2011,February,10,Wednesday,Workingday,Mist,0.22,0.2727,1.0,0.0,2,59,61,61,698,61,1,2,1,121,1,727,126257,1,61
2011-02-02,spring,2011,February,11,Wednesday,Workingday,Mist,0.24,0.2273,0.93,0.194,5,47,52,52,698,52,1,2,1,121,1,727,151320,1,52
2011-02-02,spring,2011,February,12,Wednesday,Workingday,Mist,0.24,0.2273,0.93,0.2239,3,61,64,64,698,64,1,2,1,121,1,728,184414,1,64
2011-02-02,spring,2011,February,13,Wednesday,Workingday,Clear,0.34,0.3333,0.93,0.1642,1,74,75,75,698,75,1,2,1,121,0,729,184919,1,75
2011-02-02,spring,2011,February,14,Wednesday,Workingday,Clear,0.38,0.3939,0.82,0.3881,2,61,63,63,698,63,1,2,2,122,1,729,175652,1,63
2011-02-02,spring,2011,February,15,Wednesday,Workingday,Clear,0.38,0.3939,0.76,0.3284,10,66,76,76,698,76,1,2,2,122,1,729,183149,1,76
2011-02-02,spring,2011,February,16,Wednesday,Workingday,Clear,0.36,0.3333,0.71,0.2985,8,95,103,103,698,103,1,2,1,121,1,730,227748,1,103
2011-02-02,spring,2011,February,17,Wednesday,Workingday,Clear,0.36,0.3182,0.53,0.5224,7,183,190,190,698,190,1,3,1,131,1,730,336860,1,190
2011-02-02,spring,2011,February,18,Wednesday,Workingday,Clear,0.34,0.2879,0.42,0.5522,7,175,182,182,698,182,1,3,1,131,1,728,309772,1,182
2011-02-02,spring,2011,February,19,Wednesday,Workingday,Clear,0.28,0.2424,0.45,0.4925,3,88,91,91,698,91,1,2,1,121,1,728,226789,1,91
2011-02-02,spring,2011,February,20,Wednesday,Workingday,Clear,0.24,0.197,0.48,0.5522,4,71,75,75,698,75,1,2,1,121,1,728,164550,1,75
2011-02-02,spring,2011,February,21,Wednesday,Workingday,Clear,0.22,0.197,0.47,0.3284,1,62,63,63,698,63,1,2,1,121,1,728,125445,1,63
2011-02-02,spring,2011,February,22,Wednesday,Workingday,Clear,0.22,0.2121,0.44,0.2537,5,35,40,40,698,40,1,1,1,111,1,728,95612,1,40
2011-02-02,spring,2011,February,23,Wednesday,Workingday,Clear,0.2,0.1667,0.44,0.4478,3,29,32,32,698,32,1,1,1,111,1,728,63941,1,32
2011-02-03,spring,2011,February,0,Thursday,Workingday,Clear,0.2,0.1667,0.4,0.4478,1,11,12,12,697,12,1,1,1,111,1,726,39130,1,12
2011-02-03,spring,2011,February,1,Thursday,Workingday,Clear,0.2,0.1515,0.44,0.5224,0,5,5,5,697,5,1,1,1,111,1,724,24164,1,5
2011-02-03,spring,2011,February,2,Thursday,Workingday,Clear,0.18,0.1667,0.43,0.2537,0,2,2,2,697,2,1,1,1,111,1,715,16352,1,2
2011-02-03,spring,2011,February,3,Thursday,Workingday,Clear,0.18,0.1667,0.43,0.2537,0,1,1,1,697,1,1,1,1,111,1,697,8174,1,1
2011-02-03,spring,2011,February,5,Thursday,Workingday,Clear,0.16,0.1364,0.5,0.2985,0,2,2,2,697,2,1,1,1,111,1,717,14261,1,2
2011-02-03,spring,2011,February,6,Thursday,Workingday,Clear,0.16,0.1364,0.43,0.3582,0,39,39,39,697,39,1,1,1,111,1,725,55132,1,39
2011-02-03,spring,2011,February,7,Thursday,Workingday,Clear,0.14,0.1212,0.5,0.3284,1,86,87,87,697,87,1,2,1,121,1,727,154171,1,87
2011-02-03,spring,2011,February,8,Thursday,Workingday,Clear,0.14,0.1212,0.5,0.3582,4,184,188,188,697,188,1,3,1,131,1,727,261001,1,188
2011-02-03,spring,2011,February,9,Thursday,Workingday,Clear,0.16,0.1364,0.47,0.2985,6,127,133,133,697,133,1,2,1,121,1,727,159438,1,133
2011-02-03,spring,2011,February,10,Thursday,Workingday,Clear,0.18,0.1515,0.43,0.3284,2,50,52,52,697,52,1,2,1,121,1,727,126257,1,52
2011-02-03,spring,2011,February,11,Thursday,Workingday,Clear,0.18,0.1364,0.43,0.4478,9,55,64,64,697,64,1,2,1,121,1,727,151320,1,64
2011-02-03,spring,2011,February,12,Thursday,Workingday,Clear,0.2,0.1818,0.4,0.3582,2,67,69,69,697,69,1,2,1,121,1,728,184414,1,69
2011-02-03,spring,2011,February,13,Thursday,Workingday,Clear,0.2,0.1667,0.4,0.4179,4,47,51,51,697,51,1,2,1,121,1,729,184919,1,51
2011-02-03,spring,2011,February,14,Thursday,Workingday,Clear,0.22,0.197,0.37,0.3881,4,43,47,47,697,47,1,2,1,121,1,729,175652,1,47
2011-02-03,spring,2011,February,15,Thursday,Workingday,Clear,0.22,0.197,0.37,0.3284,4,56,60,60,697,60,1,2,1,121,1,729,183149,1,60
2011-02-03,spring,2011,February,16,Thursday,Workingday,Clear,0.22,0.2121,0.37,0.2537,5,73,78,78,697,78,1,2,1,121,1,730,227748,1,78
2011-02-03,spring,2011,February,17,Thursday,Workingday,Clear,0.2,0.197,0.4,0.194,5,170,175,175,697,175,1,3,1,131,1,730,336860,1,175
2011-02-03,spring,2011,February,18,Thursday,Workingday,Clear,0.2,0.2121,0.4,0.1642,2,145,147,147,697,147,1,3,1,131,1,728,309772,1,147
2011-02-03,spring,2011,February,19,Thursday,Workingday,Clear,0.2,0.2576,0.4,0.0,4,92,96,96,697,96,1,2,1,121,1,728,226789,1,96
2011-02-03,spring,2011,February,20,Thursday,Workingday,Clear,0.2,0.2273,0.47,0.0896,1,108,109,109,697,109,1,2,1,121,1,728,164550,1,109
2011-02-03,spring,2011,February,21,Thursday,Workingday,Clear,0.18,0.2121,0.55,0.1045,1,53,54,54,697,54,1,2,1,121,1,728,125445,1,54
2011-02-03,spring,2011,February,22,Thursday,Workingday,Clear,0.18,0.2121,0.51,0.0896,2,39,41,41,697,41,1,2,1,121,1,728,95612,1,41
2011-02-03,spring,2011,February,23,Thursday,Workingday,Clear,0.2,0.2273,0.47,0.1045,4,34,38,38,697,38,1,1,1,111,1,728,63941,1,38
2011-02-04,spring,2011,February,0,Friday,Workingday,Mist,0.2,0.2576,0.44,0.0,3,10,13,13,696,13,1,1,1,111,1,726,39130,1,13
2011-02-04,spring,2011,February,1,Friday,Workingday,Mist,0.16,0.2273,0.59,0.0,0,7,7,7,696,7,1,1,1,111,1,724,24164,1,7
2011-02-04,spring,2011,February,2,Friday,Workingday,Mist,0.14,0.1667,0.63,0.1045,0,1,1,1,696,1,1,1,1,111,1,715,16352,1,1
2011-02-04,spring,2011,February,3,Friday,Workingday,Mist,0.14,0.1667,0.63,0.1045,0,1,1,1,696,1,1,1,1,111,1,697,8174,1,1
2011-02-04,spring,2011,February,5,Friday,Workingday,Mist,0.14,0.1515,0.63,0.1343,0,7,7,7,696,7,1,1,1,111,1,717,14261,1,7
2011-02-04,spring,2011,February,6,Friday,Workingday,Mist,0.16,0.2273,0.55,0.0,2,26,28,28,696,28,1,1,1,111,1,725,55132,1,28
2011-02-04,spring,2011,February,7,Friday,Workingday,Clear,0.14,0.2121,0.59,0.0,0,87,87,87,696,87,1,2,1,121,1,727,154171,1,87
2011-02-04,spring,2011,February,8,Friday,Workingday,Clear,0.14,0.1515,0.74,0.1343,3,217,220,220,696,220,1,3,1,131,1,727,261001,1,220
2011-02-04,spring,2011,February,9,Friday,Workingday,Mist,0.16,0.1818,0.8,0.1343,3,124,127,127,696,127,1,2,1,121,1,727,159438,1,127
2011-02-04,spring,2011,February,10,Friday,Workingday,Mist,0.2,0.2121,0.51,0.1343,5,46,51,51,696,51,1,2,1,121,1,727,126257,1,51
2011-02-04,spring,2011,February,11,Friday,Workingday,Clear,0.22,0.2273,0.51,0.1642,3,61,64,64,696,64,1,2,1,121,1,727,151320,1,64
2011-02-04,spring,2011,February,12,Friday,Workingday,Mist,0.24,0.2424,0.48,0.1642,8,78,86,86,696,86,1,2,1,121,1,728,184414,1,86
2011-02-04,spring,2011,February,13,Friday,Workingday,Mist,0.26,0.2576,0.5,0.2239,9,73,82,82,696,82,1,2,1,121,1,729,184919,1,82
2011-02-04,spring,2011,February,14,Friday,Workingday,Mist,0.28,0.2727,0.45,0.1642,15,76,91,91,696,91,1,2,1,121,1,729,175652,1,91
2011-02-04,spring,2011,February,15,Friday,Workingday,Mist,0.28,0.2727,0.48,0.2537,9,81,90,90,696,90,1,2,1,121,1,729,183149,1,90
2011-02-04,spring,2011,February,16,Friday,Workingday,Mist,0.3,0.2879,0.42,0.2239,8,91,99,99,696,99,1,2,1,121,1,730,227748,1,99
2011-02-04,spring,2011,February,17,Friday,Workingday,Mist,0.26,0.2727,0.56,0.1343,10,195,205,205,696,205,1,3,1,131,1,730,336860,1,205
2011-02-04,spring,2011,February,18,Friday,Workingday,Mist,0.24,0.2576,0.6,0.1045,3,152,155,155,696,155,1,3,1,131,1,728,309772,1,155
2011-02-04,spring,2011,February,19,Friday,Workingday,Mist,0.24,0.2424,0.65,0.1343,1,102,103,103,696,103,1,2,1,121,1,728,226789,1,103
2011-02-04,spring,2011,February,20,Friday,Workingday,Mist,0.24,0.2424,0.65,0.1642,2,69,71,71,696,71,1,2,1,121,1,728,164550,1,71
2011-02-04,spring,2011,February,21,Friday,Workingday,Mist,0.24,0.2424,0.7,0.1642,2,41,43,43,696,43,1,2,1,121,1,728,125445,1,43
2011-02-04,spring,2011,February,22,Friday,Workingday,Mist,0.24,0.2424,0.65,0.1642,1,45,46,46,696,46,1,2,1,121,1,728,95612,1,46
2011-02-04,spring,2011,February,23,Friday,Workingday,Mist,0.24,0.2424,0.7,0.1343,1,30,31,31,696,31,1,1,1,111,1,728,63941,1,31
2011-02-05,spring,2011,February,0,Saturday,Holiday,Mist,0.24,0.2424,0.7,0.1642,3,36,39,39,695,39,1,1,1,111,1,726,39130,1,39
2011-02-05,spring,2011,February,1,Saturday,Holiday,Mist,0.24,0.2424,0.65,0.1642,1,17,18,18,695,18,1,1,1,111,1,724,24164,1,18
2011-02-05,spring,2011,February,2,Saturday,Holiday,Mist,0.24,0.2424,0.75,0.1642,5,12,17,17,695,17,1,1,1,111,1,715,16352,1,17
2011-02-05,spring,2011,February,3,Saturday,Holiday,Mist,0.24,0.2424,0.75,0.1642,1,10,11,11,695,11,1,1,1,111,1,697,8174,1,11
2011-02-05,spring,2011,February,4,Saturday,Holiday,Light Snow,0.22,0.2273,0.93,0.1343,0,8,8,8,695,8,1,1,1,111,1,697,4428,1,8
2011-02-05,spring,2011,February,5,Saturday,Holiday,Light Snow,0.2,0.2273,1.0,0.0896,0,9,9,9,695,9,1,1,1,111,1,717,14261,1,9
2011-02-05,spring,2011,February,6,Saturday,Holiday,Light Snow,0.2,0.2576,1.0,0.0,0,4,4,4,695,4,1,1,1,111,1,725,55132,1,4
2011-02-05,spring,2011,February,7,Saturday,Holiday,Light Snow,0.22,0.2576,0.93,0.0896,0,4,4,4,695,4,1,1,1,111,1,727,154171,1,4
2011-02-05,spring,2011,February,8,Saturday,Holiday,Light Snow,0.2,0.2273,1.0,0.0896,0,10,10,10,695,10,1,1,1,111,1,727,261001,1,10
2011-02-05,spring,2011,February,9,Saturday,Holiday,Light Snow,0.2,0.2273,1.0,0.0896,3,17,20,20,695,20,1,1,1,111,1,727,159438,1,20
2011-02-05,spring,2011,February,10,Saturday,Holiday,Light Snow,0.2,0.2121,1.0,0.1343,3,31,34,34,695,34,1,1,1,111,1,727,126257,1,34
2011-02-05,spring,2011,February,11,Saturday,Holiday,Light Snow,0.22,0.2273,1.0,0.1343,1,46,47,47,695,47,1,2,1,121,1,727,151320,1,47
2011-02-05,spring,2011,February,12,Saturday,Holiday,Light Snow,0.22,0.2273,1.0,0.1642,10,42,52,52,695,52,1,2,1,121,1,728,184414,1,52
2011-02-05,spring,2011,February,13,Saturday,Holiday,Light Snow,0.22,0.2273,1.0,0.1642,10,62,72,72,695,72,1,2,1,121,1,729,184919,1,72
2011-02-05,spring,2011,February,14,Saturday,Holiday,Light Snow,0.22,0.2727,1.0,0.0,5,50,55,55,695,55,1,2,1,121,1,729,175652,1,55
2011-02-05,spring,2011,February,15,Saturday,Holiday,Light Snow,0.22,0.2727,1.0,0.0,11,49,60,60,695,60,1,2,1,121,1,729,183149,1,60
2011-02-05,spring,2011,February,16,Saturday,Holiday,Light Snow,0.22,0.2273,1.0,0.1343,8,63,71,71,695,71,1,2,1,121,1,730,227748,1,71
2011-02-05,spring,2011,February,17,Saturday,Holiday,Mist,0.24,0.2121,1.0,0.2836,14,64,78,78,695,78,1,2,1,121,1,730,336860,1,78
2011-02-05,spring,2011,February,18,Saturday,Holiday,Mist,0.28,0.2424,0.93,0.4478,2,81,83,83,695,83,1,2,1,121,1,728,309772,1,83
2011-02-05,spring,2011,February,19,Saturday,Holiday,Mist,0.28,0.2424,0.93,0.4478,6,78,84,84,695,84,1,2,1,121,1,728,226789,1,84
2011-02-05,spring,2011,February,20,Saturday,Holiday,Clear,0.3,0.2879,0.87,0.2537,5,64,69,69,695,69,1,2,1,121,1,728,164550,1,69
2011-02-05,spring,2011,February,21,Saturday,Holiday,Clear,0.26,0.2576,1.0,0.194,3,53,56,56,695,56,1,2,1,121,1,728,125445,1,56
2011-02-05,spring,2011,February,22,Saturday,Holiday,Clear,0.26,0.2727,0.93,0.1343,2,43,45,45,695,45,1,2,1,121,1,728,95612,1,45
2011-02-05,spring,2011,February,23,Saturday,Holiday,Clear,0.26,0.2576,0.93,0.2239,7,52,59,59,695,59,1,2,1,121,1,728,63941,1,59
2011-02-06,spring,2011,February,0,Sunday,Holiday,Clear,0.26,0.2576,0.7,0.194,2,37,39,39,694,39,1,1,1,111,1,726,39130,1,39
2011-02-06,spring,2011,February,1,Sunday,Holiday,Clear,0.26,0.2273,0.65,0.4179,4,40,44,44,694,44,1,2,1,121,1,724,24164,1,44
2011-02-06,spring,2011,February,2,Sunday,Holiday,Clear,0.26,0.2273,0.6,0.3284,0,20,20,20,694,20,1,1,1,111,1,715,16352,1,20
2011-02-06,spring,2011,February,3,Sunday,Holiday,Clear,0.26,0.2879,0.6,0.0896,3,10,13,13,694,13,1,1,1,111,1,697,8174,1,13
2011-02-06,spring,2011,February,4,Sunday,Holiday,Clear,0.26,0.2273,0.6,0.3582,0,2,2,2,694,2,1,1,1,111,1,697,4428,1,2
2011-02-06,spring,2011,February,5,Sunday,Holiday,Clear,0.26,0.2576,0.6,0.2239,0,1,1,1,694,1,1,1,1,111,1,717,14261,1,1
2011-02-06,spring,2011,February,6,Sunday,Holiday,Clear,0.26,0.2576,0.6,0.2239,0,1,1,1,694,1,1,1,1,111,1,725,55132,1,1
2011-02-06,spring,2011,February,7,Sunday,Holiday,Clear,0.24,0.2424,0.65,0.1642,0,8,8,8,694,8,1,1,1,111,1,727,154171,1,8
2011-02-06,spring,2011,February,8,Sunday,Holiday,Clear,0.24,0.2576,0.65,0.1045,2,21,23,23,694,23,1,1,1,111,1,727,261001,1,23
2011-02-06,spring,2011,February,9,Sunday,Holiday,Clear,0.28,0.2879,0.56,0.1045,7,38,45,45,694,45,1,2,1,121,1,727,159438,1,45
2011-02-06,spring,2011,February,10,Sunday,Holiday,Clear,0.3,0.2879,0.52,0.2537,15,74,89,89,694,89,1,2,1,121,1,727,126257,1,89
2011-02-06,spring,2011,February,11,Sunday,Holiday,Clear,0.32,0.303,0.49,0.2537,28,89,117,117,694,117,1,2,1,121,1,727,151320,1,117
2011-02-06,spring,2011,February,12,Sunday,Holiday,Clear,0.34,0.3333,0.46,0.0,48,126,174,174,694,174,1,3,1,131,1,728,184414,1,174
2011-02-06,spring,2011,February,13,Sunday,Holiday,Clear,0.34,0.3636,0.46,0.0,47,135,182,182,694,182,1,3,2,132,1,729,184919,1,182
2011-02-06,spring,2011,February,14,Sunday,Holiday,Clear,0.34,0.3485,0.46,0.0896,47,114,161,161,694,161,1,3,2,132,1,729,175652,1,161
2011-02-06,spring,2011,February,15,Sunday,Holiday,Clear,0.34,0.3485,0.46,0.0896,52,130,182,182,694,182,1,3,2,132,1,729,183149,1,182
2011-02-06,spring,2011,February,16,Sunday,Holiday,Clear,0.34,0.3485,0.49,0.1045,42,115,157,157,694,157,1,3,2,132,1,730,227748,1,157
2011-02-06,spring,2011,February,17,Sunday,Holiday,Clear,0.34,0.3636,0.46,0.0,24,97,121,121,694,121,1,2,2,122,1,730,336860,1,121
2011-02-06,spring,2011,February,18,Sunday,Holiday,Clear,0.3,0.303,0.56,0.1642,13,65,78,78,694,78,1,2,1,121,1,728,309772,1,78
2011-02-06,spring,2011,February,19,Sunday,Holiday,Clear,0.28,0.2879,0.61,0.1343,1,20,21,21,694,21,1,1,1,111,1,728,226789,1,21
2011-02-06,spring,2011,February,20,Sunday,Holiday,Clear,0.28,0.2879,0.61,0.1045,5,21,26,26,694,26,1,1,1,111,1,728,164550,1,26
2011-02-06,spring,2011,February,21,Sunday,Holiday,Clear,0.26,0.303,0.6,0.0,5,22,27,27,694,27,1,1,1,111,1,728,125445,1,27
2011-02-06,spring,2011,February,22,Sunday,Holiday,Clear,0.26,0.303,0.6,0.0,5,57,62,62,694,62,1,2,1,121,1,728,95612,1,62
2011-02-06,spring,2011,February,23,Sunday,Holiday,Clear,0.24,0.2879,0.65,0.0,4,26,30,30,694,30,1,1,1,111,1,728,63941,1,30
2011-02-07,spring,2011,February,0,Monday,Workingday,Clear,0.24,0.2879,0.65,0.0,1,14,15,15,693,15,1,1,1,111,1,726,39130,1,15
2011-02-07,spring,2011,February,1,Monday,Workingday,Clear,0.22,0.2727,0.75,0.0,1,4,5,5,693,5,1,1,1,111,1,724,24164,1,5
2011-02-07,spring,2011,February,2,Monday,Workingday,Clear,0.2,0.2576,0.8,0.0,0,3,3,3,693,3,1,1,1,111,1,715,16352,1,3
2011-02-07,spring,2011,February,3,Monday,Workingday,Clear,0.2,0.2576,0.86,0.0,0,1,1,1,693,1,1,1,1,111,1,697,8174,1,1
2011-02-07,spring,2011,February,4,Monday,Workingday,Clear,0.2,0.2576,0.86,0.0,1,1,2,2,693,2,1,1,1,111,1,697,4428,1,2
2011-02-07,spring,2011,February,5,Monday,Workingday,Clear,0.2,0.2576,0.86,0.0,1,9,10,10,693,10,1,1,1,111,1,717,14261,1,10
2011-02-07,spring,2011,February,6,Monday,Workingday,Clear,0.18,0.2424,0.93,0.0,1,29,30,30,693,30,1,1,1,111,1,725,55132,1,30
2011-02-07,spring,2011,February,7,Monday,Workingday,Clear,0.18,0.2424,0.86,0.0,6,89,95,95,693,95,1,2,1,121,1,727,154171,1,95
2011-02-07,spring,2011,February,8,Monday,Workingday,Mist,0.16,0.2273,1.0,0.0,7,223,230,230,693,230,1,3,1,131,1,727,261001,1,230
2011-02-07,spring,2011,February,9,Monday,Workingday,Clear,0.22,0.2727,0.8,0.0,3,115,118,118,693,118,1,2,1,121,1,727,159438,1,118
2011-02-07,spring,2011,February,10,Monday,Workingday,Clear,0.24,0.2576,0.75,0.1045,6,49,55,55,693,55,1,2,1,121,1,727,126257,1,55
2011-02-07,spring,2011,February,11,Monday,Workingday,Clear,0.3,0.3182,0.65,0.0896,11,36,47,47,693,47,1,2,1,121,1,727,151320,1,47
2011-02-07,spring,2011,February,12,Monday,Workingday,Mist,0.32,0.3485,0.62,0.0,7,59,66,66,693,66,1,2,2,122,1,728,184414,1,66
2011-02-07,spring,2011,February,13,Monday,Workingday,Mist,0.36,0.3636,0.57,0.0896,10,54,64,64,693,64,1,2,2,122,1,729,184919,1,64
2011-02-07,spring,2011,February,14,Monday,Workingday,Mist,0.36,0.3636,0.57,0.0896,8,52,60,60,693,60,1,2,2,122,1,729,175652,1,60
2011-02-07,spring,2011,February,15,Monday,Workingday,Mist,0.38,0.3939,0.54,0.0896,4,46,50,50,693,50,1,2,2,122,1,729,183149,1,50
2011-02-07,spring,2011,February,16,Monday,Workingday,Mist,0.36,0.3485,0.57,0.1343,16,98,114,114,693,114,1,2,2,122,1,730,227748,1,114
2011-02-07,spring,2011,February,17,Monday,Workingday,Mist,0.32,0.3182,0.7,0.1642,9,207,216,216,693,216,1,3,1,131,1,730,336860,1,216
2011-02-07,spring,2011,February,18,Monday,Workingday,Mist,0.34,0.3333,0.66,0.1343,5,170,175,175,693,175,1,3,1,131,1,728,309772,1,175
2011-02-07,spring,2011,February,19,Monday,Workingday,Mist,0.32,0.3485,0.7,0.0,5,123,128,128,693,128,1,2,2,122,1,728,226789,1,128
2011-02-07,spring,2011,February,20,Monday,Workingday,Mist,0.32,0.3333,0.7,0.1045,6,82,88,88,693,88,1,2,1,121,1,728,164550,1,88
2011-02-07,spring,2011,February,21,Monday,Workingday,Clear,0.32,0.3485,0.7,0.0,3,75,78,78,693,78,1,2,2,122,1,728,125445,1,78
2011-02-07,spring,2011,February,22,Monday,Workingday,Clear,0.28,0.303,0.81,0.0896,3,34,37,37,693,37,1,1,1,111,1,728,95612,1,37
2011-02-07,spring,2011,February,23,Monday,Workingday,Mist,0.3,0.3333,0.81,0.0,6,19,25,25,693,25,1,1,1,111,1,728,63941,1,25
2011-02-08,spring,2011,February,0,Tuesday,Workingday,Mist,0.28,0.3182,0.87,0.0,4,6,10,10,692,10,1,1,1,111,1,726,39130,1,10
2011-02-08,spring,2011,February,1,Tuesday,Workingday,Mist,0.28,0.3182,0.87,0.0,0,4,4,4,692,4,1,1,1,111,1,724,24164,1,4
2011-02-08,spring,2011,February,2,Tuesday,Workingday,Mist,0.26,0.2727,0.93,0.1045,1,1,2,2,692,2,1,1,1,111,1,715,16352,1,2
2011-02-08,spring,2011,February,3,Tuesday,Workingday,Light Snow,0.28,0.2727,0.93,0.1642,0,1,1,1,692,1,1,1,1,111,1,697,8174,1,1
2011-02-08,spring,2011,February,4,Tuesday,Workingday,Clear,0.26,0.2576,0.93,0.1642,0,3,3,3,692,3,1,1,1,111,1,697,4428,1,3
2011-02-08,spring,2011,February,5,Tuesday,Workingday,Clear,0.26,0.2273,0.81,0.3284,0,2,2,2,692,2,1,1,1,111,1,717,14261,1,2
2011-02-08,spring,2011,February,6,Tuesday,Workingday,Clear,0.26,0.2273,0.7,0.3284,0,39,39,39,692,39,1,1,1,111,1,725,55132,1,39
2011-02-08,spring,2011,February,7,Tuesday,Workingday,Clear,0.24,0.197,0.65,0.4179,3,97,100,100,692,100,1,2,1,121,1,727,154171,1,100
2011-02-08,spring,2011,February,8,Tuesday,Workingday,Clear,0.24,0.197,0.56,0.4925,7,236,243,243,692,243,1,3,1,131,1,727,261001,1,243
2011-02-08,spring,2011,February,9,Tuesday,Workingday,Clear,0.24,0.197,0.52,0.4925,7,128,135,135,692,135,1,2,1,121,1,727,159438,1,135
2011-02-08,spring,2011,February,10,Tuesday,Workingday,Clear,0.22,0.1818,0.47,0.5522,4,44,48,48,692,48,1,2,1,121,1,727,126257,1,48
2011-02-08,spring,2011,February,11,Tuesday,Workingday,Clear,0.22,0.1818,0.47,0.4627,1,49,50,50,692,50,1,2,1,121,1,727,151320,1,50
2011-02-08,spring,2011,February,12,Tuesday,Workingday,Clear,0.24,0.197,0.38,0.4925,2,63,65,65,692,65,1,2,1,121,1,728,184414,1,65
2011-02-08,spring,2011,February,13,Tuesday,Workingday,Mist,0.24,0.197,0.32,0.4478,2,48,50,50,692,50,1,2,1,121,1,729,184919,1,50
2011-02-08,spring,2011,February,14,Tuesday,Workingday,Clear,0.22,0.197,0.37,0.4179,3,61,64,64,692,64,1,2,1,121,1,729,175652,1,64
2011-02-08,spring,2011,February,15,Tuesday,Workingday,Clear,0.22,0.197,0.35,0.3881,6,45,51,51,692,51,1,2,1,121,1,729,183149,1,51
2011-02-08,spring,2011,February,16,Tuesday,Workingday,Clear,0.22,0.1818,0.35,0.5224,4,79,83,83,692,83,1,2,1,121,1,730,227748,1,83
2011-02-08,spring,2011,February,17,Tuesday,Workingday,Clear,0.22,0.1818,0.32,0.5821,4,172,176,176,692,176,1,3,1,131,1,730,336860,1,176
2011-02-08,spring,2011,February,18,Tuesday,Workingday,Clear,0.2,0.1818,0.32,0.3881,1,151,152,152,692,152,1,3,1,131,1,728,309772,1,152
2011-02-08,spring,2011,February,19,Tuesday,Workingday,Clear,0.16,0.1212,0.4,0.4627,1,100,101,101,692,101,1,2,1,121,1,728,226789,1,101
2011-02-08,spring,2011,February,20,Tuesday,Workingday,Clear,0.16,0.1364,0.4,0.3284,3,53,56,56,692,56,1,2,1,121,1,728,164550,1,56
2011-02-08,spring,2011,February,21,Tuesday,Workingday,Clear,0.14,0.1061,0.33,0.4627,8,46,54,54,692,54,1,2,1,121,1,728,125445,1,54
2011-02-08,spring,2011,February,22,Tuesday,Workingday,Clear,0.12,0.1061,0.33,0.3582,0,29,29,29,692,29,1,1,1,111,1,728,95612,1,29
2011-02-08,spring,2011,February,23,Tuesday,Workingday,Clear,0.12,0.1061,0.33,0.3284,3,9,12,12,692,12,1,1,1,111,1,728,63941,1,12
2011-02-09,spring,2011,February,0,Wednesday,Workingday,Clear,0.1,0.0758,0.36,0.3582,0,17,17,17,691,17,1,1,1,111,1,726,39130,1,17
2011-02-09,spring,2011,February,1,Wednesday,Workingday,Clear,0.1,0.1061,0.36,0.2239,0,7,7,7,691,7,1,1,1,111,1,724,24164,1,7
2011-02-09,spring,2011,February,2,Wednesday,Workingday,Clear,0.08,0.0758,0.38,0.2836,1,2,3,3,691,3,1,1,1,111,1,715,16352,1,3
2011-02-09,spring,2011,February,3,Wednesday,Workingday,Clear,0.06,0.0758,0.45,0.1343,0,2,2,2,691,2,1,1,1,111,1,697,8174,1,2
2011-02-09,spring,2011,February,5,Wednesday,Workingday,Clear,0.06,0.1061,0.45,0.1045,0,7,7,7,691,7,1,1,1,111,1,717,14261,1,7
2011-02-09,spring,2011,February,6,Wednesday,Workingday,Clear,0.06,0.1515,0.45,0.0,0,43,43,43,691,43,1,2,1,121,1,725,55132,1,43
2011-02-09,spring,2011,February,7,Wednesday,Workingday,Clear,0.06,0.1061,0.49,0.1045,4,95,99,99,691,99,1,2,1,121,1,727,154171,1,99
2011-02-09,spring,2011,February,8,Wednesday,Workingday,Clear,0.1,0.1364,0.42,0.0,1,198,199,199,691,199,1,3,1,131,1,727,261001,1,199
2011-02-09,spring,2011,February,9,Wednesday,Workingday,Clear,0.12,0.1364,0.39,0.1642,4,119,123,123,691,123,1,2,1,121,1,727,159438,1,123
2011-02-09,spring,2011,February,10,Wednesday,Workingday,Clear,0.14,0.1818,0.36,0.0,8,51,59,59,691,59,1,2,1,121,1,727,126257,1,59
2011-02-09,spring,2011,February,11,Wednesday,Workingday,Mist,0.14,0.1515,0.43,0.1642,1,40,41,41,691,41,1,2,1,121,1,727,151320,1,41
2011-02-09,spring,2011,February,12,Wednesday,Workingday,Mist,0.18,0.1818,0.4,0.2239,4,57,61,61,691,61,1,2,1,121,1,728,184414,1,61
2011-02-09,spring,2011,February,13,Wednesday,Workingday,Clear,0.18,0.1667,0.4,0.2537,2,67,69,69,691,69,1,2,1,121,1,729,184919,1,69
2011-02-09,spring,2011,February,14,Wednesday,Workingday,Clear,0.2,0.1818,0.34,0.2985,2,56,58,58,691,58,1,2,1,121,1,729,175652,1,58
2011-02-09,spring,2011,February,15,Wednesday,Workingday,Mist,0.2,0.1818,0.34,0.2836,3,61,64,64,691,64,1,2,1,121,1,729,183149,1,64
2011-02-09,spring,2011,February,16,Wednesday,Workingday,Mist,0.2,0.197,0.37,0.2537,7,72,79,79,691,79,1,2,1,121,1,730,227748,1,79
2011-02-09,spring,2011,February,17,Wednesday,Workingday,Mist,0.2,0.197,0.34,0.2537,9,157,166,166,691,166,1,3,1,131,1,730,336860,1,166
2011-02-09,spring,2011,February,18,Wednesday,Workingday,Mist,0.18,0.1667,0.47,0.2985,2,168,170,170,691,170,1,3,1,131,1,728,309772,1,170
2011-02-09,spring,2011,February,19,Wednesday,Workingday,Light Snow,0.14,0.1212,0.86,0.2537,1,87,88,88,691,88,1,2,1,121,1,728,226789,1,88
2011-02-09,spring,2011,February,20,Wednesday,Workingday,Light Snow,0.14,0.1515,0.86,0.1642,0,84,84,84,691,84,1,2,1,121,1,728,164550,1,84
2011-02-09,spring,2011,February,21,Wednesday,Workingday,Mist,0.14,0.1515,0.86,0.1642,0,83,83,83,691,83,1,2,1,121,1,728,125445,1,83
2011-02-09,spring,2011,February,22,Wednesday,Workingday,Light Snow,0.16,0.1667,0.8,0.1642,4,42,46,46,691,46,1,2,1,121,1,728,95612,1,46
2011-02-09,spring,2011,February,23,Wednesday,Workingday,Light Snow,0.16,0.1515,0.8,0.194,0,37,37,37,691,37,1,1,1,111,1,728,63941,1,37
2011-02-10,spring,2011,February,0,Thursday,Workingday,Light Snow,0.14,0.1364,0.86,0.194,0,16,16,16,690,16,1,1,1,111,1,726,39130,1,16
2011-02-10,spring,2011,February,1,Thursday,Workingday,Light Snow,0.14,0.1515,0.8,0.1343,0,7,7,7,690,7,1,1,1,111,1,724,24164,1,7
2011-02-10,spring,2011,February,2,Thursday,Workingday,Light Snow,0.14,0.1515,0.8,0.1343,0,3,3,3,690,3,1,1,1,111,1,715,16352,1,3
2011-02-10,spring,2011,February,4,Thursday,Workingday,Mist,0.14,0.1364,0.59,0.2239,0,1,1,1,690,1,1,1,1,111,1,697,4428,1,1
2011-02-10,spring,2011,February,5,Thursday,Workingday,Mist,0.12,0.1212,0.5,0.2239,0,6,6,6,690,6,1,1,1,111,1,717,14261,1,6
2011-02-10,spring,2011,February,6,Thursday,Workingday,Mist,0.12,0.1212,0.54,0.2836,0,26,26,26,690,26,1,1,1,111,1,725,55132,1,26
2011-02-10,spring,2011,February,7,Thursday,Workingday,Clear,0.1,0.0758,0.5,0.4179,0,99,99,99,690,99,1,2,1,121,1,727,154171,1,99
2011-02-10,spring,2011,February,8,Thursday,Workingday,Clear,0.1,0.0758,0.49,0.3284,5,173,178,178,690,178,1,3,1,131,1,727,261001,1,178
2011-02-10,spring,2011,February,9,Thursday,Workingday,Clear,0.12,0.1061,0.42,0.3582,1,121,122,122,690,122,1,2,1,121,1,727,159438,1,122
2011-02-10,spring,2011,February,10,Thursday,Workingday,Clear,0.12,0.1061,0.42,0.2985,1,34,35,35,690,35,1,1,1,111,1,727,126257,1,35
2011-02-10,spring,2011,February,11,Thursday,Workingday,Clear,0.14,0.1212,0.39,0.3582,1,44,45,45,690,45,1,2,1,121,1,727,151320,1,45
2011-02-10,spring,2011,February,12,Thursday,Workingday,Clear,0.16,0.1364,0.34,0.3881,4,65,69,69,690,69,1,2,1,121,1,728,184414,1,69
2011-02-10,spring,2011,February,13,Thursday,Workingday,Clear,0.18,0.1667,0.29,0.2985,3,59,62,62,690,62,1,2,1,121,1,729,184919,1,62
2011-02-10,spring,2011,February,14,Thursday,Workingday,Clear,0.2,0.1818,0.27,0.2836,6,42,48,48,690,48,1,2,1,121,1,729,175652,1,48
2011-02-10,spring,2011,February,15,Thursday,Workingday,Clear,0.2,0.197,0.25,0.2537,0,50,50,50,690,50,1,2,1,121,1,729,183149,1,50
2011-02-10,spring,2011,February,16,Thursday,Workingday,Clear,0.2,0.1818,0.27,0.2985,4,76,80,80,690,80,1,2,1,121,1,730,227748,1,80
2011-02-10,spring,2011,February,17,Thursday,Workingday,Clear,0.18,0.1818,0.26,0.194,6,159,165,165,690,165,1,3,1,131,1,730,336860,1,165
2011-02-10,spring,2011,February,18,Thursday,Workingday,Clear,0.16,0.1818,0.28,0.1343,3,157,160,160,690,160,1,3,1,131,1,728,309772,1,160
2011-02-10,spring,2011,February,19,Thursday,Workingday,Clear,0.14,0.1667,0.28,0.1045,2,110,112,112,690,112,1,2,1,121,1,728,226789,1,112
2011-02-10,spring,2011,February,20,Thursday,Workingday,Clear,0.14,0.1818,0.31,0.0896,4,93,97,97,690,97,1,2,1,121,1,728,164550,1,97
2011-02-10,spring,2011,February,21,Thursday,Workingday,Clear,0.14,0.2121,0.39,0.0,2,70,72,72,690,72,1,2,1,121,1,728,125445,1,72
2011-02-10,spring,2011,February,22,Thursday,Workingday,Clear,0.12,0.197,0.39,0.0,4,47,51,51,690,51,1,2,1,121,1,728,95612,1,51
2011-02-10,spring,2011,February,23,Thursday,Workingday,Clear,0.12,0.1515,0.42,0.1045,1,33,34,34,690,34,1,1,1,111,1,728,63941,1,34
2011-02-11,spring,2011,February,0,Friday,Workingday,Clear,0.1,0.1364,0.49,0.1045,2,12,14,14,689,14,1,1,1,111,1,726,39130,1,14
2011-02-11,spring,2011,February,1,Friday,Workingday,Clear,0.1,0.1364,0.54,0.0896,1,6,7,7,689,7,1,1,1,111,1,724,24164,1,7
2011-02-11,spring,2011,February,2,Friday,Workingday,Clear,0.1,0.1364,0.54,0.0896,0,3,3,3,689,3,1,1,1,111,1,715,16352,1,3
2011-02-11,spring,2011,February,5,Friday,Workingday,Clear,0.08,0.1212,0.63,0.0896,0,4,4,4,689,4,1,1,1,111,1,717,14261,1,4
2011-02-11,spring,2011,February,6,Friday,Workingday,Clear,0.1,0.1818,0.68,0.0,1,23,24,24,689,24,1,1,1,111,1,725,55132,1,24
2011-02-11,spring,2011,February,7,Friday,Workingday,Clear,0.08,0.1667,0.73,0.0,1,73,74,74,689,74,1,2,1,121,1,727,154171,1,74
2011-02-11,spring,2011,February,8,Friday,Workingday,Clear,0.1,0.1212,0.74,0.1642,4,212,216,216,689,216,1,3,1,131,1,727,261001,1,216
2011-02-11,spring,2011,February,9,Friday,Workingday,Clear,0.12,0.1212,0.74,0.2239,8,132,140,140,689,140,1,2,1,121,1,727,159438,1,140
2011-02-11,spring,2011,February,10,Friday,Workingday,Clear,0.14,0.1364,0.69,0.194,5,39,44,44,689,44,1,2,1,121,1,727,126257,1,44
2011-02-11,spring,2011,February,11,Friday,Workingday,Clear,0.22,0.2273,0.47,0.1343,12,52,64,64,689,64,1,2,1,121,1,727,151320,1,64
2011-02-11,spring,2011,February,12,Friday,Workingday,Clear,0.22,0.2273,0.47,0.1343,7,64,71,71,689,71,1,2,1,121,1,728,184414,1,71
2011-02-11,spring,2011,February,13,Friday,Workingday,Clear,0.24,0.2273,0.35,0.194,21,89,110,110,689,110,1,2,1,121,1,729,184919,1,110
2011-02-11,spring,2011,February,14,Friday,Workingday,Clear,0.3,0.2879,0.26,0.2537,17,67,84,84,689,84,1,2,1,121,1,729,175652,1,84
2011-02-11,spring,2011,February,15,Friday,Workingday,Clear,0.32,0.3182,0.21,0.1642,12,62,74,74,689,74,1,2,1,121,1,729,183149,1,74
2011-02-11,spring,2011,February,16,Friday,Workingday,Clear,0.3,0.2879,0.28,0.194,14,111,125,125,689,125,1,2,1,121,1,730,227748,1,125
2011-02-11,spring,2011,February,17,Friday,Workingday,Clear,0.3,0.3333,0.24,0.0,18,193,211,211,689,211,1,3,1,131,1,730,336860,1,211
2011-02-11,spring,2011,February,18,Friday,Workingday,Clear,0.28,0.3182,0.28,0.0,9,165,174,174,689,174,1,3,1,131,1,728,309772,1,174
2011-02-11,spring,2011,February,19,Friday,Workingday,Clear,0.26,0.303,0.33,0.0,7,94,101,101,689,101,1,2,1,121,1,728,226789,1,101
2011-02-11,spring,2011,February,20,Friday,Workingday,Clear,0.22,0.2273,0.55,0.1343,2,61,63,63,689,63,1,2,1,121,1,728,164550,1,63
2011-02-11,spring,2011,February,21,Friday,Workingday,Clear,0.2,0.2121,0.59,0.1343,1,46,47,47,689,47,1,2,1,121,1,728,125445,1,47
2011-02-11,spring,2011,February,22,Friday,Workingday,Clear,0.2,0.2273,0.64,0.0896,2,41,43,43,689,43,1,2,1,121,1,728,95612,1,43
2011-02-11,spring,2011,February,23,Friday,Workingday,Clear,0.18,0.2424,0.69,0.0,5,48,53,53,689,53,1,2,1,121,1,728,63941,1,53
2011-02-12,spring,2011,February,0,Saturday,Holiday,Clear,0.16,0.197,0.69,0.0896,3,27,30,30,688,30,1,1,1,111,1,726,39130,1,30
2011-02-12,spring,2011,February,1,Saturday,Holiday,Clear,0.14,0.2121,0.86,0.0,2,22,24,24,688,24,1,1,1,111,1,724,24164,1,24
2011-02-12,spring,2011,February,2,Saturday,Holiday,Clear,0.14,0.2121,0.8,0.0,2,13,15,15,688,15,1,1,1,111,1,715,16352,1,15
2011-02-12,spring,2011,February,3,Saturday,Holiday,Clear,0.12,0.197,0.8,0.0,3,7,10,10,688,10,1,1,1,111,1,697,8174,1,10
2011-02-12,spring,2011,February,4,Saturday,Holiday,Clear,0.12,0.1667,0.74,0.0896,0,4,4,4,688,4,1,1,1,111,1,697,4428,1,4
2011-02-12,spring,2011,February,5,Saturday,Holiday,Clear,0.12,0.1667,0.74,0.0896,0,1,1,1,688,1,1,1,1,111,1,717,14261,1,1
2011-02-12,spring,2011,February,6,Saturday,Holiday,Clear,0.12,0.1364,0.93,0.194,1,1,2,2,688,2,1,1,1,111,1,725,55132,1,2
2011-02-12,spring,2011,February,7,Saturday,Holiday,Clear,0.12,0.1515,0.8,0.1045,2,9,11,11,688,11,1,1,1,111,1,727,154171,1,11
2011-02-12,spring,2011,February,8,Saturday,Holiday,Clear,0.14,0.1515,0.86,0.1343,2,28,30,30,688,30,1,1,1,111,1,727,261001,1,30
2011-02-12,spring,2011,February,9,Saturday,Holiday,Clear,0.16,0.1818,0.64,0.1343,5,38,43,43,688,43,1,2,1,121,1,727,159438,1,43
2011-02-12,spring,2011,February,10,Saturday,Holiday,Clear,0.22,0.2121,0.41,0.2537,13,71,84,84,688,84,1,2,1,121,1,727,126257,1,84
2011-02-12,spring,2011,February,11,Saturday,Holiday,Clear,0.3,0.2727,0.28,0.3284,30,84,114,114,688,114,1,2,1,121,1,727,151320,1,114
2011-02-12,spring,2011,February,12,Saturday,Holiday,Clear,0.3,0.2727,0.39,0.4627,27,93,120,120,688,120,1,2,1,121,1,728,184414,1,120
2011-02-12,spring,2011,February,13,Saturday,Holiday,Clear,0.3,0.2727,0.39,0.4179,32,103,135,135,688,135,1,2,1,121,1,729,184919,1,135
2011-02-12,spring,2011,February,14,Saturday,Holiday,Clear,0.34,0.3182,0.31,0.2836,30,90,120,120,688,120,1,2,1,121,1,729,175652,1,120
2011-02-12,spring,2011,February,15,Saturday,Holiday,Clear,0.34,0.303,0.29,0.4179,47,127,174,174,688,174,1,3,1,131,1,729,183149,1,174
2011-02-12,spring,2011,February,16,Saturday,Holiday,Clear,0.34,0.303,0.29,0.4179,42,103,145,145,688,145,1,3,1,131,1,730,227748,1,145
2011-02-12,spring,2011,February,17,Saturday,Holiday,Clear,0.32,0.2879,0.31,0.5224,24,113,137,137,688,137,1,2,1,121,1,730,336860,1,137
2011-02-12,spring,2011,February,18,Saturday,Holiday,Clear,0.28,0.2576,0.38,0.3284,4,60,64,64,688,64,1,2,1,121,1,728,309772,1,64
2011-02-12,spring,2011,February,19,Saturday,Holiday,Clear,0.28,0.2727,0.38,0.1642,2,39,41,41,688,41,1,2,1,121,1,728,226789,1,41
2011-02-12,spring,2011,February,20,Saturday,Holiday,Clear,0.26,0.2576,0.41,0.2239,1,39,40,40,688,40,1,1,1,111,1,728,164550,1,40
2011-02-12,spring,2011,February,21,Saturday,Holiday,Clear,0.26,0.303,0.41,0.0,9,42,51,51,688,51,1,2,1,121,1,728,125445,1,51
2011-02-12,spring,2011,February,22,Saturday,Holiday,Clear,0.24,0.2576,0.44,0.0896,6,39,45,45,688,45,1,2,1,121,1,728,95612,1,45
2011-02-12,spring,2011,February,23,Saturday,Holiday,Clear,0.22,0.2273,0.51,0.1343,1,31,32,32,688,32,1,1,1,111,1,728,63941,1,32
2011-02-13,spring,2011,February,0,Sunday,Holiday,Clear,0.2,0.2273,0.64,0.1045,5,34,39,39,687,39,1,1,1,111,1,726,39130,1,39
2011-02-13,spring,2011,February,1,Sunday,Holiday,Clear,0.2,0.2273,0.59,0.0896,1,23,24,24,687,24,1,1,1,111,1,724,24164,1,24
2011-02-13,spring,2011,February,2,Sunday,Holiday,Mist,0.2,0.2273,0.75,0.0896,1,19,20,20,687,20,1,1,1,111,1,715,16352,1,20
2011-02-13,spring,2011,February,3,Sunday,Holiday,Mist,0.2,0.2273,0.69,0.1045,4,8,12,12,687,12,1,1,1,111,1,697,8174,1,12
2011-02-13,spring,2011,February,4,Sunday,Holiday,Mist,0.2,0.2121,0.69,0.1642,0,2,2,2,687,2,1,1,1,111,1,697,4428,1,2
2011-02-13,spring,2011,February,6,Sunday,Holiday,Mist,0.2,0.2121,0.69,0.1343,2,3,5,5,687,5,1,1,1,111,1,725,55132,1,5
2011-02-13,spring,2011,February,7,Sunday,Holiday,Mist,0.22,0.2727,0.55,0.0,0,3,3,3,687,3,1,1,1,111,1,727,154171,1,3
2011-02-13,spring,2011,February,8,Sunday,Holiday,Mist,0.22,0.2273,0.64,0.194,1,11,12,12,687,12,1,1,1,111,1,727,261001,1,12
2011-02-13,spring,2011,February,9,Sunday,Holiday,Mist,0.24,0.2273,0.6,0.2239,12,35,47,47,687,47,1,2,1,121,1,727,159438,1,47
2011-02-13,spring,2011,February,10,Sunday,Holiday,Clear,0.3,0.2727,0.45,0.3284,19,86,105,105,687,105,1,2,1,121,1,727,126257,1,105
2011-02-13,spring,2011,February,11,Sunday,Holiday,Clear,0.32,0.2879,0.39,0.4478,26,86,112,112,687,112,1,2,1,121,1,727,151320,1,112
2011-02-13,spring,2011,February,12,Sunday,Holiday,Clear,0.36,0.3182,0.32,0.4627,58,94,152,152,687,152,1,3,1,131,1,728,184414,1,152
2011-02-13,spring,2011,February,13,Sunday,Holiday,Clear,0.38,0.3939,0.29,0.3582,62,92,154,154,687,154,1,3,2,132,1,729,184919,1,154
2011-02-13,spring,2011,February,14,Sunday,Holiday,Mist,0.4,0.4091,0.3,0.4179,51,110,161,161,687,161,1,3,2,132,1,729,175652,1,161
2011-02-13,spring,2011,February,15,Sunday,Holiday,Mist,0.4,0.4091,0.3,0.2985,40,122,162,162,687,162,1,3,2,132,1,729,183149,1,162
2011-02-13,spring,2011,February,16,Sunday,Holiday,Mist,0.42,0.4242,0.28,0.3284,28,106,134,134,687,134,1,2,2,122,1,730,227748,1,134
2011-02-13,spring,2011,February,17,Sunday,Holiday,Clear,0.42,0.4242,0.28,0.3284,30,95,125,125,687,125,1,2,2,122,1,730,336860,1,125
2011-02-13,spring,2011,February,18,Sunday,Holiday,Clear,0.4,0.4091,0.32,0.2985,17,78,95,95,687,95,1,2,2,122,1,728,309772,1,95
2011-02-13,spring,2011,February,19,Sunday,Holiday,Clear,0.4,0.4091,0.35,0.2836,11,50,61,61,687,61,1,2,2,122,1,728,226789,1,61
2011-02-13,spring,2011,February,20,Sunday,Holiday,Clear,0.4,0.4091,0.35,0.3284,15,32,47,47,687,47,1,2,2,122,1,728,164550,1,47
2011-02-13,spring,2011,February,21,Sunday,Holiday,Clear,0.4,0.4091,0.35,0.3582,6,45,51,51,687,51,1,2,2,122,1,728,125445,1,51
2011-02-13,spring,2011,February,22,Sunday,Holiday,Clear,0.4,0.4091,0.35,0.2985,5,31,36,36,687,36,1,1,2,112,1,728,95612,1,36
2011-02-13,spring,2011,February,23,Sunday,Holiday,Clear,0.4,0.4091,0.35,0.3582,3,27,30,30,687,30,1,1,2,112,1,728,63941,1,30
2011-02-14,spring,2011,February,0,Monday,Workingday,Clear,0.38,0.3939,0.37,0.3582,3,8,11,11,686,11,1,1,2,112,1,726,39130,1,11
2011-02-14,spring,2011,February,1,Monday,Workingday,Clear,0.38,0.3939,0.37,0.3582,1,6,7,7,686,7,1,1,2,112,1,724,24164,1,7
2011-02-14,spring,2011,February,2,Monday,Workingday,Clear,0.36,0.3333,0.4,0.2985,0,2,2,2,686,2,1,1,1,111,1,715,16352,1,2
2011-02-14,spring,2011,February,3,Monday,Workingday,Clear,0.34,0.3182,0.46,0.2239,1,1,2,2,686,2,1,1,1,111,1,697,8174,1,2
2011-02-14,spring,2011,February,4,Monday,Workingday,Clear,0.32,0.303,0.53,0.2836,0,2,2,2,686,2,1,1,1,111,1,697,4428,1,2
2011-02-14,spring,2011,February,5,Monday,Workingday,Clear,0.32,0.303,0.53,0.2836,0,3,3,3,686,3,1,1,1,111,1,717,14261,1,3
2011-02-14,spring,2011,February,6,Monday,Workingday,Clear,0.34,0.303,0.46,0.2985,1,25,26,26,686,26,1,1,1,111,1,725,55132,1,26
2011-02-14,spring,2011,February,7,Monday,Workingday,Clear,0.34,0.303,0.46,0.2985,2,96,98,98,686,98,1,2,1,121,1,727,154171,1,98
2011-02-14,spring,2011,February,8,Monday,Workingday,Clear,0.38,0.3939,0.4,0.4627,7,249,256,256,686,256,1,3,2,132,1,727,261001,1,256
2011-02-14,spring,2011,February,9,Monday,Workingday,Clear,0.4,0.4091,0.37,0.3881,8,122,130,130,686,130,1,2,2,122,1,727,159438,1,130
2011-02-14,spring,2011,February,10,Monday,Workingday,Clear,0.44,0.4394,0.33,0.2239,9,46,55,55,686,55,1,2,2,122,1,727,126257,1,55
2011-02-14,spring,2011,February,11,Monday,Workingday,Clear,0.52,0.5,0.23,0.2537,10,43,53,53,686,53,1,2,3,123,1,727,151320,1,53
2011-02-14,spring,2011,February,12,Monday,Workingday,Clear,0.56,0.5303,0.22,0.4478,27,99,126,126,686,126,1,2,3,123,2,728,184414,1,126
2011-02-14,spring,2011,February,13,Monday,Workingday,Clear,0.58,0.5455,0.19,0.3881,27,93,120,120,686,120,1,2,3,123,2,729,184919,1,120
2011-02-14,spring,2011,February,14,Monday,Workingday,Clear,0.6,0.5909,0.15,0.4925,14,76,90,90,686,90,1,2,3,123,2,729,175652,1,90
2011-02-14,spring,2011,February,15,Monday,Workingday,Clear,0.56,0.5303,0.21,0.6567,19,71,90,90,686,90,1,2,3,123,2,729,183149,1,90
2011-02-14,spring,2011,February,16,Monday,Workingday,Clear,0.52,0.5,0.27,0.4627,16,102,118,118,686,118,1,2,3,123,1,730,227748,1,118
2011-02-14,spring,2011,February,17,Monday,Workingday,Clear,0.46,0.4545,0.33,0.6119,25,218,243,243,686,243,1,3,2,132,1,730,336860,1,243
2011-02-14,spring,2011,February,18,Monday,Workingday,Clear,0.4,0.4091,0.4,0.6119,11,194,205,205,686,205,1,3,2,132,1,728,309772,1,205
2011-02-14,spring,2011,February,19,Monday,Workingday,Clear,0.38,0.3939,0.43,0.4925,12,86,98,98,686,98,1,2,2,122,1,728,226789,1,98
2011-02-14,spring,2011,February,20,Monday,Workingday,Clear,0.36,0.3182,0.46,0.4627,5,65,70,70,686,70,1,2,1,121,1,728,164550,1,70
2011-02-14,spring,2011,February,21,Monday,Workingday,Clear,0.36,0.3182,0.5,0.5224,8,35,43,43,686,43,1,2,1,121,1,728,125445,1,43
2011-02-14,spring,2011,February,22,Monday,Workingday,Clear,0.34,0.2879,0.46,0.6567,1,44,45,45,686,45,1,2,1,121,1,728,95612,1,45
2011-02-14,spring,2011,February,23,Monday,Workingday,Clear,0.32,0.2879,0.49,0.4925,1,19,20,20,686,20,1,1,1,111,1,728,63941,1,20
2011-02-15,spring,2011,February,0,Tuesday,Workingday,Clear,0.3,0.2727,0.49,0.4179,7,12,19,19,685,19,1,1,1,111,1,726,39130,1,19
2011-02-15,spring,2011,February,1,Tuesday,Workingday,Clear,0.3,0.2424,0.42,0.7761,0,5,5,5,685,5,1,1,1,111,1,724,24164,1,5
2011-02-15,spring,2011,February,2,Tuesday,Workingday,Clear,0.28,0.2273,0.41,0.6866,1,2,3,3,685,3,1,1,1,111,1,715,16352,1,3
2011-02-15,spring,2011,February,4,Tuesday,Workingday,Clear,0.22,0.1818,0.37,0.5224,0,1,1,1,685,1,1,1,1,111,1,697,4428,1,1
2011-02-15,spring,2011,February,5,Tuesday,Workingday,Clear,0.22,0.1818,0.32,0.4627,0,4,4,4,685,4,1,1,1,111,1,717,14261,1,4
2011-02-15,spring,2011,February,6,Tuesday,Workingday,Clear,0.2,0.1818,0.32,0.3284,0,30,30,30,685,30,1,1,1,111,1,725,55132,1,30
2011-02-15,spring,2011,February,7,Tuesday,Workingday,Clear,0.2,0.1818,0.32,0.3582,2,103,105,105,685,105,1,2,1,121,1,727,154171,1,105
2011-02-15,spring,2011,February,8,Tuesday,Workingday,Clear,0.2,0.1818,0.32,0.3582,10,213,223,223,685,223,1,3,1,131,1,727,261001,1,223
2011-02-15,spring,2011,February,9,Tuesday,Workingday,Clear,0.22,0.197,0.29,0.4478,2,108,110,110,685,110,1,2,1,121,1,727,159438,1,110
2011-02-15,spring,2011,February,10,Tuesday,Workingday,Clear,0.24,0.2121,0.27,0.2836,5,47,52,52,685,52,1,2,1,121,1,727,126257,1,52
2011-02-15,spring,2011,February,11,Tuesday,Workingday,Clear,0.26,0.2424,0.25,0.2537,11,46,57,57,685,57,1,2,1,121,1,727,151320,1,57
2011-02-15,spring,2011,February,12,Tuesday,Workingday,Clear,0.28,0.2727,0.24,0.2537,6,65,71,71,685,71,1,2,1,121,1,728,184414,1,71
2011-02-15,spring,2011,February,13,Tuesday,Workingday,Clear,0.32,0.303,0.21,0.2239,14,68,82,82,685,82,1,2,1,121,1,729,184919,1,82
2011-02-15,spring,2011,February,14,Tuesday,Workingday,Clear,0.34,0.3182,0.19,0.2239,10,69,79,79,685,79,1,2,1,121,1,729,175652,1,79
2011-02-15,spring,2011,February,15,Tuesday,Workingday,Clear,0.34,0.3333,0.19,0.1642,11,74,85,85,685,85,1,2,1,121,1,729,183149,1,85
2011-02-15,spring,2011,February,16,Tuesday,Workingday,Clear,0.34,0.3182,0.19,0.2537,21,77,98,98,685,98,1,2,1,121,1,730,227748,1,98
2011-02-15,spring,2011,February,17,Tuesday,Workingday,Clear,0.32,0.303,0.22,0.2239,15,191,206,206,685,206,1,3,1,131,1,730,336860,1,206
2011-02-15,spring,2011,February,18,Tuesday,Workingday,Clear,0.3,0.303,0.22,0.1343,14,198,212,212,685,212,1,3,1,131,1,728,309772,1,212
2011-02-15,spring,2011,February,19,Tuesday,Workingday,Clear,0.28,0.2879,0.26,0.1343,3,142,145,145,685,145,1,3,1,131,1,728,226789,1,145
2011-02-15,spring,2011,February,20,Tuesday,Workingday,Clear,0.26,0.2727,0.33,0.1045,3,98,101,101,685,101,1,2,1,121,1,728,164550,1,101
2011-02-15,spring,2011,February,21,Tuesday,Workingday,Clear,0.24,0.2879,0.52,0.0,5,61,66,66,685,66,1,2,1,121,1,728,125445,1,66
2011-02-15,spring,2011,February,22,Tuesday,Workingday,Clear,0.24,0.2879,0.44,0.0,0,41,41,41,685,41,1,2,1,121,1,728,95612,1,41
2011-02-15,spring,2011,February,23,Tuesday,Workingday,Mist,0.22,0.2576,0.44,0.0896,0,20,20,20,685,20,1,1,1,111,1,728,63941,1,20
2011-02-16,spring,2011,February,0,Wednesday,Workingday,Clear,0.22,0.2576,0.41,0.0896,0,15,15,15,684,15,1,1,1,111,1,726,39130,1,15
2011-02-16,spring,2011,February,1,Wednesday,Workingday,Clear,0.2,0.2273,0.44,0.0896,0,9,9,9,684,9,1,1,1,111,1,724,24164,1,9
2011-02-16,spring,2011,February,3,Wednesday,Workingday,Mist,0.2,0.197,0.47,0.194,0,1,1,1,684,1,1,1,1,111,1,697,8174,1,1
2011-02-16,spring,2011,February,4,Wednesday,Workingday,Clear,0.2,0.197,0.51,0.194,0,1,1,1,684,1,1,1,1,111,1,697,4428,1,1
2011-02-16,spring,2011,February,5,Wednesday,Workingday,Clear,0.2,0.197,0.47,0.194,0,5,5,5,684,5,1,1,1,111,1,717,14261,1,5
2011-02-16,spring,2011,February,6,Wednesday,Workingday,Clear,0.2,0.197,0.55,0.2239,1,32,33,33,684,33,1,1,1,111,1,725,55132,1,33
2011-02-16,spring,2011,February,7,Wednesday,Workingday,Mist,0.2,0.197,0.55,0.2239,5,103,108,108,684,108,1,2,1,121,1,727,154171,1,108
2011-02-16,spring,2011,February,8,Wednesday,Workingday,Mist,0.22,0.2273,0.55,0.1642,6,224,230,230,684,230,1,3,1,131,1,727,261001,1,230
2011-02-16,spring,2011,February,9,Wednesday,Workingday,Clear,0.24,0.2121,0.52,0.2836,2,122,124,124,684,124,1,2,1,121,1,727,159438,1,124
2011-02-16,spring,2011,February,10,Wednesday,Workingday,Clear,0.26,0.2273,0.41,0.3881,14,55,69,69,684,69,1,2,1,121,1,727,126257,1,69
2011-02-16,spring,2011,February,11,Wednesday,Workingday,Clear,0.34,0.303,0.34,0.2985,7,59,66,66,684,66,1,2,1,121,1,727,151320,1,66
2011-02-16,spring,2011,February,12,Wednesday,Workingday,Clear,0.38,0.3939,0.32,0.3284,14,72,86,86,684,86,1,2,2,122,1,728,184414,1,86
2011-02-16,spring,2011,February,13,Wednesday,Workingday,Clear,0.42,0.4242,0.3,0.3582,13,80,93,93,684,93,1,2,2,122,1,729,184919,1,93
2011-02-16,spring,2011,February,14,Wednesday,Workingday,Clear,0.46,0.4545,0.28,0.4179,17,65,82,82,684,82,1,2,2,122,1,729,175652,1,82
2011-02-16,spring,2011,February,15,Wednesday,Workingday,Clear,0.46,0.4545,0.28,0.4179,35,82,117,117,684,117,1,2,2,122,1,729,183149,1,117
2011-02-16,spring,2011,February,16,Wednesday,Workingday,Clear,0.46,0.4545,0.31,0.3881,26,96,122,122,684,122,1,2,2,122,1,730,227748,1,122
2011-02-16,spring,2011,February,17,Wednesday,Workingday,Clear,0.46,0.4545,0.28,0.2836,11,244,255,255,684,255,1,3,2,132,1,730,336860,1,255
2011-02-16,spring,2011,February,18,Wednesday,Workingday,Clear,0.4,0.4091,0.4,0.2239,20,202,222,222,684,222,1,3,2,132,1,728,309772,1,222
2011-02-16,spring,2011,February,19,Wednesday,Workingday,Clear,0.34,0.3182,0.53,0.2239,18,143,161,161,684,161,1,3,1,131,1,728,226789,1,161
2011-02-16,spring,2011,February,20,Wednesday,Workingday,Clear,0.38,0.3939,0.43,0.194,10,108,118,118,684,118,1,2,2,122,1,728,164550,1,118
2011-02-16,spring,2011,February,21,Wednesday,Workingday,Clear,0.36,0.3485,0.46,0.194,5,87,92,92,684,92,1,2,2,122,1,728,125445,1,92
2011-02-16,spring,2011,February,22,Wednesday,Workingday,Clear,0.34,0.3333,0.53,0.194,12,61,73,73,684,73,1,2,1,121,1,728,95612,1,73
2011-02-16,spring,2011,February,23,Wednesday,Workingday,Clear,0.38,0.3939,0.4,0.2239,2,31,33,33,684,33,1,1,2,112,1,728,63941,1,33
2011-02-17,spring,2011,February,0,Thursday,Workingday,Clear,0.34,0.3333,0.53,0.194,1,16,17,17,683,17,1,1,1,111,1,726,39130,1,17
2011-02-17,spring,2011,February,1,Thursday,Workingday,Clear,0.34,0.3182,0.53,0.2239,0,6,6,6,683,6,1,1,1,111,1,724,24164,1,6
2011-02-17,spring,2011,February,2,Thursday,Workingday,Mist,0.34,0.3182,0.53,0.2239,2,4,6,6,683,6,1,1,1,111,1,715,16352,1,6
2011-02-17,spring,2011,February,3,Thursday,Workingday,Clear,0.34,0.3333,0.53,0.194,3,1,4,4,683,4,1,1,1,111,1,697,8174,1,4
2011-02-17,spring,2011,February,4,Thursday,Workingday,Clear,0.32,0.3182,0.57,0.194,3,1,4,4,683,4,1,1,1,111,1,697,4428,1,4
2011-02-17,spring,2011,February,5,Thursday,Workingday,Clear,0.32,0.3333,0.66,0.0896,1,11,12,12,683,12,1,1,1,111,1,717,14261,1,12
2011-02-17,spring,2011,February,6,Thursday,Workingday,Clear,0.3,0.303,0.7,0.1343,3,44,47,47,683,47,1,2,1,121,1,725,55132,1,47
2011-02-17,spring,2011,February,7,Thursday,Workingday,Clear,0.32,0.3333,0.57,0.1045,7,119,126,126,683,126,1,2,1,121,1,727,154171,1,126
2011-02-17,spring,2011,February,8,Thursday,Workingday,Clear,0.32,0.3333,0.57,0.0896,18,267,285,285,683,285,1,4,1,141,1,727,261001,1,285
2011-02-17,spring,2011,February,9,Thursday,Workingday,Clear,0.36,0.3485,0.57,0.194,16,163,179,179,683,179,1,3,2,132,1,727,159438,1,179
2011-02-17,spring,2011,February,10,Thursday,Workingday,Clear,0.38,0.3939,0.54,0.194,18,70,88,88,683,88,1,2,2,122,1,727,126257,1,88
2011-02-17,spring,2011,February,11,Thursday,Workingday,Mist,0.44,0.4394,0.44,0.2537,19,71,90,90,683,90,1,2,2,122,1,727,151320,1,90
2011-02-17,spring,2011,February,12,Thursday,Workingday,Clear,0.48,0.4697,0.41,0.2239,15,86,101,101,683,101,1,2,2,122,1,728,184414,1,101
2011-02-17,spring,2011,February,13,Thursday,Workingday,Clear,0.54,0.5152,0.34,0.2239,15,108,123,123,683,123,1,2,3,123,1,729,184919,1,123
2011-02-17,spring,2011,February,14,Thursday,Workingday,Clear,0.6,0.6212,0.31,0.2239,26,55,81,81,683,81,1,2,3,123,2,729,175652,1,81
2011-02-17,spring,2011,February,15,Thursday,Workingday,Clear,0.6,0.6061,0.28,0.2537,15,91,106,106,683,106,1,2,3,123,2,729,183149,1,106
2011-02-17,spring,2011,February,16,Thursday,Workingday,Mist,0.56,0.5303,0.35,0.2985,29,117,146,146,683,146,1,3,3,133,2,730,227748,1,146
2011-02-17,spring,2011,February,17,Thursday,Workingday,Mist,0.58,0.5455,0.32,0.2985,18,256,274,274,683,274,1,3,3,133,2,730,336860,1,274
2011-02-17,spring,2011,February,18,Thursday,Workingday,Mist,0.54,0.5152,0.42,0.2836,11,211,222,222,683,222,1,3,3,133,2,728,309772,1,222
2011-02-17,spring,2011,February,19,Thursday,Workingday,Clear,0.48,0.4697,0.55,0.3284,14,161,175,175,683,175,1,3,2,132,1,728,226789,1,175
2011-02-17,spring,2011,February,20,Thursday,Workingday,Clear,0.48,0.4697,0.59,0.3284,8,131,139,139,683,139,1,2,2,122,1,728,164550,1,139
2011-02-17,spring,2011,February,21,Thursday,Workingday,Clear,0.52,0.5,0.55,0.3881,5,119,124,124,683,124,1,2,3,123,1,728,125445,1,124
2011-02-17,spring,2011,February,22,Thursday,Workingday,Clear,0.5,0.4848,0.59,0.2836,8,68,76,76,683,76,1,2,2,122,0,728,95612,1,76
2011-02-17,spring,2011,February,23,Thursday,Workingday,Clear,0.46,0.4545,0.67,0.2985,4,40,44,44,683,44,1,2,2,122,1,728,63941,1,44
2011-02-18,spring,2011,February,0,Friday,Workingday,Clear,0.44,0.4394,0.72,0.2836,12,20,32,32,682,32,1,1,2,112,1,726,39130,1,32
2011-02-18,spring,2011,February,1,Friday,Workingday,Clear,0.44,0.4394,0.72,0.2239,1,7,8,8,682,8,1,1,2,112,0,724,24164,1,8
2011-02-18,spring,2011,February,2,Friday,Workingday,Clear,0.44,0.4394,0.72,0.2836,2,5,7,7,682,7,1,1,2,112,1,715,16352,1,7
2011-02-18,spring,2011,February,3,Friday,Workingday,Clear,0.46,0.4545,0.67,0.2537,2,6,8,8,682,8,1,1,2,112,0,697,8174,1,8
2011-02-18,spring,2011,February,4,Friday,Workingday,Clear,0.46,0.4545,0.67,0.2537,0,1,1,1,682,1,1,1,2,112,0,697,4428,1,1
2011-02-18,spring,2011,February,5,Friday,Workingday,Mist,0.46,0.4545,0.67,0.1045,1,6,7,7,682,7,1,1,2,112,0,717,14261,1,7
2011-02-18,spring,2011,February,6,Friday,Workingday,Mist,0.44,0.4394,0.72,0.1642,2,48,50,50,682,50,1,2,2,122,0,725,55132,1,50
2011-02-18,spring,2011,February,7,Friday,Workingday,Mist,0.42,0.4242,0.77,0.2239,8,108,116,116,682,116,1,2,2,122,0,727,154171,1,116
2011-02-18,spring,2011,February,8,Friday,Workingday,Mist,0.42,0.4242,0.77,0.194,26,246,272,272,682,272,1,3,2,132,0,727,261001,1,272
2011-02-18,spring,2011,February,9,Friday,Workingday,Mist,0.42,0.4242,0.77,0.194,15,154,169,169,682,169,1,3,2,132,0,727,159438,1,169
2011-02-18,spring,2011,February,10,Friday,Workingday,Mist,0.44,0.4394,0.72,0.2239,17,78,95,95,682,95,1,2,2,122,0,727,126257,1,95
2011-02-18,spring,2011,February,11,Friday,Workingday,Clear,0.44,0.4394,0.72,0.1642,31,82,113,113,682,113,1,2,2,122,0,727,151320,1,113
2011-02-18,spring,2011,February,12,Friday,Workingday,Clear,0.5,0.4848,0.59,0.194,59,126,185,185,682,185,1,3,2,132,0,728,184414,1,185
2011-02-18,spring,2011,February,13,Friday,Workingday,Clear,0.6,0.6212,0.43,0.194,45,131,176,176,682,176,1,3,3,133,2,729,184919,1,176
2011-02-18,spring,2011,February,14,Friday,Workingday,Clear,0.66,0.6212,0.36,0.2985,73,118,191,191,682,191,1,3,3,133,2,729,175652,1,191
2011-02-18,spring,2011,February,15,Friday,Workingday,Clear,0.66,0.6212,0.36,0.3284,55,117,172,172,682,172,1,3,3,133,2,729,183149,1,172
2011-02-18,spring,2011,February,16,Friday,Workingday,Clear,0.66,0.6212,0.36,0.2836,68,164,232,232,682,232,1,3,3,133,2,730,227748,1,232
2011-02-18,spring,2011,February,17,Friday,Workingday,Clear,0.66,0.6212,0.34,0.3582,52,275,327,327,682,327,1,4,3,143,2,730,336860,1,327
2011-02-18,spring,2011,February,18,Friday,Workingday,Clear,0.64,0.6212,0.33,0.3284,29,195,224,224,682,224,1,3,3,133,2,728,309772,1,224
2011-02-18,spring,2011,February,19,Friday,Workingday,Clear,0.62,0.6212,0.29,0.5821,16,146,162,162,682,162,1,3,3,133,2,728,226789,1,162
2011-02-18,spring,2011,February,20,Friday,Workingday,Clear,0.6,0.6212,0.31,0.194,19,105,124,124,682,124,1,2,3,123,2,728,164550,1,124
2011-02-18,spring,2011,February,21,Friday,Workingday,Clear,0.58,0.5455,0.21,0.4925,11,61,72,72,682,72,1,2,3,123,2,728,125445,1,72
2011-02-18,spring,2011,February,22,Friday,Workingday,Clear,0.54,0.5152,0.1,0.2537,19,88,107,107,682,107,1,2,3,123,2,728,95612,1,107
2011-02-18,spring,2011,February,23,Friday,Workingday,Clear,0.52,0.5,0.08,0.2836,16,61,77,77,682,77,1,2,3,123,1,728,63941,1,77
2011-02-19,spring,2011,February,0,Saturday,Holiday,Clear,0.48,0.4697,0.12,0.4925,6,23,29,29,681,29,1,1,2,112,1,726,39130,1,29
2011-02-19,spring,2011,February,1,Saturday,Holiday,Clear,0.46,0.4545,0.14,0.4179,10,21,31,31,681,31,1,1,2,112,1,724,24164,1,31
2011-02-19,spring,2011,February,2,Saturday,Holiday,Clear,0.44,0.4394,0.13,0.3881,3,14,17,17,681,17,1,1,2,112,1,715,16352,1,17
2011-02-19,spring,2011,February,3,Saturday,Holiday,Clear,0.42,0.4242,0.14,0.2985,0,7,7,7,681,7,1,1,2,112,1,697,8174,1,7
2011-02-19,spring,2011,February,4,Saturday,Holiday,Clear,0.4,0.4091,0.15,0.3284,0,3,3,3,681,3,1,1,2,112,1,697,4428,1,3
2011-02-19,spring,2011,February,5,Saturday,Holiday,Clear,0.4,0.4091,0.15,0.3284,0,3,3,3,681,3,1,1,2,112,1,717,14261,1,3
2011-02-19,spring,2011,February,6,Saturday,Holiday,Clear,0.4,0.4091,0.17,0.4179,3,3,6,6,681,6,1,1,2,112,1,725,55132,1,6
2011-02-19,spring,2011,February,7,Saturday,Holiday,Clear,0.38,0.3939,0.17,0.5224,6,16,22,22,681,22,1,1,2,112,1,727,154171,1,22
2011-02-19,spring,2011,February,8,Saturday,Holiday,Clear,0.38,0.3939,0.17,0.5821,9,36,45,45,681,45,1,2,2,122,1,727,261001,1,45
2011-02-19,spring,2011,February,9,Saturday,Holiday,Clear,0.4,0.4091,0.16,0.6567,18,37,55,55,681,55,1,2,2,122,1,727,159438,1,55
2011-02-19,spring,2011,February,10,Saturday,Holiday,Clear,0.42,0.4242,0.16,0.5821,34,72,106,106,681,106,1,2,2,122,1,727,126257,1,106
2011-02-19,spring,2011,February,11,Saturday,Holiday,Clear,0.44,0.4394,0.16,0.5821,47,76,123,123,681,123,1,2,2,122,1,727,151320,1,123
2011-02-19,spring,2011,February,12,Saturday,Holiday,Clear,0.44,0.4394,0.18,0.4925,38,81,119,119,681,119,1,2,2,122,1,728,184414,1,119
2011-02-19,spring,2011,February,13,Saturday,Holiday,Clear,0.44,0.4394,0.16,0.6119,52,103,155,155,681,155,1,3,2,132,1,729,184919,1,155
2011-02-19,spring,2011,February,14,Saturday,Holiday,Clear,0.46,0.4545,0.15,0.6567,102,94,196,196,681,196,1,3,2,132,2,729,175652,1,196
2011-02-19,spring,2011,February,15,Saturday,Holiday,Clear,0.44,0.4394,0.16,0.7463,84,87,171,171,681,171,1,3,2,132,2,729,183149,1,171
2011-02-19,spring,2011,February,16,Saturday,Holiday,Clear,0.44,0.4394,0.16,0.6418,39,81,120,120,681,120,1,2,2,122,1,730,227748,1,120
2011-02-19,spring,2011,February,17,Saturday,Holiday,Clear,0.42,0.4242,0.19,0.6119,36,91,127,127,681,127,1,2,2,122,1,730,336860,1,127
2011-02-19,spring,2011,February,18,Saturday,Holiday,Clear,0.36,0.3182,0.25,0.4478,21,67,88,88,681,88,1,2,1,121,1,728,309772,1,88
2011-02-19,spring,2011,February,19,Saturday,Holiday,Clear,0.34,0.303,0.29,0.3582,5,54,59,59,681,59,1,2,1,121,1,728,226789,1,59
2011-02-19,spring,2011,February,20,Saturday,Holiday,Clear,0.32,0.2879,0.28,0.5224,9,38,47,47,681,47,1,2,1,121,1,728,164550,1,47
2011-02-19,spring,2011,February,21,Saturday,Holiday,Clear,0.32,0.2727,0.26,0.5522,4,29,33,33,681,33,1,1,1,111,1,728,125445,1,33
2011-02-19,spring,2011,February,22,Saturday,Holiday,Clear,0.3,0.2576,0.28,0.4925,2,42,44,44,681,44,1,2,1,121,1,728,95612,1,44
2011-02-19,spring,2011,February,23,Saturday,Holiday,Clear,0.28,0.2424,0.33,0.4478,4,25,29,29,681,29,1,1,1,111,1,728,63941,1,29
2011-02-20,spring,2011,February,0,Sunday,Holiday,Clear,0.26,0.2121,0.35,0.4478,3,14,17,17,680,17,1,1,1,111,1,726,39130,1,17
2011-02-20,spring,2011,February,1,Sunday,Holiday,Clear,0.24,0.197,0.41,0.4627,5,11,16,16,680,16,1,1,1,111,1,724,24164,1,16
2011-02-20,spring,2011,February,2,Sunday,Holiday,Clear,0.24,0.197,0.41,0.5522,0,17,17,17,680,17,1,1,1,111,1,715,16352,1,17
2011-02-20,spring,2011,February,3,Sunday,Holiday,Clear,0.22,0.1818,0.44,0.5522,9,9,18,18,680,18,1,1,1,111,1,697,8174,1,18
2011-02-20,spring,2011,February,4,Sunday,Holiday,Clear,0.22,0.1818,0.44,0.5522,0,1,1,1,680,1,1,1,1,111,1,697,4428,1,1
2011-02-20,spring,2011,February,6,Sunday,Holiday,Clear,0.2,0.1818,0.47,0.2985,1,1,2,2,680,2,1,1,1,111,1,725,55132,1,2
2011-02-20,spring,2011,February,7,Sunday,Holiday,Clear,0.18,0.1667,0.51,0.2537,0,2,2,2,680,2,1,1,1,111,1,727,154171,1,2
2011-02-20,spring,2011,February,8,Sunday,Holiday,Clear,0.2,0.2273,0.51,0.1045,2,22,24,24,680,24,1,1,1,111,1,727,261001,1,24
2011-02-20,spring,2011,February,9,Sunday,Holiday,Clear,0.22,0.2121,0.47,0.2836,7,48,55,55,680,55,1,2,1,121,1,727,159438,1,55
2011-02-20,spring,2011,February,10,Sunday,Holiday,Mist,0.26,0.2576,0.41,0.194,34,70,104,104,680,104,1,2,1,121,1,727,126257,1,104
2011-02-20,spring,2011,February,11,Sunday,Holiday,Mist,0.3,0.303,0.33,0.1642,72,89,161,161,680,161,1,3,1,131,1,727,151320,1,161
2011-02-20,spring,2011,February,12,Sunday,Holiday,Clear,0.3,0.3182,0.33,0.1045,62,120,182,182,680,182,1,3,1,131,1,728,184414,1,182
2011-02-20,spring,2011,February,13,Sunday,Holiday,Clear,0.34,0.3333,0.29,0.0,76,122,198,198,680,198,1,3,1,131,1,729,184919,1,198
2011-02-20,spring,2011,February,14,Sunday,Holiday,Clear,0.36,0.3485,0.27,0.1642,108,104,212,212,680,212,1,3,2,132,1,729,175652,1,212
2011-02-20,spring,2011,February,15,Sunday,Holiday,Clear,0.36,0.3636,0.27,0.0896,66,102,168,168,680,168,1,3,2,132,1,729,183149,1,168
2011-02-20,spring,2011,February,16,Sunday,Holiday,Clear,0.36,0.3636,0.29,0.0896,59,88,147,147,680,147,1,3,2,132,1,730,227748,1,147
2011-02-20,spring,2011,February,17,Sunday,Holiday,Clear,0.34,0.3485,0.33,0.1642,60,86,146,146,680,146,1,3,2,132,1,730,336860,1,146
2011-02-20,spring,2011,February,18,Sunday,Holiday,Mist,0.34,0.3333,0.36,0.1343,30,71,101,101,680,101,1,2,1,121,1,728,309772,1,101
2011-02-20,spring,2011,February,19,Sunday,Holiday,Mist,0.34,0.3333,0.36,0.1343,3,39,42,42,680,42,1,2,1,121,1,728,226789,1,42
2011-02-20,spring,2011,February,20,Sunday,Holiday,Mist,0.34,0.3636,0.42,0.0,12,30,42,42,680,42,1,2,2,122,1,728,164550,1,42
2011-02-20,spring,2011,February,21,Sunday,Holiday,Mist,0.32,0.3485,0.53,0.0,17,39,56,56,680,56,1,2,2,122,1,728,125445,1,56
2011-02-20,spring,2011,February,22,Sunday,Holiday,Mist,0.32,0.303,0.57,0.2239,4,43,47,47,680,47,1,2,1,121,1,728,95612,1,47
2011-02-20,spring,2011,February,23,Sunday,Holiday,Mist,0.3,0.303,0.61,0.1642,9,45,54,54,680,54,1,2,1,121,1,728,63941,1,54
2011-02-21,spring,2011,February,0,Monday,Holiday,Mist,0.34,0.303,0.42,0.3284,7,30,37,37,679,37,1,1,1,111,1,726,39130,1,37
2011-02-21,spring,2011,February,1,Monday,Holiday,Mist,0.34,0.303,0.42,0.3284,2,11,13,13,679,13,1,1,1,111,1,724,24164,1,13
2011-02-21,spring,2011,February,2,Monday,Holiday,Mist,0.34,0.303,0.42,0.3284,1,3,4,4,679,4,1,1,1,111,1,715,16352,1,4
2011-02-21,spring,2011,February,3,Monday,Holiday,Mist,0.34,0.303,0.42,0.2985,2,3,5,5,679,5,1,1,1,111,1,697,8174,1,5
2011-02-21,spring,2011,February,4,Monday,Holiday,Clear,0.32,0.3182,0.45,0.1642,1,0,1,1,679,1,1,1,1,111,1,697,4428,1,1
2011-02-21,spring,2011,February,5,Monday,Holiday,Mist,0.34,0.3636,0.36,0.0,1,2,3,3,679,3,1,1,2,112,1,717,14261,1,3
2011-02-21,spring,2011,February,6,Monday,Holiday,Mist,0.42,0.4242,0.26,0.2985,2,6,8,8,679,8,1,1,2,112,1,725,55132,1,8
2011-02-21,spring,2011,February,7,Monday,Holiday,Mist,0.42,0.4242,0.26,0.2836,3,16,19,19,679,19,1,1,2,112,1,727,154171,1,19
2011-02-21,spring,2011,February,8,Monday,Holiday,Mist,0.32,0.303,0.57,0.2985,7,56,63,63,679,63,1,2,1,121,1,727,261001,1,63
2011-02-21,spring,2011,February,9,Monday,Holiday,Mist,0.32,0.303,0.57,0.2836,11,46,57,57,679,57,1,2,1,121,1,727,159438,1,57
2011-02-21,spring,2011,February,10,Monday,Holiday,Mist,0.32,0.303,0.57,0.2537,29,52,81,81,679,81,1,2,1,121,1,727,126257,1,81
2011-02-21,spring,2011,February,11,Monday,Holiday,Mist,0.32,0.3333,0.57,0.1045,20,70,90,90,679,90,1,2,1,121,1,727,151320,1,90
2011-02-21,spring,2011,February,12,Monday,Holiday,Mist,0.32,0.3182,0.66,0.194,26,67,93,93,679,93,1,2,1,121,1,728,184414,1,93
2011-02-21,spring,2011,February,13,Monday,Holiday,Light Snow,0.3,0.2727,0.81,0.3284,28,75,103,103,679,103,1,2,1,121,1,729,184919,1,103
2011-02-21,spring,2011,February,14,Monday,Holiday,Mist,0.32,0.303,0.76,0.2537,15,101,116,116,679,116,1,2,1,121,1,729,175652,1,116
2011-02-21,spring,2011,February,15,Monday,Holiday,Mist,0.3,0.2727,0.7,0.4478,11,76,87,87,679,87,1,2,1,121,1,729,183149,1,87
2011-02-21,spring,2011,February,16,Monday,Holiday,Light Snow,0.28,0.2424,0.75,0.4179,8,48,56,56,679,56,1,2,1,121,1,730,227748,1,56
2011-02-21,spring,2011,February,17,Monday,Holiday,Mist,0.28,0.2576,0.75,0.3881,18,62,80,80,679,80,1,2,1,121,1,730,336860,1,80
2011-02-21,spring,2011,February,18,Monday,Holiday,Mist,0.24,0.2121,0.87,0.3582,2,64,66,66,679,66,1,2,1,121,1,728,309772,1,66
2011-02-21,spring,2011,February,19,Monday,Holiday,Mist,0.24,0.2121,0.87,0.3582,0,49,49,49,679,49,1,2,1,121,1,728,226789,1,49
2011-02-21,spring,2011,February,20,Monday,Holiday,Light Snow,0.24,0.2121,0.81,0.3881,0,29,29,29,679,29,1,1,1,111,1,728,164550,1,29
2011-02-21,spring,2011,February,21,Monday,Holiday,Light Snow,0.22,0.197,0.75,0.4478,1,33,34,34,679,34,1,1,1,111,1,728,125445,1,34
2011-02-21,spring,2011,February,22,Monday,Holiday,Light Snow,0.2,0.1667,0.75,0.4179,0,11,11,11,679,11,1,1,1,111,1,728,95612,1,11
2011-02-21,spring,2011,February,23,Monday,Holiday,Light Snow,0.2,0.1667,0.75,0.4179,0,2,2,2,679,2,1,1,1,111,1,728,63941,1,2
2011-02-22,spring,2011,February,6,Tuesday,Workingday,Mist,0.12,0.1212,0.8,0.2836,0,7,7,7,678,7,1,1,1,111,1,725,55132,1,7
2011-02-22,spring,2011,February,7,Tuesday,Workingday,Mist,0.12,0.1212,0.8,0.2836,0,40,40,40,678,40,1,1,1,111,1,727,154171,1,40
2011-02-22,spring,2011,February,8,Tuesday,Workingday,Mist,0.12,0.1212,0.8,0.2537,7,107,114,114,678,114,1,2,1,121,1,727,261001,1,114
2011-02-22,spring,2011,February,9,Tuesday,Workingday,Mist,0.14,0.1212,0.74,0.2537,5,101,106,106,678,106,1,2,1,121,1,727,159438,1,106
2011-02-22,spring,2011,February,10,Tuesday,Workingday,Clear,0.16,0.1818,0.69,0.0,0,44,44,44,678,44,1,2,1,121,1,727,126257,1,44
2011-02-22,spring,2011,February,11,Tuesday,Workingday,Clear,0.16,0.2273,0.64,0.0,7,43,50,50,678,50,1,2,1,121,1,727,151320,1,50
2011-02-22,spring,2011,February,12,Tuesday,Workingday,Clear,0.2,0.2273,0.59,0.1045,7,48,55,55,678,55,1,2,1,121,1,728,184414,1,55
2011-02-22,spring,2011,February,13,Tuesday,Workingday,Clear,0.22,0.2273,0.55,0.1642,3,52,55,55,678,55,1,2,1,121,1,729,184919,1,55
2011-02-22,spring,2011,February,14,Tuesday,Workingday,Clear,0.22,0.2273,0.55,0.194,9,49,58,58,678,58,1,2,1,121,1,729,175652,1,58
2011-02-22,spring,2011,February,15,Tuesday,Workingday,Clear,0.24,0.2273,0.48,0.194,2,67,69,69,678,69,1,2,1,121,1,729,183149,1,69
2011-02-22,spring,2011,February,16,Tuesday,Workingday,Clear,0.22,0.2273,0.51,0.1642,7,79,86,86,678,86,1,2,1,121,1,730,227748,1,86
2011-02-22,spring,2011,February,17,Tuesday,Workingday,Clear,0.22,0.2121,0.51,0.2239,8,188,196,196,678,196,1,3,1,131,1,730,336860,1,196
2011-02-22,spring,2011,February,18,Tuesday,Workingday,Clear,0.22,0.2273,0.47,0.1343,6,161,167,167,678,167,1,3,1,131,1,728,309772,1,167
2011-02-22,spring,2011,February,19,Tuesday,Workingday,Clear,0.2,0.1818,0.47,0.2836,4,114,118,118,678,118,1,2,1,121,1,728,226789,1,118
2011-02-22,spring,2011,February,20,Tuesday,Workingday,Clear,0.2,0.197,0.47,0.2239,3,102,105,105,678,105,1,2,1,121,1,728,164550,1,105
2011-02-22,spring,2011,February,21,Tuesday,Workingday,Clear,0.2,0.197,0.47,0.2537,2,80,82,82,678,82,1,2,1,121,1,728,125445,1,82
2011-02-22,spring,2011,February,22,Tuesday,Workingday,Clear,0.16,0.1515,0.43,0.2537,1,76,77,77,678,77,1,2,1,121,1,728,95612,1,77
2011-02-22,spring,2011,February,23,Tuesday,Workingday,Clear,0.16,0.1515,0.43,0.2537,3,18,21,21,678,21,1,1,1,111,1,728,63941,1,21
2011-02-23,spring,2011,February,0,Wednesday,Workingday,Clear,0.14,0.1364,0.5,0.194,0,6,6,6,677,6,1,1,1,111,1,726,39130,1,6
2011-02-23,spring,2011,February,1,Wednesday,Workingday,Clear,0.14,0.1515,0.46,0.1642,0,4,4,4,677,4,1,1,1,111,1,724,24164,1,4
2011-02-23,spring,2011,February,2,Wednesday,Workingday,Clear,0.12,0.1515,0.5,0.1343,0,1,1,1,677,1,1,1,1,111,1,715,16352,1,1
2011-02-23,spring,2011,February,3,Wednesday,Workingday,Clear,0.12,0.1364,0.5,0.1642,0,2,2,2,677,2,1,1,1,111,1,697,8174,1,2
2011-02-23,spring,2011,February,5,Wednesday,Workingday,Clear,0.12,0.1515,0.5,0.1045,0,8,8,8,677,8,1,1,1,111,1,717,14261,1,8
2011-02-23,spring,2011,February,6,Wednesday,Workingday,Clear,0.12,0.1515,0.5,0.1045,0,36,36,36,677,36,1,1,1,111,1,725,55132,1,36
2011-02-23,spring,2011,February,7,Wednesday,Workingday,Clear,0.12,0.1515,0.54,0.1343,2,94,96,96,677,96,1,2,1,121,1,727,154171,1,96
2011-02-23,spring,2011,February,8,Wednesday,Workingday,Clear,0.14,0.1515,0.54,0.1642,8,227,235,235,677,235,1,3,1,131,1,727,261001,1,235
2011-02-23,spring,2011,February,9,Wednesday,Workingday,Clear,0.18,0.2121,0.51,0.0896,9,130,139,139,677,139,1,2,1,121,1,727,159438,1,139
2011-02-23,spring,2011,February,10,Wednesday,Workingday,Clear,0.2,0.2576,0.4,0.0,4,47,51,51,677,51,1,2,1,121,1,727,126257,1,51
2011-02-23,spring,2011,February,11,Wednesday,Workingday,Clear,0.24,0.2576,0.41,0.1045,16,53,69,69,677,69,1,2,1,121,1,727,151320,1,69
2011-02-23,spring,2011,February,12,Wednesday,Workingday,Clear,0.26,0.2879,0.35,0.0896,11,56,67,67,677,67,1,2,1,121,1,728,184414,1,67
2011-02-23,spring,2011,February,13,Wednesday,Workingday,Clear,0.3,0.3182,0.28,0.0896,9,78,87,87,677,87,1,2,1,121,1,729,184919,1,87
2011-02-23,spring,2011,February,14,Wednesday,Workingday,Clear,0.32,0.3333,0.29,0.1045,17,61,78,78,677,78,1,2,1,121,1,729,175652,1,78
2011-02-23,spring,2011,February,15,Wednesday,Workingday,Clear,0.34,0.3485,0.25,0.0896,18,54,72,72,677,72,1,2,2,122,1,729,183149,1,72
2011-02-23,spring,2011,February,16,Wednesday,Workingday,Clear,0.34,0.3636,0.25,0.0,15,79,94,94,677,94,1,2,2,122,1,730,227748,1,94
2011-02-23,spring,2011,February,17,Wednesday,Workingday,Clear,0.34,0.3485,0.25,0.0896,15,207,222,222,677,222,1,3,2,132,1,730,336860,1,222
2011-02-23,spring,2011,February,18,Wednesday,Workingday,Clear,0.32,0.3333,0.26,0.0896,3,206,209,209,677,209,1,3,1,131,1,728,309772,1,209
2011-02-23,spring,2011,February,19,Wednesday,Workingday,Clear,0.3,0.3333,0.33,0.0,6,135,141,141,677,141,1,2,1,121,1,728,226789,1,141
2011-02-23,spring,2011,February,20,Wednesday,Workingday,Clear,0.24,0.2424,0.6,0.1642,2,107,109,109,677,109,1,2,1,121,1,728,164550,1,109
2011-02-23,spring,2011,February,21,Wednesday,Workingday,Clear,0.24,0.2879,0.48,0.0,2,89,91,91,677,91,1,2,1,121,1,728,125445,1,91
2011-02-23,spring,2011,February,22,Wednesday,Workingday,Clear,0.24,0.2879,0.48,0.0,1,60,61,61,677,61,1,2,1,121,1,728,95612,1,61
2011-02-23,spring,2011,February,23,Wednesday,Workingday,Clear,0.22,0.2576,0.55,0.0896,1,38,39,39,677,39,1,1,1,111,1,728,63941,1,39
2011-02-24,spring,2011,February,0,Thursday,Workingday,Clear,0.22,0.2576,0.55,0.0896,0,11,11,11,676,11,1,1,1,111,1,726,39130,1,11
2011-02-24,spring,2011,February,1,Thursday,Workingday,Clear,0.22,0.2576,0.6,0.0896,0,7,7,7,676,7,1,1,1,111,1,724,24164,1,7
2011-02-24,spring,2011,February,2,Thursday,Workingday,Clear,0.2,0.2273,0.64,0.0896,0,4,4,4,676,4,1,1,1,111,1,715,16352,1,4
2011-02-24,spring,2011,February,3,Thursday,Workingday,Clear,0.2,0.2121,0.64,0.1343,0,2,2,2,676,2,1,1,1,111,1,697,8174,1,2
2011-02-24,spring,2011,February,5,Thursday,Workingday,Clear,0.2,0.2121,0.69,0.1343,1,3,4,4,676,4,1,1,1,111,1,717,14261,1,4
2011-02-24,spring,2011,February,6,Thursday,Workingday,Clear,0.2,0.197,0.69,0.194,0,58,58,58,676,58,1,2,1,121,1,725,55132,1,58
2011-02-24,spring,2011,February,7,Thursday,Workingday,Clear,0.2,0.197,0.72,0.194,0,104,104,104,676,104,1,2,1,121,1,727,154171,1,104
2011-02-24,spring,2011,February,8,Thursday,Workingday,Clear,0.24,0.2273,0.7,0.2239,8,244,252,252,676,252,1,3,1,131,1,727,261001,1,252
2011-02-24,spring,2011,February,9,Thursday,Workingday,Mist,0.24,0.2121,0.75,0.2985,4,133,137,137,676,137,1,2,1,121,1,727,159438,1,137
2011-02-24,spring,2011,February,10,Thursday,Workingday,Mist,0.26,0.2424,0.7,0.2836,8,49,57,57,676,57,1,2,1,121,1,727,126257,1,57
2011-02-24,spring,2011,February,11,Thursday,Workingday,Mist,0.32,0.2879,0.57,0.3881,8,71,79,79,676,79,1,2,1,121,1,727,151320,1,79
2011-02-24,spring,2011,February,12,Thursday,Workingday,Mist,0.36,0.3333,0.53,0.3582,10,85,95,95,676,95,1,2,1,121,1,728,184414,1,95
2011-02-24,spring,2011,February,13,Thursday,Workingday,Mist,0.38,0.3939,0.54,0.2985,16,72,88,88,676,88,1,2,2,122,1,729,184919,1,88
2011-02-24,spring,2011,February,14,Thursday,Workingday,Mist,0.4,0.4091,0.5,0.2985,2,67,69,69,676,69,1,2,2,122,1,729,175652,1,69
2011-02-24,spring,2011,February,15,Thursday,Workingday,Light Snow,0.4,0.4091,0.54,0.3881,5,58,63,63,676,63,1,2,2,122,1,729,183149,1,63
2011-02-24,spring,2011,February,16,Thursday,Workingday,Light Snow,0.38,0.3939,0.62,0.2836,4,67,71,71,676,71,1,2,2,122,1,730,227748,1,71
2011-02-24,spring,2011,February,17,Thursday,Workingday,Light Snow,0.36,0.3485,0.66,0.194,9,168,177,177,676,177,1,3,2,132,1,730,336860,1,177
2011-02-24,spring,2011,February,18,Thursday,Workingday,Mist,0.34,0.303,0.87,0.3284,5,132,137,137,676,137,1,2,1,121,1,728,309772,1,137
2011-02-24,spring,2011,February,19,Thursday,Workingday,Light Snow,0.34,0.303,0.93,0.2985,3,112,115,115,676,115,1,2,1,121,1,728,226789,1,115
2011-02-24,spring,2011,February,20,Thursday,Workingday,Mist,0.34,0.303,0.93,0.3582,2,87,89,89,676,89,1,2,1,121,1,728,164550,1,89
2011-02-24,spring,2011,February,21,Thursday,Workingday,Mist,0.34,0.303,0.87,0.3284,7,76,83,83,676,83,1,2,1,121,1,728,125445,1,83
2011-02-24,spring,2011,February,22,Thursday,Workingday,Light Snow,0.34,0.3182,0.87,0.2836,5,50,55,55,676,55,1,2,1,121,1,728,95612,1,55
2011-02-24,spring,2011,February,23,Thursday,Workingday,Mist,0.32,0.303,0.93,0.2239,3,47,50,50,676,50,1,2,1,121,1,728,63941,1,50
2011-02-25,spring,2011,February,0,Friday,Workingday,Light Snow,0.32,0.3485,0.93,0.0,1,8,9,9,675,9,1,1,2,112,0,726,39130,1,9
2011-02-25,spring,2011,February,1,Friday,Workingday,Mist,0.32,0.3485,1.0,0.0,1,9,10,10,675,10,1,1,2,112,0,724,24164,1,10
2011-02-25,spring,2011,February,2,Friday,Workingday,Mist,0.32,0.3485,1.0,0.0,0,3,3,3,675,3,1,1,2,112,0,715,16352,1,3
2011-02-25,spring,2011,February,3,Friday,Workingday,Mist,0.32,0.3333,0.93,0.1045,1,1,2,2,675,2,1,1,1,111,0,697,8174,1,2
2011-02-25,spring,2011,February,5,Friday,Workingday,Mist,0.32,0.3333,0.93,0.1045,1,5,6,6,675,6,1,1,1,111,0,717,14261,1,6
2011-02-25,spring,2011,February,6,Friday,Workingday,Light Snow,0.34,0.3485,0.93,0.0896,0,11,11,11,675,11,1,1,2,112,0,725,55132,1,11
2011-02-25,spring,2011,February,7,Friday,Workingday,Light Snow,0.34,0.3333,1.0,0.1343,1,34,35,35,675,35,1,1,1,111,0,727,154171,1,35
2011-02-25,spring,2011,February,8,Friday,Workingday,Light Snow,0.36,0.3485,0.93,0.1343,3,70,73,73,675,73,1,2,2,122,0,727,261001,1,73
2011-02-25,spring,2011,February,9,Friday,Workingday,Light Snow,0.34,0.303,0.93,0.3582,3,111,114,114,675,114,1,2,1,121,1,727,159438,1,114
2011-02-25,spring,2011,February,10,Friday,Workingday,Light Snow,0.42,0.4242,0.94,0.3284,7,42,49,49,675,49,1,2,2,122,0,727,126257,1,49
2011-02-25,spring,2011,February,11,Friday,Workingday,Clear,0.52,0.5,0.77,0.4478,9,50,59,59,675,59,1,2,3,123,0,727,151320,1,59
2011-02-25,spring,2011,February,12,Friday,Workingday,Light Snow,0.54,0.5152,0.6,0.4627,20,95,115,115,675,115,1,2,3,123,1,728,184414,1,115
2011-02-25,spring,2011,February,13,Friday,Workingday,Light Snow,0.54,0.5152,0.6,0.4627,6,77,83,83,675,83,1,2,3,123,1,729,184919,1,83
2011-02-25,spring,2011,February,14,Friday,Workingday,Light Snow,0.56,0.5303,0.56,0.6119,14,71,85,85,675,85,1,2,3,123,1,729,175652,1,85
2011-02-25,spring,2011,February,15,Friday,Workingday,Clear,0.46,0.4545,0.41,0.806,5,50,55,55,675,55,1,2,2,122,1,729,183149,1,55
2011-02-25,spring,2011,February,16,Friday,Workingday,Clear,0.32,0.2879,0.49,0.4627,11,91,102,102,675,102,1,2,1,121,1,730,227748,1,102
2011-02-25,spring,2011,February,17,Friday,Workingday,Clear,0.32,0.2727,0.49,0.7463,8,181,189,189,675,189,1,3,1,131,1,730,336860,1,189
2011-02-25,spring,2011,February,18,Friday,Workingday,Clear,0.32,0.2879,0.49,0.4925,7,150,157,157,675,157,1,3,1,131,1,728,309772,1,157
2011-02-25,spring,2011,February,19,Friday,Workingday,Clear,0.3,0.2727,0.52,0.4478,4,86,90,90,675,90,1,2,1,121,1,728,226789,1,90
2011-02-25,spring,2011,February,20,Friday,Workingday,Clear,0.3,0.2576,0.49,0.6119,2,60,62,62,675,62,1,2,1,121,1,728,164550,1,62
2011-02-25,spring,2011,February,21,Friday,Workingday,Clear,0.28,0.2576,0.48,0.3881,7,56,63,63,675,63,1,2,1,121,1,728,125445,1,63
2011-02-25,spring,2011,February,22,Friday,Workingday,Clear,0.26,0.2121,0.48,0.4478,7,43,50,50,675,50,1,2,1,121,1,728,95612,1,50
2011-02-25,spring,2011,February,23,Friday,Workingday,Clear,0.26,0.2273,0.48,0.3284,2,37,39,39,675,39,1,1,1,111,1,728,63941,1,39
2011-02-26,spring,2011,February,0,Saturday,Holiday,Clear,0.24,0.2273,0.52,0.194,3,25,28,28,674,28,1,1,1,111,1,726,39130,1,28
2011-02-26,spring,2011,February,1,Saturday,Holiday,Clear,0.24,0.2121,0.52,0.2985,2,25,27,27,674,27,1,1,1,111,1,724,24164,1,27
2011-02-26,spring,2011,February,2,Saturday,Holiday,Clear,0.22,0.197,0.6,0.3582,3,9,12,12,674,12,1,1,1,111,1,715,16352,1,12
2011-02-26,spring,2011,February,3,Saturday,Holiday,Clear,0.22,0.2273,0.55,0.1343,1,7,8,8,674,8,1,1,1,111,1,697,8174,1,8
2011-02-26,spring,2011,February,4,Saturday,Holiday,Mist,0.22,0.2576,0.6,0.0896,1,1,2,2,674,2,1,1,1,111,1,697,4428,1,2
2011-02-26,spring,2011,February,5,Saturday,Holiday,Mist,0.22,0.2424,0.64,0.1045,1,9,10,10,674,10,1,1,1,111,1,717,14261,1,10
2011-02-26,spring,2011,February,6,Saturday,Holiday,Clear,0.22,0.2727,0.6,0.0,1,6,7,7,674,7,1,1,1,111,1,725,55132,1,7
2011-02-26,spring,2011,February,7,Saturday,Holiday,Clear,0.22,0.2576,0.6,0.0896,1,21,22,22,674,22,1,1,1,111,1,727,154171,1,22
2011-02-26,spring,2011,February,8,Saturday,Holiday,Mist,0.24,0.2879,0.6,0.0,2,55,57,57,674,57,1,2,1,121,1,727,261001,1,57
2011-02-26,spring,2011,February,9,Saturday,Holiday,Mist,0.26,0.2576,0.56,0.1642,9,65,74,74,674,74,1,2,1,121,1,727,159438,1,74
2011-02-26,spring,2011,February,10,Saturday,Holiday,Mist,0.3,0.303,0.49,0.1343,14,71,85,85,674,85,1,2,1,121,1,727,126257,1,85
2011-02-26,spring,2011,February,11,Saturday,Holiday,Clear,0.3,0.3333,0.45,0.0,26,100,126,126,674,126,1,2,1,121,1,727,151320,1,126
2011-02-26,spring,2011,February,12,Saturday,Holiday,Mist,0.32,0.3182,0.45,0.1642,45,115,160,160,674,160,1,3,1,131,1,728,184414,1,160
2011-02-26,spring,2011,February,13,Saturday,Holiday,Mist,0.34,0.3182,0.42,0.2537,38,136,174,174,674,174,1,3,1,131,1,729,184919,1,174
2011-02-26,spring,2011,February,14,Saturday,Holiday,Mist,0.34,0.303,0.36,0.3284,57,154,211,211,674,211,1,3,1,131,1,729,175652,1,211
2011-02-26,spring,2011,February,15,Saturday,Holiday,Mist,0.36,0.3333,0.4,0.2836,40,125,165,165,674,165,1,3,1,131,1,729,183149,1,165
2011-02-26,spring,2011,February,16,Saturday,Holiday,Clear,0.36,0.3333,0.46,0.2836,41,130,171,171,674,171,1,3,1,131,1,730,227748,1,171
2011-02-26,spring,2011,February,17,Saturday,Holiday,Clear,0.36,0.3485,0.43,0.2239,53,130,183,183,674,183,1,3,2,132,1,730,336860,1,183
2011-02-26,spring,2011,February,18,Saturday,Holiday,Clear,0.34,0.3333,0.46,0.194,26,111,137,137,674,137,1,2,1,121,1,728,309772,1,137
2011-02-26,spring,2011,February,19,Saturday,Holiday,Clear,0.32,0.303,0.49,0.2537,30,64,94,94,674,94,1,2,1,121,1,728,226789,1,94
2011-02-26,spring,2011,February,20,Saturday,Holiday,Clear,0.3,0.303,0.56,0.1642,8,60,68,68,674,68,1,2,1,121,1,728,164550,1,68
2011-02-26,spring,2011,February,21,Saturday,Holiday,Clear,0.28,0.2727,0.65,0.2537,9,59,68,68,674,68,1,2,1,121,1,728,125445,1,68
2011-02-26,spring,2011,February,22,Saturday,Holiday,Clear,0.28,0.2727,0.75,0.2239,8,38,46,46,674,46,1,2,1,121,1,728,95612,1,46
2011-02-26,spring,2011,February,23,Saturday,Holiday,Clear,0.28,0.2576,0.75,0.2836,5,29,34,34,674,34,1,1,1,111,1,728,63941,1,34
2011-02-27,spring,2011,February,0,Sunday,Holiday,Clear,0.26,0.2424,0.87,0.2836,8,26,34,34,673,34,1,1,1,111,1,726,39130,1,34
2011-02-27,spring,2011,February,1,Sunday,Holiday,Clear,0.26,0.2576,0.87,0.194,7,30,37,37,673,37,1,1,1,111,1,724,24164,1,37
2011-02-27,spring,2011,February,2,Sunday,Holiday,Clear,0.26,0.2727,0.87,0.1343,2,20,22,22,673,22,1,1,1,111,1,715,16352,1,22
2011-02-27,spring,2011,February,3,Sunday,Holiday,Clear,0.26,0.2879,0.87,0.0896,3,8,11,11,673,11,1,1,1,111,1,697,8174,1,11
2011-02-27,spring,2011,February,4,Sunday,Holiday,Clear,0.24,0.2424,0.87,0.1343,0,2,2,2,673,2,1,1,1,111,1,697,4428,1,2
2011-02-27,spring,2011,February,6,Sunday,Holiday,Clear,0.24,0.2879,0.87,0.0,2,1,3,3,673,3,1,1,1,111,1,725,55132,1,3
2011-02-27,spring,2011,February,7,Sunday,Holiday,Clear,0.24,0.2424,0.87,0.1343,6,8,14,14,673,14,1,1,1,111,1,727,154171,1,14
2011-02-27,spring,2011,February,8,Sunday,Holiday,Clear,0.26,0.303,0.87,0.0,9,26,35,35,673,35,1,1,1,111,1,727,261001,1,35
2011-02-27,spring,2011,February,9,Sunday,Holiday,Clear,0.28,0.303,0.87,0.0896,17,42,59,59,673,59,1,2,1,121,1,727,159438,1,59
2011-02-27,spring,2011,February,10,Sunday,Holiday,Clear,0.3,0.303,0.81,0.1642,24,79,103,103,673,103,1,2,1,121,1,727,126257,1,103
2011-02-27,spring,2011,February,11,Sunday,Holiday,Clear,0.36,0.3485,0.62,0.1343,33,92,125,125,673,125,1,2,2,122,1,727,151320,1,125
2011-02-27,spring,2011,February,12,Sunday,Holiday,Clear,0.4,0.4091,0.54,0.0896,61,132,193,193,673,193,1,3,2,132,1,728,184414,1,193
2011-02-27,spring,2011,February,13,Sunday,Holiday,Clear,0.42,0.4242,0.47,0.0,90,169,259,259,673,259,1,3,2,132,1,729,184919,1,259
2011-02-27,spring,2011,February,14,Sunday,Holiday,Clear,0.44,0.4394,0.47,0.0896,105,177,282,282,673,282,1,4,2,142,2,729,175652,1,282
2011-02-27,spring,2011,February,15,Sunday,Holiday,Clear,0.46,0.4545,0.44,0.1343,98,163,261,261,673,261,1,3,2,132,2,729,183149,1,261
2011-02-27,spring,2011,February,16,Sunday,Holiday,Clear,0.48,0.4697,0.44,0.1642,98,170,268,268,673,268,1,3,2,132,2,730,227748,1,268
2011-02-27,spring,2011,February,17,Sunday,Holiday,Clear,0.42,0.4242,0.54,0.194,66,121,187,187,673,187,1,3,2,132,1,730,336860,1,187
2011-02-27,spring,2011,February,18,Sunday,Holiday,Clear,0.4,0.4091,0.54,0.194,24,103,127,127,673,127,1,2,2,122,1,728,309772,1,127
2011-02-27,spring,2011,February,19,Sunday,Holiday,Clear,0.4,0.4091,0.54,0.1343,16,86,102,102,673,102,1,2,2,122,1,728,226789,1,102
2011-02-27,spring,2011,February,20,Sunday,Holiday,Clear,0.4,0.4091,0.54,0.0896,9,72,81,81,673,81,1,2,2,122,1,728,164550,1,81
2011-02-27,spring,2011,February,21,Sunday,Holiday,Clear,0.38,0.3939,0.62,0.1642,8,61,69,69,673,69,1,2,2,122,1,728,125445,1,69
2011-02-27,spring,2011,February,22,Sunday,Holiday,Mist,0.38,0.3939,0.62,0.1045,2,67,69,69,673,69,1,2,2,122,1,728,95612,1,69
2011-02-27,spring,2011,February,23,Sunday,Holiday,Mist,0.36,0.3485,0.62,0.1642,6,53,59,59,673,59,1,2,2,122,1,728,63941,1,59
2011-02-28,spring,2011,February,0,Monday,Workingday,Mist,0.36,0.3636,0.66,0.1045,5,25,30,30,672,30,1,1,2,112,1,726,39130,1,30
2011-02-28,spring,2011,February,1,Monday,Workingday,Light Snow,0.34,0.303,0.87,0.3582,1,7,8,8,672,8,1,1,1,111,1,724,24164,1,8
2011-02-28,spring,2011,February,3,Monday,Workingday,Light Snow,0.32,0.3182,0.93,0.1642,0,1,1,1,672,1,1,1,1,111,1,697,8174,1,1
2011-02-28,spring,2011,February,5,Monday,Workingday,Mist,0.34,0.3636,0.93,0.0,1,4,5,5,672,5,1,1,2,112,0,717,14261,1,5
2011-02-28,spring,2011,February,6,Monday,Workingday,Mist,0.34,0.3485,0.96,0.1045,1,27,28,28,672,28,1,1,2,112,0,725,55132,1,28
2011-02-28,spring,2011,February,7,Monday,Workingday,Mist,0.36,0.3636,0.93,0.1045,2,90,92,92,672,92,1,2,2,122,0,727,154171,1,92
2011-02-28,spring,2011,February,8,Monday,Workingday,Mist,0.34,0.303,0.93,0.2985,13,242,255,255,672,255,1,3,1,131,1,727,261001,1,255
2011-02-28,spring,2011,February,9,Monday,Workingday,Clear,0.42,0.4242,0.82,0.2836,15,127,142,142,672,142,1,2,2,122,0,727,159438,1,142
2011-02-28,spring,2011,February,10,Monday,Workingday,Mist,0.52,0.5,0.72,0.4925,13,79,92,92,672,92,1,2,3,123,1,727,126257,1,92
2011-02-28,spring,2011,February,11,Monday,Workingday,Mist,0.56,0.5303,0.64,0.2985,13,74,87,87,672,87,1,2,3,123,0,727,151320,1,87
2011-02-28,spring,2011,February,12,Monday,Workingday,Mist,0.56,0.5303,0.64,0.2985,0,36,36,36,672,36,1,1,3,113,0,728,184414,1,36
2011-02-28,spring,2011,February,13,Monday,Workingday,Light Snow,0.46,0.4545,0.94,0.2239,1,31,32,32,672,32,1,1,2,112,0,729,184919,1,32
2011-02-28,spring,2011,February,14,Monday,Workingday,Light Snow,0.42,0.4242,1.0,0.2985,1,24,25,25,672,25,1,1,2,112,0,729,175652,1,25
2011-02-28,spring,2011,February,15,Monday,Workingday,Light Snow,0.42,0.4242,1.0,0.2985,0,35,35,35,672,35,1,1,2,112,0,729,183149,1,35
2011-02-28,spring,2011,February,16,Monday,Workingday,Light Snow,0.42,0.4242,1.0,0.1343,2,40,42,42,672,42,1,2,2,122,0,730,227748,1,42
2011-02-28,spring,2011,February,17,Monday,Workingday,Light Snow,0.4,0.4091,1.0,0.2985,2,77,79,79,672,79,1,2,2,122,0,730,336860,1,79
2011-02-28,spring,2011,February,18,Monday,Workingday,Light Snow,0.46,0.4545,0.94,0.194,4,127,131,131,672,131,1,2,2,122,0,728,309772,1,131
2011-02-28,spring,2011,February,19,Monday,Workingday,Light Snow,0.44,0.4394,0.88,0.6119,1,79,80,80,672,80,1,2,2,122,1,728,226789,1,80
2011-02-28,spring,2011,February,20,Monday,Workingday,Light Snow,0.44,0.4394,0.88,0.6119,0,45,45,45,672,45,1,2,2,122,1,728,164550,1,45
2011-02-28,spring,2011,February,21,Monday,Workingday,Mist,0.38,0.3939,0.87,0.3881,2,78,80,80,672,80,1,2,2,122,1,728,125445,1,80
2011-02-28,spring,2011,February,22,Monday,Workingday,Light Snow,0.34,0.303,0.93,0.4179,4,72,76,76,672,76,1,2,1,121,1,728,95612,1,76
2011-02-28,spring,2011,February,23,Monday,Workingday,Mist,0.32,0.2879,0.81,0.3881,0,45,45,45,672,45,1,2,1,121,1,728,63941,1,45
2011-03-01,spring,2011,March,0,Tuesday,Workingday,Clear,0.3,0.2727,0.7,0.4627,0,7,7,7,671,7,1,1,1,111,1,726,39130,1,7
2011-03-01,spring,2011,March,1,Tuesday,Workingday,Clear,0.26,0.2273,0.7,0.3582,0,3,3,3,671,3,1,1,1,111,1,724,24164,1,3
2011-03-01,spring,2011,March,2,Tuesday,Workingday,Clear,0.24,0.2121,0.65,0.3881,0,4,4,4,671,4,1,1,1,111,1,715,16352,1,4
2011-03-01,spring,2011,March,3,Tuesday,Workingday,Clear,0.22,0.2121,0.69,0.2836,0,2,2,2,671,2,1,1,1,111,1,697,8174,1,2
2011-03-01,spring,2011,March,4,Tuesday,Workingday,Clear,0.22,0.2121,0.69,0.2537,0,1,1,1,671,1,1,1,1,111,1,697,4428,1,1
2011-03-01,spring,2011,March,5,Tuesday,Workingday,Clear,0.2,0.1818,0.64,0.2836,1,1,2,2,671,2,1,1,1,111,1,717,14261,1,2
2011-03-01,spring,2011,March,6,Tuesday,Workingday,Clear,0.2,0.1818,0.59,0.2985,0,46,46,46,671,46,1,2,1,121,1,725,55132,1,46
2011-03-01,spring,2011,March,7,Tuesday,Workingday,Clear,0.2,0.1818,0.59,0.3284,2,105,107,107,671,107,1,2,1,121,1,727,154171,1,107
2011-03-01,spring,2011,March,8,Tuesday,Workingday,Clear,0.2,0.1818,0.59,0.3881,10,204,214,214,671,214,1,3,1,131,1,727,261001,1,214
2011-03-01,spring,2011,March,9,Tuesday,Workingday,Clear,0.22,0.197,0.55,0.4179,8,116,124,124,671,124,1,2,1,121,1,727,159438,1,124
2011-03-01,spring,2011,March,10,Tuesday,Workingday,Clear,0.24,0.2121,0.52,0.2836,13,55,68,68,671,68,1,2,1,121,1,727,126257,1,68
2011-03-01,spring,2011,March,11,Tuesday,Workingday,Clear,0.28,0.2727,0.45,0.2537,8,48,56,56,671,56,1,2,1,121,1,727,151320,1,56
2011-03-01,spring,2011,March,12,Tuesday,Workingday,Clear,0.3,0.303,0.39,0.1343,6,80,86,86,671,86,1,2,1,121,1,728,184414,1,86
2011-03-01,spring,2011,March,13,Tuesday,Workingday,Clear,0.32,0.3485,0.39,0.0,13,65,78,78,671,78,1,2,2,122,1,729,184919,1,78
2011-03-01,spring,2011,March,14,Tuesday,Workingday,Clear,0.32,0.3333,0.36,0.1343,18,61,79,79,671,79,1,2,1,121,1,729,175652,1,79
2011-03-01,spring,2011,March,15,Tuesday,Workingday,Clear,0.34,0.3636,0.34,0.0,7,57,64,64,671,64,1,2,2,122,1,729,183149,1,64
2011-03-01,spring,2011,March,16,Tuesday,Workingday,Clear,0.34,0.3485,0.34,0.0896,10,92,102,102,671,102,1,2,2,122,1,730,227748,1,102
2011-03-01,spring,2011,March,17,Tuesday,Workingday,Clear,0.34,0.3485,0.34,0.0896,12,230,242,242,671,242,1,3,2,132,1,730,336860,1,242
2011-03-01,spring,2011,March,18,Tuesday,Workingday,Clear,0.32,0.3182,0.39,0.194,10,214,224,224,671,224,1,3,1,131,1,728,309772,1,224
2011-03-01,spring,2011,March,19,Tuesday,Workingday,Clear,0.3,0.303,0.49,0.1343,4,115,119,119,671,119,1,2,1,121,1,728,226789,1,119
2011-03-01,spring,2011,March,20,Tuesday,Workingday,Clear,0.3,0.3182,0.61,0.0896,2,86,88,88,671,88,1,2,1,121,1,728,164550,1,88
2011-03-01,spring,2011,March,21,Tuesday,Workingday,Clear,0.26,0.303,0.56,0.0,8,55,63,63,671,63,1,2,1,121,1,728,125445,1,63
2011-03-01,spring,2011,March,22,Tuesday,Workingday,Clear,0.24,0.2727,0.62,0.1045,3,44,47,47,671,47,1,2,1,121,1,728,95612,1,47
2011-03-01,spring,2011,March,23,Tuesday,Workingday,Clear,0.24,0.2273,0.65,0.2239,2,23,25,25,671,25,1,1,1,111,1,728,63941,1,25
2011-03-02,spring,2011,March,0,Wednesday,Workingday,Clear,0.22,0.2273,0.69,0.1642,3,5,8,8,670,8,1,1,1,111,1,726,39130,1,8
2011-03-02,spring,2011,March,1,Wednesday,Workingday,Clear,0.22,0.2273,0.69,0.194,0,4,4,4,670,4,1,1,1,111,1,724,24164,1,4
2011-03-02,spring,2011,March,2,Wednesday,Workingday,Clear,0.22,0.2273,0.69,0.194,0,2,2,2,670,2,1,1,1,111,1,715,16352,1,2
2011-03-02,spring,2011,March,3,Wednesday,Workingday,Clear,0.22,0.2121,0.69,0.2836,3,1,4,4,670,4,1,1,1,111,1,697,8174,1,4
2011-03-02,spring,2011,March,4,Wednesday,Workingday,Clear,0.2,0.2121,0.75,0.1343,1,0,1,1,670,1,1,1,1,111,1,697,4428,1,1
2011-03-02,spring,2011,March,5,Wednesday,Workingday,Clear,0.22,0.2121,0.69,0.2239,0,5,5,5,670,5,1,1,1,111,1,717,14261,1,5
2011-03-02,spring,2011,March,6,Wednesday,Workingday,Clear,0.22,0.2121,0.55,0.2537,1,39,40,40,670,40,1,1,1,111,1,725,55132,1,40
2011-03-02,spring,2011,March,7,Wednesday,Workingday,Clear,0.22,0.2121,0.64,0.2537,2,108,110,110,670,110,1,2,1,121,1,727,154171,1,110
2011-03-02,spring,2011,March,8,Wednesday,Workingday,Clear,0.24,0.2121,0.65,0.2836,13,243,256,256,670,256,1,3,1,131,1,727,261001,1,256
2011-03-02,spring,2011,March,9,Wednesday,Workingday,Clear,0.28,0.2576,0.56,0.2985,7,141,148,148,670,148,1,3,1,131,1,727,159438,1,148
2011-03-02,spring,2011,March,10,Wednesday,Workingday,Clear,0.32,0.303,0.49,0.2836,11,65,76,76,670,76,1,2,1,121,1,727,126257,1,76
2011-03-02,spring,2011,March,11,Wednesday,Workingday,Clear,0.34,0.303,0.53,0.3284,8,65,73,73,670,73,1,2,1,121,1,727,151320,1,73
2011-03-02,spring,2011,March,12,Wednesday,Workingday,Clear,0.4,0.4091,0.43,0.194,20,62,82,82,670,82,1,2,2,122,1,728,184414,1,82
2011-03-02,spring,2011,March,13,Wednesday,Workingday,Clear,0.5,0.4848,0.25,0.0,35,90,125,125,670,125,1,2,2,122,1,729,184919,1,125
2011-03-02,spring,2011,March,14,Wednesday,Workingday,Clear,0.52,0.5,0.23,0.2985,21,75,96,96,670,96,1,2,3,123,1,729,175652,1,96
2011-03-02,spring,2011,March,15,Wednesday,Workingday,Clear,0.54,0.5152,0.19,0.4179,19,91,110,110,670,110,1,2,3,123,1,729,183149,1,110
2011-03-02,spring,2011,March,16,Wednesday,Workingday,Clear,0.54,0.5152,0.19,0.3284,27,112,139,139,670,139,1,2,3,123,2,730,227748,1,139
2011-03-02,spring,2011,March,17,Wednesday,Workingday,Clear,0.5,0.4848,0.23,0.2836,30,238,268,268,670,268,1,3,2,132,2,730,336860,1,268
2011-03-02,spring,2011,March,18,Wednesday,Workingday,Clear,0.46,0.4545,0.23,0.4925,8,193,201,201,670,201,1,3,2,132,1,728,309772,1,201
2011-03-02,spring,2011,March,19,Wednesday,Workingday,Clear,0.4,0.4091,0.28,0.5224,6,144,150,150,670,150,1,3,2,132,1,728,226789,1,150
2011-03-02,spring,2011,March,20,Wednesday,Workingday,Clear,0.36,0.3333,0.29,0.4179,9,86,95,95,670,95,1,2,1,121,1,728,164550,1,95
2011-03-02,spring,2011,March,21,Wednesday,Workingday,Clear,0.34,0.2879,0.29,0.4627,3,68,71,71,670,71,1,2,1,121,1,728,125445,1,71
2011-03-02,spring,2011,March,22,Wednesday,Workingday,Clear,0.3,0.2576,0.26,0.5522,4,44,48,48,670,48,1,2,1,121,1,728,95612,1,48
2011-03-02,spring,2011,March,23,Wednesday,Workingday,Clear,0.26,0.2121,0.3,0.5224,0,22,22,22,670,22,1,1,1,111,1,728,63941,1,22
2011-03-03,spring,2011,March,0,Thursday,Workingday,Clear,0.24,0.197,0.3,0.4627,3,10,13,13,669,13,1,1,1,111,1,726,39130,1,13
2011-03-03,spring,2011,March,1,Thursday,Workingday,Clear,0.24,0.197,0.3,0.4627,0,1,1,1,669,1,1,1,1,111,1,724,24164,1,1
2011-03-03,spring,2011,March,2,Thursday,Workingday,Clear,0.2,0.1667,0.27,0.4627,1,2,3,3,669,3,1,1,1,111,1,715,16352,1,3
2011-03-03,spring,2011,March,3,Thursday,Workingday,Clear,0.2,0.1667,0.27,0.4627,0,1,1,1,669,1,1,1,1,111,1,697,8174,1,1
2011-03-03,spring,2011,March,4,Thursday,Workingday,Clear,0.16,0.1212,0.31,0.4925,0,1,1,1,669,1,1,1,1,111,1,697,4428,1,1
2011-03-03,spring,2011,March,5,Thursday,Workingday,Clear,0.14,0.1212,0.33,0.2985,1,7,8,8,669,8,1,1,1,111,1,717,14261,1,8
2011-03-03,spring,2011,March,6,Thursday,Workingday,Clear,0.14,0.1212,0.33,0.2985,1,34,35,35,669,35,1,1,1,111,1,725,55132,1,35
2011-03-03,spring,2011,March,7,Thursday,Workingday,Clear,0.12,0.0909,0.42,0.4179,1,110,111,111,669,111,1,2,1,121,1,727,154171,1,111
2011-03-03,spring,2011,March,8,Thursday,Workingday,Clear,0.14,0.1212,0.39,0.2985,4,216,220,220,669,220,1,3,1,131,1,727,261001,1,220
2011-03-03,spring,2011,March,9,Thursday,Workingday,Clear,0.16,0.1364,0.37,0.2836,10,135,145,145,669,145,1,3,1,131,1,727,159438,1,145
2011-03-03,spring,2011,March,10,Thursday,Workingday,Clear,0.18,0.1818,0.29,0.194,7,49,56,56,669,56,1,2,1,121,1,727,126257,1,56
2011-03-03,spring,2011,March,11,Thursday,Workingday,Clear,0.2,0.2273,0.29,0.0896,10,40,50,50,669,50,1,2,1,121,1,727,151320,1,50
2011-03-03,spring,2011,March,12,Thursday,Workingday,Clear,0.22,0.2273,0.25,0.1343,7,65,72,72,669,72,1,2,1,121,1,728,184414,1,72
2011-03-03,spring,2011,March,13,Thursday,Workingday,Clear,0.22,0.2576,0.25,0.0896,13,67,80,80,669,80,1,2,1,121,1,729,184919,1,80
2011-03-03,spring,2011,March,14,Thursday,Workingday,Clear,0.24,0.2576,0.21,0.1045,18,60,78,78,669,78,1,2,1,121,1,729,175652,1,78
2011-03-03,spring,2011,March,15,Thursday,Workingday,Clear,0.24,0.2879,0.23,0.0,6,62,68,68,669,68,1,2,1,121,1,729,183149,1,68
2011-03-03,spring,2011,March,16,Thursday,Workingday,Clear,0.26,0.303,0.23,0.0,6,65,71,71,669,71,1,2,1,121,1,730,227748,1,71
2011-03-03,spring,2011,March,17,Thursday,Workingday,Clear,0.26,0.303,0.22,0.0,17,185,202,202,669,202,1,3,1,131,1,730,336860,1,202
2011-03-03,spring,2011,March,18,Thursday,Workingday,Clear,0.24,0.2121,0.35,0.3284,6,161,167,167,669,167,1,3,1,131,1,728,309772,1,167
2011-03-03,spring,2011,March,19,Thursday,Workingday,Clear,0.2,0.197,0.4,0.2537,5,101,106,106,669,106,1,2,1,121,1,728,226789,1,106
2011-03-03,spring,2011,March,20,Thursday,Workingday,Clear,0.2,0.2273,0.4,0.0896,1,69,70,70,669,70,1,2,1,121,1,728,164550,1,70
2011-03-03,spring,2011,March,21,Thursday,Workingday,Clear,0.18,0.2121,0.4,0.1045,3,48,51,51,669,51,1,2,1,121,1,728,125445,1,51
2011-03-03,spring,2011,March,22,Thursday,Workingday,Clear,0.2,0.2576,0.4,0.0,3,50,53,53,669,53,1,2,1,121,1,728,95612,1,53
2011-03-03,spring,2011,March,23,Thursday,Workingday,Mist,0.18,0.2121,0.43,0.0896,0,23,23,23,669,23,1,1,1,111,1,728,63941,1,23
2011-03-04,spring,2011,March,0,Friday,Workingday,Mist,0.2,0.197,0.55,0.194,0,12,12,12,668,12,1,1,1,111,1,726,39130,1,12
2011-03-04,spring,2011,March,1,Friday,Workingday,Mist,0.18,0.1818,0.64,0.194,0,4,4,4,668,4,1,1,1,111,1,724,24164,1,4
2011-03-04,spring,2011,March,2,Friday,Workingday,Mist,0.18,0.1818,0.64,0.194,0,2,2,2,668,2,1,1,1,111,1,715,16352,1,2
2011-03-04,spring,2011,March,3,Friday,Workingday,Mist,0.18,0.1667,0.74,0.2537,0,1,1,1,668,1,1,1,1,111,1,697,8174,1,1
2011-03-04,spring,2011,March,4,Friday,Workingday,Mist,0.18,0.1818,0.74,0.194,1,0,1,1,668,1,1,1,1,111,1,697,4428,1,1
2011-03-04,spring,2011,March,5,Friday,Workingday,Mist,0.16,0.1818,0.74,0.1343,0,7,7,7,668,7,1,1,1,111,1,717,14261,1,7
2011-03-04,spring,2011,March,6,Friday,Workingday,Mist,0.16,0.197,0.74,0.0896,1,28,29,29,668,29,1,1,1,111,1,725,55132,1,29
2011-03-04,spring,2011,March,7,Friday,Workingday,Clear,0.16,0.1818,0.8,0.1343,0,83,83,83,668,83,1,2,1,121,1,727,154171,1,83
2011-03-04,spring,2011,March,8,Friday,Workingday,Clear,0.18,0.197,0.74,0.1343,6,222,228,228,668,228,1,3,1,131,1,727,261001,1,228
2011-03-04,spring,2011,March,9,Friday,Workingday,Clear,0.22,0.2273,0.6,0.1343,12,138,150,150,668,150,1,3,1,131,1,727,159438,1,150
2011-03-04,spring,2011,March,10,Friday,Workingday,Clear,0.24,0.2273,0.6,0.2537,10,56,66,66,668,66,1,2,1,121,1,727,126257,1,66
2011-03-04,spring,2011,March,11,Friday,Workingday,Clear,0.28,0.2727,0.52,0.2239,16,73,89,89,668,89,1,2,1,121,1,727,151320,1,89
2011-03-04,spring,2011,March,12,Friday,Workingday,Clear,0.32,0.303,0.43,0.1642,10,87,97,97,668,97,1,2,1,121,1,728,184414,1,97
2011-03-04,spring,2011,March,13,Friday,Workingday,Clear,0.34,0.3182,0.42,0.2239,13,74,87,87,668,87,1,2,1,121,1,729,184919,1,87
2011-03-04,spring,2011,March,14,Friday,Workingday,Clear,0.36,0.3333,0.4,0.2836,30,65,95,95,668,95,1,2,1,121,1,729,175652,1,95
2011-03-04,spring,2011,March,15,Friday,Workingday,Clear,0.36,0.3333,0.4,0.2985,31,75,106,106,668,106,1,2,1,121,1,729,183149,1,106
2011-03-04,spring,2011,March,16,Friday,Workingday,Clear,0.36,0.3485,0.46,0.194,17,101,118,118,668,118,1,2,2,122,1,730,227748,1,118
2011-03-04,spring,2011,March,17,Friday,Workingday,Mist,0.36,0.3333,0.5,0.2537,22,206,228,228,668,228,1,3,1,131,1,730,336860,1,228
2011-03-04,spring,2011,March,18,Friday,Workingday,Mist,0.34,0.303,0.53,0.2985,15,172,187,187,668,187,1,3,1,131,1,728,309772,1,187
2011-03-04,spring,2011,March,19,Friday,Workingday,Clear,0.32,0.303,0.61,0.2537,5,102,107,107,668,107,1,2,1,121,1,728,226789,1,107
2011-03-04,spring,2011,March,20,Friday,Workingday,Mist,0.3,0.2879,0.7,0.194,9,78,87,87,668,87,1,2,1,121,1,728,164550,1,87
2011-03-04,spring,2011,March,21,Friday,Workingday,Mist,0.3,0.2879,0.7,0.2239,6,64,70,70,668,70,1,2,1,121,1,728,125445,1,70
2011-03-04,spring,2011,March,22,Friday,Workingday,Clear,0.3,0.2879,0.7,0.194,4,40,44,44,668,44,1,2,1,121,1,728,95612,1,44
2011-03-04,spring,2011,March,23,Friday,Workingday,Mist,0.3,0.303,0.75,0.1642,6,40,46,46,668,46,1,2,1,121,1,728,63941,1,46
2011-03-05,spring,2011,March,0,Saturday,Holiday,Mist,0.28,0.2879,0.81,0.1045,4,15,19,19,667,19,1,1,1,111,1,726,39130,1,19
2011-03-05,spring,2011,March,1,Saturday,Holiday,Mist,0.3,0.3182,0.81,0.1045,5,20,25,25,667,25,1,1,1,111,1,724,24164,1,25
2011-03-05,spring,2011,March,2,Saturday,Holiday,Mist,0.3,0.2879,0.87,0.194,5,15,20,20,667,20,1,1,1,111,1,715,16352,1,20
2011-03-05,spring,2011,March,3,Saturday,Holiday,Mist,0.3,0.2879,0.87,0.194,0,2,2,2,667,2,1,1,1,111,1,697,8174,1,2
2011-03-05,spring,2011,March,4,Saturday,Holiday,Mist,0.3,0.303,0.93,0.1642,0,1,1,1,667,1,1,1,1,111,1,697,4428,1,1
2011-03-05,spring,2011,March,5,Saturday,Holiday,Mist,0.3,0.303,1.0,0.1343,0,3,3,3,667,3,1,1,1,111,0,717,14261,1,3
2011-03-05,spring,2011,March,6,Saturday,Holiday,Mist,0.3,0.2879,1.0,0.2239,1,3,4,4,667,4,1,1,1,111,1,725,55132,1,4
2011-03-05,spring,2011,March,7,Saturday,Holiday,Mist,0.3,0.2727,1.0,0.2985,5,10,15,15,667,15,1,1,1,111,1,727,154171,1,15
2011-03-05,spring,2011,March,8,Saturday,Holiday,Mist,0.3,0.2727,1.0,0.2985,11,34,45,45,667,45,1,2,1,121,1,727,261001,1,45
2011-03-05,spring,2011,March,9,Saturday,Holiday,Mist,0.32,0.303,0.93,0.2239,15,48,63,63,667,63,1,2,1,121,1,727,159438,1,63
2011-03-05,spring,2011,March,10,Saturday,Holiday,Mist,0.34,0.3333,0.93,0.194,34,69,103,103,667,103,1,2,1,121,1,727,126257,1,103
2011-03-05,spring,2011,March,11,Saturday,Holiday,Mist,0.4,0.4091,0.76,0.2239,43,116,159,159,667,159,1,3,2,132,1,727,151320,1,159
2011-03-05,spring,2011,March,12,Saturday,Holiday,Mist,0.44,0.4394,0.67,0.2537,46,121,167,167,667,167,1,3,2,132,1,728,184414,1,167
2011-03-05,spring,2011,March,13,Saturday,Holiday,Mist,0.46,0.4545,0.67,0.2836,60,130,190,190,667,190,1,3,2,132,0,729,184919,1,190
2011-03-05,spring,2011,March,14,Saturday,Holiday,Mist,0.48,0.4697,0.59,0.2836,80,118,198,198,667,198,1,3,2,132,2,729,175652,1,198
2011-03-05,spring,2011,March,15,Saturday,Holiday,Mist,0.46,0.4545,0.63,0.2985,83,122,205,205,667,205,1,3,2,132,1,729,183149,1,205
2011-03-05,spring,2011,March,16,Saturday,Holiday,Mist,0.48,0.4697,0.59,0.2985,74,130,204,204,667,204,1,3,2,132,1,730,227748,1,204
2011-03-05,spring,2011,March,17,Saturday,Holiday,Mist,0.48,0.4697,0.59,0.3582,60,104,164,164,667,164,1,3,2,132,1,730,336860,1,164
2011-03-05,spring,2011,March,18,Saturday,Holiday,Mist,0.48,0.4697,0.59,0.3284,37,115,152,152,667,152,1,3,2,132,1,728,309772,1,152
2011-03-05,spring,2011,March,19,Saturday,Holiday,Mist,0.46,0.4545,0.67,0.3284,27,62,89,89,667,89,1,2,2,122,1,728,226789,1,89
2011-03-05,spring,2011,March,20,Saturday,Holiday,Mist,0.44,0.4394,0.77,0.3284,12,58,70,70,667,70,1,2,2,122,1,728,164550,1,70
2011-03-05,spring,2011,March,21,Saturday,Holiday,Mist,0.44,0.4394,0.72,0.3284,12,60,72,72,667,72,1,2,2,122,1,728,125445,1,72
2011-03-05,spring,2011,March,22,Saturday,Holiday,Mist,0.42,0.4242,0.77,0.2985,16,47,63,63,667,63,1,2,2,122,1,728,95612,1,63
2011-03-05,spring,2011,March,23,Saturday,Holiday,Mist,0.44,0.4394,0.77,0.2985,10,34,44,44,667,44,1,2,2,122,0,728,63941,1,44
2011-03-06,spring,2011,March,0,Sunday,Holiday,Mist,0.42,0.4242,0.77,0.3582,11,41,52,52,666,52,1,2,2,122,1,726,39130,1,52
2011-03-06,spring,2011,March,1,Sunday,Holiday,Mist,0.42,0.4242,0.77,0.2836,12,27,39,39,666,39,1,1,2,112,1,724,24164,1,39
2011-03-06,spring,2011,March,2,Sunday,Holiday,Mist,0.4,0.4091,0.82,0.2836,5,27,32,32,666,32,1,1,2,112,1,715,16352,1,32
2011-03-06,spring,2011,March,3,Sunday,Holiday,Mist,0.42,0.4242,0.82,0.2985,2,9,11,11,666,11,1,1,2,112,0,697,8174,1,11
2011-03-06,spring,2011,March,4,Sunday,Holiday,Mist,0.42,0.4242,0.88,0.3582,0,3,3,3,666,3,1,1,2,112,0,697,4428,1,3
2011-03-06,spring,2011,March,6,Sunday,Holiday,Mist,0.42,0.4242,0.94,0.3582,1,1,2,2,666,2,1,1,2,112,0,725,55132,1,2
2011-03-06,spring,2011,March,7,Sunday,Holiday,Light Snow,0.42,0.4242,1.0,0.4478,0,5,5,5,666,5,1,1,2,112,0,727,154171,1,5
2011-03-06,spring,2011,March,8,Sunday,Holiday,Mist,0.4,0.4091,1.0,0.2985,1,8,9,9,666,9,1,1,2,112,0,727,261001,1,9
2011-03-06,spring,2011,March,9,Sunday,Holiday,Mist,0.42,0.4242,1.0,0.2836,4,18,22,22,666,22,1,1,2,112,0,727,159438,1,22
2011-03-06,spring,2011,March,10,Sunday,Holiday,Mist,0.42,0.4242,1.0,0.2985,4,27,31,31,666,31,1,1,2,112,0,727,126257,1,31
2011-03-06,spring,2011,March,11,Sunday,Holiday,Mist,0.42,0.4242,1.0,0.2239,18,44,62,62,666,62,1,2,2,122,0,727,151320,1,62
2011-03-06,spring,2011,March,12,Sunday,Holiday,Mist,0.46,0.4545,0.94,0.3284,10,69,79,79,666,79,1,2,2,122,0,728,184414,1,79
2011-03-06,spring,2011,March,13,Sunday,Holiday,Mist,0.46,0.4545,0.94,0.3582,22,83,105,105,666,105,1,2,2,122,0,729,184919,1,105
2011-03-06,spring,2011,March,14,Sunday,Holiday,Light Snow,0.44,0.4394,1.0,0.2239,12,27,39,39,666,39,1,1,2,112,0,729,175652,1,39
2011-03-06,spring,2011,March,15,Sunday,Holiday,Light Snow,0.44,0.4394,1.0,0.2239,3,4,7,7,666,7,1,1,2,112,0,729,183149,1,7
2011-03-06,spring,2011,March,16,Sunday,Holiday,Light Snow,0.36,0.3333,1.0,0.2836,3,8,11,11,666,11,1,1,1,111,1,730,227748,1,11
2011-03-06,spring,2011,March,17,Sunday,Holiday,Light Snow,0.34,0.303,1.0,0.2985,2,23,25,25,666,25,1,1,1,111,1,730,336860,1,25
2011-03-06,spring,2011,March,18,Sunday,Holiday,Light Snow,0.32,0.2879,1.0,0.3582,0,23,23,23,666,23,1,1,1,111,1,728,309772,1,23
2011-03-06,spring,2011,March,19,Sunday,Holiday,Light Snow,0.3,0.2576,1.0,0.4925,0,11,11,11,666,11,1,1,1,111,1,728,226789,1,11
2011-03-06,spring,2011,March,20,Sunday,Holiday,Light Snow,0.28,0.2424,1.0,0.4179,3,8,11,11,666,11,1,1,1,111,1,728,164550,1,11
2011-03-06,spring,2011,March,21,Sunday,Holiday,Light Snow,0.24,0.1818,0.93,0.6119,1,6,7,7,666,7,1,1,1,111,1,728,125445,1,7
2011-03-06,spring,2011,March,22,Sunday,Holiday,Mist,0.22,0.197,1.0,0.3881,0,10,10,10,666,10,1,1,1,111,1,728,95612,1,10
2011-03-06,spring,2011,March,23,Sunday,Holiday,Mist,0.22,0.197,1.0,0.4179,0,9,9,9,666,9,1,1,1,111,1,728,63941,1,9
2011-03-07,spring,2011,March,0,Monday,Workingday,Light Snow,0.2,0.1818,1.0,0.3284,0,4,4,4,665,4,1,1,1,111,1,726,39130,1,4
2011-03-07,spring,2011,March,1,Monday,Workingday,Light Snow,0.2,0.1818,1.0,0.3284,0,2,2,2,665,2,1,1,1,111,1,724,24164,1,2
2011-03-07,spring,2011,March,3,Monday,Workingday,Clear,0.2,0.1515,0.8,0.5821,0,1,1,1,665,1,1,1,1,111,1,697,8174,1,1
2011-03-07,spring,2011,March,4,Monday,Workingday,Clear,0.2,0.1515,0.8,0.5224,1,0,1,1,665,1,1,1,1,111,1,697,4428,1,1
2011-03-07,spring,2011,March,5,Monday,Workingday,Clear,0.2,0.1818,0.75,0.3582,0,1,1,1,665,1,1,1,1,111,1,717,14261,1,1
2011-03-07,spring,2011,March,6,Monday,Workingday,Clear,0.2,0.1818,0.75,0.3881,3,31,34,34,665,34,1,1,1,111,1,725,55132,1,34
2011-03-07,spring,2011,March,7,Monday,Workingday,Clear,0.2,0.1667,0.75,0.4179,3,88,91,91,665,91,1,2,1,121,1,727,154171,1,91
2011-03-07,spring,2011,March,8,Monday,Workingday,Clear,0.2,0.1818,0.75,0.3881,11,200,211,211,665,211,1,3,1,131,1,727,261001,1,211
2011-03-07,spring,2011,March,9,Monday,Workingday,Clear,0.22,0.1818,0.64,0.4627,5,129,134,134,665,134,1,2,1,121,1,727,159438,1,134
2011-03-07,spring,2011,March,10,Monday,Workingday,Clear,0.24,0.2121,0.6,0.2985,15,43,58,58,665,58,1,2,1,121,1,727,126257,1,58
2011-03-07,spring,2011,March,11,Monday,Workingday,Clear,0.26,0.2121,0.48,0.4478,19,41,60,60,665,60,1,2,1,121,1,727,151320,1,60
2011-03-07,spring,2011,March,12,Monday,Workingday,Clear,0.3,0.2727,0.42,0.4179,28,68,96,96,665,96,1,2,1,121,1,728,184414,1,96
2011-03-07,spring,2011,March,13,Monday,Workingday,Clear,0.32,0.2879,0.36,0.3881,16,54,70,70,665,70,1,2,1,121,1,729,184919,1,70
2011-03-07,spring,2011,March,14,Monday,Workingday,Clear,0.32,0.2879,0.36,0.4179,21,56,77,77,665,77,1,2,1,121,1,729,175652,1,77
2011-03-07,spring,2011,March,15,Monday,Workingday,Clear,0.34,0.303,0.31,0.3881,32,64,96,96,665,96,1,2,1,121,1,729,183149,1,96
2011-03-07,spring,2011,March,16,Monday,Workingday,Clear,0.34,0.303,0.31,0.3582,26,96,122,122,665,122,1,2,1,121,1,730,227748,1,122
2011-03-07,spring,2011,March,17,Monday,Workingday,Clear,0.34,0.303,0.29,0.3582,27,206,233,233,665,233,1,3,1,131,1,730,336860,1,233
2011-03-07,spring,2011,March,18,Monday,Workingday,Clear,0.32,0.303,0.31,0.2239,19,214,233,233,665,233,1,3,1,131,1,728,309772,1,233
2011-03-07,spring,2011,March,19,Monday,Workingday,Clear,0.3,0.2879,0.33,0.2239,11,134,145,145,665,145,1,3,1,131,1,728,226789,1,145
2011-03-07,spring,2011,March,20,Monday,Workingday,Clear,0.3,0.303,0.33,0.1642,5,87,92,92,665,92,1,2,1,121,1,728,164550,1,92
2011-03-07,spring,2011,March,21,Monday,Workingday,Clear,0.28,0.2727,0.38,0.2239,1,53,54,54,665,54,1,2,1,121,1,728,125445,1,54
2011-03-07,spring,2011,March,22,Monday,Workingday,Clear,0.26,0.2576,0.48,0.1642,1,34,35,35,665,35,1,1,1,111,1,728,95612,1,35
2011-03-07,spring,2011,March,23,Monday,Workingday,Clear,0.28,0.3182,0.48,0.0,0,22,22,22,665,22,1,1,1,111,1,728,63941,1,22
2011-03-08,spring,2011,March,0,Tuesday,Workingday,Clear,0.26,0.2879,0.48,0.0896,1,9,10,10,664,10,1,1,1,111,1,726,39130,1,10
2011-03-08,spring,2011,March,1,Tuesday,Workingday,Clear,0.24,0.2424,0.52,0.1343,0,4,4,4,664,4,1,1,1,111,1,724,24164,1,4
2011-03-08,spring,2011,March,2,Tuesday,Workingday,Clear,0.24,0.2424,0.52,0.1343,1,0,1,1,664,1,1,1,1,111,1,715,16352,1,1
2011-03-08,spring,2011,March,3,Tuesday,Workingday,Clear,0.24,0.2576,0.52,0.0896,5,2,7,7,664,7,1,1,1,111,1,697,8174,1,7
2011-03-08,spring,2011,March,4,Tuesday,Workingday,Clear,0.22,0.2727,0.64,0.0,0,2,2,2,664,2,1,1,1,111,1,697,4428,1,2
2011-03-08,spring,2011,March,5,Tuesday,Workingday,Clear,0.2,0.2273,0.69,0.1045,2,8,10,10,664,10,1,1,1,111,1,717,14261,1,10
2011-03-08,spring,2011,March,6,Tuesday,Workingday,Clear,0.2,0.2576,0.59,0.0,3,42,45,45,664,45,1,2,1,121,1,725,55132,1,45
2011-03-08,spring,2011,March,7,Tuesday,Workingday,Clear,0.18,0.197,0.64,0.1343,9,119,128,128,664,128,1,2,1,121,1,727,154171,1,128
2011-03-08,spring,2011,March,8,Tuesday,Workingday,Clear,0.22,0.2273,0.55,0.194,10,247,257,257,664,257,1,3,1,131,1,727,261001,1,257
2011-03-08,spring,2011,March,9,Tuesday,Workingday,Clear,0.26,0.2576,0.41,0.1642,11,140,151,151,664,151,1,3,1,131,1,727,159438,1,151
2011-03-08,spring,2011,March,10,Tuesday,Workingday,Mist,0.3,0.2879,0.33,0.194,25,46,71,71,664,71,1,2,1,121,1,727,126257,1,71
2011-03-08,spring,2011,March,11,Tuesday,Workingday,Mist,0.36,0.3485,0.25,0.1642,26,52,78,78,664,78,1,2,2,122,1,727,151320,1,78
2011-03-08,spring,2011,March,12,Tuesday,Workingday,Mist,0.36,0.3788,0.23,0.0,29,70,99,99,664,99,1,2,2,122,1,728,184414,1,99
2011-03-08,spring,2011,March,13,Tuesday,Workingday,Mist,0.38,0.3939,0.25,0.1045,25,73,98,98,664,98,1,2,2,122,1,729,184919,1,98
2011-03-08,spring,2011,March,14,Tuesday,Workingday,Mist,0.38,0.3939,0.2,0.0,16,56,72,72,664,72,1,2,2,122,1,729,175652,1,72
2011-03-08,spring,2011,March,15,Tuesday,Workingday,Mist,0.36,0.3788,0.18,0.0,35,77,112,112,664,112,1,2,2,122,1,729,183149,1,112
2011-03-08,spring,2011,March,16,Tuesday,Workingday,Clear,0.38,0.3939,0.27,0.1642,26,82,108,108,664,108,1,2,2,122,1,730,227748,1,108
2011-03-08,spring,2011,March,17,Tuesday,Workingday,Clear,0.36,0.3485,0.27,0.2239,39,209,248,248,664,248,1,3,2,132,1,730,336860,1,248
2011-03-08,spring,2011,March,18,Tuesday,Workingday,Clear,0.34,0.3333,0.27,0.194,21,214,235,235,664,235,1,3,1,131,1,728,309772,1,235
2011-03-08,spring,2011,March,19,Tuesday,Workingday,Clear,0.34,0.3485,0.31,0.1045,9,141,150,150,664,150,1,3,2,132,1,728,226789,1,150
2011-03-08,spring,2011,March,20,Tuesday,Workingday,Clear,0.32,0.3333,0.39,0.0896,2,74,76,76,664,76,1,2,1,121,1,728,164550,1,76
2011-03-08,spring,2011,March,21,Tuesday,Workingday,Clear,0.3,0.2879,0.49,0.194,7,68,75,75,664,75,1,2,1,121,1,728,125445,1,75
2011-03-08,spring,2011,March,22,Tuesday,Workingday,Clear,0.3,0.2879,0.49,0.2239,11,44,55,55,664,55,1,2,1,121,1,728,95612,1,55
2011-03-08,spring,2011,March,23,Tuesday,Workingday,Clear,0.28,0.2727,0.61,0.194,3,38,41,41,664,41,1,2,1,121,1,728,63941,1,41
2011-03-09,spring,2011,March,0,Wednesday,Workingday,Clear,0.26,0.2879,0.65,0.0896,0,9,9,9,663,9,1,1,1,111,1,726,39130,1,9
2011-03-09,spring,2011,March,1,Wednesday,Workingday,Clear,0.26,0.2727,0.52,0.1343,0,4,4,4,663,4,1,1,1,111,1,724,24164,1,4
2011-03-09,spring,2011,March,2,Wednesday,Workingday,Clear,0.26,0.2727,0.52,0.1343,1,1,2,2,663,2,1,1,1,111,1,715,16352,1,2
2011-03-09,spring,2011,March,3,Wednesday,Workingday,Clear,0.24,0.2576,0.7,0.0896,1,2,3,3,663,3,1,1,1,111,1,697,8174,1,3
2011-03-09,spring,2011,March,4,Wednesday,Workingday,Clear,0.24,0.2576,0.75,0.1045,0,2,2,2,663,2,1,1,1,111,1,697,4428,1,2
2011-03-09,spring,2011,March,5,Wednesday,Workingday,Mist,0.24,0.2424,0.81,0.1343,1,7,8,8,663,8,1,1,1,111,1,717,14261,1,8
2011-03-09,spring,2011,March,6,Wednesday,Workingday,Mist,0.24,0.2576,0.85,0.1045,5,44,49,49,663,49,1,2,1,121,1,725,55132,1,49
2011-03-09,spring,2011,March,7,Wednesday,Workingday,Mist,0.24,0.2424,0.87,0.1642,18,123,141,141,663,141,1,2,1,121,1,727,154171,1,141
2011-03-09,spring,2011,March,8,Wednesday,Workingday,Mist,0.24,0.2424,0.87,0.1343,11,238,249,249,663,249,1,3,1,131,1,727,261001,1,249
2011-03-09,spring,2011,March,9,Wednesday,Workingday,Mist,0.26,0.2424,0.87,0.2537,5,136,141,141,663,141,1,2,1,121,1,727,159438,1,141
2011-03-09,spring,2011,March,10,Wednesday,Workingday,Mist,0.3,0.2879,0.75,0.2537,8,49,57,57,663,57,1,2,1,121,1,727,126257,1,57
2011-03-09,spring,2011,March,11,Wednesday,Workingday,Mist,0.32,0.2879,0.76,0.3881,15,44,59,59,663,59,1,2,1,121,1,727,151320,1,59
2011-03-09,spring,2011,March,12,Wednesday,Workingday,Mist,0.32,0.303,0.76,0.2537,14,84,98,98,663,98,1,2,1,121,1,728,184414,1,98
2011-03-09,spring,2011,March,13,Wednesday,Workingday,Mist,0.32,0.2879,0.76,0.3582,17,82,99,99,663,99,1,2,1,121,1,729,184919,1,99
2011-03-09,spring,2011,March,14,Wednesday,Workingday,Mist,0.34,0.303,0.76,0.2985,10,61,71,71,663,71,1,2,1,121,1,729,175652,1,71
2011-03-09,spring,2011,March,15,Wednesday,Workingday,Mist,0.36,0.3333,0.71,0.2985,15,64,79,79,663,79,1,2,1,121,1,729,183149,1,79
2011-03-09,spring,2011,March,16,Wednesday,Workingday,Mist,0.34,0.303,0.76,0.3284,10,102,112,112,663,112,1,2,1,121,1,730,227748,1,112
2011-03-09,spring,2011,March,17,Wednesday,Workingday,Mist,0.34,0.303,0.76,0.2985,18,176,194,194,663,194,1,3,1,131,1,730,336860,1,194
2011-03-09,spring,2011,March,18,Wednesday,Workingday,Mist,0.34,0.3182,0.76,0.2537,12,176,188,188,663,188,1,3,1,131,1,728,309772,1,188
2011-03-09,spring,2011,March,19,Wednesday,Workingday,Mist,0.34,0.303,0.76,0.3284,11,123,134,134,663,134,1,2,1,121,1,728,226789,1,134
2011-03-09,spring,2011,March,20,Wednesday,Workingday,Mist,0.32,0.3182,0.87,0.194,4,87,91,91,663,91,1,2,1,121,1,728,164550,1,91
2011-03-09,spring,2011,March,21,Wednesday,Workingday,Mist,0.32,0.303,0.93,0.3284,10,52,62,62,663,62,1,2,1,121,1,728,125445,1,62
2011-03-09,spring,2011,March,22,Wednesday,Workingday,Light Snow,0.32,0.3182,0.93,0.1642,4,17,21,21,663,21,1,1,1,111,1,728,95612,1,21
2011-03-09,spring,2011,March,23,Wednesday,Workingday,Light Snow,0.34,0.3333,0.93,0.194,1,17,18,18,663,18,1,1,1,111,1,728,63941,1,18
2011-03-10,spring,2011,March,0,Thursday,Workingday,Light Snow,0.34,0.3182,0.0,0.2537,3,0,3,3,662,3,1,1,1,111,1,726,39130,1,3
2011-03-10,spring,2011,March,1,Thursday,Workingday,Light Snow,0.34,0.3182,0.0,0.2537,0,2,2,2,662,2,1,1,1,111,1,724,24164,1,2
2011-03-10,spring,2011,March,2,Thursday,Workingday,Light Snow,0.34,0.3182,0.0,0.2537,0,1,1,1,662,1,1,1,1,111,1,715,16352,1,1
2011-03-10,spring,2011,March,5,Thursday,Workingday,Light Snow,0.36,0.3485,0.0,0.194,1,2,3,3,662,3,1,1,2,112,1,717,14261,1,3
2011-03-10,spring,2011,March,6,Thursday,Workingday,Light Snow,0.36,0.3333,0.0,0.3284,0,12,12,12,662,12,1,1,1,111,1,725,55132,1,12
2011-03-10,spring,2011,March,7,Thursday,Workingday,Light Snow,0.38,0.3939,0.0,0.2239,1,36,37,37,662,37,1,1,2,112,1,727,154171,1,37
2011-03-10,spring,2011,March,8,Thursday,Workingday,Light Snow,0.38,0.3939,0.0,0.2836,1,43,44,44,662,44,1,2,2,122,1,727,261001,1,44
2011-03-10,spring,2011,March,9,Thursday,Workingday,Light Snow,0.4,0.4091,0.0,0.2239,1,23,24,24,662,24,1,1,2,112,1,727,159438,1,24
2011-03-10,spring,2011,March,10,Thursday,Workingday,Light Snow,0.4,0.4091,0.0,0.1642,0,17,17,17,662,17,1,1,2,112,1,727,126257,1,17
2011-03-10,spring,2011,March,11,Thursday,Workingday,Light Snow,0.4,0.4091,0.0,0.2537,6,5,11,11,662,11,1,1,2,112,1,727,151320,1,11
2011-03-10,spring,2011,March,12,Thursday,Workingday,Light Snow,0.42,0.4242,0.0,0.2239,4,30,34,34,662,34,1,1,2,112,1,728,184414,1,34
2011-03-10,spring,2011,March,13,Thursday,Workingday,Light Snow,0.42,0.4242,0.0,0.2239,1,11,12,12,662,12,1,1,2,112,1,729,184919,1,12
2011-03-10,spring,2011,March,14,Thursday,Workingday,Light Snow,0.44,0.4394,0.0,0.2985,0,12,12,12,662,12,1,1,2,112,1,729,175652,1,12
2011-03-10,spring,2011,March,15,Thursday,Workingday,Light Snow,0.44,0.4394,0.0,0.2239,3,11,14,14,662,14,1,1,2,112,1,729,183149,1,14
2011-03-10,spring,2011,March,16,Thursday,Workingday,Light Snow,0.42,0.4242,0.0,0.2537,1,20,21,21,662,21,1,1,2,112,1,730,227748,1,21
2011-03-10,spring,2011,March,17,Thursday,Workingday,Mist,0.44,0.4394,0.0,0.3881,2,109,111,111,662,111,1,2,2,122,1,730,336860,1,111
2011-03-10,spring,2011,March,18,Thursday,Workingday,Light Snow,0.44,0.4394,0.0,0.3582,2,80,82,82,662,82,1,2,2,122,1,728,309772,1,82
2011-03-10,spring,2011,March,19,Thursday,Workingday,Light Snow,0.44,0.4394,0.0,0.5821,5,51,56,56,662,56,1,2,2,122,1,728,226789,1,56
2011-03-10,spring,2011,March,20,Thursday,Workingday,Light Snow,0.36,0.3333,0.0,0.3284,9,29,38,38,662,38,1,1,1,111,1,728,164550,1,38
2011-03-10,spring,2011,March,21,Thursday,Workingday,Light Snow,0.36,0.3485,0.0,0.2239,1,27,28,28,662,28,1,1,2,112,1,728,125445,1,28
2011-03-10,spring,2011,March,22,Thursday,Workingday,Mist,0.34,0.3333,0.0,0.1343,4,30,34,34,662,34,1,1,1,111,1,728,95612,1,34
2011-03-10,spring,2011,March,23,Thursday,Workingday,Light Snow,0.34,0.3485,0.0,0.0896,1,26,27,27,662,27,1,1,2,112,1,728,63941,1,27
2011-03-11,spring,2011,March,0,Friday,Workingday,Mist,0.34,0.3485,1.0,0.0896,0,6,6,6,661,6,1,1,2,112,0,726,39130,1,6
2011-03-11,spring,2011,March,1,Friday,Workingday,Light Snow,0.34,0.3485,1.0,0.1045,0,8,8,8,661,8,1,1,2,112,0,724,24164,1,8
2011-03-11,spring,2011,March,2,Friday,Workingday,Light Snow,0.34,0.3485,1.0,0.1045,2,3,5,5,661,5,1,1,2,112,0,715,16352,1,5
2011-03-11,spring,2011,March,3,Friday,Workingday,Mist,0.32,0.3333,0.93,0.0896,0,2,2,2,661,2,1,1,1,111,0,697,8174,1,2
2011-03-11,spring,2011,March,5,Friday,Workingday,Clear,0.3,0.2879,0.81,0.2239,1,6,7,7,661,7,1,1,1,111,1,717,14261,1,7
2011-03-11,spring,2011,March,6,Friday,Workingday,Clear,0.26,0.2424,0.81,0.2836,1,31,32,32,661,32,1,1,1,111,1,725,55132,1,32
2011-03-11,spring,2011,March,7,Friday,Workingday,Clear,0.26,0.2576,0.7,0.194,10,104,114,114,661,114,1,2,1,121,1,727,154171,1,114
2011-03-11,spring,2011,March,8,Friday,Workingday,Clear,0.28,0.2727,0.7,0.2537,15,244,259,259,661,259,1,3,1,131,1,727,261001,1,259
2011-03-11,spring,2011,March,9,Friday,Workingday,Mist,0.3,0.2879,0.61,0.2836,13,143,156,156,661,156,1,3,1,131,1,727,159438,1,156
2011-03-11,spring,2011,March,10,Friday,Workingday,Mist,0.32,0.303,0.57,0.2985,18,60,78,78,661,78,1,2,1,121,1,727,126257,1,78
2011-03-11,spring,2011,March,11,Friday,Workingday,Mist,0.32,0.303,0.57,0.2985,14,67,81,81,661,81,1,2,1,121,1,727,151320,1,81
2011-03-11,spring,2011,March,12,Friday,Workingday,Mist,0.34,0.3182,0.53,0.2537,15,96,111,111,661,111,1,2,1,121,1,728,184414,1,111
2011-03-11,spring,2011,March,13,Friday,Workingday,Clear,0.36,0.3333,0.53,0.2537,15,92,107,107,661,107,1,2,1,121,1,729,184919,1,107
2011-03-11,spring,2011,March,14,Friday,Workingday,Mist,0.36,0.3333,0.5,0.3582,25,64,89,89,661,89,1,2,1,121,1,729,175652,1,89
2011-03-11,spring,2011,March,15,Friday,Workingday,Mist,0.34,0.3182,0.53,0.2537,21,64,85,85,661,85,1,2,1,121,1,729,183149,1,85
2011-03-11,spring,2011,March,16,Friday,Workingday,Mist,0.34,0.303,0.49,0.2985,18,95,113,113,661,113,1,2,1,121,1,730,227748,1,113
2011-03-11,spring,2011,March,17,Friday,Workingday,Clear,0.34,0.3182,0.49,0.2239,23,200,223,223,661,223,1,3,1,131,1,730,336860,1,223
2011-03-11,spring,2011,March,18,Friday,Workingday,Clear,0.32,0.303,0.49,0.3284,19,134,153,153,661,153,1,3,1,131,1,728,309772,1,153
2011-03-11,spring,2011,March,19,Friday,Workingday,Clear,0.3,0.2727,0.56,0.3284,7,111,118,118,661,118,1,2,1,121,1,728,226789,1,118
2011-03-11,spring,2011,March,20,Friday,Workingday,Clear,0.3,0.303,0.56,0.1642,6,70,76,76,661,76,1,2,1,121,1,728,164550,1,76
2011-03-11,spring,2011,March,21,Friday,Workingday,Mist,0.3,0.2879,0.52,0.2537,10,43,53,53,661,53,1,2,1,121,1,728,125445,1,53
2011-03-11,spring,2011,March,22,Friday,Workingday,Clear,0.3,0.303,0.52,0.1642,11,53,64,64,661,64,1,2,1,121,1,728,95612,1,64
2011-03-11,spring,2011,March,23,Friday,Workingday,Clear,0.3,0.2879,0.52,0.2537,3,34,37,37,661,37,1,1,1,111,1,728,63941,1,37
2011-03-12,spring,2011,March,0,Saturday,Holiday,Clear,0.26,0.2727,0.6,0.1343,4,30,34,34,660,34,1,1,1,111,1,726,39130,1,34
2011-03-12,spring,2011,March,1,Saturday,Holiday,Clear,0.24,0.2273,0.65,0.194,3,15,18,18,660,18,1,1,1,111,1,724,24164,1,18
2011-03-12,spring,2011,March,2,Saturday,Holiday,Clear,0.24,0.2273,0.65,0.194,0,14,14,14,660,14,1,1,1,111,1,715,16352,1,14
2011-03-12,spring,2011,March,3,Saturday,Holiday,Clear,0.24,0.2273,0.65,0.2537,1,6,7,7,660,7,1,1,1,111,1,697,8174,1,7
2011-03-12,spring,2011,March,4,Saturday,Holiday,Clear,0.24,0.2273,0.65,0.2537,0,1,1,1,660,1,1,1,1,111,1,697,4428,1,1
2011-03-12,spring,2011,March,5,Saturday,Holiday,Clear,0.22,0.2273,0.69,0.194,0,2,2,2,660,2,1,1,1,111,1,717,14261,1,2
2011-03-12,spring,2011,March,6,Saturday,Holiday,Clear,0.22,0.2121,0.75,0.2537,2,2,4,4,660,4,1,1,1,111,1,725,55132,1,4
2011-03-12,spring,2011,March,7,Saturday,Holiday,Clear,0.24,0.2273,0.7,0.194,4,19,23,23,660,23,1,1,1,111,1,727,154171,1,23
2011-03-12,spring,2011,March,8,Saturday,Holiday,Clear,0.26,0.2576,0.65,0.1642,9,44,53,53,660,53,1,2,1,121,1,727,261001,1,53
2011-03-12,spring,2011,March,9,Saturday,Holiday,Clear,0.28,0.2879,0.65,0.1045,25,76,101,101,660,101,1,2,1,121,1,727,159438,1,101
2011-03-12,spring,2011,March,10,Saturday,Holiday,Clear,0.32,0.303,0.66,0.2239,21,78,99,99,660,99,1,2,1,121,1,727,126257,1,99
2011-03-12,spring,2011,March,11,Saturday,Holiday,Clear,0.34,0.303,0.49,0.3284,36,83,119,119,660,119,1,2,1,121,1,727,151320,1,119
2011-03-12,spring,2011,March,12,Saturday,Holiday,Clear,0.34,0.3182,0.53,0.2836,51,107,158,158,660,158,1,3,1,131,1,728,184414,1,158
2011-03-12,spring,2011,March,13,Saturday,Holiday,Clear,0.36,0.3333,0.51,0.3582,62,95,157,157,660,157,1,3,1,131,1,729,184919,1,157
2011-03-12,spring,2011,March,14,Saturday,Holiday,Clear,0.4,0.4091,0.5,0.4478,70,96,166,166,660,166,1,3,2,132,1,729,175652,1,166
2011-03-12,spring,2011,March,15,Saturday,Holiday,Clear,0.42,0.4242,0.44,0.4925,81,101,182,182,660,182,1,3,2,132,1,729,183149,1,182
2011-03-12,spring,2011,March,16,Saturday,Holiday,Clear,0.46,0.4545,0.41,0.4478,100,144,244,244,660,244,1,3,2,132,2,730,227748,1,244
2011-03-12,spring,2011,March,17,Saturday,Holiday,Clear,0.46,0.4545,0.44,0.3284,99,114,213,213,660,213,1,3,2,132,2,730,336860,1,213
2011-03-12,spring,2011,March,18,Saturday,Holiday,Clear,0.42,0.4242,0.54,0.1642,54,91,145,145,660,145,1,3,2,132,1,728,309772,1,145
2011-03-12,spring,2011,March,19,Saturday,Holiday,Clear,0.42,0.4242,0.54,0.0896,26,86,112,112,660,112,1,2,2,122,1,728,226789,1,112
2011-03-12,spring,2011,March,20,Saturday,Holiday,Clear,0.4,0.4091,0.58,0.1045,22,64,86,86,660,86,1,2,2,122,1,728,164550,1,86
2011-03-12,spring,2011,March,21,Saturday,Holiday,Clear,0.38,0.3939,0.62,0.0,36,46,82,82,660,82,1,2,2,122,0,728,125445,1,82
2011-03-12,spring,2011,March,22,Saturday,Holiday,Clear,0.36,0.3788,0.71,0.0,7,56,63,63,660,63,1,2,2,122,0,728,95612,1,63
2011-03-12,spring,2011,March,23,Saturday,Holiday,Clear,0.38,0.3939,0.66,0.0896,11,38,49,49,660,49,1,2,2,122,1,728,63941,1,49
2011-03-13,spring,2011,March,0,Sunday,Holiday,Clear,0.38,0.3939,0.62,0.1045,3,35,38,38,659,38,1,1,2,112,1,726,39130,1,38
2011-03-13,spring,2011,March,1,Sunday,Holiday,Clear,0.36,0.3485,0.66,0.1343,10,23,33,33,659,33,1,1,2,112,1,724,24164,1,33
2011-03-13,spring,2011,March,3,Sunday,Holiday,Clear,0.34,0.3333,0.76,0.1343,6,17,23,23,659,23,1,1,1,111,1,697,8174,1,23
2011-03-13,spring,2011,March,4,Sunday,Holiday,Clear,0.34,0.3333,0.66,0.1642,4,9,13,13,659,13,1,1,1,111,1,697,4428,1,13
2011-03-13,spring,2011,March,5,Sunday,Holiday,Clear,0.36,0.3485,0.62,0.1343,0,3,3,3,659,3,1,1,2,112,1,717,14261,1,3
2011-03-13,spring,2011,March,6,Sunday,Holiday,Clear,0.34,0.3636,0.66,0.0,0,2,2,2,659,2,1,1,2,112,1,725,55132,1,2
2011-03-13,spring,2011,March,7,Sunday,Holiday,Clear,0.36,0.3485,0.62,0.194,2,8,10,10,659,10,1,1,2,112,1,727,154171,1,10
2011-03-13,spring,2011,March,8,Sunday,Holiday,Clear,0.4,0.4091,0.5,0.2985,11,23,34,34,659,34,1,1,2,112,1,727,261001,1,34
2011-03-13,spring,2011,March,9,Sunday,Holiday,Clear,0.4,0.4091,0.5,0.4179,8,36,44,44,659,44,1,2,2,122,1,727,159438,1,44
2011-03-13,spring,2011,March,10,Sunday,Holiday,Clear,0.42,0.4242,0.47,0.2537,36,86,122,122,659,122,1,2,2,122,1,727,126257,1,122
2011-03-13,spring,2011,March,11,Sunday,Holiday,Clear,0.44,0.4394,0.41,0.4179,88,93,181,181,659,181,1,3,2,132,1,727,151320,1,181
2011-03-13,spring,2011,March,12,Sunday,Holiday,Clear,0.46,0.4545,0.38,0.3881,74,120,194,194,659,194,1,3,2,132,2,728,184414,1,194
2011-03-13,spring,2011,March,13,Sunday,Holiday,Clear,0.46,0.4545,0.38,0.3881,97,124,221,221,659,221,1,3,2,132,2,729,184919,1,221
2011-03-13,spring,2011,March,14,Sunday,Holiday,Clear,0.46,0.4545,0.41,0.2985,144,106,250,250,659,250,1,3,2,132,2,729,175652,1,250
2011-03-13,spring,2011,March,15,Sunday,Holiday,Clear,0.48,0.4697,0.39,0.3284,149,155,304,304,659,304,1,4,2,142,2,729,183149,1,304
2011-03-13,spring,2011,March,16,Sunday,Holiday,Clear,0.46,0.4545,0.41,0.3881,124,132,256,256,659,256,1,3,2,132,2,730,227748,1,256
2011-03-13,spring,2011,March,17,Sunday,Holiday,Clear,0.44,0.4394,0.41,0.3582,98,143,241,241,659,241,1,3,2,132,2,730,336860,1,241
2011-03-13,spring,2011,March,18,Sunday,Holiday,Clear,0.4,0.4091,0.43,0.3582,55,92,147,147,659,147,1,3,2,132,1,728,309772,1,147
2011-03-13,spring,2011,March,19,Sunday,Holiday,Clear,0.36,0.3333,0.5,0.3582,28,73,101,101,659,101,1,2,1,121,1,728,226789,1,101
2011-03-13,spring,2011,March,20,Sunday,Holiday,Clear,0.32,0.303,0.57,0.2985,23,54,77,77,659,77,1,2,1,121,1,728,164550,1,77
2011-03-13,spring,2011,March,21,Sunday,Holiday,Clear,0.3,0.2879,0.56,0.2537,9,49,58,58,659,58,1,2,1,121,1,728,125445,1,58
2011-03-13,spring,2011,March,22,Sunday,Holiday,Clear,0.3,0.2727,0.56,0.3284,8,29,37,37,659,37,1,1,1,111,1,728,95612,1,37
2011-03-13,spring,2011,March,23,Sunday,Holiday,Clear,0.26,0.2576,0.65,0.2239,5,23,28,28,659,28,1,1,1,111,1,728,63941,1,28
2011-03-14,spring,2011,March,0,Monday,Workingday,Clear,0.26,0.2727,0.65,0.1045,4,7,11,11,658,11,1,1,1,111,1,726,39130,1,11
2011-03-14,spring,2011,March,1,Monday,Workingday,Clear,0.26,0.2879,0.65,0.0896,0,1,1,1,658,1,1,1,1,111,1,724,24164,1,1
2011-03-14,spring,2011,March,2,Monday,Workingday,Clear,0.26,0.2879,0.65,0.0896,0,1,1,1,658,1,1,1,1,111,1,715,16352,1,1
2011-03-14,spring,2011,March,3,Monday,Workingday,Clear,0.26,0.2727,0.65,0.1343,0,3,3,3,658,3,1,1,1,111,1,697,8174,1,3
2011-03-14,spring,2011,March,5,Monday,Workingday,Clear,0.24,0.2424,0.7,0.1343,0,8,8,8,658,8,1,1,1,111,1,717,14261,1,8
2011-03-14,spring,2011,March,6,Monday,Workingday,Clear,0.26,0.2727,0.65,0.1343,1,27,28,28,658,28,1,1,1,111,1,725,55132,1,28
2011-03-14,spring,2011,March,7,Monday,Workingday,Mist,0.28,0.3182,0.61,0.0,4,84,88,88,658,88,1,2,1,121,1,727,154171,1,88
2011-03-14,spring,2011,March,8,Monday,Workingday,Mist,0.3,0.303,0.56,0.1343,24,217,241,241,658,241,1,3,1,131,1,727,261001,1,241
2011-03-14,spring,2011,March,9,Monday,Workingday,Clear,0.32,0.303,0.53,0.3284,13,127,140,140,658,140,1,2,1,121,1,727,159438,1,140
2011-03-14,spring,2011,March,10,Monday,Workingday,Clear,0.34,0.3182,0.42,0.2537,27,57,84,84,658,84,1,2,1,121,1,727,126257,1,84
2011-03-14,spring,2011,March,11,Monday,Workingday,Clear,0.36,0.3333,0.4,0.2537,26,45,71,71,658,71,1,2,1,121,1,727,151320,1,71
2011-03-14,spring,2011,March,12,Monday,Workingday,Clear,0.38,0.3939,0.37,0.0,40,54,94,94,658,94,1,2,2,122,1,728,184414,1,94
2011-03-14,spring,2011,March,13,Monday,Workingday,Clear,0.38,0.3939,0.36,0.3284,24,51,75,75,658,75,1,2,2,122,1,729,184919,1,75
2011-03-14,spring,2011,March,14,Monday,Workingday,Mist,0.38,0.3939,0.34,0.0,27,52,79,79,658,79,1,2,2,122,1,729,175652,1,79
2011-03-14,spring,2011,March,15,Monday,Workingday,Clear,0.38,0.3939,0.37,0.1642,24,77,101,101,658,101,1,2,2,122,1,729,183149,1,101
2011-03-14,spring,2011,March,16,Monday,Workingday,Clear,0.4,0.4091,0.35,0.1045,27,80,107,107,658,107,1,2,2,122,1,730,227748,1,107
2011-03-14,spring,2011,March,17,Monday,Workingday,Clear,0.38,0.3939,0.4,0.194,42,229,271,271,658,271,1,3,2,132,1,730,336860,1,271
2011-03-14,spring,2011,March,18,Monday,Workingday,Clear,0.36,0.3636,0.4,0.1045,25,210,235,235,658,235,1,3,2,132,1,728,309772,1,235
2011-03-14,spring,2011,March,19,Monday,Workingday,Clear,0.36,0.3485,0.43,0.1343,17,133,150,150,658,150,1,3,2,132,1,728,226789,1,150
2011-03-14,spring,2011,March,20,Monday,Workingday,Clear,0.34,0.3182,0.46,0.2239,23,106,129,129,658,129,1,2,1,121,1,728,164550,1,129
2011-03-14,spring,2011,March,21,Monday,Workingday,Clear,0.34,0.3333,0.46,0.1343,5,58,63,63,658,63,1,2,1,121,1,728,125445,1,63
2011-03-14,spring,2011,March,22,Monday,Workingday,Clear,0.32,0.3333,0.49,0.1045,4,43,47,47,658,47,1,2,1,121,1,728,95612,1,47
2011-03-14,spring,2011,March,23,Monday,Workingday,Clear,0.32,0.3485,0.53,0.0,2,17,19,19,658,19,1,1,2,112,1,728,63941,1,19
2011-03-15,spring,2011,March,0,Tuesday,Workingday,Clear,0.32,0.3485,0.53,0.0,7,7,14,14,657,14,1,1,2,112,1,726,39130,1,14
2011-03-15,spring,2011,March,1,Tuesday,Workingday,Clear,0.3,0.303,0.62,0.0896,4,6,10,10,657,10,1,1,1,111,1,724,24164,1,10
2011-03-15,spring,2011,March,2,Tuesday,Workingday,Clear,0.3,0.303,0.62,0.0896,1,2,3,3,657,3,1,1,1,111,1,715,16352,1,3
2011-03-15,spring,2011,March,4,Tuesday,Workingday,Clear,0.24,0.2576,0.75,0.0896,1,1,2,2,657,2,1,1,1,111,1,697,4428,1,2
2011-03-15,spring,2011,March,5,Tuesday,Workingday,Clear,0.24,0.2273,0.75,0.194,0,11,11,11,657,11,1,1,1,111,1,717,14261,1,11
2011-03-15,spring,2011,March,6,Tuesday,Workingday,Clear,0.22,0.2273,0.8,0.194,3,32,35,35,657,35,1,1,1,111,1,725,55132,1,35
2011-03-15,spring,2011,March,7,Tuesday,Workingday,Clear,0.24,0.2424,0.75,0.1642,10,109,119,119,657,119,1,2,1,121,1,727,154171,1,119
2011-03-15,spring,2011,March,8,Tuesday,Workingday,Clear,0.26,0.2879,0.7,0.0896,23,259,282,282,657,282,1,4,1,141,1,727,261001,1,282
2011-03-15,spring,2011,March,9,Tuesday,Workingday,Mist,0.3,0.3333,0.7,0.0,10,147,157,157,657,157,1,3,1,131,1,727,159438,1,157
2011-03-15,spring,2011,March,10,Tuesday,Workingday,Mist,0.32,0.3182,0.66,0.194,22,56,78,78,657,78,1,2,1,121,1,727,126257,1,78
2011-03-15,spring,2011,March,11,Tuesday,Workingday,Mist,0.34,0.3182,0.57,0.2239,27,51,78,78,657,78,1,2,1,121,1,727,151320,1,78
2011-03-15,spring,2011,March,12,Tuesday,Workingday,Mist,0.36,0.3485,0.5,0.2239,32,70,102,102,657,102,1,2,2,122,1,728,184414,1,102
2011-03-15,spring,2011,March,13,Tuesday,Workingday,Mist,0.36,0.3333,0.57,0.2836,23,74,97,97,657,97,1,2,1,121,1,729,184919,1,97
2011-03-15,spring,2011,March,14,Tuesday,Workingday,Mist,0.38,0.3939,0.46,0.2985,14,74,88,88,657,88,1,2,2,122,1,729,175652,1,88
2011-03-15,spring,2011,March,15,Tuesday,Workingday,Mist,0.38,0.3939,0.43,0.2836,24,66,90,90,657,90,1,2,2,122,1,729,183149,1,90
2011-03-15,spring,2011,March,16,Tuesday,Workingday,Mist,0.38,0.3939,0.46,0.3284,21,93,114,114,657,114,1,2,2,122,1,730,227748,1,114
2011-03-15,spring,2011,March,17,Tuesday,Workingday,Mist,0.36,0.3485,0.62,0.194,22,195,217,217,657,217,1,3,2,132,1,730,336860,1,217
2011-03-15,spring,2011,March,18,Tuesday,Workingday,Mist,0.36,0.3333,0.62,0.2985,18,207,225,225,657,225,1,3,1,131,1,728,309772,1,225
2011-03-15,spring,2011,March,19,Tuesday,Workingday,Mist,0.34,0.3182,0.71,0.2836,14,138,152,152,657,152,1,3,1,131,1,728,226789,1,152
2011-03-15,spring,2011,March,20,Tuesday,Workingday,Mist,0.34,0.3182,0.71,0.2836,9,79,88,88,657,88,1,2,1,121,1,728,164550,1,88
2011-03-15,spring,2011,March,21,Tuesday,Workingday,Light Snow,0.32,0.3333,0.81,0.1045,2,53,55,55,657,55,1,2,1,121,1,728,125445,1,55
2011-03-15,spring,2011,March,22,Tuesday,Workingday,Mist,0.32,0.3182,0.87,0.1642,1,20,21,21,657,21,1,1,1,111,1,728,95612,1,21
2011-03-15,spring,2011,March,23,Tuesday,Workingday,Mist,0.32,0.3182,0.87,0.1642,1,17,18,18,657,18,1,1,1,111,1,728,63941,1,18
2011-03-16,spring,2011,March,0,Wednesday,Workingday,Light Snow,0.3,0.2879,0.93,0.2537,0,8,8,8,656,8,1,1,1,111,1,726,39130,1,8
2011-03-16,spring,2011,March,1,Wednesday,Workingday,Light Snow,0.3,0.2727,1.0,0.2985,1,2,3,3,656,3,1,1,1,111,1,724,24164,1,3
2011-03-16,spring,2011,March,3,Wednesday,Workingday,Mist,0.28,0.2727,1.0,0.2239,1,2,3,3,656,3,1,1,1,111,1,697,8174,1,3
2011-03-16,spring,2011,March,4,Wednesday,Workingday,Mist,0.3,0.303,0.93,0.1642,0,1,1,1,656,1,1,1,1,111,1,697,4428,1,1
2011-03-16,spring,2011,March,5,Wednesday,Workingday,Mist,0.3,0.3182,0.93,0.1045,0,3,3,3,656,3,1,1,1,111,1,717,14261,1,3
2011-03-16,spring,2011,March,6,Wednesday,Workingday,Mist,0.3,0.3182,0.93,0.1045,1,30,31,31,656,31,1,1,1,111,1,725,55132,1,31
2011-03-16,spring,2011,March,7,Wednesday,Workingday,Mist,0.3,0.2879,0.93,0.194,10,101,111,111,656,111,1,2,1,121,1,727,154171,1,111
2011-03-16,spring,2011,March,8,Wednesday,Workingday,Mist,0.32,0.3182,0.93,0.0,26,227,253,253,656,253,1,3,1,131,0,727,261001,1,253
2011-03-16,spring,2011,March,9,Wednesday,Workingday,Mist,0.32,0.3333,0.93,0.1343,10,144,154,154,656,154,1,3,1,131,0,727,159438,1,154
2011-03-16,spring,2011,March,10,Wednesday,Workingday,Mist,0.36,0.3485,0.81,0.1642,19,49,68,68,656,68,1,2,2,122,1,727,126257,1,68
2011-03-16,spring,2011,March,11,Wednesday,Workingday,Mist,0.36,0.3485,0.81,0.1343,13,62,75,75,656,75,1,2,2,122,1,727,151320,1,75
2011-03-16,spring,2011,March,12,Wednesday,Workingday,Mist,0.4,0.4091,0.71,0.1045,23,65,88,88,656,88,1,2,2,122,0,728,184414,1,88
2011-03-16,spring,2011,March,13,Wednesday,Workingday,Mist,0.4,0.4091,0.76,0.1343,18,81,99,99,656,99,1,2,2,122,0,729,184919,1,99
2011-03-16,spring,2011,March,14,Wednesday,Workingday,Mist,0.4,0.4091,0.76,0.2239,33,67,100,100,656,100,1,2,2,122,1,729,175652,1,100
2011-03-16,spring,2011,March,15,Wednesday,Workingday,Mist,0.4,0.4091,0.76,0.2537,22,79,101,101,656,101,1,2,2,122,1,729,183149,1,101
2011-03-16,spring,2011,March,16,Wednesday,Workingday,Mist,0.4,0.4091,0.76,0.1642,30,121,151,151,656,151,1,3,2,132,0,730,227748,1,151
2011-03-16,spring,2011,March,17,Wednesday,Workingday,Mist,0.44,0.4394,0.54,0.2985,37,216,253,253,656,253,1,3,2,132,1,730,336860,1,253
2011-03-16,spring,2011,March,18,Wednesday,Workingday,Mist,0.44,0.4394,0.54,0.2239,26,211,237,237,656,237,1,3,2,132,1,728,309772,1,237
2011-03-16,spring,2011,March,19,Wednesday,Workingday,Mist,0.44,0.4394,0.51,0.3284,18,150,168,168,656,168,1,3,2,132,1,728,226789,1,168
2011-03-16,spring,2011,March,20,Wednesday,Workingday,Mist,0.42,0.4242,0.54,0.2985,10,111,121,121,656,121,1,2,2,122,1,728,164550,1,121
2011-03-16,spring,2011,March,21,Wednesday,Workingday,Mist,0.42,0.4242,0.58,0.2836,3,75,78,78,656,78,1,2,2,122,1,728,125445,1,78
2011-03-16,spring,2011,March,22,Wednesday,Workingday,Mist,0.4,0.4091,0.62,0.3881,11,48,59,59,656,59,1,2,2,122,1,728,95612,1,59
2011-03-16,spring,2011,March,23,Wednesday,Workingday,Clear,0.4,0.4091,0.65,0.194,9,18,27,27,656,27,1,1,2,112,1,728,63941,1,27
2011-03-17,spring,2011,March,0,Thursday,Workingday,Clear,0.38,0.3939,0.66,0.2537,4,19,23,23,655,23,1,1,2,112,1,726,39130,1,23
2011-03-17,spring,2011,March,1,Thursday,Workingday,Clear,0.36,0.3485,0.71,0.2239,1,11,12,12,655,12,1,1,2,112,1,724,24164,1,12
2011-03-17,spring,2011,March,2,Thursday,Workingday,Clear,0.34,0.303,0.71,0.2985,3,5,8,8,655,8,1,1,1,111,1,715,16352,1,8
2011-03-17,spring,2011,March,3,Thursday,Workingday,Clear,0.34,0.3333,0.66,0.1642,1,1,2,2,655,2,1,1,1,111,1,697,8174,1,2
2011-03-17,spring,2011,March,4,Thursday,Workingday,Clear,0.34,0.3333,0.71,0.194,0,3,3,3,655,3,1,1,1,111,1,697,4428,1,3
2011-03-17,spring,2011,March,5,Thursday,Workingday,Clear,0.32,0.3333,0.76,0.1045,0,13,13,13,655,13,1,1,1,111,1,717,14261,1,13
2011-03-17,spring,2011,March,6,Thursday,Workingday,Clear,0.32,0.3182,0.76,0.194,4,47,51,51,655,51,1,2,1,121,1,725,55132,1,51
2011-03-17,spring,2011,March,7,Thursday,Workingday,Clear,0.32,0.3333,0.76,0.1343,12,128,140,140,655,140,1,2,1,121,1,727,154171,1,140
2011-03-17,spring,2011,March,8,Thursday,Workingday,Clear,0.36,0.3485,0.66,0.1343,17,282,299,299,655,299,1,4,2,142,1,727,261001,1,299
2011-03-17,spring,2011,March,9,Thursday,Workingday,Clear,0.4,0.4091,0.62,0.2537,23,162,185,185,655,185,1,3,2,132,1,727,159438,1,185
2011-03-17,spring,2011,March,10,Thursday,Workingday,Clear,0.44,0.4394,0.54,0.3284,9,69,78,78,655,78,1,2,2,122,1,727,126257,1,78
2011-03-17,spring,2011,March,11,Thursday,Workingday,Clear,0.44,0.4394,0.54,0.2836,20,66,86,86,655,86,1,2,2,122,1,727,151320,1,86
2011-03-17,spring,2011,March,12,Thursday,Workingday,Clear,0.5,0.4848,0.45,0.2239,24,81,105,105,655,105,1,2,2,122,1,728,184414,1,105
2011-03-17,spring,2011,March,13,Thursday,Workingday,Mist,0.52,0.5,0.42,0.0896,26,85,111,111,655,111,1,2,3,123,0,729,184919,1,111
2011-03-17,spring,2011,March,14,Thursday,Workingday,Clear,0.5,0.4848,0.45,0.1045,32,87,119,119,655,119,1,2,2,122,0,729,175652,1,119
2011-03-17,spring,2011,March,15,Thursday,Workingday,Clear,0.52,0.5,0.42,0.2537,30,95,125,125,655,125,1,2,3,123,1,729,183149,1,125
2011-03-17,spring,2011,March,16,Thursday,Workingday,Clear,0.5,0.4848,0.48,0.2836,34,108,142,142,655,142,1,2,2,122,1,730,227748,1,142
2011-03-17,spring,2011,March,17,Thursday,Workingday,Clear,0.5,0.4848,0.42,0.194,48,265,313,313,655,313,1,4,2,142,2,730,336860,1,313
2011-03-17,spring,2011,March,18,Thursday,Workingday,Mist,0.46,0.4545,0.59,0.1642,50,260,310,310,655,310,1,4,2,142,0,728,309772,1,310
2011-03-17,spring,2011,March,19,Thursday,Workingday,Clear,0.44,0.4394,0.58,0.194,18,189,207,207,655,207,1,3,2,132,1,728,226789,1,207
2011-03-17,spring,2011,March,20,Thursday,Workingday,Clear,0.42,0.4242,0.67,0.2239,25,112,137,137,655,137,1,2,2,122,1,728,164550,1,137
2011-03-17,spring,2011,March,21,Thursday,Workingday,Clear,0.42,0.4242,0.62,0.2239,19,119,138,138,655,138,1,2,2,122,1,728,125445,1,138
2011-03-17,spring,2011,March,22,Thursday,Workingday,Clear,0.4,0.4091,0.66,0.2239,17,70,87,87,655,87,1,2,2,122,1,728,95612,1,87
2011-03-17,spring,2011,March,23,Thursday,Workingday,Clear,0.42,0.4242,0.62,0.2836,7,43,50,50,655,50,1,2,2,122,1,728,63941,1,50
2011-03-18,spring,2011,March,0,Friday,Workingday,Clear,0.42,0.4242,0.58,0.2836,5,24,29,29,654,29,1,1,2,112,1,726,39130,1,29
2011-03-18,spring,2011,March,1,Friday,Workingday,Clear,0.4,0.4091,0.62,0.2537,4,12,16,16,654,16,1,1,2,112,1,724,24164,1,16
2011-03-18,spring,2011,March,2,Friday,Workingday,Clear,0.4,0.4091,0.62,0.194,5,9,14,14,654,14,1,1,2,112,1,715,16352,1,14
2011-03-18,spring,2011,March,3,Friday,Workingday,Clear,0.36,0.3485,0.71,0.194,1,4,5,5,654,5,1,1,2,112,1,697,8174,1,5
2011-03-18,spring,2011,March,5,Friday,Workingday,Clear,0.38,0.3939,0.66,0.1642,2,8,10,10,654,10,1,1,2,112,1,717,14261,1,10
2011-03-18,spring,2011,March,6,Friday,Workingday,Clear,0.4,0.4091,0.66,0.194,1,35,36,36,654,36,1,1,2,112,1,725,55132,1,36
2011-03-18,spring,2011,March,7,Friday,Workingday,Clear,0.4,0.4091,0.66,0.194,11,112,123,123,654,123,1,2,2,122,1,727,154171,1,123
2011-03-18,spring,2011,March,8,Friday,Workingday,Clear,0.42,0.4242,0.67,0.2537,24,256,280,280,654,280,1,3,2,132,1,727,261001,1,280
2011-03-18,spring,2011,March,9,Friday,Workingday,Clear,0.46,0.4545,0.63,0.2239,18,192,210,210,654,210,1,3,2,132,0,727,159438,1,210
2011-03-18,spring,2011,March,10,Friday,Workingday,Clear,0.52,0.5,0.53,0.2836,43,74,117,117,654,117,1,2,3,123,0,727,126257,1,117
2011-03-18,spring,2011,March,11,Friday,Workingday,Clear,0.54,0.5152,0.52,0.2836,55,104,159,159,654,159,1,3,3,133,2,727,151320,1,159
2011-03-18,spring,2011,March,12,Friday,Workingday,Mist,0.56,0.5303,0.49,0.3582,72,123,195,195,654,195,1,3,3,133,2,728,184414,1,195
2011-03-18,spring,2011,March,13,Friday,Workingday,Clear,0.64,0.6212,0.41,0.2836,57,118,175,175,654,175,1,3,3,133,2,729,184919,1,175
2011-03-18,spring,2011,March,14,Friday,Workingday,Clear,0.66,0.6212,0.39,0.2537,71,103,174,174,654,174,1,3,3,133,2,729,175652,1,174
2011-03-18,spring,2011,March,15,Friday,Workingday,Mist,0.68,0.6364,0.39,0.3582,62,111,173,173,654,173,1,3,4,134,2,729,183149,1,173
2011-03-18,spring,2011,March,16,Friday,Workingday,Clear,0.68,0.6364,0.39,0.2836,67,137,204,204,654,204,1,3,4,134,2,730,227748,1,204
2011-03-18,spring,2011,March,17,Friday,Workingday,Clear,0.7,0.6364,0.37,0.3284,95,237,332,332,654,332,1,4,4,144,2,730,336860,1,332
2011-03-18,spring,2011,March,18,Friday,Workingday,Clear,0.68,0.6364,0.39,0.1642,84,247,331,331,654,331,1,4,4,144,2,728,309772,1,331
2011-03-18,spring,2011,March,19,Friday,Workingday,Clear,0.66,0.6212,0.44,0.1343,58,132,190,190,654,190,1,3,3,133,2,728,226789,1,190
2011-03-18,spring,2011,March,20,Friday,Workingday,Clear,0.62,0.6212,0.46,0.1343,46,103,149,149,654,149,1,3,3,133,2,728,164550,1,149
2011-03-18,spring,2011,March,21,Friday,Workingday,Clear,0.62,0.6212,0.46,0.1045,22,91,113,113,654,113,1,2,3,123,0,728,125445,1,113
2011-03-18,spring,2011,March,22,Friday,Workingday,Clear,0.62,0.6212,0.5,0.1642,55,63,118,118,654,118,1,2,3,123,0,728,95612,1,118
2011-03-18,spring,2011,March,23,Friday,Workingday,Mist,0.6,0.6212,0.53,0.2239,26,60,86,86,654,86,1,2,3,123,0,728,63941,1,86
2011-03-19,spring,2011,March,0,Saturday,Holiday,Mist,0.6,0.6212,0.53,0.2537,26,50,76,76,653,76,1,2,3,123,0,726,39130,1,76
2011-03-19,spring,2011,March,1,Saturday,Holiday,Mist,0.58,0.5455,0.46,0.3582,16,35,51,51,653,51,1,2,3,123,0,724,24164,1,51
2011-03-19,spring,2011,March,2,Saturday,Holiday,Mist,0.56,0.5303,0.43,0.2239,5,20,25,25,653,25,1,1,3,113,0,715,16352,1,25
2011-03-19,spring,2011,March,3,Saturday,Holiday,Mist,0.54,0.5152,0.39,0.3284,1,7,8,8,653,8,1,1,3,113,1,697,8174,1,8
2011-03-19,spring,2011,March,4,Saturday,Holiday,Clear,0.52,0.5,0.34,0.4179,1,2,3,3,653,3,1,1,3,113,1,697,4428,1,3
2011-03-19,spring,2011,March,5,Saturday,Holiday,Clear,0.52,0.5,0.34,0.4179,0,2,2,2,653,2,1,1,3,113,1,717,14261,1,2
2011-03-19,spring,2011,March,6,Saturday,Holiday,Clear,0.44,0.4394,0.44,0.4179,0,10,10,10,653,10,1,1,2,112,1,725,55132,1,10
2011-03-19,spring,2011,March,7,Saturday,Holiday,Clear,0.4,0.4091,0.5,0.3284,4,9,13,13,653,13,1,1,2,112,1,727,154171,1,13
2011-03-19,spring,2011,March,8,Saturday,Holiday,Clear,0.42,0.4242,0.47,0.4925,11,37,48,48,653,48,1,2,2,122,1,727,261001,1,48
2011-03-19,spring,2011,March,9,Saturday,Holiday,Clear,0.42,0.4242,0.44,0.4627,35,41,76,76,653,76,1,2,2,122,1,727,159438,1,76
2011-03-19,spring,2011,March,10,Saturday,Holiday,Clear,0.44,0.4394,0.38,0.4179,55,85,140,140,653,140,1,2,2,122,1,727,126257,1,140
2011-03-19,spring,2011,March,11,Saturday,Holiday,Clear,0.46,0.4545,0.36,0.4478,90,106,196,196,653,196,1,3,2,132,2,727,151320,1,196
2011-03-19,spring,2011,March,12,Saturday,Holiday,Clear,0.46,0.4545,0.33,0.4179,126,141,267,267,653,267,1,3,2,132,2,728,184414,1,267
2011-03-19,spring,2011,March,13,Saturday,Holiday,Clear,0.5,0.4848,0.34,0.4627,174,127,301,301,653,301,1,4,2,142,2,729,184919,1,301
2011-03-19,spring,2011,March,14,Saturday,Holiday,Clear,0.5,0.4848,0.31,0.4925,168,144,312,312,653,312,1,4,2,142,2,729,175652,1,312
2011-03-19,spring,2011,March,15,Saturday,Holiday,Clear,0.5,0.4848,0.29,0.4179,170,143,313,313,653,313,1,4,2,142,2,729,183149,1,313
2011-03-19,spring,2011,March,16,Saturday,Holiday,Clear,0.5,0.4848,0.31,0.3881,175,129,304,304,653,304,1,4,2,142,2,730,227748,1,304
2011-03-19,spring,2011,March,17,Saturday,Holiday,Clear,0.48,0.4697,0.31,0.3284,138,140,278,278,653,278,1,3,2,132,2,730,336860,1,278
2011-03-19,spring,2011,March,18,Saturday,Holiday,Clear,0.46,0.4545,0.31,0.3284,92,125,217,217,653,217,1,3,2,132,2,728,309772,1,217
2011-03-19,spring,2011,March,19,Saturday,Holiday,Clear,0.44,0.4394,0.33,0.2836,38,116,154,154,653,154,1,3,2,132,1,728,226789,1,154
2011-03-19,spring,2011,March,20,Saturday,Holiday,Clear,0.42,0.4242,0.35,0.2239,39,69,108,108,653,108,1,2,2,122,1,728,164550,1,108
2011-03-19,spring,2011,March,21,Saturday,Holiday,Clear,0.4,0.4091,0.37,0.2985,20,73,93,93,653,93,1,2,2,122,1,728,125445,1,93
2011-03-19,spring,2011,March,22,Saturday,Holiday,Clear,0.4,0.4091,0.37,0.3284,27,45,72,72,653,72,1,2,2,122,1,728,95612,1,72
2011-03-19,spring,2011,March,23,Saturday,Holiday,Clear,0.38,0.3939,0.4,0.2985,13,37,50,50,653,50,1,2,2,122,1,728,63941,1,50
2011-03-20,spring,2011,March,0,Sunday,Holiday,Clear,0.34,0.303,0.49,0.4179,7,33,40,40,652,40,1,1,1,111,1,726,39130,1,40
2011-03-20,spring,2011,March,1,Sunday,Holiday,Clear,0.32,0.2879,0.53,0.3582,2,22,24,24,652,24,1,1,1,111,1,724,24164,1,24
2011-03-20,spring,2011,March,2,Sunday,Holiday,Clear,0.3,0.2879,0.52,0.2836,6,24,30,30,652,30,1,1,1,111,1,715,16352,1,30
2011-03-20,spring,2011,March,3,Sunday,Holiday,Clear,0.28,0.2727,0.56,0.2537,1,11,12,12,652,12,1,1,1,111,1,697,8174,1,12
2011-03-20,spring,2011,March,4,Sunday,Holiday,Clear,0.26,0.2576,0.56,0.2239,2,1,3,3,652,3,1,1,1,111,1,697,4428,1,3
2011-03-20,spring,2011,March,5,Sunday,Holiday,Clear,0.26,0.2576,0.6,0.194,3,6,9,9,652,9,1,1,1,111,1,717,14261,1,9
2011-03-20,spring,2011,March,6,Sunday,Holiday,Clear,0.26,0.2576,0.6,0.2239,1,3,4,4,652,4,1,1,1,111,1,725,55132,1,4
2011-03-20,spring,2011,March,7,Sunday,Holiday,Clear,0.24,0.2273,0.6,0.2239,5,9,14,14,652,14,1,1,1,111,1,727,154171,1,14
2011-03-20,spring,2011,March,8,Sunday,Holiday,Clear,0.28,0.2727,0.56,0.1642,7,30,37,37,652,37,1,1,1,111,1,727,261001,1,37
2011-03-20,spring,2011,March,9,Sunday,Holiday,Clear,0.3,0.303,0.52,0.1343,35,43,78,78,652,78,1,2,1,121,1,727,159438,1,78
2011-03-20,spring,2011,March,10,Sunday,Holiday,Mist,0.32,0.3485,0.45,0.0,55,81,136,136,652,136,1,2,2,122,1,727,126257,1,136
2011-03-20,spring,2011,March,11,Sunday,Holiday,Clear,0.34,0.3485,0.39,0.1045,92,111,203,203,652,203,1,3,2,132,1,727,151320,1,203
2011-03-20,spring,2011,March,12,Sunday,Holiday,Clear,0.36,0.3636,0.4,0.1045,120,108,228,228,652,228,1,3,2,132,1,728,184414,1,228
2011-03-20,spring,2011,March,13,Sunday,Holiday,Clear,0.38,0.3939,0.34,0.0,88,115,203,203,652,203,1,3,2,132,1,729,184919,1,203
2011-03-20,spring,2011,March,14,Sunday,Holiday,Clear,0.4,0.4091,0.3,0.0,145,134,279,279,652,279,1,3,2,132,2,729,175652,1,279
2011-03-20,spring,2011,March,15,Sunday,Holiday,Clear,0.4,0.4091,0.32,0.0896,172,136,308,308,652,308,1,4,2,142,2,729,183149,1,308
2011-03-20,spring,2011,March,16,Sunday,Holiday,Clear,0.42,0.4242,0.32,0.0,92,132,224,224,652,224,1,3,2,132,1,730,227748,1,224
2011-03-20,spring,2011,March,17,Sunday,Holiday,Clear,0.4,0.4091,0.35,0.2836,83,143,226,226,652,226,1,3,2,132,1,730,336860,1,226
2011-03-20,spring,2011,March,18,Sunday,Holiday,Clear,0.38,0.3939,0.4,0.3582,58,98,156,156,652,156,1,3,2,132,1,728,309772,1,156
2011-03-20,spring,2011,March,19,Sunday,Holiday,Clear,0.36,0.3333,0.43,0.2836,21,58,79,79,652,79,1,2,1,121,1,728,226789,1,79
2011-03-20,spring,2011,March,20,Sunday,Holiday,Clear,0.36,0.3333,0.46,0.2836,21,46,67,67,652,67,1,2,1,121,1,728,164550,1,67
2011-03-20,spring,2011,March,21,Sunday,Holiday,Mist,0.34,0.3182,0.53,0.2836,10,39,49,49,652,49,1,2,1,121,1,728,125445,1,49
2011-03-20,spring,2011,March,22,Sunday,Holiday,Mist,0.34,0.303,0.53,0.3284,8,30,38,38,652,38,1,1,1,111,1,728,95612,1,38
2011-03-20,spring,2011,March,23,Sunday,Holiday,Light Snow,0.34,0.303,0.61,0.3881,13,11,24,24,652,24,1,1,1,111,1,728,63941,1,24
2011-03-21,summer,2011,March,0,Monday,Workingday,Light Snow,0.34,0.303,0.66,0.3881,2,11,13,13,651,13,1,1,1,111,1,726,39130,1,13
2011-03-21,summer,2011,March,1,Monday,Workingday,Mist,0.34,0.303,0.71,0.3881,1,6,7,7,651,7,1,1,1,111,1,724,24164,1,7
2011-03-21,summer,2011,March,2,Monday,Workingday,Mist,0.34,0.303,0.71,0.3284,1,5,6,6,651,6,1,1,1,111,1,715,16352,1,6
2011-03-21,summer,2011,March,3,Monday,Workingday,Mist,0.34,0.303,0.71,0.3284,0,1,1,1,651,1,1,1,1,111,1,697,8174,1,1
2011-03-21,summer,2011,March,5,Monday,Workingday,Clear,0.32,0.303,0.81,0.2985,1,1,2,2,651,2,1,1,1,111,1,717,14261,1,2
2011-03-21,summer,2011,March,6,Monday,Workingday,Light Snow,0.32,0.303,0.76,0.2537,2,30,32,32,651,32,1,1,1,111,1,725,55132,1,32
2011-03-21,summer,2011,March,7,Monday,Workingday,Light Snow,0.3,0.2727,0.87,0.4179,3,15,18,18,651,18,1,1,1,111,1,727,154171,1,18
2011-03-21,summer,2011,March,8,Monday,Workingday,Mist,0.3,0.2727,0.87,0.4179,3,95,98,98,651,98,1,2,1,121,1,727,261001,1,98
2011-03-21,summer,2011,March,9,Monday,Workingday,Mist,0.34,0.303,0.81,0.3284,12,115,127,127,651,127,1,2,1,121,1,727,159438,1,127
2011-03-21,summer,2011,March,10,Monday,Workingday,Mist,0.38,0.3939,0.76,0.3881,17,45,62,62,651,62,1,2,2,122,1,727,126257,1,62
2011-03-21,summer,2011,March,11,Monday,Workingday,Mist,0.42,0.4242,0.71,0.2985,32,47,79,79,651,79,1,2,2,122,1,727,151320,1,79
2011-03-21,summer,2011,March,12,Monday,Workingday,Mist,0.44,0.4394,0.77,0.2537,25,56,81,81,651,81,1,2,2,122,0,728,184414,1,81
2011-03-21,summer,2011,March,13,Monday,Workingday,Mist,0.5,0.4848,0.63,0.2239,35,77,112,112,651,112,1,2,2,122,0,729,184919,1,112
2011-03-21,summer,2011,March,14,Monday,Workingday,Mist,0.54,0.5152,0.64,0.2239,36,65,101,101,651,101,1,2,3,123,0,729,175652,1,101
2011-03-21,summer,2011,March,15,Monday,Workingday,Mist,0.56,0.5303,0.6,0.2239,41,66,107,107,651,107,1,2,3,123,0,729,183149,1,107
2011-03-21,summer,2011,March,16,Monday,Workingday,Mist,0.54,0.5152,0.64,0.2836,29,112,141,141,651,141,1,2,3,123,0,730,227748,1,141
2011-03-21,summer,2011,March,17,Monday,Workingday,Mist,0.54,0.5152,0.64,0.2537,41,231,272,272,651,272,1,3,3,133,0,730,336860,1,272
2011-03-21,summer,2011,March,18,Monday,Workingday,Mist,0.52,0.5,0.72,0.2239,44,232,276,276,651,276,1,3,3,133,0,728,309772,1,276
2011-03-21,summer,2011,March,19,Monday,Workingday,Clear,0.58,0.5455,0.6,0.4179,22,199,221,221,651,221,1,3,3,133,2,728,226789,1,221
2011-03-21,summer,2011,March,20,Monday,Workingday,Clear,0.56,0.5303,0.64,0.194,16,106,122,122,651,122,1,2,3,123,0,728,164550,1,122
2011-03-21,summer,2011,March,21,Monday,Workingday,Clear,0.46,0.4545,0.94,0.194,12,79,91,91,651,91,1,2,2,122,0,728,125445,1,91
2011-03-21,summer,2011,March,22,Monday,Workingday,Clear,0.46,0.4545,0.88,0.2239,18,60,78,78,651,78,1,2,2,122,0,728,95612,1,78
2011-03-21,summer,2011,March,23,Monday,Workingday,Clear,0.46,0.4545,0.88,0.0896,8,22,30,30,651,30,1,1,2,112,0,728,63941,1,30
2011-03-22,summer,2011,March,0,Tuesday,Workingday,Clear,0.46,0.4545,0.88,0.194,4,7,11,11,650,11,1,1,2,112,0,726,39130,1,11
2011-03-22,summer,2011,March,1,Tuesday,Workingday,Clear,0.42,0.4242,1.0,0.1343,6,13,19,19,650,19,1,1,2,112,0,724,24164,1,19
2011-03-22,summer,2011,March,2,Tuesday,Workingday,Clear,0.44,0.4394,0.94,0.0896,0,1,1,1,650,1,1,1,2,112,0,715,16352,1,1
2011-03-22,summer,2011,March,3,Tuesday,Workingday,Clear,0.44,0.4394,0.82,0.2239,3,2,5,5,650,5,1,1,2,112,0,697,8174,1,5
2011-03-22,summer,2011,March,4,Tuesday,Workingday,Mist,0.42,0.4242,0.82,0.1642,0,1,1,1,650,1,1,1,2,112,0,697,4428,1,1
2011-03-22,summer,2011,March,5,Tuesday,Workingday,Mist,0.4,0.4091,0.87,0.1343,1,11,12,12,650,12,1,1,2,112,0,717,14261,1,12
2011-03-22,summer,2011,March,6,Tuesday,Workingday,Clear,0.4,0.4091,0.87,0.2537,2,58,60,60,650,60,1,2,2,122,0,725,55132,1,60
2011-03-22,summer,2011,March,7,Tuesday,Workingday,Mist,0.4,0.4091,0.76,0.1045,4,132,136,136,650,136,1,2,2,122,0,727,154171,1,136
2011-03-22,summer,2011,March,8,Tuesday,Workingday,Mist,0.4,0.4091,0.58,0.2985,24,312,336,336,650,336,1,4,2,142,1,727,261001,1,336
2011-03-22,summer,2011,March,9,Tuesday,Workingday,Mist,0.4,0.4091,0.58,0.4627,19,159,178,178,650,178,1,3,2,132,1,727,159438,1,178
2011-03-22,summer,2011,March,10,Tuesday,Workingday,Mist,0.44,0.4394,0.54,0.2985,29,95,124,124,650,124,1,2,2,122,1,727,126257,1,124
2011-03-22,summer,2011,March,11,Tuesday,Workingday,Clear,0.44,0.4394,0.51,0.3284,22,64,86,86,650,86,1,2,2,122,1,727,151320,1,86
2011-03-22,summer,2011,March,12,Tuesday,Workingday,Clear,0.46,0.4545,0.47,0.2537,35,86,121,121,650,121,1,2,2,122,1,728,184414,1,121
2011-03-22,summer,2011,March,13,Tuesday,Workingday,Clear,0.5,0.4848,0.45,0.2239,21,85,106,106,650,106,1,2,2,122,1,729,184919,1,106
2011-03-22,summer,2011,March,14,Tuesday,Workingday,Clear,0.5,0.4848,0.42,0.3284,30,71,101,101,650,101,1,2,2,122,1,729,175652,1,101
2011-03-22,summer,2011,March,15,Tuesday,Workingday,Clear,0.5,0.4848,0.42,0.2239,55,79,134,134,650,134,1,2,2,122,1,729,183149,1,134
2011-03-22,summer,2011,March,16,Tuesday,Workingday,Clear,0.5,0.4848,0.42,0.1045,40,125,165,165,650,165,1,3,2,132,0,730,227748,1,165
2011-03-22,summer,2011,March,17,Tuesday,Workingday,Clear,0.5,0.4848,0.42,0.1045,42,265,307,307,650,307,1,4,2,142,2,730,336860,1,307
2011-03-22,summer,2011,March,18,Tuesday,Workingday,Clear,0.48,0.4697,0.44,0.0896,41,271,312,312,650,312,1,4,2,142,2,728,309772,1,312
2011-03-22,summer,2011,March,19,Tuesday,Workingday,Mist,0.44,0.4394,0.54,0.2537,22,142,164,164,650,164,1,3,2,132,1,728,226789,1,164
2011-03-22,summer,2011,March,20,Tuesday,Workingday,Mist,0.44,0.4394,0.54,0.3582,19,116,135,135,650,135,1,2,2,122,1,728,164550,1,135
2011-03-22,summer,2011,March,21,Tuesday,Workingday,Mist,0.42,0.4242,0.54,0.2836,24,63,87,87,650,87,1,2,2,122,1,728,125445,1,87
2011-03-22,summer,2011,March,22,Tuesday,Workingday,Mist,0.4,0.4091,0.58,0.2537,13,57,70,70,650,70,1,2,2,122,1,728,95612,1,70
2011-03-22,summer,2011,March,23,Tuesday,Workingday,Mist,0.4,0.4091,0.58,0.2537,4,28,32,32,650,32,1,1,2,112,1,728,63941,1,32
2011-03-23,summer,2011,March,0,Wednesday,Workingday,Light Snow,0.36,0.3485,0.71,0.2239,3,8,11,11,649,11,1,1,2,112,1,726,39130,1,11
2011-03-23,summer,2011,March,1,Wednesday,Workingday,Light Snow,0.34,0.3182,0.76,0.2239,0,7,7,7,649,7,1,1,1,111,1,724,24164,1,7
2011-03-23,summer,2011,March,2,Wednesday,Workingday,Light Snow,0.34,0.3182,0.76,0.2239,1,1,2,2,649,2,1,1,1,111,1,715,16352,1,2
2011-03-23,summer,2011,March,3,Wednesday,Workingday,Mist,0.34,0.3182,0.76,0.2537,0,3,3,3,649,3,1,1,1,111,1,697,8174,1,3
2011-03-23,summer,2011,March,5,Wednesday,Workingday,Light Snow,0.32,0.3182,0.87,0.194,0,10,10,10,649,10,1,1,1,111,1,717,14261,1,10
2011-03-23,summer,2011,March,6,Wednesday,Workingday,Mist,0.34,0.3182,0.87,0.2537,1,43,44,44,649,44,1,2,1,121,1,725,55132,1,44
2011-03-23,summer,2011,March,7,Wednesday,Workingday,Mist,0.32,0.303,0.93,0.2239,7,111,118,118,649,118,1,2,1,121,1,727,154171,1,118
2011-03-23,summer,2011,March,8,Wednesday,Workingday,Mist,0.32,0.3182,0.87,0.194,14,247,261,261,649,261,1,3,1,131,1,727,261001,1,261
2011-03-23,summer,2011,March,9,Wednesday,Workingday,Mist,0.32,0.303,0.81,0.2537,8,174,182,182,649,182,1,3,1,131,1,727,159438,1,182
2011-03-23,summer,2011,March,10,Wednesday,Workingday,Mist,0.34,0.3182,0.81,0.2836,15,60,75,75,649,75,1,2,1,121,1,727,126257,1,75
2011-03-23,summer,2011,March,11,Wednesday,Workingday,Mist,0.34,0.3333,0.87,0.194,18,53,71,71,649,71,1,2,1,121,1,727,151320,1,71
2011-03-23,summer,2011,March,12,Wednesday,Workingday,Mist,0.34,0.3182,0.87,0.2239,14,73,87,87,649,87,1,2,1,121,1,728,184414,1,87
2011-03-23,summer,2011,March,13,Wednesday,Workingday,Light Snow,0.34,0.3333,0.87,0.1343,14,94,108,108,649,108,1,2,1,121,1,729,184919,1,108
2011-03-23,summer,2011,March,14,Wednesday,Workingday,Mist,0.36,0.3636,0.87,0.1045,13,71,84,84,649,84,1,2,2,122,0,729,175652,1,84
2011-03-23,summer,2011,March,15,Wednesday,Workingday,Mist,0.38,0.3939,0.82,0.2239,11,74,85,85,649,85,1,2,2,122,1,729,183149,1,85
2011-03-23,summer,2011,March,16,Wednesday,Workingday,Mist,0.4,0.4091,0.76,0.2239,13,123,136,136,649,136,1,2,2,122,1,730,227748,1,136
2011-03-23,summer,2011,March,17,Wednesday,Workingday,Mist,0.4,0.4091,0.76,0.2239,28,245,273,273,649,273,1,3,2,132,1,730,336860,1,273
2011-03-23,summer,2011,March,18,Wednesday,Workingday,Light Snow,0.38,0.3939,0.82,0.2537,20,218,238,238,649,238,1,3,2,132,1,728,309772,1,238
2011-03-23,summer,2011,March,19,Wednesday,Workingday,Light Snow,0.38,0.3939,0.82,0.2537,12,147,159,159,649,159,1,3,2,132,1,728,226789,1,159
2011-03-23,summer,2011,March,20,Wednesday,Workingday,Light Snow,0.36,0.303,0.87,0.6418,3,72,75,75,649,75,1,2,1,121,1,728,164550,1,75
2011-03-23,summer,2011,March,21,Wednesday,Workingday,Light Snow,0.32,0.2879,1.0,0.4179,0,22,22,22,649,22,1,1,1,111,1,728,125445,1,22
2011-03-23,summer,2011,March,22,Wednesday,Workingday,Mist,0.32,0.3182,0.93,0.1642,6,38,44,44,649,44,1,2,1,121,1,728,95612,1,44
2011-03-23,summer,2011,March,23,Wednesday,Workingday,Light Snow,0.32,0.3333,0.9,0.0,2,24,26,26,649,26,1,1,1,111,0,728,63941,1,26
2011-03-24,summer,2011,March,0,Thursday,Workingday,Mist,0.32,0.303,0.93,0.2239,0,11,11,11,648,11,1,1,1,111,1,726,39130,1,11
2011-03-24,summer,2011,March,1,Thursday,Workingday,Mist,0.3,0.2879,1.0,0.2239,0,3,3,3,648,3,1,1,1,111,1,724,24164,1,3
2011-03-24,summer,2011,March,2,Thursday,Workingday,Mist,0.3,0.2879,1.0,0.2537,0,6,6,6,648,6,1,1,1,111,1,715,16352,1,6
2011-03-24,summer,2011,March,3,Thursday,Workingday,Mist,0.28,0.2727,1.0,0.194,1,0,1,1,648,1,1,1,1,111,1,697,8174,1,1
2011-03-24,summer,2011,March,4,Thursday,Workingday,Mist,0.28,0.2727,1.0,0.194,0,1,1,1,648,1,1,1,1,111,1,697,4428,1,1
2011-03-24,summer,2011,March,5,Thursday,Workingday,Mist,0.28,0.2727,0.93,0.2239,1,8,9,9,648,9,1,1,1,111,1,717,14261,1,9
2011-03-24,summer,2011,March,6,Thursday,Workingday,Mist,0.28,0.2727,0.93,0.2239,0,41,41,41,648,41,1,2,1,121,1,725,55132,1,41
2011-03-24,summer,2011,March,7,Thursday,Workingday,Light Snow,0.26,0.2576,1.0,0.2239,2,106,108,108,648,108,1,2,1,121,1,727,154171,1,108
2011-03-24,summer,2011,March,8,Thursday,Workingday,Light Snow,0.26,0.2273,1.0,0.2985,4,120,124,124,648,124,1,2,1,121,1,727,261001,1,124
2011-03-24,summer,2011,March,9,Thursday,Workingday,Mist,0.26,0.2576,0.93,0.2239,3,94,97,97,648,97,1,2,1,121,1,727,159438,1,97
2011-03-24,summer,2011,March,10,Thursday,Workingday,Mist,0.26,0.2273,0.93,0.3284,10,55,65,65,648,65,1,2,1,121,1,727,126257,1,65
2011-03-24,summer,2011,March,11,Thursday,Workingday,Mist,0.3,0.2727,0.81,0.2985,10,61,71,71,648,71,1,2,1,121,1,727,151320,1,71
2011-03-24,summer,2011,March,12,Thursday,Workingday,Mist,0.3,0.2727,0.7,0.3284,12,82,94,94,648,94,1,2,1,121,1,728,184414,1,94
2011-03-24,summer,2011,March,13,Thursday,Workingday,Mist,0.32,0.303,0.7,0.2239,11,90,101,101,648,101,1,2,1,121,1,729,184919,1,101
2011-03-24,summer,2011,March,14,Thursday,Workingday,Mist,0.3,0.303,0.7,0.1343,17,66,83,83,648,83,1,2,1,121,1,729,175652,1,83
2011-03-24,summer,2011,March,15,Thursday,Workingday,Mist,0.3,0.2879,0.7,0.2537,13,77,90,90,648,90,1,2,1,121,1,729,183149,1,90
2011-03-24,summer,2011,March,16,Thursday,Workingday,Mist,0.3,0.2879,0.65,0.2239,6,78,84,84,648,84,1,2,1,121,1,730,227748,1,84
2011-03-24,summer,2011,March,17,Thursday,Workingday,Mist,0.3,0.2879,0.7,0.2239,12,221,233,233,648,233,1,3,1,131,1,730,336860,1,233
2011-03-24,summer,2011,March,18,Thursday,Workingday,Mist,0.3,0.2727,0.61,0.2985,17,197,214,214,648,214,1,3,1,131,1,728,309772,1,214
2011-03-24,summer,2011,March,19,Thursday,Workingday,Clear,0.3,0.2727,0.56,0.3881,16,122,138,138,648,138,1,2,1,121,1,728,226789,1,138
2011-03-24,summer,2011,March,20,Thursday,Workingday,Clear,0.28,0.2576,0.61,0.2836,8,110,118,118,648,118,1,2,1,121,1,728,164550,1,118
2011-03-24,summer,2011,March,21,Thursday,Workingday,Clear,0.26,0.2576,0.65,0.2239,11,67,78,78,648,78,1,2,1,121,1,728,125445,1,78
2011-03-24,summer,2011,March,22,Thursday,Workingday,Clear,0.26,0.2576,0.65,0.1642,3,59,62,62,648,62,1,2,1,121,1,728,95612,1,62
2011-03-24,summer,2011,March,23,Thursday,Workingday,Clear,0.24,0.2273,0.65,0.194,9,24,33,33,648,33,1,1,1,111,1,728,63941,1,33
2011-03-25,summer,2011,March,0,Friday,Workingday,Clear,0.24,0.2273,0.6,0.194,1,17,18,18,647,18,1,1,1,111,1,726,39130,1,18
2011-03-25,summer,2011,March,1,Friday,Workingday,Clear,0.2,0.2121,0.69,0.1642,0,5,5,5,647,5,1,1,1,111,1,724,24164,1,5
2011-03-25,summer,2011,March,2,Friday,Workingday,Clear,0.2,0.197,0.69,0.2239,0,5,5,5,647,5,1,1,1,111,1,715,16352,1,5
2011-03-25,summer,2011,March,3,Friday,Workingday,Clear,0.2,0.2273,0.69,0.1045,0,2,2,2,647,2,1,1,1,111,1,697,8174,1,2
2011-03-25,summer,2011,March,4,Friday,Workingday,Clear,0.18,0.2121,0.74,0.1045,3,2,5,5,647,5,1,1,1,111,1,697,4428,1,5
2011-03-25,summer,2011,March,5,Friday,Workingday,Clear,0.18,0.197,0.74,0.1642,0,9,9,9,647,9,1,1,1,111,1,717,14261,1,9
2011-03-25,summer,2011,March,6,Friday,Workingday,Clear,0.18,0.1818,0.74,0.2239,0,32,32,32,647,32,1,1,1,111,1,725,55132,1,32
2011-03-25,summer,2011,March,7,Friday,Workingday,Clear,0.2,0.1818,0.59,0.3582,4,100,104,104,647,104,1,2,1,121,1,727,154171,1,104
2011-03-25,summer,2011,March,8,Friday,Workingday,Clear,0.22,0.2121,0.51,0.2836,9,228,237,237,647,237,1,3,1,131,1,727,261001,1,237
2011-03-25,summer,2011,March,9,Friday,Workingday,Clear,0.24,0.2121,0.48,0.2985,16,150,166,166,647,166,1,3,1,131,1,727,159438,1,166
2011-03-25,summer,2011,March,10,Friday,Workingday,Clear,0.26,0.2576,0.48,0.0,15,53,68,68,647,68,1,2,1,121,1,727,126257,1,68
2011-03-25,summer,2011,March,11,Friday,Workingday,Clear,0.3,0.2879,0.45,0.2836,17,58,75,75,647,75,1,2,1,121,1,727,151320,1,75
2011-03-25,summer,2011,March,12,Friday,Workingday,Clear,0.32,0.303,0.42,0.2537,37,108,145,145,647,145,1,3,1,131,1,728,184414,1,145
2011-03-25,summer,2011,March,13,Friday,Workingday,Clear,0.32,0.3182,0.39,0.194,34,104,138,138,647,138,1,2,1,121,1,729,184919,1,138
2011-03-25,summer,2011,March,14,Friday,Workingday,Clear,0.36,0.3333,0.32,0.3284,30,103,133,133,647,133,1,2,1,121,1,729,175652,1,133
2011-03-25,summer,2011,March,15,Friday,Workingday,Mist,0.34,0.3182,0.36,0.2537,43,79,122,122,647,122,1,2,1,121,1,729,183149,1,122
2011-03-25,summer,2011,March,16,Friday,Workingday,Mist,0.34,0.303,0.34,0.2985,23,127,150,150,647,150,1,3,1,131,1,730,227748,1,150
2011-03-25,summer,2011,March,17,Friday,Workingday,Mist,0.32,0.2879,0.36,0.3582,23,202,225,225,647,225,1,3,1,131,1,730,336860,1,225
2011-03-25,summer,2011,March,18,Friday,Workingday,Clear,0.3,0.2879,0.39,0.2537,8,190,198,198,647,198,1,3,1,131,1,728,309772,1,198
2011-03-25,summer,2011,March,19,Friday,Workingday,Mist,0.3,0.2879,0.36,0.2836,9,126,135,135,647,135,1,2,1,121,1,728,226789,1,135
2011-03-25,summer,2011,March,20,Friday,Workingday,Mist,0.3,0.303,0.39,0.1343,6,75,81,81,647,81,1,2,1,121,1,728,164550,1,81
2011-03-25,summer,2011,March,21,Friday,Workingday,Mist,0.3,0.303,0.39,0.1642,11,64,75,75,647,75,1,2,1,121,1,728,125445,1,75
2011-03-25,summer,2011,March,22,Friday,Workingday,Mist,0.28,0.2576,0.38,0.3284,3,40,43,43,647,43,1,2,1,121,1,728,95612,1,43
2011-03-25,summer,2011,March,23,Friday,Workingday,Mist,0.26,0.2424,0.38,0.2836,8,31,39,39,647,39,1,1,1,111,1,728,63941,1,39
2011-03-26,summer,2011,March,0,Saturday,Holiday,Mist,0.26,0.2424,0.38,0.2836,3,25,28,28,646,28,1,1,1,111,1,726,39130,1,28
2011-03-26,summer,2011,March,1,Saturday,Holiday,Clear,0.26,0.2273,0.38,0.2985,3,24,27,27,646,27,1,1,1,111,1,724,24164,1,27
2011-03-26,summer,2011,March,2,Saturday,Holiday,Clear,0.22,0.2121,0.44,0.2239,4,21,25,25,646,25,1,1,1,111,1,715,16352,1,25
2011-03-26,summer,2011,March,3,Saturday,Holiday,Clear,0.2,0.197,0.47,0.194,2,7,9,9,646,9,1,1,1,111,1,697,8174,1,9
2011-03-26,summer,2011,March,4,Saturday,Holiday,Clear,0.22,0.2121,0.44,0.2239,2,4,6,6,646,6,1,1,1,111,1,697,4428,1,6
2011-03-26,summer,2011,March,5,Saturday,Holiday,Clear,0.2,0.197,0.51,0.194,0,8,8,8,646,8,1,1,1,111,1,717,14261,1,8
2011-03-26,summer,2011,March,6,Saturday,Holiday,Clear,0.18,0.1818,0.55,0.194,2,8,10,10,646,10,1,1,1,111,1,725,55132,1,10
2011-03-26,summer,2011,March,7,Saturday,Holiday,Clear,0.2,0.197,0.51,0.194,18,23,41,41,646,41,1,2,1,121,1,727,154171,1,41
2011-03-26,summer,2011,March,8,Saturday,Holiday,Clear,0.22,0.2273,0.44,0.1343,24,42,66,66,646,66,1,2,1,121,1,727,261001,1,66
2011-03-26,summer,2011,March,9,Saturday,Holiday,Clear,0.24,0.2424,0.41,0.1343,32,68,100,100,646,100,1,2,1,121,1,727,159438,1,100
2011-03-26,summer,2011,March,10,Saturday,Holiday,Clear,0.26,0.2576,0.41,0.1642,32,93,125,125,646,125,1,2,1,121,1,727,126257,1,125
2011-03-26,summer,2011,March,11,Saturday,Holiday,Clear,0.28,0.2727,0.38,0.1642,75,93,168,168,646,168,1,3,1,131,1,727,151320,1,168
2011-03-26,summer,2011,March,12,Saturday,Holiday,Clear,0.3,0.2879,0.36,0.194,98,129,227,227,646,227,1,3,1,131,1,728,184414,1,227
2011-03-26,summer,2011,March,13,Saturday,Holiday,Clear,0.32,0.303,0.33,0.2239,94,145,239,239,646,239,1,3,1,131,1,729,184919,1,239
2011-03-26,summer,2011,March,14,Saturday,Holiday,Clear,0.34,0.3182,0.29,0.2239,93,123,216,216,646,216,1,3,1,131,1,729,175652,1,216
2011-03-26,summer,2011,March,15,Saturday,Holiday,Clear,0.34,0.3333,0.29,0.194,110,109,219,219,646,219,1,3,1,131,1,729,183149,1,219
2011-03-26,summer,2011,March,16,Saturday,Holiday,Clear,0.34,0.3333,0.23,0.194,118,130,248,248,646,248,1,3,1,131,1,730,227748,1,248
2011-03-26,summer,2011,March,17,Saturday,Holiday,Clear,0.32,0.303,0.24,0.2239,102,101,203,203,646,203,1,3,1,131,1,730,336860,1,203
2011-03-26,summer,2011,March,18,Saturday,Holiday,Mist,0.32,0.3182,0.21,0.1642,64,89,153,153,646,153,1,3,1,131,1,728,309772,1,153
2011-03-26,summer,2011,March,19,Saturday,Holiday,Mist,0.28,0.2727,0.45,0.2537,45,93,138,138,646,138,1,2,1,121,1,728,226789,1,138
2011-03-26,summer,2011,March,20,Saturday,Holiday,Mist,0.28,0.2727,0.45,0.2537,18,67,85,85,646,85,1,2,1,121,1,728,164550,1,85
2011-03-26,summer,2011,March,21,Saturday,Holiday,Mist,0.26,0.2576,0.44,0.194,15,36,51,51,646,51,1,2,1,121,1,728,125445,1,51
2011-03-26,summer,2011,March,22,Saturday,Holiday,Mist,0.28,0.2727,0.41,0.2239,17,46,63,63,646,63,1,2,1,121,1,728,95612,1,63
2011-03-26,summer,2011,March,23,Saturday,Holiday,Mist,0.26,0.2424,0.44,0.2836,10,31,41,41,646,41,1,2,1,121,1,728,63941,1,41
2011-03-27,summer,2011,March,0,Sunday,Holiday,Mist,0.26,0.2576,0.41,0.1642,5,26,31,31,645,31,1,1,1,111,1,726,39130,1,31
2011-03-27,summer,2011,March,1,Sunday,Holiday,Mist,0.24,0.2273,0.52,0.194,3,17,20,20,645,20,1,1,1,111,1,724,24164,1,20
2011-03-27,summer,2011,March,2,Sunday,Holiday,Light Snow,0.22,0.2273,0.55,0.194,6,15,21,21,645,21,1,1,1,111,1,715,16352,1,21
2011-03-27,summer,2011,March,3,Sunday,Holiday,Light Snow,0.2,0.197,0.69,0.2239,0,14,14,14,645,14,1,1,1,111,1,697,8174,1,14
2011-03-27,summer,2011,March,4,Sunday,Holiday,Light Snow,0.18,0.197,0.74,0.1642,1,5,6,6,645,6,1,1,1,111,1,697,4428,1,6
2011-03-27,summer,2011,March,6,Sunday,Holiday,Light Snow,0.16,0.1818,0.86,0.1343,0,2,2,2,645,2,1,1,1,111,1,725,55132,1,2
2011-03-27,summer,2011,March,7,Sunday,Holiday,Light Snow,0.16,0.1667,0.86,0.1642,0,7,7,7,645,7,1,1,1,111,1,727,154171,1,7
2011-03-27,summer,2011,March,8,Sunday,Holiday,Clear,0.2,0.197,0.69,0.2239,6,8,14,14,645,14,1,1,1,111,1,727,261001,1,14
2011-03-27,summer,2011,March,9,Sunday,Holiday,Clear,0.22,0.2273,0.55,0.1343,17,37,54,54,645,54,1,2,1,121,1,727,159438,1,54
2011-03-27,summer,2011,March,10,Sunday,Holiday,Mist,0.22,0.2121,0.55,0.2239,27,59,86,86,645,86,1,2,1,121,1,727,126257,1,86
2011-03-27,summer,2011,March,11,Sunday,Holiday,Mist,0.24,0.2424,0.48,0.1642,23,85,108,108,645,108,1,2,1,121,1,727,151320,1,108
2011-03-27,summer,2011,March,12,Sunday,Holiday,Mist,0.26,0.2576,0.44,0.2239,43,120,163,163,645,163,1,3,1,131,1,728,184414,1,163
2011-03-27,summer,2011,March,13,Sunday,Holiday,Clear,0.3,0.2879,0.39,0.2239,47,100,147,147,645,147,1,3,1,131,1,729,184919,1,147
2011-03-27,summer,2011,March,14,Sunday,Holiday,Clear,0.32,0.3182,0.36,0.1642,61,103,164,164,645,164,1,3,1,131,1,729,175652,1,164
2011-03-27,summer,2011,March,15,Sunday,Holiday,Clear,0.32,0.303,0.36,0.2836,61,111,172,172,645,172,1,3,1,131,1,729,183149,1,172
2011-03-27,summer,2011,March,16,Sunday,Holiday,Clear,0.34,0.3333,0.34,0.0,45,98,143,143,645,143,1,3,1,131,1,730,227748,1,143
2011-03-27,summer,2011,March,17,Sunday,Holiday,Clear,0.32,0.303,0.31,0.2537,50,109,159,159,645,159,1,3,1,131,1,730,336860,1,159
2011-03-27,summer,2011,March,18,Sunday,Holiday,Clear,0.3,0.2879,0.33,0.194,32,105,137,137,645,137,1,2,1,121,1,728,309772,1,137
2011-03-27,summer,2011,March,19,Sunday,Holiday,Clear,0.3,0.2879,0.31,0.2239,23,80,103,103,645,103,1,2,1,121,1,728,226789,1,103
2011-03-27,summer,2011,March,20,Sunday,Holiday,Clear,0.28,0.2727,0.36,0.1642,7,50,57,57,645,57,1,2,1,121,1,728,164550,1,57
2011-03-27,summer,2011,March,21,Sunday,Holiday,Clear,0.26,0.2576,0.41,0.1642,7,29,36,36,645,36,1,1,1,111,1,728,125445,1,36
2011-03-27,summer,2011,March,22,Sunday,Holiday,Clear,0.26,0.2576,0.41,0.1642,5,25,30,30,645,30,1,1,1,111,1,728,95612,1,30
2011-03-27,summer,2011,March,23,Sunday,Holiday,Clear,0.26,0.2576,0.44,0.194,3,16,19,19,645,19,1,1,1,111,1,728,63941,1,19
2011-03-28,summer,2011,March,0,Monday,Workingday,Clear,0.22,0.2273,0.55,0.194,1,11,12,12,644,12,1,1,1,111,1,726,39130,1,12
2011-03-28,summer,2011,March,1,Monday,Workingday,Clear,0.22,0.2273,0.44,0.194,2,4,6,6,644,6,1,1,1,111,1,724,24164,1,6
2011-03-28,summer,2011,March,2,Monday,Workingday,Clear,0.22,0.2273,0.44,0.1642,0,5,5,5,644,5,1,1,1,111,1,715,16352,1,5
2011-03-28,summer,2011,March,3,Monday,Workingday,Clear,0.22,0.2273,0.44,0.1642,0,2,2,2,644,2,1,1,1,111,1,697,8174,1,2
2011-03-28,summer,2011,March,5,Monday,Workingday,Clear,0.18,0.1818,0.43,0.194,0,8,8,8,644,8,1,1,1,111,1,717,14261,1,8
2011-03-28,summer,2011,March,6,Monday,Workingday,Clear,0.18,0.1667,0.34,0.2836,0,40,40,40,644,40,1,1,1,111,1,725,55132,1,40
2011-03-28,summer,2011,March,7,Monday,Workingday,Clear,0.2,0.1818,0.32,0.3284,6,104,110,110,644,110,1,2,1,121,1,727,154171,1,110
2011-03-28,summer,2011,March,8,Monday,Workingday,Clear,0.2,0.197,0.34,0.2239,15,239,254,254,644,254,1,3,1,131,1,727,261001,1,254
2011-03-28,summer,2011,March,9,Monday,Workingday,Mist,0.22,0.2121,0.32,0.2239,12,109,121,121,644,121,1,2,1,121,1,727,159438,1,121
2011-03-28,summer,2011,March,10,Monday,Workingday,Clear,0.24,0.2273,0.3,0.194,22,47,69,69,644,69,1,2,1,121,1,727,126257,1,69
2011-03-28,summer,2011,March,11,Monday,Workingday,Mist,0.26,0.2424,0.3,0.2836,18,39,57,57,644,57,1,2,1,121,1,727,151320,1,57
2011-03-28,summer,2011,March,12,Monday,Workingday,Mist,0.26,0.2727,0.25,0.0,8,71,79,79,644,79,1,2,1,121,1,728,184414,1,79
2011-03-28,summer,2011,March,13,Monday,Workingday,Mist,0.3,0.2879,0.24,0.2239,14,69,83,83,644,83,1,2,1,121,1,729,184919,1,83
2011-03-28,summer,2011,March,14,Monday,Workingday,Clear,0.32,0.303,0.22,0.2239,15,65,80,80,644,80,1,2,1,121,1,729,175652,1,80
2011-03-28,summer,2011,March,15,Monday,Workingday,Clear,0.32,0.303,0.24,0.2836,19,53,72,72,644,72,1,2,1,121,1,729,183149,1,72
2011-03-28,summer,2011,March,16,Monday,Workingday,Clear,0.34,0.3182,0.23,0.2239,15,117,132,132,644,132,1,2,1,121,1,730,227748,1,132
2011-03-28,summer,2011,March,17,Monday,Workingday,Clear,0.34,0.303,0.23,0.2985,25,227,252,252,644,252,1,3,1,131,1,730,336860,1,252
2011-03-28,summer,2011,March,18,Monday,Workingday,Clear,0.32,0.303,0.21,0.2836,21,220,241,241,644,241,1,3,1,131,1,728,309772,1,241
2011-03-28,summer,2011,March,19,Monday,Workingday,Clear,0.3,0.303,0.22,0.1343,17,156,173,173,644,173,1,3,1,131,1,728,226789,1,173
2011-03-28,summer,2011,March,20,Monday,Workingday,Clear,0.32,0.3333,0.22,0.1045,5,107,112,112,644,112,1,2,1,121,1,728,164550,1,112
2011-03-28,summer,2011,March,21,Monday,Workingday,Clear,0.32,0.3333,0.21,0.1343,6,55,61,61,644,61,1,2,1,121,1,728,125445,1,61
2011-03-28,summer,2011,March,22,Monday,Workingday,Clear,0.3,0.2879,0.22,0.2239,0,40,40,40,644,40,1,1,1,111,1,728,95612,1,40
2011-03-28,summer,2011,March,23,Monday,Workingday,Clear,0.28,0.2576,0.24,0.2985,1,18,19,19,644,19,1,1,1,111,1,728,63941,1,19
2011-03-29,summer,2011,March,0,Tuesday,Workingday,Clear,0.26,0.2273,0.28,0.3284,1,15,16,16,643,16,1,1,1,111,1,726,39130,1,16
2011-03-29,summer,2011,March,1,Tuesday,Workingday,Clear,0.24,0.2121,0.32,0.2985,0,4,4,4,643,4,1,1,1,111,1,724,24164,1,4
2011-03-29,summer,2011,March,2,Tuesday,Workingday,Clear,0.24,0.2121,0.32,0.2985,0,3,3,3,643,3,1,1,1,111,1,715,16352,1,3
2011-03-29,summer,2011,March,3,Tuesday,Workingday,Clear,0.24,0.2121,0.32,0.2985,2,1,3,3,643,3,1,1,1,111,1,697,8174,1,3
2011-03-29,summer,2011,March,4,Tuesday,Workingday,Clear,0.2,0.2121,0.44,0.1642,1,1,2,2,643,2,1,1,1,111,1,697,4428,1,2
2011-03-29,summer,2011,March,5,Tuesday,Workingday,Clear,0.22,0.2121,0.37,0.2537,0,8,8,8,643,8,1,1,1,111,1,717,14261,1,8
2011-03-29,summer,2011,March,6,Tuesday,Workingday,Clear,0.22,0.2121,0.41,0.2985,4,46,50,50,643,50,1,2,1,121,1,725,55132,1,50
2011-03-29,summer,2011,March,7,Tuesday,Workingday,Clear,0.22,0.197,0.41,0.3582,5,128,133,133,643,133,1,2,1,121,1,727,154171,1,133
2011-03-29,summer,2011,March,8,Tuesday,Workingday,Clear,0.24,0.2121,0.35,0.3582,19,268,287,287,643,287,1,4,1,141,1,727,261001,1,287
2011-03-29,summer,2011,March,9,Tuesday,Workingday,Clear,0.28,0.2576,0.28,0.3881,16,156,172,172,643,172,1,3,1,131,1,727,159438,1,172
2011-03-29,summer,2011,March,10,Tuesday,Workingday,Clear,0.3,0.2727,0.24,0.2985,13,46,59,59,643,59,1,2,1,121,1,727,126257,1,59
2011-03-29,summer,2011,March,11,Tuesday,Workingday,Mist,0.34,0.303,0.25,0.3881,18,63,81,81,643,81,1,2,1,121,1,727,151320,1,81
2011-03-29,summer,2011,March,12,Tuesday,Workingday,Clear,0.34,0.3333,0.25,0.1642,29,77,106,106,643,106,1,2,1,121,1,728,184414,1,106
2011-03-29,summer,2011,March,13,Tuesday,Workingday,Clear,0.34,0.303,0.25,0.2985,24,80,104,104,643,104,1,2,1,121,1,729,184919,1,104
2011-03-29,summer,2011,March,14,Tuesday,Workingday,Clear,0.36,0.3333,0.25,0.2537,20,66,86,86,643,86,1,2,1,121,1,729,175652,1,86
2011-03-29,summer,2011,March,15,Tuesday,Workingday,Clear,0.38,0.3939,0.25,0.2239,22,65,87,87,643,87,1,2,2,122,1,729,183149,1,87
2011-03-29,summer,2011,March,16,Tuesday,Workingday,Clear,0.38,0.3939,0.22,0.1642,12,124,136,136,643,136,1,2,2,122,1,730,227748,1,136
2011-03-29,summer,2011,March,17,Tuesday,Workingday,Clear,0.4,0.4091,0.2,0.1343,34,265,299,299,643,299,1,4,2,142,1,730,336860,1,299
2011-03-29,summer,2011,March,18,Tuesday,Workingday,Clear,0.36,0.3636,0.21,0.0896,42,252,294,294,643,294,1,4,2,142,1,728,309772,1,294
2011-03-29,summer,2011,March,19,Tuesday,Workingday,Clear,0.34,0.3333,0.23,0.194,20,170,190,190,643,190,1,3,1,131,1,728,226789,1,190
2011-03-29,summer,2011,March,20,Tuesday,Workingday,Clear,0.36,0.3636,0.21,0.0896,13,119,132,132,643,132,1,2,2,122,1,728,164550,1,132
2011-03-29,summer,2011,March,21,Tuesday,Workingday,Clear,0.34,0.3636,0.42,0.0,8,75,83,83,643,83,1,2,2,122,1,728,125445,1,83
2011-03-29,summer,2011,March,22,Tuesday,Workingday,Clear,0.34,0.3636,0.49,0.0,6,49,55,55,643,55,1,2,2,122,1,728,95612,1,55
2011-03-29,summer,2011,March,23,Tuesday,Workingday,Mist,0.32,0.3333,0.57,0.1045,8,27,35,35,643,35,1,1,1,111,1,728,63941,1,35
2011-03-30,summer,2011,March,0,Wednesday,Workingday,Mist,0.32,0.3485,0.57,0.0,3,8,11,11,642,11,1,1,2,112,1,726,39130,1,11
2011-03-30,summer,2011,March,1,Wednesday,Workingday,Clear,0.32,0.3485,0.39,0.0,1,9,10,10,642,10,1,1,2,112,1,724,24164,1,10
2011-03-30,summer,2011,March,2,Wednesday,Workingday,Mist,0.32,0.3485,0.57,0.0,0,4,4,4,642,4,1,1,2,112,1,715,16352,1,4
2011-03-30,summer,2011,March,3,Wednesday,Workingday,Mist,0.32,0.3485,0.49,0.0,0,4,4,4,642,4,1,1,2,112,1,697,8174,1,4
2011-03-30,summer,2011,March,4,Wednesday,Workingday,Mist,0.32,0.3485,0.57,0.0,1,0,1,1,642,1,1,1,2,112,1,697,4428,1,1
2011-03-30,summer,2011,March,5,Wednesday,Workingday,Mist,0.3,0.2879,0.56,0.194,0,7,7,7,642,7,1,1,1,111,1,717,14261,1,7
2011-03-30,summer,2011,March,6,Wednesday,Workingday,Mist,0.3,0.303,0.49,0.1343,4,44,48,48,642,48,1,2,1,121,1,725,55132,1,48
2011-03-30,summer,2011,March,7,Wednesday,Workingday,Mist,0.32,0.3333,0.45,0.1045,8,128,136,136,642,136,1,2,1,121,1,727,154171,1,136
2011-03-30,summer,2011,March,8,Wednesday,Workingday,Mist,0.32,0.3182,0.49,0.1642,16,247,263,263,642,263,1,3,1,131,1,727,261001,1,263
2011-03-30,summer,2011,March,9,Wednesday,Workingday,Mist,0.32,0.303,0.45,0.2239,7,147,154,154,642,154,1,3,1,131,1,727,159438,1,154
2011-03-30,summer,2011,March,10,Wednesday,Workingday,Mist,0.34,0.3182,0.46,0.2239,13,51,64,64,642,64,1,2,1,121,1,727,126257,1,64
2011-03-30,summer,2011,March,11,Wednesday,Workingday,Mist,0.34,0.3182,0.46,0.2537,26,64,90,90,642,90,1,2,1,121,1,727,151320,1,90
2011-03-30,summer,2011,March,12,Wednesday,Workingday,Mist,0.34,0.3333,0.46,0.1642,15,65,80,80,642,80,1,2,1,121,1,728,184414,1,80
2011-03-30,summer,2011,March,13,Wednesday,Workingday,Mist,0.36,0.3485,0.46,0.2239,14,84,98,98,642,98,1,2,2,122,1,729,184919,1,98
2011-03-30,summer,2011,March,14,Wednesday,Workingday,Mist,0.36,0.3333,0.46,0.2985,16,64,80,80,642,80,1,2,1,121,1,729,175652,1,80
2011-03-30,summer,2011,March,15,Wednesday,Workingday,Light Snow,0.28,0.2576,0.81,0.2985,14,56,70,70,642,70,1,2,1,121,1,729,183149,1,70
2011-03-30,summer,2011,March,16,Wednesday,Workingday,Light Snow,0.28,0.2727,0.87,0.2537,0,36,36,36,642,36,1,1,1,111,1,730,227748,1,36
2011-03-30,summer,2011,March,17,Wednesday,Workingday,Light Snow,0.26,0.2727,0.93,0.1045,11,105,116,116,642,116,1,2,1,121,1,730,336860,1,116
2011-03-30,summer,2011,March,18,Wednesday,Workingday,Mist,0.26,0.2576,0.93,0.2239,6,79,85,85,642,85,1,2,1,121,1,728,309772,1,85
2011-03-30,summer,2011,March,19,Wednesday,Workingday,Mist,0.26,0.2576,0.93,0.2239,5,67,72,72,642,72,1,2,1,121,1,728,226789,1,72
2011-03-30,summer,2011,March,20,Wednesday,Workingday,Light Snow,0.24,0.2121,0.93,0.2985,4,40,44,44,642,44,1,2,1,121,1,728,164550,1,44
2011-03-30,summer,2011,March,21,Wednesday,Workingday,Mist,0.24,0.2273,0.93,0.2537,0,27,27,27,642,27,1,1,1,111,1,728,125445,1,27
2011-03-30,summer,2011,March,22,Wednesday,Workingday,Light Snow,0.24,0.2273,0.93,0.2239,3,21,24,24,642,24,1,1,1,111,1,728,95612,1,24
2011-03-30,summer,2011,March,23,Wednesday,Workingday,Light Snow,0.24,0.2121,0.93,0.2836,1,11,12,12,642,12,1,1,1,111,1,728,63941,1,12
2011-03-31,summer,2011,March,0,Thursday,Workingday,Light Snow,0.24,0.2273,0.93,0.2239,0,3,3,3,641,3,1,1,1,111,1,726,39130,1,3
2011-03-31,summer,2011,March,1,Thursday,Workingday,Light Snow,0.24,0.2273,0.93,0.194,1,4,5,5,641,5,1,1,1,111,1,724,24164,1,5
2011-03-31,summer,2011,March,2,Thursday,Workingday,Light Snow,0.24,0.2273,0.93,0.194,0,5,5,5,641,5,1,1,1,111,1,715,16352,1,5
2011-03-31,summer,2011,March,3,Thursday,Workingday,Light Snow,0.24,0.2273,0.93,0.2239,0,1,1,1,641,1,1,1,1,111,1,697,8174,1,1
2011-03-31,summer,2011,March,4,Thursday,Workingday,Light Snow,0.24,0.2273,0.93,0.2537,0,2,2,2,641,2,1,1,1,111,1,697,4428,1,2
2011-03-31,summer,2011,March,5,Thursday,Workingday,Light Snow,0.24,0.2273,0.93,0.2239,0,8,8,8,641,8,1,1,1,111,1,717,14261,1,8
2011-03-31,summer,2011,March,6,Thursday,Workingday,Light Snow,0.24,0.2121,0.93,0.2985,2,34,36,36,641,36,1,1,1,111,1,725,55132,1,36
2011-03-31,summer,2011,March,7,Thursday,Workingday,Light Snow,0.24,0.2273,0.93,0.2537,5,87,92,92,641,92,1,2,1,121,1,727,154171,1,92
2011-03-31,summer,2011,March,8,Thursday,Workingday,Mist,0.24,0.2273,1.0,0.2537,7,185,192,192,641,192,1,3,1,131,1,727,261001,1,192
2011-03-31,summer,2011,March,9,Thursday,Workingday,Light Snow,0.26,0.2424,0.93,0.2537,6,126,132,132,641,132,1,2,1,121,1,727,159438,1,132
2011-03-31,summer,2011,March,10,Thursday,Workingday,Light Snow,0.26,0.2424,0.93,0.2537,15,54,69,69,641,69,1,2,1,121,1,727,126257,1,69
2011-03-31,summer,2011,March,11,Thursday,Workingday,Light Snow,0.28,0.2727,0.93,0.194,6,52,58,58,641,58,1,2,1,121,1,727,151320,1,58
2011-03-31,summer,2011,March,12,Thursday,Workingday,Light Snow,0.28,0.2727,0.93,0.194,17,73,90,90,641,90,1,2,1,121,1,728,184414,1,90
2011-03-31,summer,2011,March,13,Thursday,Workingday,Light Snow,0.3,0.303,0.87,0.1343,13,55,68,68,641,68,1,2,1,121,1,729,184919,1,68
2011-03-31,summer,2011,March,14,Thursday,Workingday,Light Snow,0.3,0.303,0.87,0.1343,27,49,76,76,641,76,1,2,1,121,1,729,175652,1,76
2011-03-31,summer,2011,March,15,Thursday,Workingday,Light Snow,0.3,0.2727,0.87,0.2985,4,61,65,65,641,65,1,2,1,121,1,729,183149,1,65
2011-03-31,summer,2011,March,16,Thursday,Workingday,Mist,0.3,0.2879,0.87,0.2537,13,72,85,85,641,85,1,2,1,121,1,730,227748,1,85
2011-03-31,summer,2011,March,17,Thursday,Workingday,Mist,0.3,0.2879,0.87,0.2537,15,153,168,168,641,168,1,3,1,131,1,730,336860,1,168
2011-03-31,summer,2011,March,18,Thursday,Workingday,Mist,0.3,0.303,0.87,0.1343,12,165,177,177,641,177,1,3,1,131,1,728,309772,1,177
2011-03-31,summer,2011,March,19,Thursday,Workingday,Mist,0.3,0.303,0.87,0.1343,12,118,130,130,641,130,1,2,1,121,1,728,226789,1,130
2011-03-31,summer,2011,March,20,Thursday,Workingday,Light Snow,0.28,0.2576,0.93,0.2836,6,79,85,85,641,85,1,2,1,121,1,728,164550,1,85
2011-03-31,summer,2011,March,21,Thursday,Workingday,Mist,0.28,0.2727,0.93,0.1642,7,53,60,60,641,60,1,2,1,121,1,728,125445,1,60
2011-03-31,summer,2011,March,22,Thursday,Workingday,Light Snow,0.28,0.2727,0.93,0.2537,7,44,51,51,641,51,1,2,1,121,1,728,95612,1,51
2011-03-31,summer,2011,March,23,Thursday,Workingday,Light Snow,0.26,0.2576,1.0,0.1642,4,23,27,27,641,27,1,1,1,111,1,728,63941,1,27
2011-04-01,summer,2011,April,0,Friday,Workingday,Light Snow,0.26,0.2576,1.0,0.1642,0,6,6,6,640,6,1,1,1,111,1,726,39130,1,6
2011-04-01,summer,2011,April,1,Friday,Workingday,Light Snow,0.26,0.2576,1.0,0.1642,0,4,4,4,640,4,1,1,1,111,1,724,24164,1,4
2011-04-01,summer,2011,April,2,Friday,Workingday,Light Snow,0.26,0.2576,0.93,0.194,0,7,7,7,640,7,1,1,1,111,1,715,16352,1,7
2011-04-01,summer,2011,April,3,Friday,Workingday,Mist,0.24,0.2273,0.93,0.2537,0,4,4,4,640,4,1,1,1,111,1,697,8174,1,4
2011-04-01,summer,2011,April,4,Friday,Workingday,Mist,0.24,0.2273,0.93,0.2537,0,3,3,3,640,3,1,1,1,111,1,697,4428,1,3
2011-04-01,summer,2011,April,5,Friday,Workingday,Light Snow,0.24,0.2273,0.93,0.2239,1,11,12,12,640,12,1,1,1,111,1,717,14261,1,12
2011-04-01,summer,2011,April,6,Friday,Workingday,Light Snow,0.24,0.2273,0.93,0.2239,2,26,28,28,640,28,1,1,1,111,1,725,55132,1,28
2011-04-01,summer,2011,April,7,Friday,Workingday,Light Snow,0.24,0.2424,0.93,0.0,4,91,95,95,640,95,1,2,1,121,1,727,154171,1,95
2011-04-01,summer,2011,April,8,Friday,Workingday,Mist,0.26,0.2424,0.87,0.2537,8,198,206,206,640,206,1,3,1,131,1,727,261001,1,206
2011-04-01,summer,2011,April,9,Friday,Workingday,Clear,0.32,0.2879,0.7,0.3582,11,162,173,173,640,173,1,3,1,131,1,727,159438,1,173
2011-04-01,summer,2011,April,10,Friday,Workingday,Clear,0.32,0.303,0.66,0.2836,12,63,75,75,640,75,1,2,1,121,1,727,126257,1,75
2011-04-01,summer,2011,April,11,Friday,Workingday,Clear,0.32,0.2879,0.61,0.3582,17,72,89,89,640,89,1,2,1,121,1,727,151320,1,89
2011-04-01,summer,2011,April,12,Friday,Workingday,Clear,0.34,0.303,0.53,0.3582,15,80,95,95,640,95,1,2,1,121,1,728,184414,1,95
2011-04-01,summer,2011,April,13,Friday,Workingday,Clear,0.36,0.3333,0.5,0.3582,18,92,110,110,640,110,1,2,1,121,1,729,184919,1,110
2011-04-01,summer,2011,April,14,Friday,Workingday,Mist,0.36,0.3333,0.46,0.3582,26,61,87,87,640,87,1,2,1,121,1,729,175652,1,87
2011-04-01,summer,2011,April,15,Friday,Workingday,Clear,0.34,0.303,0.46,0.4179,30,81,111,111,640,111,1,2,1,121,1,729,183149,1,111
2011-04-01,summer,2011,April,16,Friday,Workingday,Clear,0.34,0.303,0.46,0.4179,42,125,167,167,640,167,1,3,1,131,1,730,227748,1,167
2011-04-01,summer,2011,April,17,Friday,Workingday,Clear,0.34,0.303,0.46,0.3284,36,245,281,281,640,281,1,3,1,131,1,730,336860,1,281
2011-04-01,summer,2011,April,18,Friday,Workingday,Clear,0.34,0.303,0.46,0.3284,36,205,241,241,640,241,1,3,1,131,1,728,309772,1,241
2011-04-01,summer,2011,April,19,Friday,Workingday,Clear,0.34,0.303,0.49,0.3284,16,120,136,136,640,136,1,2,1,121,1,728,226789,1,136
2011-04-01,summer,2011,April,20,Friday,Workingday,Clear,0.32,0.3182,0.53,0.194,2,75,77,77,640,77,1,2,1,121,1,728,164550,1,77
2011-04-01,summer,2011,April,21,Friday,Workingday,Clear,0.32,0.3333,0.53,0.1343,9,84,93,93,640,93,1,2,1,121,1,728,125445,1,93
2011-04-01,summer,2011,April,22,Friday,Workingday,Clear,0.3,0.303,0.56,0.1642,10,64,74,74,640,74,1,2,1,121,1,728,95612,1,74
2011-04-01,summer,2011,April,23,Friday,Workingday,Clear,0.3,0.3182,0.61,0.0896,12,41,53,53,640,53,1,2,1,121,1,728,63941,1,53
2011-04-02,summer,2011,April,0,Saturday,Holiday,Mist,0.3,0.3333,0.61,0.0,3,29,32,32,639,32,1,1,1,111,1,726,39130,1,32
2011-04-02,summer,2011,April,1,Saturday,Holiday,Clear,0.26,0.2727,0.65,0.1343,4,28,32,32,639,32,1,1,1,111,1,724,24164,1,32
2011-04-02,summer,2011,April,2,Saturday,Holiday,Clear,0.24,0.2424,0.75,0.1343,1,20,21,21,639,21,1,1,1,111,1,715,16352,1,21
2011-04-02,summer,2011,April,3,Saturday,Holiday,Clear,0.24,0.2424,0.7,0.1642,1,8,9,9,639,9,1,1,1,111,1,697,8174,1,9
2011-04-02,summer,2011,April,4,Saturday,Holiday,Clear,0.24,0.2424,0.7,0.1642,0,5,5,5,639,5,1,1,1,111,1,697,4428,1,5
2011-04-02,summer,2011,April,5,Saturday,Holiday,Mist,0.24,0.2424,0.75,0.1642,1,4,5,5,639,5,1,1,1,111,1,717,14261,1,5
2011-04-02,summer,2011,April,6,Saturday,Holiday,Clear,0.26,0.2727,0.7,0.1045,5,7,12,12,639,12,1,1,1,111,1,725,55132,1,12
2011-04-02,summer,2011,April,7,Saturday,Holiday,Mist,0.26,0.2727,0.7,0.1045,2,16,18,18,639,18,1,1,1,111,1,727,154171,1,18
2011-04-02,summer,2011,April,8,Saturday,Holiday,Clear,0.3,0.3182,0.7,0.1045,10,45,55,55,639,55,1,2,1,121,1,727,261001,1,55
2011-04-02,summer,2011,April,9,Saturday,Holiday,Mist,0.34,0.3485,0.66,0.1045,22,65,87,87,639,87,1,2,2,122,1,727,159438,1,87
2011-04-02,summer,2011,April,10,Saturday,Holiday,Mist,0.36,0.3485,0.57,0.1642,41,113,154,154,639,154,1,3,2,132,1,727,126257,1,154
2011-04-02,summer,2011,April,11,Saturday,Holiday,Mist,0.4,0.4091,0.47,0.1642,72,126,198,198,639,198,1,3,2,132,1,727,151320,1,198
2011-04-02,summer,2011,April,12,Saturday,Holiday,Light Snow,0.32,0.3333,0.81,0.1343,84,100,184,184,639,184,1,3,1,131,1,728,184414,1,184
2011-04-02,summer,2011,April,13,Saturday,Holiday,Clear,0.34,0.3333,0.81,0.1343,56,81,137,137,639,137,1,2,1,121,1,729,184919,1,137
2011-04-02,summer,2011,April,14,Saturday,Holiday,Light Snow,0.32,0.303,0.76,0.3284,97,93,190,190,639,190,1,3,1,131,1,729,175652,1,190
2011-04-02,summer,2011,April,15,Saturday,Holiday,Light Snow,0.34,0.303,0.76,0.3881,72,64,136,136,639,136,1,2,1,121,1,729,183149,1,136
2011-04-02,summer,2011,April,16,Saturday,Holiday,Clear,0.38,0.3939,0.62,0.3284,111,85,196,196,639,196,1,3,2,132,1,730,227748,1,196
2011-04-02,summer,2011,April,17,Saturday,Holiday,Clear,0.38,0.3939,0.54,0.3582,89,95,184,184,639,184,1,3,2,132,1,730,336860,1,184
2011-04-02,summer,2011,April,18,Saturday,Holiday,Clear,0.38,0.3939,0.54,0.194,69,110,179,179,639,179,1,3,2,132,1,728,309772,1,179
2011-04-02,summer,2011,April,19,Saturday,Holiday,Clear,0.36,0.3333,0.53,0.3582,71,77,148,148,639,148,1,3,1,131,1,728,226789,1,148
2011-04-02,summer,2011,April,20,Saturday,Holiday,Clear,0.34,0.3182,0.53,0.2836,29,56,85,85,639,85,1,2,1,121,1,728,164550,1,85
2011-04-02,summer,2011,April,21,Saturday,Holiday,Clear,0.32,0.303,0.61,0.2537,24,53,77,77,639,77,1,2,1,121,1,728,125445,1,77
2011-04-02,summer,2011,April,22,Saturday,Holiday,Clear,0.32,0.303,0.61,0.2985,14,41,55,55,639,55,1,2,1,121,1,728,95612,1,55
2011-04-02,summer,2011,April,23,Saturday,Holiday,Clear,0.32,0.3182,0.61,0.1642,20,33,53,53,639,53,1,2,1,121,1,728,63941,1,53
2011-04-03,summer,2011,April,0,Sunday,Holiday,Clear,0.3,0.2879,0.65,0.194,8,31,39,39,638,39,1,1,1,111,1,726,39130,1,39
2011-04-03,summer,2011,April,1,Sunday,Holiday,Clear,0.3,0.3182,0.61,0.1045,8,26,34,34,638,34,1,1,1,111,1,724,24164,1,34
2011-04-03,summer,2011,April,2,Sunday,Holiday,Clear,0.26,0.2727,0.7,0.1343,5,19,24,24,638,24,1,1,1,111,1,715,16352,1,24
2011-04-03,summer,2011,April,3,Sunday,Holiday,Clear,0.3,0.3333,0.61,0.0,3,8,11,11,638,11,1,1,1,111,1,697,8174,1,11
2011-04-03,summer,2011,April,4,Sunday,Holiday,Clear,0.28,0.303,0.7,0.0896,3,0,3,3,638,3,1,1,1,111,1,697,4428,1,3
2011-04-03,summer,2011,April,5,Sunday,Holiday,Clear,0.28,0.2727,0.65,0.2239,1,4,5,5,638,5,1,1,1,111,1,717,14261,1,5
2011-04-03,summer,2011,April,6,Sunday,Holiday,Clear,0.28,0.2727,0.65,0.194,10,23,33,33,638,33,1,1,1,111,1,725,55132,1,33
2011-04-03,summer,2011,April,7,Sunday,Holiday,Clear,0.32,0.303,0.57,0.2239,13,20,33,33,638,33,1,1,1,111,1,727,154171,1,33
2011-04-03,summer,2011,April,8,Sunday,Holiday,Clear,0.34,0.3333,0.57,0.1642,18,44,62,62,638,62,1,2,1,121,1,727,261001,1,62
2011-04-03,summer,2011,April,9,Sunday,Holiday,Clear,0.36,0.3182,0.5,0.4925,68,74,142,142,638,142,1,2,1,121,1,727,159438,1,142
2011-04-03,summer,2011,April,10,Sunday,Holiday,Clear,0.4,0.4091,0.43,0.4179,111,104,215,215,638,215,1,3,2,132,1,727,126257,1,215
2011-04-03,summer,2011,April,11,Sunday,Holiday,Clear,0.42,0.4242,0.41,0.2537,139,104,243,243,638,243,1,3,2,132,2,727,151320,1,243
2011-04-03,summer,2011,April,12,Sunday,Holiday,Clear,0.44,0.4394,0.38,0.2836,166,147,313,313,638,313,1,4,2,142,2,728,184414,1,313
2011-04-03,summer,2011,April,13,Sunday,Holiday,Clear,0.44,0.4394,0.33,0.2985,219,148,367,367,638,367,1,4,2,142,2,729,184919,1,367
2011-04-03,summer,2011,April,14,Sunday,Holiday,Clear,0.46,0.4545,0.31,0.1343,240,109,349,349,638,349,1,4,2,142,2,729,175652,1,349
2011-04-03,summer,2011,April,15,Sunday,Holiday,Mist,0.46,0.4545,0.33,0.0,174,118,292,292,638,292,1,4,2,142,2,729,183149,1,292
2011-04-03,summer,2011,April,16,Sunday,Holiday,Mist,0.46,0.4545,0.31,0.194,147,156,303,303,638,303,1,4,2,142,2,730,227748,1,303
2011-04-03,summer,2011,April,17,Sunday,Holiday,Mist,0.46,0.4545,0.28,0.1343,148,126,274,274,638,274,1,3,2,132,2,730,336860,1,274
2011-04-03,summer,2011,April,18,Sunday,Holiday,Mist,0.46,0.4545,0.31,0.0,71,101,172,172,638,172,1,3,2,132,1,728,309772,1,172
2011-04-03,summer,2011,April,19,Sunday,Holiday,Mist,0.42,0.4242,0.44,0.194,51,93,144,144,638,144,1,3,2,132,1,728,226789,1,144
2011-04-03,summer,2011,April,20,Sunday,Holiday,Light Snow,0.42,0.4242,0.41,0.2239,24,55,79,79,638,79,1,2,2,122,1,728,164550,1,79
2011-04-03,summer,2011,April,21,Sunday,Holiday,Mist,0.42,0.4242,0.44,0.2239,8,37,45,45,638,45,1,2,2,122,1,728,125445,1,45
2011-04-03,summer,2011,April,22,Sunday,Holiday,Clear,0.4,0.4091,0.43,0.1045,7,29,36,36,638,36,1,1,2,112,1,728,95612,1,36
2011-04-03,summer,2011,April,23,Sunday,Holiday,Clear,0.4,0.4091,0.5,0.0896,9,22,31,31,638,31,1,1,2,112,1,728,63941,1,31
2011-04-04,summer,2011,April,0,Monday,Workingday,Clear,0.4,0.4091,0.5,0.2239,1,5,6,6,637,6,1,1,2,112,1,726,39130,1,6
2011-04-04,summer,2011,April,1,Monday,Workingday,Clear,0.4,0.4091,0.56,0.3582,7,4,11,11,637,11,1,1,2,112,1,724,24164,1,11
2011-04-04,summer,2011,April,2,Monday,Workingday,Clear,0.38,0.3939,0.66,0.2537,1,1,2,2,637,2,1,1,2,112,1,715,16352,1,2
2011-04-04,summer,2011,April,3,Monday,Workingday,Clear,0.38,0.3939,0.66,0.2836,1,0,1,1,637,1,1,1,2,112,1,697,8174,1,1
2011-04-04,summer,2011,April,4,Monday,Workingday,Clear,0.38,0.3939,0.71,0.2985,1,1,2,2,637,2,1,1,2,112,1,697,4428,1,2
2011-04-04,summer,2011,April,5,Monday,Workingday,Clear,0.4,0.4091,0.62,0.2537,0,7,7,7,637,7,1,1,2,112,1,717,14261,1,7
2011-04-04,summer,2011,April,6,Monday,Workingday,Clear,0.42,0.4242,0.58,0.2836,3,43,46,46,637,46,1,2,2,122,1,725,55132,1,46
2011-04-04,summer,2011,April,7,Monday,Workingday,Mist,0.44,0.4394,0.54,0.2537,7,150,157,157,637,157,1,3,2,132,1,727,154171,1,157
2011-04-04,summer,2011,April,8,Monday,Workingday,Mist,0.46,0.4545,0.55,0.2985,31,308,339,339,637,339,1,4,2,142,1,727,261001,1,339
2011-04-04,summer,2011,April,9,Monday,Workingday,Mist,0.5,0.4848,0.51,0.3881,24,134,158,158,637,158,1,3,2,132,1,727,159438,1,158
2011-04-04,summer,2011,April,10,Monday,Workingday,Mist,0.54,0.5152,0.45,0.3582,35,55,90,90,637,90,1,2,3,123,1,727,126257,1,90
2011-04-04,summer,2011,April,11,Monday,Workingday,Clear,0.6,0.6212,0.4,0.3881,58,66,124,124,637,124,1,2,3,123,2,727,151320,1,124
2011-04-04,summer,2011,April,12,Monday,Workingday,Clear,0.64,0.6212,0.36,0.4627,59,98,157,157,637,157,1,3,3,133,2,728,184414,1,157
2011-04-04,summer,2011,April,13,Monday,Workingday,Clear,0.68,0.6364,0.34,0.3284,47,92,139,139,637,139,1,2,4,124,2,729,184919,1,139
2011-04-04,summer,2011,April,14,Monday,Workingday,Mist,0.74,0.6515,0.27,0.4925,47,76,123,123,637,123,1,2,4,124,2,729,175652,1,123
2011-04-04,summer,2011,April,15,Monday,Workingday,Clear,0.76,0.6667,0.23,0.5522,47,96,143,143,637,143,1,3,4,134,2,729,183149,1,143
2011-04-04,summer,2011,April,16,Monday,Workingday,Clear,0.76,0.6515,0.22,0.5224,59,130,189,189,637,189,1,3,4,134,2,730,227748,1,189
2011-04-04,summer,2011,April,17,Monday,Workingday,Clear,0.74,0.6515,0.23,0.6119,83,283,366,366,637,366,1,4,4,144,2,730,336860,1,366
2011-04-04,summer,2011,April,18,Monday,Workingday,Mist,0.72,0.6364,0.23,0.4925,78,308,386,386,637,386,1,4,4,144,2,728,309772,1,386
2011-04-04,summer,2011,April,19,Monday,Workingday,Clear,0.7,0.6364,0.24,0.4627,51,227,278,278,637,278,1,3,4,134,2,728,226789,1,278
2011-04-04,summer,2011,April,20,Monday,Workingday,Mist,0.7,0.6364,0.24,0.5522,40,133,173,173,637,173,1,3,4,134,2,728,164550,1,173
2011-04-04,summer,2011,April,21,Monday,Workingday,Mist,0.7,0.6364,0.3,0.4478,19,76,95,95,637,95,1,2,4,124,2,728,125445,1,95
2011-04-04,summer,2011,April,22,Monday,Workingday,Mist,0.68,0.6364,0.36,0.4627,17,58,75,75,637,75,1,2,4,124,2,728,95612,1,75
2011-04-04,summer,2011,April,23,Monday,Workingday,Mist,0.64,0.6212,0.47,0.2239,18,30,48,48,637,48,1,2,3,123,0,728,63941,1,48
2011-04-05,summer,2011,April,0,Tuesday,Workingday,Clear,0.62,0.6212,0.5,0.1045,10,12,22,22,636,22,1,1,3,113,0,726,39130,1,22
2011-04-05,summer,2011,April,1,Tuesday,Workingday,Light Snow,0.62,0.6212,0.57,0.4179,10,5,15,15,636,15,1,1,3,113,0,724,24164,1,15
2011-04-05,summer,2011,April,2,Tuesday,Workingday,Mist,0.54,0.5152,0.73,0.3284,0,5,5,5,636,5,1,1,3,113,0,715,16352,1,5
2011-04-05,summer,2011,April,3,Tuesday,Workingday,Mist,0.54,0.5152,0.73,0.3284,1,3,4,4,636,4,1,1,3,113,0,697,8174,1,4
2011-04-05,summer,2011,April,4,Tuesday,Workingday,Light Snow,0.5,0.4848,0.88,0.4925,0,2,2,2,636,2,1,1,2,112,0,697,4428,1,2
2011-04-05,summer,2011,April,5,Tuesday,Workingday,Light Snow,0.46,0.4545,0.94,0.2985,0,5,5,5,636,5,1,1,2,112,0,717,14261,1,5
2011-04-05,summer,2011,April,6,Tuesday,Workingday,Mist,0.48,0.4697,0.88,0.3284,2,36,38,38,636,38,1,1,2,112,0,725,55132,1,38
2011-04-05,summer,2011,April,7,Tuesday,Workingday,Mist,0.48,0.4697,0.88,0.3284,10,124,134,134,636,134,1,2,2,122,0,727,154171,1,134
2011-04-05,summer,2011,April,8,Tuesday,Workingday,Light Snow,0.38,0.3939,0.87,0.5821,9,148,157,157,636,157,1,3,2,132,1,727,261001,1,157
2011-04-05,summer,2011,April,9,Tuesday,Workingday,Light Snow,0.36,0.3182,0.87,0.4925,2,44,46,46,636,46,1,2,1,121,1,727,159438,1,46
2011-04-05,summer,2011,April,10,Tuesday,Workingday,Light Snow,0.34,0.303,0.81,0.3881,3,25,28,28,636,28,1,1,1,111,1,727,126257,1,28
2011-04-05,summer,2011,April,11,Tuesday,Workingday,Light Snow,0.32,0.2879,0.81,0.4478,1,18,19,19,636,19,1,1,1,111,1,727,151320,1,19
2011-04-05,summer,2011,April,12,Tuesday,Workingday,Mist,0.34,0.303,0.71,0.3881,6,32,38,38,636,38,1,1,1,111,1,728,184414,1,38
2011-04-05,summer,2011,April,13,Tuesday,Workingday,Mist,0.36,0.3333,0.63,0.4179,5,51,56,56,636,56,1,2,1,121,1,729,184919,1,56
2011-04-05,summer,2011,April,14,Tuesday,Workingday,Mist,0.36,0.3182,0.57,0.4925,9,67,76,76,636,76,1,2,1,121,1,729,175652,1,76
2011-04-05,summer,2011,April,15,Tuesday,Workingday,Clear,0.4,0.4091,0.46,0.4627,6,62,68,68,636,68,1,2,2,122,1,729,183149,1,68
2011-04-05,summer,2011,April,16,Tuesday,Workingday,Clear,0.38,0.3939,0.46,0.4179,17,113,130,130,636,130,1,2,2,122,1,730,227748,1,130
2011-04-05,summer,2011,April,17,Tuesday,Workingday,Clear,0.42,0.4242,0.38,0.4179,27,246,273,273,636,273,1,3,2,132,1,730,336860,1,273
2011-04-05,summer,2011,April,18,Tuesday,Workingday,Clear,0.38,0.3939,0.4,0.4925,19,248,267,267,636,267,1,3,2,132,1,728,309772,1,267
2011-04-05,summer,2011,April,19,Tuesday,Workingday,Clear,0.36,0.3333,0.43,0.2985,12,148,160,160,636,160,1,3,1,131,1,728,226789,1,160
2011-04-05,summer,2011,April,20,Tuesday,Workingday,Clear,0.34,0.3182,0.46,0.2836,4,87,91,91,636,91,1,2,1,121,1,728,164550,1,91
2011-04-05,summer,2011,April,21,Tuesday,Workingday,Clear,0.34,0.2879,0.46,0.5224,8,81,89,89,636,89,1,2,1,121,1,728,125445,1,89
2011-04-05,summer,2011,April,22,Tuesday,Workingday,Clear,0.32,0.303,0.49,0.2985,3,43,46,46,636,46,1,2,1,121,1,728,95612,1,46
2011-04-05,summer,2011,April,23,Tuesday,Workingday,Clear,0.3,0.2879,0.49,0.2836,3,23,26,26,636,26,1,1,1,111,1,728,63941,1,26
2011-04-06,summer,2011,April,0,Wednesday,Workingday,Clear,0.3,0.3182,0.49,0.1045,0,15,15,15,635,15,1,1,1,111,1,726,39130,1,15
2011-04-06,summer,2011,April,1,Wednesday,Workingday,Clear,0.26,0.2727,0.6,0.1343,0,2,2,2,635,2,1,1,1,111,1,724,24164,1,2
2011-04-06,summer,2011,April,2,Wednesday,Workingday,Clear,0.24,0.2424,0.7,0.1343,0,5,5,5,635,5,1,1,1,111,1,715,16352,1,5
2011-04-06,summer,2011,April,3,Wednesday,Workingday,Clear,0.26,0.2727,0.6,0.1343,0,4,4,4,635,4,1,1,1,111,1,697,8174,1,4
2011-04-06,summer,2011,April,4,Wednesday,Workingday,Clear,0.24,0.2424,0.65,0.1343,0,1,1,1,635,1,1,1,1,111,1,697,4428,1,1
2011-04-06,summer,2011,April,5,Wednesday,Workingday,Clear,0.24,0.2576,0.7,0.1045,1,12,13,13,635,13,1,1,1,111,1,717,14261,1,13
2011-04-06,summer,2011,April,6,Wednesday,Workingday,Clear,0.24,0.2576,0.7,0.1045,4,52,56,56,635,56,1,2,1,121,1,725,55132,1,56
2011-04-06,summer,2011,April,7,Wednesday,Workingday,Clear,0.26,0.2727,0.65,0.1045,3,130,133,133,635,133,1,2,1,121,1,727,154171,1,133
2011-04-06,summer,2011,April,8,Wednesday,Workingday,Clear,0.32,0.303,0.61,0.2239,17,308,325,325,635,325,1,4,1,141,1,727,261001,1,325
2011-04-06,summer,2011,April,9,Wednesday,Workingday,Clear,0.36,0.3333,0.46,0.2537,8,157,165,165,635,165,1,3,1,131,1,727,159438,1,165
2011-04-06,summer,2011,April,10,Wednesday,Workingday,Clear,0.4,0.4091,0.37,0.3881,21,48,69,69,635,69,1,2,2,122,1,727,126257,1,69
2011-04-06,summer,2011,April,11,Wednesday,Workingday,Clear,0.42,0.4242,0.38,0.3881,23,70,93,93,635,93,1,2,2,122,1,727,151320,1,93
2011-04-06,summer,2011,April,12,Wednesday,Workingday,Clear,0.44,0.4394,0.41,0.2537,22,112,134,134,635,134,1,2,2,122,1,728,184414,1,134
2011-04-06,summer,2011,April,13,Wednesday,Workingday,Clear,0.46,0.4545,0.38,0.4925,29,83,112,112,635,112,1,2,2,122,1,729,184919,1,112
2011-04-06,summer,2011,April,14,Wednesday,Workingday,Clear,0.5,0.4848,0.34,0.4179,35,80,115,115,635,115,1,2,2,122,1,729,175652,1,115
2011-04-06,summer,2011,April,15,Wednesday,Workingday,Clear,0.52,0.5,0.32,0.3284,34,83,117,117,635,117,1,2,3,123,1,729,183149,1,117
2011-04-06,summer,2011,April,16,Wednesday,Workingday,Clear,0.54,0.5152,0.28,0.4179,27,142,169,169,635,169,1,3,3,133,2,730,227748,1,169
2011-04-06,summer,2011,April,17,Wednesday,Workingday,Clear,0.52,0.5,0.32,0.4478,53,303,356,356,635,356,1,4,3,143,2,730,336860,1,356
2011-04-06,summer,2011,April,18,Wednesday,Workingday,Clear,0.52,0.5,0.29,0.3582,43,282,325,325,635,325,1,4,3,143,2,728,309772,1,325
2011-04-06,summer,2011,April,19,Wednesday,Workingday,Clear,0.5,0.4848,0.31,0.2985,36,196,232,232,635,232,1,3,2,132,2,728,226789,1,232
2011-04-06,summer,2011,April,20,Wednesday,Workingday,Clear,0.46,0.4545,0.51,0.2239,15,126,141,141,635,141,1,2,2,122,1,728,164550,1,141
2011-04-06,summer,2011,April,21,Wednesday,Workingday,Clear,0.46,0.4545,0.41,0.2836,18,84,102,102,635,102,1,2,2,122,1,728,125445,1,102
2011-04-06,summer,2011,April,22,Wednesday,Workingday,Clear,0.46,0.4545,0.41,0.2836,13,71,84,84,635,84,1,2,2,122,1,728,95612,1,84
2011-04-06,summer,2011,April,23,Wednesday,Workingday,Clear,0.46,0.4545,0.41,0.2985,11,29,40,40,635,40,1,1,2,112,1,728,63941,1,40
2011-04-07,summer,2011,April,0,Thursday,Workingday,Clear,0.46,0.4545,0.41,0.2836,5,15,20,20,634,20,1,1,2,112,1,726,39130,1,20
2011-04-07,summer,2011,April,1,Thursday,Workingday,Clear,0.42,0.4242,0.47,0.1343,2,11,13,13,634,13,1,1,2,112,1,724,24164,1,13
2011-04-07,summer,2011,April,2,Thursday,Workingday,Clear,0.42,0.4242,0.54,0.0,0,7,7,7,634,7,1,1,2,112,0,715,16352,1,7
2011-04-07,summer,2011,April,3,Thursday,Workingday,Clear,0.36,0.3485,0.66,0.194,0,3,3,3,634,3,1,1,2,112,1,697,8174,1,3
2011-04-07,summer,2011,April,4,Thursday,Workingday,Clear,0.34,0.3333,0.76,0.194,0,1,1,1,634,1,1,1,1,111,1,697,4428,1,1
2011-04-07,summer,2011,April,5,Thursday,Workingday,Clear,0.34,0.3182,0.76,0.2239,0,6,6,6,634,6,1,1,1,111,1,717,14261,1,6
2011-04-07,summer,2011,April,6,Thursday,Workingday,Clear,0.32,0.303,0.81,0.2537,5,59,64,64,634,64,1,2,1,121,1,725,55132,1,64
2011-04-07,summer,2011,April,7,Thursday,Workingday,Mist,0.34,0.3333,0.76,0.1642,8,152,160,160,634,160,1,3,1,131,1,727,154171,1,160
2011-04-07,summer,2011,April,8,Thursday,Workingday,Clear,0.36,0.3485,0.76,0.194,23,291,314,314,634,314,1,4,2,142,1,727,261001,1,314
2011-04-07,summer,2011,April,9,Thursday,Workingday,Mist,0.4,0.4091,0.66,0.1343,15,155,170,170,634,170,1,3,2,132,1,727,159438,1,170
2011-04-07,summer,2011,April,10,Thursday,Workingday,Mist,0.42,0.4242,0.67,0.1045,29,66,95,95,634,95,1,2,2,122,0,727,126257,1,95
2011-04-07,summer,2011,April,11,Thursday,Workingday,Mist,0.46,0.4545,0.55,0.0,36,86,122,122,634,122,1,2,2,122,0,727,151320,1,122
2011-04-07,summer,2011,April,12,Thursday,Workingday,Mist,0.46,0.4545,0.55,0.0,39,114,153,153,634,153,1,3,2,132,0,728,184414,1,153
2011-04-07,summer,2011,April,13,Thursday,Workingday,Mist,0.52,0.5,0.48,0.0896,36,99,135,135,634,135,1,2,3,123,0,729,184919,1,135
2011-04-07,summer,2011,April,14,Thursday,Workingday,Clear,0.56,0.5303,0.43,0.0896,46,111,157,157,634,157,1,3,3,133,0,729,175652,1,157
2011-04-07,summer,2011,April,15,Thursday,Workingday,Clear,0.6,0.6212,0.38,0.1045,27,133,160,160,634,160,1,3,3,133,2,729,183149,1,160
2011-04-07,summer,2011,April,16,Thursday,Workingday,Clear,0.6,0.6212,0.35,0.0,52,161,213,213,634,213,1,3,3,133,2,730,227748,1,213
2011-04-07,summer,2011,April,17,Thursday,Workingday,Clear,0.52,0.5,0.52,0.2836,63,280,343,343,634,343,1,4,3,143,2,730,336860,1,343
2011-04-07,summer,2011,April,18,Thursday,Workingday,Clear,0.48,0.4697,0.55,0.2537,68,265,333,333,634,333,1,4,2,142,2,728,309772,1,333
2011-04-07,summer,2011,April,19,Thursday,Workingday,Clear,0.46,0.4545,0.59,0.2985,34,192,226,226,634,226,1,3,2,132,1,728,226789,1,226
2011-04-07,summer,2011,April,20,Thursday,Workingday,Clear,0.44,0.4394,0.62,0.1642,37,166,203,203,634,203,1,3,2,132,0,728,164550,1,203
2011-04-07,summer,2011,April,21,Thursday,Workingday,Mist,0.44,0.4394,0.67,0.2836,19,89,108,108,634,108,1,2,2,122,1,728,125445,1,108
2011-04-07,summer,2011,April,22,Thursday,Workingday,Mist,0.4,0.4091,0.76,0.194,18,63,81,81,634,81,1,2,2,122,0,728,95612,1,81
2011-04-07,summer,2011,April,23,Thursday,Workingday,Clear,0.38,0.3939,0.76,0.2537,9,45,54,54,634,54,1,2,2,122,1,728,63941,1,54
2011-04-08,summer,2011,April,0,Friday,Workingday,Mist,0.36,0.3485,0.76,0.2239,4,21,25,25,633,25,1,1,2,112,1,726,39130,1,25
2011-04-08,summer,2011,April,1,Friday,Workingday,Mist,0.34,0.3333,0.76,0.1343,3,6,9,9,633,9,1,1,1,111,1,724,24164,1,9
2011-04-08,summer,2011,April,2,Friday,Workingday,Light Snow,0.34,0.3333,0.76,0.1642,3,10,13,13,633,13,1,1,1,111,1,715,16352,1,13
2011-04-08,summer,2011,April,3,Friday,Workingday,Light Snow,0.34,0.3333,0.76,0.1642,0,1,1,1,633,1,1,1,1,111,1,697,8174,1,1
2011-04-08,summer,2011,April,4,Friday,Workingday,Mist,0.34,0.3333,0.86,0.1343,0,1,1,1,633,1,1,1,1,111,1,697,4428,1,1
2011-04-08,summer,2011,April,5,Friday,Workingday,Mist,0.32,0.3182,0.87,0.194,1,8,9,9,633,9,1,1,1,111,1,717,14261,1,9
2011-04-08,summer,2011,April,6,Friday,Workingday,Mist,0.34,0.3636,0.87,0.0,2,33,35,35,633,35,1,1,2,112,0,725,55132,1,35
2011-04-08,summer,2011,April,7,Friday,Workingday,Light Snow,0.34,0.3333,0.87,0.1642,4,109,113,113,633,113,1,2,1,121,1,727,154171,1,113
2011-04-08,summer,2011,April,8,Friday,Workingday,Light Snow,0.34,0.3333,0.87,0.1642,13,208,221,221,633,221,1,3,1,131,1,727,261001,1,221
2011-04-08,summer,2011,April,9,Friday,Workingday,Mist,0.36,0.3485,0.76,0.194,17,168,185,185,633,185,1,3,2,132,1,727,159438,1,185
2011-04-08,summer,2011,April,10,Friday,Workingday,Mist,0.36,0.3333,0.71,0.2836,10,63,73,73,633,73,1,2,1,121,1,727,126257,1,73
2011-04-08,summer,2011,April,11,Friday,Workingday,Mist,0.4,0.4091,0.62,0.3881,19,79,98,98,633,98,1,2,2,122,1,727,151320,1,98
2011-04-08,summer,2011,April,12,Friday,Workingday,Light Snow,0.38,0.3939,0.66,0.2239,29,51,80,80,633,80,1,2,2,122,1,728,184414,1,80
2011-04-08,summer,2011,April,13,Friday,Workingday,Light Snow,0.36,0.3333,0.76,0.2836,7,35,42,42,633,42,1,2,1,121,1,729,184919,1,42
2011-04-08,summer,2011,April,14,Friday,Workingday,Light Snow,0.34,0.3182,0.87,0.2239,2,13,15,15,633,15,1,1,1,111,1,729,175652,1,15
2011-04-08,summer,2011,April,15,Friday,Workingday,Light Snow,0.34,0.3182,0.87,0.2239,1,24,25,25,633,25,1,1,1,111,1,729,183149,1,25
2011-04-08,summer,2011,April,16,Friday,Workingday,Mist,0.32,0.303,0.93,0.2537,2,58,60,60,633,60,1,2,1,121,1,730,227748,1,60
2011-04-08,summer,2011,April,17,Friday,Workingday,Light Snow,0.32,0.303,0.93,0.2537,10,138,148,148,633,148,1,3,1,131,1,730,336860,1,148
2011-04-08,summer,2011,April,18,Friday,Workingday,Light Snow,0.32,0.303,0.93,0.2537,8,54,62,62,633,62,1,2,1,121,1,728,309772,1,62
2011-04-08,summer,2011,April,19,Friday,Workingday,Light Snow,0.3,0.2727,0.93,0.4179,1,52,53,53,633,53,1,2,1,121,1,728,226789,1,53
2011-04-08,summer,2011,April,20,Friday,Workingday,Mist,0.3,0.2727,0.93,0.3284,12,51,63,63,633,63,1,2,1,121,1,728,164550,1,63
2011-04-08,summer,2011,April,21,Friday,Workingday,Mist,0.3,0.2879,0.93,0.2537,11,43,54,54,633,54,1,2,1,121,1,728,125445,1,54
2011-04-08,summer,2011,April,22,Friday,Workingday,Mist,0.3,0.2727,0.93,0.2985,9,42,51,51,633,51,1,2,1,121,1,728,95612,1,51
2011-04-08,summer,2011,April,23,Friday,Workingday,Mist,0.3,0.2879,0.93,0.2239,4,31,35,35,633,35,1,1,1,111,1,728,63941,1,35
2011-04-09,summer,2011,April,0,Saturday,Holiday,Mist,0.3,0.2879,0.87,0.2239,5,26,31,31,632,31,1,1,1,111,1,726,39130,1,31
2011-04-09,summer,2011,April,1,Saturday,Holiday,Mist,0.3,0.303,0.87,0.1343,3,17,20,20,632,20,1,1,1,111,1,724,24164,1,20
2011-04-09,summer,2011,April,2,Saturday,Holiday,Mist,0.32,0.303,0.87,0.2239,2,15,17,17,632,17,1,1,1,111,1,715,16352,1,17
2011-04-09,summer,2011,April,3,Saturday,Holiday,Light Snow,0.3,0.2879,1.0,0.2537,3,11,14,14,632,14,1,1,1,111,1,697,8174,1,14
2011-04-09,summer,2011,April,4,Saturday,Holiday,Light Snow,0.3,0.2727,1.0,0.2537,0,3,3,3,632,3,1,1,1,111,1,697,4428,1,3
2011-04-09,summer,2011,April,5,Saturday,Holiday,Mist,0.3,0.2879,0.93,0.2239,0,5,5,5,632,5,1,1,1,111,1,717,14261,1,5
2011-04-09,summer,2011,April,6,Saturday,Holiday,Mist,0.3,0.2879,0.93,0.194,0,13,13,13,632,13,1,1,1,111,1,725,55132,1,13
2011-04-09,summer,2011,April,7,Saturday,Holiday,Mist,0.3,0.303,0.93,0.1642,8,13,21,21,632,21,1,1,1,111,1,727,154171,1,21
2011-04-09,summer,2011,April,8,Saturday,Holiday,Mist,0.32,0.303,0.93,0.1642,7,47,54,54,632,54,1,2,1,121,1,727,261001,1,54
2011-04-09,summer,2011,April,9,Saturday,Holiday,Mist,0.34,0.3485,0.87,0.1045,27,71,98,98,632,98,1,2,2,122,0,727,159438,1,98
2011-04-09,summer,2011,April,10,Saturday,Holiday,Mist,0.34,0.3333,0.87,0.1343,43,90,133,133,632,133,1,2,1,121,1,727,126257,1,133
2011-04-09,summer,2011,April,11,Saturday,Holiday,Mist,0.36,0.3636,0.81,0.0,51,91,142,142,632,142,1,2,2,122,0,727,151320,1,142
2011-04-09,summer,2011,April,12,Saturday,Holiday,Mist,0.36,0.3485,0.81,0.1343,79,123,202,202,632,202,1,3,2,132,1,728,184414,1,202
2011-04-09,summer,2011,April,13,Saturday,Holiday,Mist,0.36,0.3788,0.81,0.0,114,108,222,222,632,222,1,3,2,132,0,729,184919,1,222
2011-04-09,summer,2011,April,14,Saturday,Holiday,Mist,0.36,0.3485,0.81,0.1343,94,118,212,212,632,212,1,3,2,132,0,729,175652,1,212
2011-04-09,summer,2011,April,15,Saturday,Holiday,Mist,0.36,0.3788,0.87,0.0,85,116,201,201,632,201,1,3,2,132,0,729,183149,1,201
2011-04-09,summer,2011,April,16,Saturday,Holiday,Mist,0.38,0.3939,0.82,0.0,73,118,191,191,632,191,1,3,2,132,0,730,227748,1,191
2011-04-09,summer,2011,April,17,Saturday,Holiday,Mist,0.38,0.3939,0.82,0.0896,128,129,257,257,632,257,1,3,2,132,0,730,336860,1,257
2011-04-09,summer,2011,April,18,Saturday,Holiday,Mist,0.38,0.3939,0.82,0.1045,48,129,177,177,632,177,1,3,2,132,0,728,309772,1,177
2011-04-09,summer,2011,April,19,Saturday,Holiday,Mist,0.38,0.3939,0.82,0.1343,47,83,130,130,632,130,1,2,2,122,0,728,226789,1,130
2011-04-09,summer,2011,April,20,Saturday,Holiday,Mist,0.38,0.3939,0.87,0.1642,19,74,93,93,632,93,1,2,2,122,0,728,164550,1,93
2011-04-09,summer,2011,April,21,Saturday,Holiday,Mist,0.36,0.3485,0.93,0.1343,10,65,75,75,632,75,1,2,2,122,0,728,125445,1,75
2011-04-09,summer,2011,April,22,Saturday,Holiday,Mist,0.36,0.3485,0.93,0.1343,21,66,87,87,632,87,1,2,2,122,0,728,95612,1,87
2011-04-09,summer,2011,April,23,Saturday,Holiday,Mist,0.38,0.3939,0.87,0.0896,12,45,57,57,632,57,1,2,2,122,0,728,63941,1,57
2011-04-10,summer,2011,April,0,Sunday,Holiday,Mist,0.38,0.3939,0.87,0.0896,5,48,53,53,631,53,1,2,2,122,0,726,39130,1,53
2011-04-10,summer,2011,April,1,Sunday,Holiday,Mist,0.38,0.3939,0.87,0.1343,6,31,37,37,631,37,1,1,2,112,0,724,24164,1,37
2011-04-10,summer,2011,April,2,Sunday,Holiday,Mist,0.38,0.3939,0.87,0.0896,12,24,36,36,631,36,1,1,2,112,0,715,16352,1,36
2011-04-10,summer,2011,April,3,Sunday,Holiday,Mist,0.38,0.3939,0.87,0.1343,5,11,16,16,631,16,1,1,2,112,0,697,8174,1,16
2011-04-10,summer,2011,April,4,Sunday,Holiday,Mist,0.36,0.3636,0.93,0.1045,3,2,5,5,631,5,1,1,2,112,0,697,4428,1,5
2011-04-10,summer,2011,April,5,Sunday,Holiday,Mist,0.36,0.3636,0.93,0.0896,0,4,4,4,631,4,1,1,2,112,0,717,14261,1,4
2011-04-10,summer,2011,April,6,Sunday,Holiday,Mist,0.36,0.3636,0.93,0.0896,0,4,4,4,631,4,1,1,2,112,0,725,55132,1,4
2011-04-10,summer,2011,April,7,Sunday,Holiday,Mist,0.36,0.3636,1.0,0.0896,3,7,10,10,631,10,1,1,2,112,0,727,154171,1,10
2011-04-10,summer,2011,April,8,Sunday,Holiday,Mist,0.38,0.3939,0.94,0.0896,17,38,55,55,631,55,1,2,2,122,0,727,261001,1,55
2011-04-10,summer,2011,April,9,Sunday,Holiday,Mist,0.38,0.3939,0.94,0.1343,31,50,81,81,631,81,1,2,2,122,0,727,159438,1,81
2011-04-10,summer,2011,April,10,Sunday,Holiday,Mist,0.4,0.4091,0.87,0.0,69,81,150,150,631,150,1,3,2,132,0,727,126257,1,150
2011-04-10,summer,2011,April,11,Sunday,Holiday,Mist,0.4,0.4091,0.87,0.1343,93,109,202,202,631,202,1,3,2,132,0,727,151320,1,202
2011-04-10,summer,2011,April,12,Sunday,Holiday,Mist,0.42,0.4242,0.88,0.1343,94,136,230,230,631,230,1,3,2,132,0,728,184414,1,230
2011-04-10,summer,2011,April,13,Sunday,Holiday,Clear,0.46,0.4545,0.82,0.1045,121,142,263,263,631,263,1,3,2,132,0,729,184919,1,263
2011-04-10,summer,2011,April,14,Sunday,Holiday,Clear,0.5,0.4848,0.72,0.194,148,133,281,281,631,281,1,3,2,132,2,729,175652,1,281
2011-04-10,summer,2011,April,15,Sunday,Holiday,Clear,0.5,0.4848,0.77,0.2239,156,141,297,297,631,297,1,4,2,142,2,729,183149,1,297
2011-04-10,summer,2011,April,16,Sunday,Holiday,Mist,0.52,0.5,0.72,0.1642,135,153,288,288,631,288,1,4,3,143,2,730,227748,1,288
2011-04-10,summer,2011,April,17,Sunday,Holiday,Mist,0.52,0.5,0.72,0.194,84,152,236,236,631,236,1,3,3,133,0,730,336860,1,236
2011-04-10,summer,2011,April,18,Sunday,Holiday,Clear,0.5,0.4848,0.77,0.194,103,137,240,240,631,240,1,3,2,132,0,728,309772,1,240
2011-04-10,summer,2011,April,19,Sunday,Holiday,Clear,0.5,0.4848,0.77,0.194,47,84,131,131,631,131,1,2,2,122,0,728,226789,1,131
2011-04-10,summer,2011,April,20,Sunday,Holiday,Clear,0.46,0.4545,0.82,0.1343,21,71,92,92,631,92,1,2,2,122,0,728,164550,1,92
2011-04-10,summer,2011,April,21,Sunday,Holiday,Clear,0.44,0.4394,0.88,0.194,18,77,95,95,631,95,1,2,2,122,0,728,125445,1,95
2011-04-10,summer,2011,April,22,Sunday,Holiday,Clear,0.44,0.4394,0.94,0.2537,12,45,57,57,631,57,1,2,2,122,0,728,95612,1,57
2011-04-10,summer,2011,April,23,Sunday,Holiday,Clear,0.46,0.4545,0.88,0.3582,5,27,32,32,631,32,1,1,2,112,0,728,63941,1,32
2011-04-11,summer,2011,April,0,Monday,Workingday,Clear,0.48,0.4697,0.88,0.3284,7,16,23,23,630,23,1,1,2,112,0,726,39130,1,23
2011-04-11,summer,2011,April,1,Monday,Workingday,Clear,0.46,0.4545,0.94,0.2836,1,3,4,4,630,4,1,1,2,112,0,724,24164,1,4
2011-04-11,summer,2011,April,2,Monday,Workingday,Clear,0.46,0.4545,0.94,0.2836,7,2,9,9,630,9,1,1,2,112,0,715,16352,1,9
2011-04-11,summer,2011,April,4,Monday,Workingday,Clear,0.46,0.4545,0.94,0.194,0,1,1,1,630,1,1,1,2,112,0,697,4428,1,1
2011-04-11,summer,2011,April,5,Monday,Workingday,Clear,0.46,0.4545,0.94,0.194,1,12,13,13,630,13,1,1,2,112,0,717,14261,1,13
2011-04-11,summer,2011,April,6,Monday,Workingday,Mist,0.46,0.4545,1.0,0.2239,2,59,61,61,630,61,1,2,2,122,0,725,55132,1,61
2011-04-11,summer,2011,April,7,Monday,Workingday,Mist,0.5,0.4848,0.88,0.2239,12,164,176,176,630,176,1,3,2,132,0,727,154171,1,176
2011-04-11,summer,2011,April,8,Monday,Workingday,Mist,0.52,0.5,0.88,0.2836,28,286,314,314,630,314,1,4,3,143,0,727,261001,1,314
2011-04-11,summer,2011,April,9,Monday,Workingday,Mist,0.56,0.5303,0.83,0.2836,33,132,165,165,630,165,1,3,3,133,0,727,159438,1,165
2011-04-11,summer,2011,April,10,Monday,Workingday,Mist,0.56,0.5303,0.83,0.2985,41,55,96,96,630,96,1,2,3,123,0,727,126257,1,96
2011-04-11,summer,2011,April,11,Monday,Workingday,Mist,0.6,0.5909,0.73,0.2985,45,59,104,104,630,104,1,2,3,123,0,727,151320,1,104
2011-04-11,summer,2011,April,12,Monday,Workingday,Mist,0.6,0.5909,0.73,0.3284,37,97,134,134,630,134,1,2,3,123,0,728,184414,1,134
2011-04-11,summer,2011,April,13,Monday,Workingday,Mist,0.64,0.6061,0.69,0.4179,62,77,139,139,630,139,1,2,3,123,2,729,184919,1,139
2011-04-11,summer,2011,April,14,Monday,Workingday,Mist,0.72,0.6667,0.54,0.3582,60,85,145,145,630,145,1,3,4,134,2,729,175652,1,145
2011-04-11,summer,2011,April,15,Monday,Workingday,Clear,0.74,0.6667,0.48,0.5224,56,85,141,141,630,141,1,2,4,124,2,729,183149,1,141
2011-04-11,summer,2011,April,16,Monday,Workingday,Clear,0.74,0.6667,0.48,0.5224,73,162,235,235,630,235,1,3,4,134,2,730,227748,1,235
2011-04-11,summer,2011,April,17,Monday,Workingday,Clear,0.74,0.6667,0.48,0.5224,100,352,452,452,630,452,1,4,4,144,2,730,336860,1,452
2011-04-11,summer,2011,April,18,Monday,Workingday,Clear,0.72,0.6667,0.51,0.3881,93,290,383,383,630,383,1,4,4,144,2,728,309772,1,383
2011-04-11,summer,2011,April,19,Monday,Workingday,Clear,0.72,0.6667,0.51,0.4478,73,211,284,284,630,284,1,4,4,144,2,728,226789,1,284
2011-04-11,summer,2011,April,20,Monday,Workingday,Clear,0.68,0.6364,0.57,0.5224,44,122,166,166,630,166,1,3,4,134,2,728,164550,1,166
2011-04-11,summer,2011,April,21,Monday,Workingday,Clear,0.66,0.6212,0.61,0.2537,39,119,158,158,630,158,1,3,3,133,0,728,125445,1,158
2011-04-11,summer,2011,April,22,Monday,Workingday,Mist,0.64,0.6212,0.5,0.2836,25,66,91,91,630,91,1,2,3,123,0,728,95612,1,91
2011-04-11,summer,2011,April,23,Monday,Workingday,Light Snow,0.58,0.5455,0.6,0.0,16,38,54,54,630,54,1,2,3,123,0,728,63941,1,54
2011-04-12,summer,2011,April,0,Tuesday,Workingday,Mist,0.62,0.6212,0.5,0.1045,11,13,24,24,629,24,1,1,3,113,0,726,39130,1,24
2011-04-12,summer,2011,April,1,Tuesday,Workingday,Mist,0.62,0.6212,0.5,0.0896,6,7,13,13,629,13,1,1,3,113,0,724,24164,1,13
2011-04-12,summer,2011,April,2,Tuesday,Workingday,Mist,0.6,0.6212,0.53,0.1343,7,7,14,14,629,14,1,1,3,113,0,715,16352,1,14
2011-04-12,summer,2011,April,3,Tuesday,Workingday,Mist,0.58,0.5455,0.56,0.1343,0,1,1,1,629,1,1,1,3,113,0,697,8174,1,1
2011-04-12,summer,2011,April,4,Tuesday,Workingday,Mist,0.56,0.5303,0.64,0.1343,4,2,6,6,629,6,1,1,3,113,0,697,4428,1,6
2011-04-12,summer,2011,April,5,Tuesday,Workingday,Mist,0.54,0.5152,0.68,0.1343,1,15,16,16,629,16,1,1,3,113,0,717,14261,1,16
2011-04-12,summer,2011,April,6,Tuesday,Workingday,Mist,0.54,0.5152,0.68,0.2836,3,55,58,58,629,58,1,2,3,123,0,725,55132,1,58
2011-04-12,summer,2011,April,7,Tuesday,Workingday,Mist,0.54,0.5152,0.68,0.2239,12,177,189,189,629,189,1,3,3,133,0,727,154171,1,189
2011-04-12,summer,2011,April,8,Tuesday,Workingday,Light Snow,0.48,0.4697,0.88,0.3881,15,211,226,226,629,226,1,3,2,132,0,727,261001,1,226
2011-04-12,summer,2011,April,9,Tuesday,Workingday,Light Snow,0.46,0.4545,0.94,0.4925,4,50,54,54,629,54,1,2,2,122,0,727,159438,1,54
2011-04-12,summer,2011,April,10,Tuesday,Workingday,Light Snow,0.5,0.4848,0.82,0.4179,6,34,40,40,629,40,1,1,2,112,0,727,126257,1,40
2011-04-12,summer,2011,April,11,Tuesday,Workingday,Clear,0.52,0.5,0.77,0.3582,11,38,49,49,629,49,1,2,3,123,0,727,151320,1,49
2011-04-12,summer,2011,April,12,Tuesday,Workingday,Mist,0.56,0.5303,0.64,0.4627,9,83,92,92,629,92,1,2,3,123,0,728,184414,1,92
2011-04-12,summer,2011,April,13,Tuesday,Workingday,Light Snow,0.54,0.5152,0.68,0.2836,22,84,106,106,629,106,1,2,3,123,0,729,184919,1,106
2011-04-12,summer,2011,April,14,Tuesday,Workingday,Mist,0.5,0.4848,0.82,0.2836,16,28,44,44,629,44,1,2,2,122,0,729,175652,1,44
2011-04-12,summer,2011,April,15,Tuesday,Workingday,Mist,0.48,0.4697,0.77,0.5224,24,54,78,78,629,78,1,2,2,122,1,729,183149,1,78
2011-04-12,summer,2011,April,16,Tuesday,Workingday,Mist,0.48,0.4697,0.77,0.3881,19,80,99,99,629,99,1,2,2,122,0,730,227748,1,99
2011-04-12,summer,2011,April,17,Tuesday,Workingday,Light Snow,0.44,0.4394,0.77,0.2239,29,262,291,291,629,291,1,4,2,142,0,730,336860,1,291
2011-04-12,summer,2011,April,18,Tuesday,Workingday,Light Snow,0.44,0.4394,0.77,0.2239,21,203,224,224,629,224,1,3,2,132,0,728,309772,1,224
2011-04-12,summer,2011,April,19,Tuesday,Workingday,Mist,0.42,0.4242,0.82,0.2836,3,127,130,130,629,130,1,2,2,122,0,728,226789,1,130
2011-04-12,summer,2011,April,20,Tuesday,Workingday,Mist,0.42,0.4242,0.82,0.2836,9,94,103,103,629,103,1,2,2,122,0,728,164550,1,103
2011-04-12,summer,2011,April,21,Tuesday,Workingday,Mist,0.42,0.4242,0.82,0.194,10,74,84,84,629,84,1,2,2,122,0,728,125445,1,84
2011-04-12,summer,2011,April,22,Tuesday,Workingday,Mist,0.4,0.4091,0.94,0.2985,7,47,54,54,629,54,1,2,2,122,0,728,95612,1,54
2011-04-12,summer,2011,April,23,Tuesday,Workingday,Mist,0.4,0.4091,0.94,0.2537,8,31,39,39,629,39,1,1,2,112,0,728,63941,1,39
2011-04-13,summer,2011,April,0,Wednesday,Workingday,Mist,0.4,0.4091,1.0,0.2985,3,12,15,15,628,15,1,1,2,112,0,726,39130,1,15
2011-04-13,summer,2011,April,1,Wednesday,Workingday,Mist,0.4,0.4091,1.0,0.2985,0,1,1,1,628,1,1,1,2,112,0,724,24164,1,1
2011-04-13,summer,2011,April,2,Wednesday,Workingday,Light Snow,0.4,0.4091,1.0,0.2985,0,2,2,2,628,2,1,1,2,112,0,715,16352,1,2
2011-04-13,summer,2011,April,3,Wednesday,Workingday,Light Snow,0.4,0.4091,0.94,0.3284,0,2,2,2,628,2,1,1,2,112,0,697,8174,1,2
2011-04-13,summer,2011,April,4,Wednesday,Workingday,Light Snow,0.4,0.4091,0.94,0.3284,1,2,3,3,628,3,1,1,2,112,0,697,4428,1,3
2011-04-13,summer,2011,April,5,Wednesday,Workingday,Light Snow,0.38,0.3939,0.94,0.2537,1,4,5,5,628,5,1,1,2,112,0,717,14261,1,5
2011-04-13,summer,2011,April,6,Wednesday,Workingday,Light Snow,0.38,0.3939,0.94,0.2239,1,33,34,34,628,34,1,1,2,112,0,725,55132,1,34
2011-04-13,summer,2011,April,7,Wednesday,Workingday,Light Snow,0.36,0.3485,1.0,0.2239,3,67,70,70,628,70,1,2,2,122,0,727,154171,1,70
2011-04-13,summer,2011,April,8,Wednesday,Workingday,Light Snow,0.38,0.3939,0.94,0.194,6,158,164,164,628,164,1,3,2,132,0,727,261001,1,164
2011-04-13,summer,2011,April,9,Wednesday,Workingday,Mist,0.38,0.3939,0.94,0.2239,2,63,65,65,628,65,1,2,2,122,0,727,159438,1,65
2011-04-13,summer,2011,April,10,Wednesday,Workingday,Mist,0.4,0.4091,0.87,0.194,4,42,46,46,628,46,1,2,2,122,0,727,126257,1,46
2011-04-13,summer,2011,April,11,Wednesday,Workingday,Mist,0.42,0.4242,0.82,0.194,4,57,61,61,628,61,1,2,2,122,0,727,151320,1,61
2011-04-13,summer,2011,April,12,Wednesday,Workingday,Light Snow,0.42,0.4242,0.82,0.2537,12,83,95,95,628,95,1,2,2,122,0,728,184414,1,95
2011-04-13,summer,2011,April,13,Wednesday,Workingday,Mist,0.44,0.4394,0.77,0.194,6,55,61,61,628,61,1,2,2,122,0,729,184919,1,61
2011-04-13,summer,2011,April,14,Wednesday,Workingday,Mist,0.42,0.4242,0.77,0.2537,24,82,106,106,628,106,1,2,2,122,0,729,175652,1,106
2011-04-13,summer,2011,April,15,Wednesday,Workingday,Mist,0.44,0.4394,0.72,0.2836,12,69,81,81,628,81,1,2,2,122,1,729,183149,1,81
2011-04-13,summer,2011,April,16,Wednesday,Workingday,Clear,0.46,0.4545,0.67,0.2836,23,119,142,142,628,142,1,2,2,122,1,730,227748,1,142
2011-04-13,summer,2011,April,17,Wednesday,Workingday,Clear,0.46,0.4545,0.67,0.2985,25,284,309,309,628,309,1,4,2,142,1,730,336860,1,309
2011-04-13,summer,2011,April,18,Wednesday,Workingday,Clear,0.44,0.4394,0.62,0.3881,28,293,321,321,628,321,1,4,2,142,1,728,309772,1,321
2011-04-13,summer,2011,April,19,Wednesday,Workingday,Clear,0.44,0.4394,0.62,0.2537,15,160,175,175,628,175,1,3,2,132,1,728,226789,1,175
2011-04-13,summer,2011,April,20,Wednesday,Workingday,Clear,0.44,0.4394,0.62,0.2537,7,119,126,126,628,126,1,2,2,122,1,728,164550,1,126
2011-04-13,summer,2011,April,21,Wednesday,Workingday,Clear,0.42,0.4242,0.67,0.1642,17,100,117,117,628,117,1,2,2,122,0,728,125445,1,117
2011-04-13,summer,2011,April,22,Wednesday,Workingday,Clear,0.42,0.4242,0.67,0.194,10,89,99,99,628,99,1,2,2,122,1,728,95612,1,99
2011-04-13,summer,2011,April,23,Wednesday,Workingday,Clear,0.4,0.4091,0.71,0.1343,5,57,62,62,628,62,1,2,2,122,0,728,63941,1,62
2011-04-14,summer,2011,April,0,Thursday,Workingday,Clear,0.38,0.3939,0.76,0.1343,3,18,21,21,627,21,1,1,2,112,0,726,39130,1,21
2011-04-14,summer,2011,April,1,Thursday,Workingday,Clear,0.38,0.3939,0.76,0.2239,1,9,10,10,627,10,1,1,2,112,1,724,24164,1,10
2011-04-14,summer,2011,April,2,Thursday,Workingday,Clear,0.36,0.3485,0.76,0.1343,0,3,3,3,627,3,1,1,2,112,1,715,16352,1,3
2011-04-14,summer,2011,April,3,Thursday,Workingday,Clear,0.34,0.3333,0.81,0.1343,0,2,2,2,627,2,1,1,1,111,1,697,8174,1,2
2011-04-14,summer,2011,April,4,Thursday,Workingday,Clear,0.34,0.3636,0.76,0.0,1,8,9,9,627,9,1,1,2,112,0,697,4428,1,9
2011-04-14,summer,2011,April,5,Thursday,Workingday,Clear,0.34,0.3485,0.76,0.0896,2,12,14,14,627,14,1,1,2,112,1,717,14261,1,14
2011-04-14,summer,2011,April,6,Thursday,Workingday,Clear,0.34,0.3485,0.76,0.1045,4,66,70,70,627,70,1,2,2,122,1,725,55132,1,70
2011-04-14,summer,2011,April,7,Thursday,Workingday,Clear,0.38,0.3939,0.66,0.0,11,182,193,193,627,193,1,3,2,132,0,727,154171,1,193
2011-04-14,summer,2011,April,8,Thursday,Workingday,Clear,0.42,0.4242,0.58,0.1642,21,316,337,337,627,337,1,4,2,142,1,727,261001,1,337
2011-04-14,summer,2011,April,9,Thursday,Workingday,Clear,0.46,0.4545,0.51,0.1343,18,152,170,170,627,170,1,3,2,132,1,727,159438,1,170
2011-04-14,summer,2011,April,10,Thursday,Workingday,Clear,0.5,0.4848,0.51,0.194,21,68,89,89,627,89,1,2,2,122,0,727,126257,1,89
2011-04-14,summer,2011,April,11,Thursday,Workingday,Clear,0.52,0.5,0.45,0.1642,28,87,115,115,627,115,1,2,3,123,0,727,151320,1,115
2011-04-14,summer,2011,April,12,Thursday,Workingday,Clear,0.54,0.5152,0.42,0.1343,35,110,145,145,627,145,1,3,3,133,0,728,184414,1,145
2011-04-14,summer,2011,April,13,Thursday,Workingday,Clear,0.56,0.5303,0.37,0.2239,38,121,159,159,627,159,1,3,3,133,2,729,184919,1,159
2011-04-14,summer,2011,April,14,Thursday,Workingday,Clear,0.56,0.5303,0.35,0.0896,36,101,137,137,627,137,1,2,3,123,0,729,175652,1,137
2011-04-14,summer,2011,April,15,Thursday,Workingday,Clear,0.6,0.6212,0.31,0.0896,57,85,142,142,627,142,1,2,3,123,2,729,183149,1,142
2011-04-14,summer,2011,April,16,Thursday,Workingday,Clear,0.6,0.6061,0.26,0.1045,49,153,202,202,627,202,1,3,3,133,2,730,227748,1,202
2011-04-14,summer,2011,April,17,Thursday,Workingday,Clear,0.6,0.6061,0.28,0.0,50,338,388,388,627,388,1,4,3,143,2,730,336860,1,388
2011-04-14,summer,2011,April,18,Thursday,Workingday,Clear,0.56,0.5303,0.3,0.0,47,290,337,337,627,337,1,4,3,143,2,728,309772,1,337
2011-04-14,summer,2011,April,19,Thursday,Workingday,Clear,0.54,0.5152,0.32,0.0,37,222,259,259,627,259,1,3,3,133,2,728,226789,1,259
2011-04-14,summer,2011,April,20,Thursday,Workingday,Clear,0.5,0.4848,0.51,0.194,22,147,169,169,627,169,1,3,2,132,0,728,164550,1,169
2011-04-14,summer,2011,April,21,Thursday,Workingday,Clear,0.46,0.4545,0.63,0.1343,19,126,145,145,627,145,1,3,2,132,0,728,125445,1,145
2011-04-14,summer,2011,April,22,Thursday,Workingday,Clear,0.48,0.4697,0.55,0.1045,22,82,104,104,627,104,1,2,2,122,0,728,95612,1,104
2011-04-14,summer,2011,April,23,Thursday,Workingday,Clear,0.46,0.4545,0.59,0.1045,7,40,47,47,627,47,1,2,2,122,0,728,63941,1,47
2011-04-15,summer,2011,April,0,Friday,Holiday,Clear,0.44,0.4394,0.67,0.0,6,21,27,27,626,27,1,1,2,112,0,726,39130,1,27
2011-04-15,summer,2011,April,1,Friday,Holiday,Clear,0.44,0.4394,0.62,0.0,6,9,15,15,626,15,1,1,2,112,0,724,24164,1,15
2011-04-15,summer,2011,April,2,Friday,Holiday,Clear,0.4,0.4091,0.76,0.0,8,10,18,18,626,18,1,1,2,112,0,715,16352,1,18
2011-04-15,summer,2011,April,3,Friday,Holiday,Clear,0.4,0.4091,0.76,0.0,0,3,3,3,626,3,1,1,2,112,0,697,8174,1,3
2011-04-15,summer,2011,April,4,Friday,Holiday,Clear,0.38,0.3939,0.82,0.0896,0,3,3,3,626,3,1,1,2,112,0,697,4428,1,3
2011-04-15,summer,2011,April,5,Friday,Holiday,Clear,0.36,0.3636,0.81,0.1045,2,11,13,13,626,13,1,1,2,112,0,717,14261,1,13
2011-04-15,summer,2011,April,6,Friday,Holiday,Clear,0.36,0.3636,0.81,0.0896,5,42,47,47,626,47,1,2,2,122,0,725,55132,1,47
2011-04-15,summer,2011,April,7,Friday,Holiday,Clear,0.4,0.4091,0.71,0.1642,10,139,149,149,626,149,1,3,2,132,1,727,154171,1,149
2011-04-15,summer,2011,April,8,Friday,Holiday,Clear,0.44,0.4394,0.62,0.2985,21,279,300,300,626,300,1,4,2,142,1,727,261001,1,300
2011-04-15,summer,2011,April,9,Friday,Holiday,Clear,0.5,0.4848,0.55,0.194,16,162,178,178,626,178,1,3,2,132,0,727,159438,1,178
2011-04-15,summer,2011,April,10,Friday,Holiday,Clear,0.5,0.4848,0.55,0.194,31,91,122,122,626,122,1,2,2,122,0,727,126257,1,122
2011-04-15,summer,2011,April,11,Friday,Holiday,Clear,0.52,0.5,0.55,0.194,41,95,136,136,626,136,1,2,3,123,0,727,151320,1,136
2011-04-15,summer,2011,April,12,Friday,Holiday,Clear,0.52,0.5,0.55,0.2836,45,155,200,200,626,200,1,3,3,133,0,728,184414,1,200
2011-04-15,summer,2011,April,13,Friday,Holiday,Clear,0.54,0.5152,0.52,0.2537,47,133,180,180,626,180,1,3,3,133,0,729,184919,1,180
2011-04-15,summer,2011,April,14,Friday,Holiday,Clear,0.54,0.5152,0.52,0.2537,57,106,163,163,626,163,1,3,3,133,2,729,175652,1,163
2011-04-15,summer,2011,April,15,Friday,Holiday,Clear,0.54,0.5152,0.52,0.4478,50,112,162,162,626,162,1,3,3,133,2,729,183149,1,162
2011-04-15,summer,2011,April,16,Friday,Holiday,Clear,0.52,0.5,0.55,0.4925,70,173,243,243,626,243,1,3,3,133,2,730,227748,1,243
2011-04-15,summer,2011,April,17,Friday,Holiday,Mist,0.5,0.4848,0.63,0.3881,64,267,331,331,626,331,1,4,2,142,2,730,336860,1,331
2011-04-15,summer,2011,April,18,Friday,Holiday,Mist,0.46,0.4545,0.67,0.3881,47,216,263,263,626,263,1,3,2,132,1,728,309772,1,263
2011-04-15,summer,2011,April,19,Friday,Holiday,Clear,0.42,0.4242,0.77,0.3881,41,168,209,209,626,209,1,3,2,132,1,728,226789,1,209
2011-04-15,summer,2011,April,20,Friday,Holiday,Mist,0.4,0.4091,0.76,0.3284,26,92,118,118,626,118,1,2,2,122,1,728,164550,1,118
2011-04-15,summer,2011,April,21,Friday,Holiday,Mist,0.4,0.4091,0.76,0.2985,25,77,102,102,626,102,1,2,2,122,1,728,125445,1,102
2011-04-15,summer,2011,April,22,Friday,Holiday,Mist,0.38,0.3939,0.82,0.3881,16,64,80,80,626,80,1,2,2,122,1,728,95612,1,80
2011-04-15,summer,2011,April,23,Friday,Holiday,Mist,0.36,0.3485,0.81,0.194,8,56,64,64,626,64,1,2,2,122,1,728,63941,1,64
2011-04-16,summer,2011,April,0,Saturday,Holiday,Mist,0.36,0.3485,0.81,0.2239,7,36,43,43,625,43,1,2,2,122,1,726,39130,1,43
2011-04-16,summer,2011,April,1,Saturday,Holiday,Mist,0.36,0.3333,0.87,0.2836,5,28,33,33,625,33,1,1,1,111,1,724,24164,1,33
2011-04-16,summer,2011,April,2,Saturday,Holiday,Mist,0.36,0.3485,0.87,0.1343,5,19,24,24,625,24,1,1,2,112,0,715,16352,1,24
2011-04-16,summer,2011,April,3,Saturday,Holiday,Mist,0.36,0.3485,0.87,0.1642,5,9,14,14,625,14,1,1,2,112,1,697,8174,1,14
2011-04-16,summer,2011,April,4,Saturday,Holiday,Mist,0.36,0.3485,0.87,0.2239,1,4,5,5,625,5,1,1,2,112,1,697,4428,1,5
2011-04-16,summer,2011,April,5,Saturday,Holiday,Mist,0.38,0.3939,0.87,0.2836,1,3,4,4,625,4,1,1,2,112,1,717,14261,1,4
2011-04-16,summer,2011,April,6,Saturday,Holiday,Light Snow,0.4,0.4091,0.82,0.3284,1,9,10,10,625,10,1,1,2,112,1,725,55132,1,10
2011-04-16,summer,2011,April,7,Saturday,Holiday,Mist,0.4,0.4091,0.82,0.4179,3,18,21,21,625,21,1,1,2,112,1,727,154171,1,21
2011-04-16,summer,2011,April,8,Saturday,Holiday,Light Snow,0.4,0.4091,0.87,0.3582,7,38,45,45,625,45,1,2,2,122,1,727,261001,1,45
2011-04-16,summer,2011,April,9,Saturday,Holiday,Light Snow,0.4,0.4091,1.0,0.2985,2,27,29,29,625,29,1,1,2,112,0,727,159438,1,29
2011-04-16,summer,2011,April,10,Saturday,Holiday,Light Snow,0.42,0.4242,0.94,0.3881,1,21,22,22,625,22,1,1,2,112,0,727,126257,1,22
2011-04-16,summer,2011,April,11,Saturday,Holiday,Light Snow,0.42,0.4242,0.94,0.4478,4,27,31,31,625,31,1,1,2,112,1,727,151320,1,31
2011-04-16,summer,2011,April,12,Saturday,Holiday,Mist,0.46,0.4545,0.88,0.5821,6,26,32,32,625,32,1,1,2,112,1,728,184414,1,32
2011-04-16,summer,2011,April,13,Saturday,Holiday,Light Snow,0.46,0.4545,0.94,0.5224,9,49,58,58,625,58,1,2,2,122,0,729,184919,1,58
2011-04-16,summer,2011,April,14,Saturday,Holiday,Light Snow,0.52,0.5,0.83,0.5821,14,49,63,63,625,63,1,2,3,123,0,729,175652,1,63
2011-04-16,summer,2011,April,15,Saturday,Holiday,Light Snow,0.52,0.5,0.83,0.5821,16,62,78,78,625,78,1,2,3,123,0,729,183149,1,78
2011-04-16,summer,2011,April,16,Saturday,Holiday,Light Snow,0.5,0.4848,0.88,0.4627,6,27,33,33,625,33,1,1,2,112,0,730,227748,1,33
2011-04-16,summer,2011,April,17,Saturday,Holiday,Light Snow,0.5,0.4848,0.88,0.5821,1,14,15,15,625,15,1,1,2,112,0,730,336860,1,15
2011-04-16,summer,2011,April,18,Saturday,Holiday,Mist,0.5,0.4848,0.94,0.3881,6,32,38,38,625,38,1,1,2,112,0,728,309772,1,38
2011-04-16,summer,2011,April,19,Saturday,Holiday,Mist,0.52,0.5,0.94,0.4179,9,62,71,71,625,71,1,2,3,123,0,728,226789,1,71
2011-04-16,summer,2011,April,20,Saturday,Holiday,Light Snow,0.44,0.4394,0.94,0.2239,4,49,53,53,625,53,1,2,2,122,0,728,164550,1,53
2011-04-16,summer,2011,April,21,Saturday,Holiday,Mist,0.44,0.4394,0.94,0.0,1,13,14,14,625,14,1,1,2,112,0,728,125445,1,14
2011-04-16,summer,2011,April,22,Saturday,Holiday,Light Snow,0.42,0.4242,1.0,0.0,2,22,24,24,625,24,1,1,2,112,0,728,95612,1,24
2011-04-16,summer,2011,April,23,Saturday,Holiday,Mist,0.44,0.4394,0.77,0.2836,5,30,35,35,625,35,1,1,2,112,0,728,63941,1,35
2011-04-17,summer,2011,April,0,Sunday,Holiday,Mist,0.44,0.4394,0.77,0.2836,4,29,33,33,624,33,1,1,2,112,0,726,39130,1,33
2011-04-17,summer,2011,April,1,Sunday,Holiday,Clear,0.42,0.4242,0.67,0.2239,6,25,31,31,624,31,1,1,2,112,1,724,24164,1,31
2011-04-17,summer,2011,April,2,Sunday,Holiday,Clear,0.4,0.4091,0.62,0.194,4,25,29,29,624,29,1,1,2,112,1,715,16352,1,29
2011-04-17,summer,2011,April,3,Sunday,Holiday,Clear,0.4,0.4091,0.66,0.1343,12,13,25,25,624,25,1,1,2,112,1,697,8174,1,25
2011-04-17,summer,2011,April,4,Sunday,Holiday,Clear,0.36,0.3636,0.76,0.1045,2,5,7,7,624,7,1,1,2,112,1,697,4428,1,7
2011-04-17,summer,2011,April,5,Sunday,Holiday,Clear,0.36,0.3485,0.71,0.1642,2,1,3,3,624,3,1,1,2,112,1,717,14261,1,3
2011-04-17,summer,2011,April,6,Sunday,Holiday,Clear,0.36,0.3182,0.66,0.4478,3,5,8,8,624,8,1,1,1,111,1,725,55132,1,8
2011-04-17,summer,2011,April,7,Sunday,Holiday,Clear,0.36,0.3333,0.5,0.3582,2,14,16,16,624,16,1,1,1,111,1,727,154171,1,16
2011-04-17,summer,2011,April,8,Sunday,Holiday,Clear,0.38,0.3939,0.46,0.3881,7,36,43,43,624,43,1,2,2,122,1,727,261001,1,43
2011-04-17,summer,2011,April,9,Sunday,Holiday,Clear,0.4,0.4091,0.43,0.2836,31,71,102,102,624,102,1,2,2,122,1,727,159438,1,102
2011-04-17,summer,2011,April,10,Sunday,Holiday,Clear,0.42,0.4242,0.44,0.4478,91,120,211,211,624,211,1,3,2,132,1,727,126257,1,211
2011-04-17,summer,2011,April,11,Sunday,Holiday,Clear,0.46,0.4545,0.41,0.4179,119,185,304,304,624,304,1,4,2,142,2,727,151320,1,304
2011-04-17,summer,2011,April,12,Sunday,Holiday,Clear,0.46,0.4545,0.38,0.3881,167,187,354,354,624,354,1,4,2,142,2,728,184414,1,354
2011-04-17,summer,2011,April,13,Sunday,Holiday,Clear,0.5,0.4848,0.34,0.3881,181,162,343,343,624,343,1,4,2,142,2,729,184919,1,343
2011-04-17,summer,2011,April,14,Sunday,Holiday,Clear,0.52,0.5,0.34,0.3881,170,191,361,361,624,361,1,4,3,143,2,729,175652,1,361
2011-04-17,summer,2011,April,15,Sunday,Holiday,Clear,0.54,0.5152,0.32,0.5224,179,209,388,388,624,388,1,4,3,143,2,729,183149,1,388
2011-04-17,summer,2011,April,16,Sunday,Holiday,Clear,0.54,0.5152,0.3,0.3582,161,182,343,343,624,343,1,4,3,143,2,730,227748,1,343
2011-04-17,summer,2011,April,17,Sunday,Holiday,Clear,0.56,0.5303,0.3,0.4478,143,163,306,306,624,306,1,4,3,143,2,730,336860,1,306
2011-04-17,summer,2011,April,18,Sunday,Holiday,Clear,0.56,0.5303,0.3,0.3881,102,175,277,277,624,277,1,3,3,133,2,728,309772,1,277
2011-04-17,summer,2011,April,19,Sunday,Holiday,Clear,0.56,0.5303,0.3,0.2985,75,135,210,210,624,210,1,3,3,133,2,728,226789,1,210
2011-04-17,summer,2011,April,20,Sunday,Holiday,Clear,0.52,0.5,0.36,0.194,44,97,141,141,624,141,1,2,3,123,1,728,164550,1,141
2011-04-17,summer,2011,April,21,Sunday,Holiday,Clear,0.5,0.4848,0.42,0.194,13,70,83,83,624,83,1,2,2,122,1,728,125445,1,83
2011-04-17,summer,2011,April,22,Sunday,Holiday,Clear,0.5,0.4848,0.39,0.1045,21,49,70,70,624,70,1,2,2,122,1,728,95612,1,70
2011-04-17,summer,2011,April,23,Sunday,Holiday,Clear,0.44,0.4394,0.67,0.1642,19,37,56,56,624,56,1,2,2,122,0,728,63941,1,56
2011-04-18,summer,2011,April,0,Monday,Workingday,Clear,0.46,0.4545,0.47,0.0896,15,24,39,39,623,39,1,1,2,112,1,726,39130,1,39
2011-04-18,summer,2011,April,1,Monday,Workingday,Clear,0.46,0.4545,0.47,0.1343,11,8,19,19,623,19,1,1,2,112,1,724,24164,1,19
2011-04-18,summer,2011,April,2,Monday,Workingday,Clear,0.42,0.4242,0.67,0.1045,14,2,16,16,623,16,1,1,2,112,0,715,16352,1,16
2011-04-18,summer,2011,April,3,Monday,Workingday,Clear,0.42,0.4242,0.62,0.1045,6,1,7,7,623,7,1,1,2,112,0,697,8174,1,7
2011-04-18,summer,2011,April,4,Monday,Workingday,Clear,0.4,0.4091,0.87,0.1642,2,4,6,6,623,6,1,1,2,112,0,697,4428,1,6
2011-04-18,summer,2011,April,5,Monday,Workingday,Clear,0.4,0.4091,0.76,0.0896,0,16,16,16,623,16,1,1,2,112,0,717,14261,1,16
2011-04-18,summer,2011,April,6,Monday,Workingday,Clear,0.4,0.4091,0.82,0.0,3,51,54,54,623,54,1,2,2,122,0,725,55132,1,54
2011-04-18,summer,2011,April,7,Monday,Workingday,Clear,0.46,0.4545,0.63,0.0,12,156,168,168,623,168,1,3,2,132,0,727,154171,1,168
2011-04-18,summer,2011,April,8,Monday,Workingday,Clear,0.46,0.4545,0.63,0.0,20,277,297,297,623,297,1,4,2,142,0,727,261001,1,297
2011-04-18,summer,2011,April,9,Monday,Workingday,Mist,0.5,0.4848,0.55,0.1045,37,132,169,169,623,169,1,3,2,132,0,727,159438,1,169
2011-04-18,summer,2011,April,10,Monday,Workingday,Mist,0.52,0.5,0.55,0.1045,41,68,109,109,623,109,1,2,3,123,0,727,126257,1,109
2011-04-18,summer,2011,April,11,Monday,Workingday,Mist,0.54,0.5152,0.52,0.0896,36,87,123,123,623,123,1,2,3,123,0,727,151320,1,123
2011-04-18,summer,2011,April,12,Monday,Workingday,Mist,0.56,0.5303,0.49,0.0896,60,124,184,184,623,184,1,3,3,133,0,728,184414,1,184
2011-04-18,summer,2011,April,13,Monday,Workingday,Mist,0.56,0.5303,0.49,0.1642,41,128,169,169,623,169,1,3,3,133,0,729,184919,1,169
2011-04-18,summer,2011,April,14,Monday,Workingday,Mist,0.58,0.5455,0.49,0.194,49,95,144,144,623,144,1,3,3,133,0,729,175652,1,144
2011-04-18,summer,2011,April,15,Monday,Workingday,Mist,0.6,0.6212,0.43,0.194,64,112,176,176,623,176,1,3,3,133,2,729,183149,1,176
2011-04-18,summer,2011,April,16,Monday,Workingday,Clear,0.6,0.6212,0.46,0.2836,40,165,205,205,623,205,1,3,3,133,2,730,227748,1,205
2011-04-18,summer,2011,April,17,Monday,Workingday,Clear,0.58,0.5455,0.49,0.2836,66,362,428,428,623,428,1,4,3,143,2,730,336860,1,428
2011-04-18,summer,2011,April,18,Monday,Workingday,Clear,0.64,0.6212,0.31,0.3582,41,321,362,362,623,362,1,4,3,143,2,728,309772,1,362
2011-04-18,summer,2011,April,19,Monday,Workingday,Clear,0.56,0.5303,0.46,0.2537,42,244,286,286,623,286,1,4,3,143,2,728,226789,1,286
2011-04-18,summer,2011,April,20,Monday,Workingday,Clear,0.6,0.6212,0.33,0.2985,29,136,165,165,623,165,1,3,3,133,2,728,164550,1,165
2011-04-18,summer,2011,April,21,Monday,Workingday,Clear,0.56,0.5303,0.37,0.2836,20,131,151,151,623,151,1,3,3,133,2,728,125445,1,151
2011-04-18,summer,2011,April,22,Monday,Workingday,Clear,0.52,0.5,0.55,0.2836,9,81,90,90,623,90,1,2,3,123,0,728,95612,1,90
2011-04-18,summer,2011,April,23,Monday,Workingday,Clear,0.5,0.4848,0.59,0.2537,11,35,46,46,623,46,1,2,2,122,0,728,63941,1,46
2011-04-19,summer,2011,April,0,Tuesday,Workingday,Clear,0.5,0.4848,0.55,0.2239,2,23,25,25,622,25,1,1,2,112,0,726,39130,1,25
2011-04-19,summer,2011,April,1,Tuesday,Workingday,Clear,0.46,0.4545,0.63,0.2239,5,2,7,7,622,7,1,1,2,112,0,724,24164,1,7
2011-04-19,summer,2011,April,2,Tuesday,Workingday,Clear,0.46,0.4545,0.67,0.2836,8,5,13,13,622,13,1,1,2,112,1,715,16352,1,13
2011-04-19,summer,2011,April,3,Tuesday,Workingday,Clear,0.48,0.4697,0.63,0.2239,0,3,3,3,622,3,1,1,2,112,0,697,8174,1,3
2011-04-19,summer,2011,April,4,Tuesday,Workingday,Clear,0.46,0.4545,0.67,0.0896,1,4,5,5,622,5,1,1,2,112,0,697,4428,1,5
2011-04-19,summer,2011,April,5,Tuesday,Workingday,Mist,0.46,0.4545,0.72,0.194,1,17,18,18,622,18,1,1,2,112,0,717,14261,1,18
2011-04-19,summer,2011,April,6,Tuesday,Workingday,Mist,0.48,0.4697,0.67,0.0,2,63,65,65,622,65,1,2,2,122,0,725,55132,1,65
2011-04-19,summer,2011,April,7,Tuesday,Workingday,Mist,0.52,0.5,0.55,0.0,22,166,188,188,622,188,1,3,3,133,0,727,154171,1,188
2011-04-19,summer,2011,April,8,Tuesday,Workingday,Mist,0.5,0.4848,0.68,0.1343,20,331,351,351,622,351,1,4,2,142,0,727,261001,1,351
2011-04-19,summer,2011,April,9,Tuesday,Workingday,Light Snow,0.52,0.5,0.63,0.0896,23,139,162,162,622,162,1,3,3,133,0,727,159438,1,162
2011-04-19,summer,2011,April,10,Tuesday,Workingday,Mist,0.5,0.4848,0.72,0.2239,15,60,75,75,622,75,1,2,2,122,0,727,126257,1,75
2011-04-19,summer,2011,April,11,Tuesday,Workingday,Mist,0.54,0.5152,0.68,0.1642,19,53,72,72,622,72,1,2,3,123,0,727,151320,1,72
2011-04-19,summer,2011,April,12,Tuesday,Workingday,Mist,0.54,0.5152,0.64,0.0896,19,84,103,103,622,103,1,2,3,123,0,728,184414,1,103
2011-04-19,summer,2011,April,13,Tuesday,Workingday,Mist,0.54,0.5152,0.68,0.2239,26,103,129,129,622,129,1,2,3,123,0,729,184919,1,129
2011-04-19,summer,2011,April,14,Tuesday,Workingday,Mist,0.54,0.5152,0.64,0.194,19,88,107,107,622,107,1,2,3,123,0,729,175652,1,107
2011-04-19,summer,2011,April,15,Tuesday,Workingday,Mist,0.54,0.5152,0.65,0.1642,44,83,127,127,622,127,1,2,3,123,0,729,183149,1,127
2011-04-19,summer,2011,April,16,Tuesday,Workingday,Clear,0.56,0.5303,0.52,0.2985,30,162,192,192,622,192,1,3,3,133,2,730,227748,1,192
2011-04-19,summer,2011,April,17,Tuesday,Workingday,Clear,0.56,0.5303,0.6,0.1045,39,372,411,411,622,411,1,4,3,143,2,730,336860,1,411
2011-04-19,summer,2011,April,18,Tuesday,Workingday,Mist,0.54,0.5152,0.64,0.1343,44,377,421,421,622,421,1,4,3,143,2,728,309772,1,421
2011-04-19,summer,2011,April,19,Tuesday,Workingday,Mist,0.5,0.4848,0.72,0.194,28,248,276,276,622,276,1,3,2,132,0,728,226789,1,276
2011-04-19,summer,2011,April,20,Tuesday,Workingday,Mist,0.5,0.4848,0.72,0.2239,20,148,168,168,622,168,1,3,2,132,0,728,164550,1,168
2011-04-19,summer,2011,April,21,Tuesday,Workingday,Mist,0.5,0.4848,0.72,0.1343,8,114,122,122,622,122,1,2,2,122,0,728,125445,1,122
2011-04-19,summer,2011,April,22,Tuesday,Workingday,Clear,0.48,0.4697,0.77,0.0896,3,109,112,112,622,112,1,2,2,122,0,728,95612,1,112
2011-04-19,summer,2011,April,23,Tuesday,Workingday,Clear,0.46,0.4545,0.88,0.0896,11,41,52,52,622,52,1,2,2,122,0,728,63941,1,52
2011-04-20,summer,2011,April,0,Wednesday,Workingday,Clear,0.44,0.4394,0.88,0.1343,4,29,33,33,621,33,1,1,2,112,0,726,39130,1,33
2011-04-20,summer,2011,April,1,Wednesday,Workingday,Clear,0.42,0.4242,0.94,0.1642,2,5,7,7,621,7,1,1,2,112,0,724,24164,1,7
2011-04-20,summer,2011,April,2,Wednesday,Workingday,Clear,0.42,0.4242,0.94,0.1642,0,2,2,2,621,2,1,1,2,112,0,715,16352,1,2
2011-04-20,summer,2011,April,3,Wednesday,Workingday,Clear,0.42,0.4242,0.94,0.0,0,2,2,2,621,2,1,1,2,112,0,697,8174,1,2
2011-04-20,summer,2011,April,4,Wednesday,Workingday,Clear,0.4,0.4091,1.0,0.1045,5,4,9,9,621,9,1,1,2,112,0,697,4428,1,9
2011-04-20,summer,2011,April,5,Wednesday,Workingday,Clear,0.4,0.4091,0.94,0.194,1,14,15,15,621,15,1,1,2,112,0,717,14261,1,15
2011-04-20,summer,2011,April,6,Wednesday,Workingday,Clear,0.42,0.4242,0.94,0.1642,2,62,64,64,621,64,1,2,2,122,0,725,55132,1,64
2011-04-20,summer,2011,April,7,Wednesday,Workingday,Clear,0.44,0.4394,0.94,0.0,26,211,237,237,621,237,1,3,2,132,0,727,154171,1,237
2011-04-20,summer,2011,April,8,Wednesday,Workingday,Clear,0.62,0.6061,0.69,0.4627,22,374,396,396,621,396,1,4,3,143,2,727,261001,1,396
2011-04-20,summer,2011,April,9,Wednesday,Workingday,Clear,0.66,0.6212,0.61,0.2836,27,170,197,197,621,197,1,3,3,133,0,727,159438,1,197
2011-04-20,summer,2011,April,10,Wednesday,Workingday,Clear,0.62,0.6061,0.69,0.0896,45,86,131,131,621,131,1,2,3,123,0,727,126257,1,131
2011-04-20,summer,2011,April,11,Wednesday,Workingday,Clear,0.62,0.6061,0.69,0.0896,31,87,118,118,621,118,1,2,3,123,0,727,151320,1,118
2011-04-20,summer,2011,April,12,Wednesday,Workingday,Clear,0.7,0.6515,0.48,0.3881,28,117,145,145,621,145,1,3,4,134,2,728,184414,1,145
2011-04-20,summer,2011,April,13,Wednesday,Workingday,Clear,0.7,0.6515,0.48,0.3881,42,135,177,177,621,177,1,3,4,134,2,729,184919,1,177
2011-04-20,summer,2011,April,14,Wednesday,Workingday,Clear,0.74,0.6515,0.4,0.4627,33,115,148,148,621,148,1,3,4,134,2,729,175652,1,148
2011-04-20,summer,2011,April,15,Wednesday,Workingday,Mist,0.76,0.6667,0.35,0.3582,32,113,145,145,621,145,1,3,4,134,2,729,183149,1,145
2011-04-20,summer,2011,April,16,Wednesday,Workingday,Mist,0.76,0.6667,0.35,0.3582,54,201,255,255,621,255,1,3,4,134,2,730,227748,1,255
2011-04-20,summer,2011,April,17,Wednesday,Workingday,Mist,0.74,0.6515,0.37,0.4179,34,398,432,432,621,432,1,4,4,144,2,730,336860,1,432
2011-04-20,summer,2011,April,18,Wednesday,Workingday,Clear,0.74,0.6515,0.3,0.3582,56,385,441,441,621,441,1,4,4,144,2,728,309772,1,441
2011-04-20,summer,2011,April,19,Wednesday,Workingday,Clear,0.7,0.6364,0.32,0.2537,74,309,383,383,621,383,1,4,4,144,2,728,226789,1,383
2011-04-20,summer,2011,April,20,Wednesday,Workingday,Clear,0.68,0.6212,0.32,0.1045,31,194,225,225,621,225,1,3,3,133,2,728,164550,1,225
2011-04-20,summer,2011,April,21,Wednesday,Workingday,Clear,0.66,0.6212,0.36,0.2836,38,134,172,172,621,172,1,3,3,133,2,728,125445,1,172
2011-04-20,summer,2011,April,22,Wednesday,Workingday,Clear,0.62,0.6212,0.41,0.2537,12,105,117,117,621,117,1,2,3,123,2,728,95612,1,117
2011-04-20,summer,2011,April,23,Wednesday,Workingday,Clear,0.6,0.6212,0.4,0.3284,14,79,93,93,621,93,1,2,3,123,2,728,63941,1,93
2011-04-21,summer,2011,April,0,Thursday,Workingday,Clear,0.56,0.5303,0.43,0.3582,11,33,44,44,620,44,1,2,3,123,1,726,39130,1,44
2011-04-21,summer,2011,April,1,Thursday,Workingday,Clear,0.52,0.5,0.45,0.2239,6,20,26,26,620,26,1,1,3,113,1,724,24164,1,26
2011-04-21,summer,2011,April,2,Thursday,Workingday,Clear,0.5,0.4848,0.42,0.3881,3,10,13,13,620,13,1,1,2,112,1,715,16352,1,13
2011-04-21,summer,2011,April,3,Thursday,Workingday,Mist,0.46,0.4545,0.51,0.4627,4,3,7,7,620,7,1,1,2,112,1,697,8174,1,7
2011-04-21,summer,2011,April,4,Thursday,Workingday,Mist,0.44,0.4394,0.54,0.4478,2,4,6,6,620,6,1,1,2,112,1,697,4428,1,6
2011-04-21,summer,2011,April,5,Thursday,Workingday,Mist,0.42,0.4242,0.54,0.5522,0,14,14,14,620,14,1,1,2,112,1,717,14261,1,14
2011-04-21,summer,2011,April,6,Thursday,Workingday,Mist,0.4,0.4091,0.58,0.5821,2,73,75,75,620,75,1,2,2,122,1,725,55132,1,75
2011-04-21,summer,2011,April,7,Thursday,Workingday,Mist,0.42,0.4242,0.47,0.4627,15,183,198,198,620,198,1,3,2,132,1,727,154171,1,198
2011-04-21,summer,2011,April,8,Thursday,Workingday,Mist,0.4,0.4091,0.5,0.4925,19,346,365,365,620,365,1,4,2,142,1,727,261001,1,365
2011-04-21,summer,2011,April,9,Thursday,Workingday,Mist,0.42,0.4242,0.47,0.2836,18,178,196,196,620,196,1,3,2,132,1,727,159438,1,196
2011-04-21,summer,2011,April,10,Thursday,Workingday,Clear,0.42,0.4242,0.44,0.3582,25,73,98,98,620,98,1,2,2,122,1,727,126257,1,98
2011-04-21,summer,2011,April,11,Thursday,Workingday,Clear,0.44,0.4394,0.41,0.2836,34,99,133,133,620,133,1,2,2,122,1,727,151320,1,133
2011-04-21,summer,2011,April,12,Thursday,Workingday,Clear,0.46,0.4545,0.38,0.1642,49,150,199,199,620,199,1,3,2,132,1,728,184414,1,199
2011-04-21,summer,2011,April,13,Thursday,Workingday,Clear,0.48,0.4697,0.33,0.3284,55,122,177,177,620,177,1,3,2,132,1,729,184919,1,177
2011-04-21,summer,2011,April,14,Thursday,Workingday,Clear,0.5,0.4848,0.34,0.3881,68,160,228,228,620,228,1,3,2,132,2,729,175652,1,228
2011-04-21,summer,2011,April,15,Thursday,Workingday,Clear,0.52,0.5,0.29,0.4179,69,166,235,235,620,235,1,3,3,133,2,729,183149,1,235
2011-04-21,summer,2011,April,16,Thursday,Workingday,Clear,0.52,0.5,0.27,0.3582,66,228,294,294,620,294,1,4,3,143,2,730,227748,1,294
2011-04-21,summer,2011,April,17,Thursday,Workingday,Clear,0.5,0.4848,0.29,0.1642,79,402,481,481,620,481,1,4,2,142,2,730,336860,1,481
2011-04-21,summer,2011,April,18,Thursday,Workingday,Clear,0.5,0.4848,0.25,0.2836,71,381,452,452,620,452,1,4,2,142,2,728,309772,1,452
2011-04-21,summer,2011,April,19,Thursday,Workingday,Clear,0.46,0.4545,0.28,0.2836,52,272,324,324,620,324,1,4,2,142,2,728,226789,1,324
2011-04-21,summer,2011,April,20,Thursday,Workingday,Clear,0.44,0.4394,0.3,0.1343,28,176,204,204,620,204,1,3,2,132,1,728,164550,1,204
2011-04-21,summer,2011,April,21,Thursday,Workingday,Clear,0.42,0.4242,0.47,0.194,25,159,184,184,620,184,1,3,2,132,1,728,125445,1,184
2011-04-21,summer,2011,April,22,Thursday,Workingday,Clear,0.42,0.4242,0.38,0.0896,31,106,137,137,620,137,1,2,2,122,1,728,95612,1,137
2011-04-21,summer,2011,April,23,Thursday,Workingday,Clear,0.4,0.4091,0.43,0.1045,13,86,99,99,620,99,1,2,2,122,1,728,63941,1,99
2011-04-22,summer,2011,April,0,Friday,Workingday,Clear,0.36,0.3485,0.62,0.194,3,30,33,33,619,33,1,1,2,112,1,726,39130,1,33
2011-04-22,summer,2011,April,1,Friday,Workingday,Clear,0.36,0.3333,0.53,0.2537,2,22,24,24,619,24,1,1,1,111,1,724,24164,1,24
2011-04-22,summer,2011,April,2,Friday,Workingday,Clear,0.36,0.3333,0.53,0.2985,2,7,9,9,619,9,1,1,1,111,1,715,16352,1,9
2011-04-22,summer,2011,April,3,Friday,Workingday,Clear,0.36,0.3333,0.53,0.2985,0,2,2,2,619,2,1,1,1,111,1,697,8174,1,2
2011-04-22,summer,2011,April,4,Friday,Workingday,Clear,0.34,0.3182,0.53,0.2836,1,2,3,3,619,3,1,1,1,111,1,697,4428,1,3
2011-04-22,summer,2011,April,5,Friday,Workingday,Clear,0.34,0.3182,0.53,0.2239,0,16,16,16,619,16,1,1,1,111,1,717,14261,1,16
2011-04-22,summer,2011,April,6,Friday,Workingday,Clear,0.34,0.3182,0.53,0.2836,2,47,49,49,619,49,1,2,1,121,1,725,55132,1,49
2011-04-22,summer,2011,April,7,Friday,Workingday,Mist,0.34,0.3182,0.53,0.2836,5,175,180,180,619,180,1,3,1,131,1,727,154171,1,180
2011-04-22,summer,2011,April,8,Friday,Workingday,Mist,0.34,0.3182,0.53,0.2537,15,331,346,346,619,346,1,4,1,141,1,727,261001,1,346
2011-04-22,summer,2011,April,9,Friday,Workingday,Light Snow,0.34,0.303,0.61,0.2985,17,178,195,195,619,195,1,3,1,131,1,727,159438,1,195
2011-04-22,summer,2011,April,10,Friday,Workingday,Mist,0.36,0.3485,0.62,0.194,32,104,136,136,619,136,1,2,2,122,1,727,126257,1,136
2011-04-22,summer,2011,April,11,Friday,Workingday,Light Snow,0.34,0.3333,0.66,0.194,23,83,106,106,619,106,1,2,1,121,1,727,151320,1,106
2011-04-22,summer,2011,April,12,Friday,Workingday,Light Snow,0.34,0.3333,0.76,0.1343,19,61,80,80,619,80,1,2,1,121,1,728,184414,1,80
2011-04-22,summer,2011,April,13,Friday,Workingday,Light Snow,0.34,0.3333,0.87,0.194,3,37,40,40,619,40,1,1,1,111,1,729,184919,1,40
2011-04-22,summer,2011,April,14,Friday,Workingday,Light Snow,0.34,0.3182,0.87,0.2537,3,33,36,36,619,36,1,1,1,111,1,729,175652,1,36
2011-04-22,summer,2011,April,15,Friday,Workingday,Light Snow,0.34,0.3333,0.87,0.194,13,62,75,75,619,75,1,2,1,121,1,729,183149,1,75
2011-04-22,summer,2011,April,16,Friday,Workingday,Light Snow,0.34,0.3333,0.87,0.1343,4,58,62,62,619,62,1,2,1,121,1,730,227748,1,62
2011-04-22,summer,2011,April,17,Friday,Workingday,Light Snow,0.32,0.303,0.93,0.2239,6,63,69,69,619,69,1,2,1,121,1,730,336860,1,69
2011-04-22,summer,2011,April,18,Friday,Workingday,Light Snow,0.32,0.303,0.93,0.2239,4,47,51,51,619,51,1,2,1,121,1,728,309772,1,51
2011-04-22,summer,2011,April,19,Friday,Workingday,Light Snow,0.32,0.303,0.93,0.2239,7,48,55,55,619,55,1,2,1,121,1,728,226789,1,55
2011-04-22,summer,2011,April,20,Friday,Workingday,Light Snow,0.32,0.303,0.87,0.2239,8,39,47,47,619,47,1,2,1,121,1,728,164550,1,47
2011-04-22,summer,2011,April,21,Friday,Workingday,Light Snow,0.3,0.303,0.93,0.1642,5,23,28,28,619,28,1,1,1,111,1,728,125445,1,28
2011-04-22,summer,2011,April,22,Friday,Workingday,Light Snow,0.3,0.303,1.0,0.1343,3,21,24,24,619,24,1,1,1,111,0,728,95612,1,24
2011-04-22,summer,2011,April,23,Friday,Workingday,Light Snow,0.32,0.3333,0.93,0.1045,0,17,17,17,619,17,1,1,1,111,0,728,63941,1,17
2011-04-23,summer,2011,April,0,Saturday,Holiday,Mist,0.32,0.3182,1.0,0.194,0,18,18,18,618,18,1,1,1,111,1,726,39130,1,18
2011-04-23,summer,2011,April,1,Saturday,Holiday,Mist,0.32,0.3182,1.0,0.194,5,11,16,16,618,16,1,1,1,111,1,724,24164,1,16
2011-04-23,summer,2011,April,2,Saturday,Holiday,Light Snow,0.32,0.3333,1.0,0.1343,3,14,17,17,618,17,1,1,1,111,0,715,16352,1,17
2011-04-23,summer,2011,April,3,Saturday,Holiday,Light Snow,0.32,0.3333,1.0,0.0896,0,4,4,4,618,4,1,1,1,111,0,697,8174,1,4
2011-04-23,summer,2011,April,4,Saturday,Holiday,Light Snow,0.34,0.3636,1.0,0.0,2,3,5,5,618,5,1,1,2,112,0,697,4428,1,5
2011-04-23,summer,2011,April,5,Saturday,Holiday,Light Snow,0.34,0.3636,1.0,0.0,1,6,7,7,618,7,1,1,2,112,0,717,14261,1,7
2011-04-23,summer,2011,April,6,Saturday,Holiday,Mist,0.34,0.3333,1.0,0.1642,0,11,11,11,618,11,1,1,1,111,0,725,55132,1,11
2011-04-23,summer,2011,April,7,Saturday,Holiday,Light Snow,0.34,0.3333,1.0,0.1642,2,17,19,19,618,19,1,1,1,111,0,727,154171,1,19
2011-04-23,summer,2011,April,8,Saturday,Holiday,Mist,0.36,0.3333,1.0,0.2537,15,32,47,47,618,47,1,2,1,121,0,727,261001,1,47
2011-04-23,summer,2011,April,9,Saturday,Holiday,Mist,0.38,0.3939,0.94,0.2985,13,55,68,68,618,68,1,2,2,122,0,727,159438,1,68
2011-04-23,summer,2011,April,10,Saturday,Holiday,Mist,0.42,0.4242,0.88,0.2239,36,93,129,129,618,129,1,2,2,122,0,727,126257,1,129
2011-04-23,summer,2011,April,11,Saturday,Holiday,Mist,0.46,0.4545,0.88,0.2239,68,164,232,232,618,232,1,3,2,132,0,727,151320,1,232
2011-04-23,summer,2011,April,12,Saturday,Holiday,Clear,0.52,0.5,0.83,0.4179,94,197,291,291,618,291,1,4,3,143,2,728,184414,1,291
2011-04-23,summer,2011,April,13,Saturday,Holiday,Clear,0.52,0.5,0.83,0.3881,126,186,312,312,618,312,1,4,3,143,2,729,184919,1,312
2011-04-23,summer,2011,April,14,Saturday,Holiday,Clear,0.58,0.5455,0.78,0.3582,182,209,391,391,618,391,1,4,3,143,2,729,175652,1,391
2011-04-23,summer,2011,April,15,Saturday,Holiday,Clear,0.6,0.5909,0.73,0.3881,171,226,397,397,618,397,1,4,3,143,2,729,183149,1,397
2011-04-23,summer,2011,April,16,Saturday,Holiday,Clear,0.6,0.5909,0.73,0.2836,180,246,426,426,618,426,1,4,3,143,2,730,227748,1,426
2011-04-23,summer,2011,April,17,Saturday,Holiday,Clear,0.6,0.5909,0.73,0.3284,168,215,383,383,618,383,1,4,3,143,2,730,336860,1,383
2011-04-23,summer,2011,April,18,Saturday,Holiday,Clear,0.58,0.5455,0.78,0.194,149,227,376,376,618,376,1,4,3,143,2,728,309772,1,376
2011-04-23,summer,2011,April,19,Saturday,Holiday,Clear,0.56,0.5303,0.83,0.2836,84,199,283,283,618,283,1,4,3,143,0,728,226789,1,283
2011-04-23,summer,2011,April,20,Saturday,Holiday,Mist,0.54,0.5152,0.88,0.2537,45,138,183,183,618,183,1,3,3,133,0,728,164550,1,183
2011-04-23,summer,2011,April,21,Saturday,Holiday,Mist,0.56,0.5303,0.83,0.2836,32,103,135,135,618,135,1,2,3,123,0,728,125445,1,135
2011-04-23,summer,2011,April,22,Saturday,Holiday,Mist,0.58,0.5455,0.78,0.2537,55,114,169,169,618,169,1,3,3,133,0,728,95612,1,169
2011-04-23,summer,2011,April,23,Saturday,Holiday,Mist,0.54,0.5152,0.88,0.1642,31,86,117,117,618,117,1,2,3,123,0,728,63941,1,117
2011-04-24,summer,2011,April,0,Sunday,Holiday,Clear,0.52,0.5,0.83,0.2239,30,66,96,96,617,96,1,2,3,123,0,726,39130,1,96
2011-04-24,summer,2011,April,1,Sunday,Holiday,Clear,0.5,0.4848,0.88,0.194,14,40,54,54,617,54,1,2,2,122,0,724,24164,1,54
2011-04-24,summer,2011,April,2,Sunday,Holiday,Clear,0.5,0.4848,0.88,0.194,27,45,72,72,617,72,1,2,2,122,0,715,16352,1,72
2011-04-24,summer,2011,April,3,Sunday,Holiday,Clear,0.5,0.4848,0.94,0.0896,4,20,24,24,617,24,1,1,2,112,0,697,8174,1,24
2011-04-24,summer,2011,April,4,Sunday,Holiday,Clear,0.5,0.4848,0.94,0.0896,0,5,5,5,617,5,1,1,2,112,0,697,4428,1,5
2011-04-24,summer,2011,April,5,Sunday,Holiday,Clear,0.5,0.4848,0.94,0.0896,5,7,12,12,617,12,1,1,2,112,0,717,14261,1,12
2011-04-24,summer,2011,April,6,Sunday,Holiday,Mist,0.5,0.4848,1.0,0.0,10,3,13,13,617,13,1,1,2,112,0,725,55132,1,13
2011-04-24,summer,2011,April,7,Sunday,Holiday,Mist,0.5,0.4848,1.0,0.0,16,11,27,27,617,27,1,1,2,112,0,727,154171,1,27
2011-04-24,summer,2011,April,8,Sunday,Holiday,Clear,0.52,0.5,0.94,0.2239,38,42,80,80,617,80,1,2,3,123,0,727,261001,1,80
2011-04-24,summer,2011,April,9,Sunday,Holiday,Clear,0.56,0.5303,0.88,0.2537,73,104,177,177,617,177,1,3,3,133,0,727,159438,1,177
2011-04-24,summer,2011,April,10,Sunday,Holiday,Clear,0.6,0.5758,0.78,0.1642,118,171,289,289,617,289,1,4,3,143,2,727,126257,1,289
2011-04-24,summer,2011,April,11,Sunday,Holiday,Clear,0.66,0.6212,0.65,0.1343,124,193,317,317,617,317,1,4,3,143,2,727,151320,1,317
2011-04-24,summer,2011,April,12,Sunday,Holiday,Clear,0.68,0.6364,0.65,0.2537,168,220,388,388,617,388,1,4,4,144,2,728,184414,1,388
2011-04-24,summer,2011,April,13,Sunday,Holiday,Clear,0.7,0.6515,0.58,0.2836,205,236,441,441,617,441,1,4,4,144,2,729,184919,1,441
2011-04-24,summer,2011,April,14,Sunday,Holiday,Clear,0.7,0.6515,0.54,0.3284,197,223,420,420,617,420,1,4,4,144,2,729,175652,1,420
2011-04-24,summer,2011,April,15,Sunday,Holiday,Clear,0.66,0.6212,0.61,0.2537,167,202,369,369,617,369,1,4,3,143,2,729,183149,1,369
2011-04-24,summer,2011,April,16,Sunday,Holiday,Clear,0.74,0.6667,0.48,0.3881,162,197,359,359,617,359,1,4,4,144,2,730,227748,1,359
2011-04-24,summer,2011,April,17,Sunday,Holiday,Clear,0.66,0.6212,0.65,0.2985,142,189,331,331,617,331,1,4,3,143,2,730,336860,1,331
2011-04-24,summer,2011,April,18,Sunday,Holiday,Clear,0.64,0.6061,0.69,0.1642,96,174,270,270,617,270,1,3,3,133,2,728,309772,1,270
2011-04-24,summer,2011,April,19,Sunday,Holiday,Light Snow,0.6,0.5606,0.83,0.2836,62,132,194,194,617,194,1,3,3,133,0,728,226789,1,194
2011-04-24,summer,2011,April,20,Sunday,Holiday,Light Snow,0.6,0.5606,0.83,0.2836,34,71,105,105,617,105,1,2,3,123,0,728,164550,1,105
2011-04-24,summer,2011,April,21,Sunday,Holiday,Light Snow,0.54,0.5152,0.94,0.1642,8,53,61,61,617,61,1,2,3,123,0,728,125445,1,61
2011-04-24,summer,2011,April,22,Sunday,Holiday,Light Snow,0.54,0.5152,1.0,0.1642,5,40,45,45,617,45,1,2,3,123,0,728,95612,1,45
2011-04-24,summer,2011,April,23,Sunday,Holiday,Light Snow,0.54,0.5152,1.0,0.0896,5,37,42,42,617,42,1,2,3,123,0,728,63941,1,42
2011-04-25,summer,2011,April,0,Monday,Workingday,Light Snow,0.52,0.5,1.0,0.0,2,10,12,12,616,12,1,1,3,113,0,726,39130,1,12
2011-04-25,summer,2011,April,1,Monday,Workingday,Clear,0.54,0.5152,1.0,0.0896,2,8,10,10,616,10,1,1,3,113,0,724,24164,1,10
2011-04-25,summer,2011,April,2,Monday,Workingday,Clear,0.54,0.5152,1.0,0.0896,1,9,10,10,616,10,1,1,3,113,0,715,16352,1,10
2011-04-25,summer,2011,April,3,Monday,Workingday,Mist,0.5,0.4848,1.0,0.1045,2,8,10,10,616,10,1,1,2,112,0,697,8174,1,10
2011-04-25,summer,2011,April,4,Monday,Workingday,Mist,0.52,0.5,1.0,0.0,1,4,5,5,616,5,1,1,3,113,0,697,4428,1,5
2011-04-25,summer,2011,April,5,Monday,Workingday,Mist,0.46,0.4545,1.0,0.0,3,14,17,17,616,17,1,1,2,112,0,717,14261,1,17
2011-04-25,summer,2011,April,6,Monday,Workingday,Mist,0.5,0.4848,1.0,0.0,7,59,66,66,616,66,1,2,2,122,0,725,55132,1,66
2011-04-25,summer,2011,April,7,Monday,Workingday,Mist,0.52,0.5,1.0,0.0896,13,183,196,196,616,196,1,3,3,133,0,727,154171,1,196
2011-04-25,summer,2011,April,8,Monday,Workingday,Clear,0.56,0.5303,0.88,0.1045,27,326,353,353,616,353,1,4,3,143,0,727,261001,1,353
2011-04-25,summer,2011,April,9,Monday,Workingday,Clear,0.6,0.5606,0.83,0.1343,27,147,174,174,616,174,1,3,3,133,0,727,159438,1,174
2011-04-25,summer,2011,April,10,Monday,Workingday,Clear,0.64,0.6061,0.73,0.2239,61,64,125,125,616,125,1,2,3,123,0,727,126257,1,125
2011-04-25,summer,2011,April,11,Monday,Workingday,Clear,0.64,0.6061,0.73,0.2239,53,94,147,147,616,147,1,3,3,133,0,727,151320,1,147
2011-04-25,summer,2011,April,12,Monday,Workingday,Clear,0.66,0.6212,0.74,0.2537,48,140,188,188,616,188,1,3,3,133,0,728,184414,1,188
2011-04-25,summer,2011,April,13,Monday,Workingday,Clear,0.7,0.6515,0.65,0.2239,57,146,203,203,616,203,1,3,4,134,2,729,184919,1,203
2011-04-25,summer,2011,April,14,Monday,Workingday,Clear,0.72,0.6667,0.54,0.2239,47,99,146,146,616,146,1,3,4,134,2,729,175652,1,146
2011-04-25,summer,2011,April,15,Monday,Workingday,Clear,0.74,0.6667,0.51,0.2239,50,125,175,175,616,175,1,3,4,134,2,729,183149,1,175
2011-04-25,summer,2011,April,16,Monday,Workingday,Clear,0.7,0.6515,0.54,0.3582,41,198,239,239,616,239,1,3,4,134,2,730,227748,1,239
2011-04-25,summer,2011,April,17,Monday,Workingday,Clear,0.7,0.6515,0.54,0.2985,80,441,521,521,616,521,1,4,4,144,2,730,336860,1,521
2011-04-25,summer,2011,April,18,Monday,Workingday,Clear,0.68,0.6364,0.57,0.3582,74,425,499,499,616,499,1,4,4,144,2,728,309772,1,499
2011-04-25,summer,2011,April,19,Monday,Workingday,Clear,0.66,0.6212,0.57,0.3284,62,320,382,382,616,382,1,4,3,143,2,728,226789,1,382
2011-04-25,summer,2011,April,20,Monday,Workingday,Clear,0.66,0.6212,0.61,0.2836,42,195,237,237,616,237,1,3,3,133,2,728,164550,1,237
2011-04-25,summer,2011,April,21,Monday,Workingday,Clear,0.62,0.6061,0.69,0.2537,41,149,190,190,616,190,1,3,3,133,0,728,125445,1,190
2011-04-25,summer,2011,April,22,Monday,Workingday,Clear,0.6,0.5909,0.73,0.2985,23,83,106,106,616,106,1,2,3,123,0,728,95612,1,106
2011-04-25,summer,2011,April,23,Monday,Workingday,Clear,0.58,0.5455,0.78,0.2836,9,53,62,62,616,62,1,2,3,123,0,728,63941,1,62
2011-04-26,summer,2011,April,0,Tuesday,Workingday,Clear,0.62,0.6061,0.69,0.2836,10,17,27,27,615,27,1,1,3,113,0,726,39130,1,27
2011-04-26,summer,2011,April,1,Tuesday,Workingday,Clear,0.62,0.5909,0.73,0.2836,16,5,21,21,615,21,1,1,3,113,0,724,24164,1,21
2011-04-26,summer,2011,April,2,Tuesday,Workingday,Clear,0.56,0.5303,0.83,0.3284,17,9,26,26,615,26,1,1,3,113,0,715,16352,1,26
2011-04-26,summer,2011,April,3,Tuesday,Workingday,Clear,0.54,0.5152,0.88,0.2836,17,4,21,21,615,21,1,1,3,113,0,697,8174,1,21
2011-04-26,summer,2011,April,4,Tuesday,Workingday,Clear,0.56,0.5303,0.83,0.2537,2,4,6,6,615,6,1,1,3,113,0,697,4428,1,6
2011-04-26,summer,2011,April,5,Tuesday,Workingday,Clear,0.54,0.5152,0.88,0.2537,0,16,16,16,615,16,1,1,3,113,0,717,14261,1,16
2011-04-26,summer,2011,April,6,Tuesday,Workingday,Clear,0.56,0.5303,0.88,0.2239,0,80,80,80,615,80,1,2,3,123,0,725,55132,1,80
2011-04-26,summer,2011,April,7,Tuesday,Workingday,Clear,0.58,0.5455,0.83,0.2985,16,254,270,270,615,270,1,3,3,133,0,727,154171,1,270
2011-04-26,summer,2011,April,8,Tuesday,Workingday,Clear,0.58,0.5455,0.83,0.2985,32,417,449,449,615,449,1,4,3,143,2,727,261001,1,449
2011-04-26,summer,2011,April,9,Tuesday,Workingday,Clear,0.64,0.6061,0.73,0.3582,35,164,199,199,615,199,1,3,3,133,0,727,159438,1,199
2011-04-26,summer,2011,April,10,Tuesday,Workingday,Clear,0.66,0.6212,0.69,0.3582,22,98,120,120,615,120,1,2,3,123,0,727,126257,1,120
2011-04-26,summer,2011,April,11,Tuesday,Workingday,Clear,0.68,0.6364,0.65,0.3881,40,132,172,172,615,172,1,3,4,134,2,727,151320,1,172
2011-04-26,summer,2011,April,12,Tuesday,Workingday,Clear,0.7,0.6515,0.61,0.4179,40,146,186,186,615,186,1,3,4,134,2,728,184414,1,186
2011-04-26,summer,2011,April,13,Tuesday,Workingday,Clear,0.74,0.6667,0.51,0.4478,37,139,176,176,615,176,1,3,4,134,2,729,184919,1,176
2011-04-26,summer,2011,April,14,Tuesday,Workingday,Clear,0.72,0.6667,0.58,0.3284,40,115,155,155,615,155,1,3,4,134,2,729,175652,1,155
2011-04-26,summer,2011,April,15,Tuesday,Workingday,Clear,0.7,0.6515,0.61,0.3582,34,119,153,153,615,153,1,3,4,134,2,729,183149,1,153
2011-04-26,summer,2011,April,16,Tuesday,Workingday,Clear,0.7,0.6515,0.58,0.3881,40,251,291,291,615,291,1,4,4,144,2,730,227748,1,291
2011-04-26,summer,2011,April,17,Tuesday,Workingday,Clear,0.68,0.6364,0.61,0.3582,66,455,521,521,615,521,1,4,4,144,2,730,336860,1,521
2011-04-26,summer,2011,April,18,Tuesday,Workingday,Clear,0.68,0.6364,0.65,0.4478,65,463,528,528,615,528,1,4,4,144,2,728,309772,1,528
2011-04-26,summer,2011,April,19,Tuesday,Workingday,Clear,0.64,0.6061,0.73,0.4179,42,286,328,328,615,328,1,4,3,143,2,728,226789,1,328
2011-04-26,summer,2011,April,20,Tuesday,Workingday,Clear,0.64,0.6061,0.73,0.3582,35,199,234,234,615,234,1,3,3,133,0,728,164550,1,234
2011-04-26,summer,2011,April,21,Tuesday,Workingday,Clear,0.62,0.5909,0.78,0.2836,33,162,195,195,615,195,1,3,3,133,0,728,125445,1,195
2011-04-26,summer,2011,April,22,Tuesday,Workingday,Mist,0.6,0.5606,0.83,0.194,32,116,148,148,615,148,1,3,3,133,0,728,95612,1,148
2011-04-26,summer,2011,April,23,Tuesday,Workingday,Mist,0.6,0.5606,0.83,0.2239,7,71,78,78,615,78,1,2,3,123,0,728,63941,1,78
2011-04-27,summer,2011,April,0,Wednesday,Workingday,Clear,0.6,0.5606,0.83,0.2239,3,24,27,27,614,27,1,1,3,113,0,726,39130,1,27
2011-04-27,summer,2011,April,1,Wednesday,Workingday,Clear,0.6,0.5606,0.83,0.2537,2,15,17,17,614,17,1,1,3,113,0,724,24164,1,17
2011-04-27,summer,2011,April,2,Wednesday,Workingday,Clear,0.58,0.5455,0.88,0.2537,0,5,5,5,614,5,1,1,3,113,0,715,16352,1,5
2011-04-27,summer,2011,April,3,Wednesday,Workingday,Mist,0.58,0.5455,0.88,0.2836,3,4,7,7,614,7,1,1,3,113,0,697,8174,1,7
2011-04-27,summer,2011,April,4,Wednesday,Workingday,Clear,0.56,0.5303,0.94,0.2239,0,6,6,6,614,6,1,1,3,113,0,697,4428,1,6
2011-04-27,summer,2011,April,5,Wednesday,Workingday,Mist,0.56,0.5303,0.94,0.2537,1,16,17,17,614,17,1,1,3,113,0,717,14261,1,17
2011-04-27,summer,2011,April,6,Wednesday,Workingday,Clear,0.56,0.5303,0.94,0.2537,5,79,84,84,614,84,1,2,3,123,0,725,55132,1,84
2011-04-27,summer,2011,April,7,Wednesday,Workingday,Mist,0.58,0.5455,0.88,0.2836,17,229,246,246,614,246,1,3,3,133,0,727,154171,1,246
2011-04-27,summer,2011,April,8,Wednesday,Workingday,Mist,0.58,0.5455,0.88,0.3284,31,413,444,444,614,444,1,4,3,143,0,727,261001,1,444
2011-04-27,summer,2011,April,9,Wednesday,Workingday,Mist,0.6,0.5455,0.88,0.4179,20,161,181,181,614,181,1,3,3,133,0,727,159438,1,181
2011-04-27,summer,2011,April,10,Wednesday,Workingday,Mist,0.62,0.5758,0.83,0.2836,26,66,92,92,614,92,1,2,3,123,0,727,126257,1,92
2011-04-27,summer,2011,April,11,Wednesday,Workingday,Mist,0.64,0.5909,0.78,0.2836,53,103,156,156,614,156,1,3,3,133,0,727,151320,1,156
2011-04-27,summer,2011,April,12,Wednesday,Workingday,Clear,0.66,0.6061,0.78,0.3284,38,135,173,173,614,173,1,3,3,133,0,728,184414,1,173
2011-04-27,summer,2011,April,13,Wednesday,Workingday,Clear,0.64,0.5909,0.78,0.2985,31,119,150,150,614,150,1,3,3,133,0,729,184919,1,150
2011-04-27,summer,2011,April,14,Wednesday,Workingday,Clear,0.68,0.6364,0.74,0.2836,29,119,148,148,614,148,1,3,4,134,0,729,175652,1,148
2011-04-27,summer,2011,April,15,Wednesday,Workingday,Clear,0.7,0.6515,0.65,0.4925,18,120,138,138,614,138,1,2,4,124,2,729,183149,1,138
2011-04-27,summer,2011,April,16,Wednesday,Workingday,Clear,0.7,0.6515,0.7,0.3881,29,189,218,218,614,218,1,3,4,134,2,730,227748,1,218
2011-04-27,summer,2011,April,17,Wednesday,Workingday,Light Snow,0.66,0.6061,0.83,0.3881,63,458,521,521,614,521,1,4,3,143,2,730,336860,1,521
2011-04-27,summer,2011,April,18,Wednesday,Workingday,Light Snow,0.66,0.6061,0.83,0.3881,46,366,412,412,614,412,1,4,3,143,2,728,309772,1,412
2011-04-27,summer,2011,April,19,Wednesday,Workingday,Clear,0.62,0.5909,0.78,0.2836,40,220,260,260,614,260,1,3,3,133,0,728,226789,1,260
2011-04-27,summer,2011,April,20,Wednesday,Workingday,Clear,0.64,0.5758,0.83,0.3284,30,188,218,218,614,218,1,3,3,133,0,728,164550,1,218
2011-04-27,summer,2011,April,21,Wednesday,Workingday,Clear,0.62,0.5606,0.88,0.2836,19,126,145,145,614,145,1,3,3,133,0,728,125445,1,145
2011-04-27,summer,2011,April,22,Wednesday,Workingday,Mist,0.62,0.5606,0.88,0.3284,18,111,129,129,614,129,1,2,3,123,0,728,95612,1,129
2011-04-27,summer,2011,April,23,Wednesday,Workingday,Mist,0.62,0.5606,0.88,0.3582,25,53,78,78,614,78,1,2,3,123,0,728,63941,1,78
2011-04-28,summer,2011,April,0,Thursday,Workingday,Clear,0.64,0.5909,0.78,0.3582,13,41,54,54,613,54,1,2,3,123,0,726,39130,1,54
2011-04-28,summer,2011,April,1,Thursday,Workingday,Mist,0.62,0.5758,0.83,0.3881,8,12,20,20,613,20,1,1,3,113,0,724,24164,1,20
2011-04-28,summer,2011,April,2,Thursday,Workingday,Mist,0.62,0.5758,0.83,0.4478,14,7,21,21,613,21,1,1,3,113,0,715,16352,1,21
2011-04-28,summer,2011,April,3,Thursday,Workingday,Mist,0.64,0.5909,0.78,0.3881,2,1,3,3,613,3,1,1,3,113,0,697,8174,1,3
2011-04-28,summer,2011,April,4,Thursday,Workingday,Mist,0.62,0.5758,0.83,0.4179,4,5,9,9,613,9,1,1,3,113,0,697,4428,1,9
2011-04-28,summer,2011,April,5,Thursday,Workingday,Mist,0.62,0.5758,0.83,0.3881,0,13,13,13,613,13,1,1,3,113,0,717,14261,1,13
2011-04-28,summer,2011,April,6,Thursday,Workingday,Mist,0.64,0.5909,0.78,0.4627,7,79,86,86,613,86,1,2,3,123,0,725,55132,1,86
2011-04-28,summer,2011,April,7,Thursday,Workingday,Mist,0.64,0.5909,0.78,0.4478,14,201,215,215,613,215,1,3,3,133,0,727,154171,1,215
2011-04-28,summer,2011,April,8,Thursday,Workingday,Mist,0.66,0.6061,0.78,0.4478,31,367,398,398,613,398,1,4,3,143,2,727,261001,1,398
2011-04-28,summer,2011,April,9,Thursday,Workingday,Light Snow,0.62,0.5606,0.88,0.3284,18,165,183,183,613,183,1,3,3,133,0,727,159438,1,183
2011-04-28,summer,2011,April,10,Thursday,Workingday,Mist,0.62,0.5606,0.88,0.2836,9,45,54,54,613,54,1,2,3,123,0,727,126257,1,54
2011-04-28,summer,2011,April,11,Thursday,Workingday,Mist,0.62,0.5758,0.83,0.2836,10,74,84,84,613,84,1,2,3,123,0,727,151320,1,84
2011-04-28,summer,2011,April,12,Thursday,Workingday,Mist,0.62,0.5909,0.78,0.2537,23,84,107,107,613,107,1,2,3,123,0,728,184414,1,107
2011-04-28,summer,2011,April,13,Thursday,Workingday,Mist,0.62,0.5758,0.83,0.2985,18,103,121,121,613,121,1,2,3,123,0,729,184919,1,121
2011-04-28,summer,2011,April,14,Thursday,Workingday,Clear,0.62,0.5758,0.83,0.2985,21,121,142,142,613,142,1,2,3,123,0,729,175652,1,142
2011-04-28,summer,2011,April,15,Thursday,Workingday,Clear,0.66,0.6212,0.69,0.3284,46,117,163,163,613,163,1,3,3,133,0,729,183149,1,163
2011-04-28,summer,2011,April,16,Thursday,Workingday,Clear,0.62,0.5909,0.78,0.2537,42,228,270,270,613,270,1,3,3,133,0,730,227748,1,270
2011-04-28,summer,2011,April,17,Thursday,Workingday,Clear,0.64,0.6212,0.47,0.3582,49,406,455,455,613,455,1,4,3,143,2,730,336860,1,455
2011-04-28,summer,2011,April,18,Thursday,Workingday,Clear,0.64,0.6212,0.47,0.3582,44,486,530,530,613,530,1,4,3,143,2,728,309772,1,530
2011-04-28,summer,2011,April,19,Thursday,Workingday,Clear,0.62,0.6212,0.43,0.2985,57,347,404,404,613,404,1,4,3,143,2,728,226789,1,404
2011-04-28,summer,2011,April,20,Thursday,Workingday,Clear,0.58,0.5455,0.43,0.2239,49,220,269,269,613,269,1,3,3,133,2,728,164550,1,269
2011-04-28,summer,2011,April,21,Thursday,Workingday,Clear,0.56,0.5303,0.46,0.1343,27,167,194,194,613,194,1,3,3,133,0,728,125445,1,194
2011-04-28,summer,2011,April,22,Thursday,Workingday,Clear,0.54,0.5152,0.45,0.1642,34,119,153,153,613,153,1,3,3,133,0,728,95612,1,153
2011-04-28,summer,2011,April,23,Thursday,Workingday,Clear,0.54,0.5152,0.39,0.0896,29,81,110,110,613,110,1,2,3,123,0,728,63941,1,110
2011-04-29,summer,2011,April,0,Friday,Workingday,Clear,0.52,0.5,0.39,0.2836,11,37,48,48,612,48,1,2,3,123,1,726,39130,1,48
2011-04-29,summer,2011,April,1,Friday,Workingday,Clear,0.5,0.4848,0.45,0.0896,10,21,31,31,612,31,1,1,2,112,0,724,24164,1,31
2011-04-29,summer,2011,April,2,Friday,Workingday,Clear,0.46,0.4545,0.63,0.1045,2,8,10,10,612,10,1,1,2,112,0,715,16352,1,10
2011-04-29,summer,2011,April,3,Friday,Workingday,Clear,0.46,0.4545,0.59,0.0896,1,4,5,5,612,5,1,1,2,112,0,697,8174,1,5
2011-04-29,summer,2011,April,4,Friday,Workingday,Clear,0.46,0.4545,0.51,0.1343,0,6,6,6,612,6,1,1,2,112,1,697,4428,1,6
2011-04-29,summer,2011,April,5,Friday,Workingday,Clear,0.46,0.4545,0.47,0.1343,0,25,25,25,612,25,1,1,2,112,1,717,14261,1,25
2011-04-29,summer,2011,April,6,Friday,Workingday,Clear,0.5,0.4848,0.45,0.2836,4,67,71,71,612,71,1,2,2,122,1,725,55132,1,71
2011-04-29,summer,2011,April,7,Friday,Workingday,Clear,0.52,0.5,0.42,0.194,18,222,240,240,612,240,1,3,3,133,2,727,154171,1,240
2011-04-29,summer,2011,April,8,Friday,Workingday,Clear,0.54,0.5152,0.39,0.2985,35,386,421,421,612,421,1,4,3,143,2,727,261001,1,421
2011-04-29,summer,2011,April,9,Friday,Workingday,Clear,0.54,0.5152,0.39,0.3284,45,185,230,230,612,230,1,3,3,133,2,727,159438,1,230
2011-04-29,summer,2011,April,10,Friday,Workingday,Clear,0.56,0.5303,0.4,0.2836,57,99,156,156,612,156,1,3,3,133,2,727,126257,1,156
2011-04-29,summer,2011,April,11,Friday,Workingday,Clear,0.6,0.6212,0.38,0.2239,49,108,157,157,612,157,1,3,3,133,2,727,151320,1,157
2011-04-29,summer,2011,April,12,Friday,Workingday,Clear,0.56,0.5303,0.37,0.2836,63,160,223,223,612,223,1,3,3,133,2,728,184414,1,223
2011-04-29,summer,2011,April,13,Friday,Workingday,Clear,0.56,0.5303,0.37,0.2985,74,234,308,308,612,308,1,4,3,143,2,729,184919,1,308
2011-04-29,summer,2011,April,14,Friday,Workingday,Clear,0.6,0.6212,0.35,0.3284,58,190,248,248,612,248,1,3,3,133,2,729,175652,1,248
2011-04-29,summer,2011,April,15,Friday,Workingday,Mist,0.56,0.5303,0.4,0.2985,77,175,252,252,612,252,1,3,3,133,2,729,183149,1,252
2011-04-29,summer,2011,April,16,Friday,Workingday,Mist,0.54,0.5152,0.42,0.3582,59,240,299,299,612,299,1,4,3,143,2,730,227748,1,299
2011-04-29,summer,2011,April,17,Friday,Workingday,Mist,0.52,0.5,0.45,0.3881,75,433,508,508,612,508,1,4,3,143,2,730,336860,1,508
2011-04-29,summer,2011,April,18,Friday,Workingday,Clear,0.52,0.5,0.48,0.3582,55,384,439,439,612,439,1,4,3,143,2,728,309772,1,439
2011-04-29,summer,2011,April,19,Friday,Workingday,Clear,0.46,0.4545,0.55,0.3284,40,230,270,270,612,270,1,3,2,132,1,728,226789,1,270
2011-04-29,summer,2011,April,20,Friday,Workingday,Clear,0.48,0.4697,0.48,0.2239,34,160,194,194,612,194,1,3,2,132,1,728,164550,1,194
2011-04-29,summer,2011,April,21,Friday,Workingday,Clear,0.46,0.4545,0.51,0.194,50,145,195,195,612,195,1,3,2,132,1,728,125445,1,195
2011-04-29,summer,2011,April,22,Friday,Workingday,Clear,0.42,0.4242,0.58,0.1642,36,110,146,146,612,146,1,3,2,132,1,728,95612,1,146
2011-04-29,summer,2011,April,23,Friday,Workingday,Mist,0.44,0.4394,0.54,0.0896,25,88,113,113,612,113,1,2,2,122,1,728,63941,1,113
2011-04-30,summer,2011,April,0,Saturday,Holiday,Mist,0.44,0.4394,0.54,0.2537,33,73,106,106,611,106,1,2,2,122,1,726,39130,1,106
2011-04-30,summer,2011,April,1,Saturday,Holiday,Mist,0.44,0.4394,0.54,0.1642,15,59,74,74,611,74,1,2,2,122,1,724,24164,1,74
2011-04-30,summer,2011,April,2,Saturday,Holiday,Mist,0.44,0.4394,0.54,0.2239,12,53,65,65,611,65,1,2,2,122,1,715,16352,1,65
2011-04-30,summer,2011,April,3,Saturday,Holiday,Mist,0.42,0.4242,0.54,0.194,4,13,17,17,611,17,1,1,2,112,1,697,8174,1,17
2011-04-30,summer,2011,April,4,Saturday,Holiday,Mist,0.42,0.4242,0.54,0.2239,2,5,7,7,611,7,1,1,2,112,1,697,4428,1,7
2011-04-30,summer,2011,April,5,Saturday,Holiday,Clear,0.42,0.4242,0.54,0.3881,3,4,7,7,611,7,1,1,2,112,1,717,14261,1,7
2011-04-30,summer,2011,April,6,Saturday,Holiday,Clear,0.4,0.4091,0.58,0.2836,10,11,21,21,611,21,1,1,2,112,1,725,55132,1,21
2011-04-30,summer,2011,April,7,Saturday,Holiday,Clear,0.4,0.4091,0.54,0.3881,21,27,48,48,611,48,1,2,2,122,1,727,154171,1,48
2011-04-30,summer,2011,April,8,Saturday,Holiday,Clear,0.4,0.4091,0.54,0.2985,21,70,91,91,611,91,1,2,2,122,1,727,261001,1,91
2011-04-30,summer,2011,April,9,Saturday,Holiday,Clear,0.44,0.4394,0.51,0.3582,35,121,156,156,611,156,1,3,2,132,1,727,159438,1,156
2011-04-30,summer,2011,April,10,Saturday,Holiday,Clear,0.48,0.4697,0.44,0.3881,94,185,279,279,611,279,1,3,2,132,2,727,126257,1,279
2011-04-30,summer,2011,April,11,Saturday,Holiday,Clear,0.5,0.4848,0.42,0.3582,120,201,321,321,611,321,1,4,2,142,2,727,151320,1,321
2011-04-30,summer,2011,April,12,Saturday,Holiday,Clear,0.52,0.5,0.42,0.3881,178,238,416,416,611,416,1,4,3,143,2,728,184414,1,416
2011-04-30,summer,2011,April,13,Saturday,Holiday,Clear,0.54,0.5152,0.39,0.2985,185,270,455,455,611,455,1,4,3,143,2,729,184919,1,455
2011-04-30,summer,2011,April,14,Saturday,Holiday,Clear,0.54,0.5152,0.39,0.2239,184,268,452,452,611,452,1,4,3,143,2,729,175652,1,452
2011-04-30,summer,2011,April,15,Saturday,Holiday,Clear,0.56,0.5303,0.37,0.1343,217,282,499,499,611,499,1,4,3,143,2,729,183149,1,499
2011-04-30,summer,2011,April,16,Saturday,Holiday,Clear,0.58,0.5455,0.37,0.194,191,273,464,464,611,464,1,4,3,143,2,730,227748,1,464
2011-04-30,summer,2011,April,17,Saturday,Holiday,Clear,0.56,0.5303,0.43,0.1343,162,245,407,407,611,407,1,4,3,143,2,730,336860,1,407
2011-04-30,summer,2011,April,18,Saturday,Holiday,Clear,0.54,0.5152,0.43,0.1343,134,237,371,371,611,371,1,4,3,143,2,728,309772,1,371
2011-04-30,summer,2011,April,19,Saturday,Holiday,Clear,0.54,0.5152,0.43,0.1343,150,237,387,387,611,387,1,4,3,143,2,728,226789,1,387
2011-04-30,summer,2011,April,20,Saturday,Holiday,Clear,0.44,0.4394,0.62,0.1343,65,159,224,224,611,224,1,3,2,132,0,728,164550,1,224
2011-04-30,summer,2011,April,21,Saturday,Holiday,Clear,0.44,0.4394,0.62,0.1343,58,119,177,177,611,177,1,3,2,132,0,728,125445,1,177
2011-04-30,summer,2011,April,22,Saturday,Holiday,Clear,0.44,0.4394,0.67,0.1045,37,106,143,143,611,143,1,3,2,132,0,728,95612,1,143
2011-04-30,summer,2011,April,23,Saturday,Holiday,Clear,0.44,0.4394,0.67,0.1045,34,91,125,125,611,125,1,2,2,122,0,728,63941,1,125
2011-05-01,summer,2011,May,0,Sunday,Holiday,Clear,0.42,0.4242,0.67,0.0896,19,77,96,96,610,96,1,2,2,122,0,726,39130,1,96
2011-05-01,summer,2011,May,1,Sunday,Holiday,Clear,0.42,0.4242,0.69,0.1045,9,50,59,59,610,59,1,2,2,122,0,724,24164,1,59
2011-05-01,summer,2011,May,2,Sunday,Holiday,Clear,0.42,0.4242,0.77,0.1045,7,43,50,50,610,50,1,2,2,122,0,715,16352,1,50
2011-05-01,summer,2011,May,3,Sunday,Holiday,Clear,0.4,0.4091,0.82,0.1045,8,15,23,23,610,23,1,1,2,112,0,697,8174,1,23
2011-05-01,summer,2011,May,4,Sunday,Holiday,Clear,0.4,0.4091,0.76,0.1045,6,11,17,17,610,17,1,1,2,112,0,697,4428,1,17
2011-05-01,summer,2011,May,5,Sunday,Holiday,Clear,0.4,0.4091,0.82,0.0896,0,10,10,10,610,10,1,1,2,112,0,717,14261,1,10
2011-05-01,summer,2011,May,6,Sunday,Holiday,Mist,0.4,0.4091,0.82,0.0896,4,9,13,13,610,13,1,1,2,112,0,725,55132,1,13
2011-05-01,summer,2011,May,7,Sunday,Holiday,Mist,0.42,0.4242,0.77,0.0896,7,26,33,33,610,33,1,1,2,112,0,727,154171,1,33
2011-05-01,summer,2011,May,8,Sunday,Holiday,Mist,0.44,0.4394,0.77,0.1343,16,43,59,59,610,59,1,2,2,122,0,727,261001,1,59
2011-05-01,summer,2011,May,9,Sunday,Holiday,Mist,0.46,0.4545,0.72,0.1343,45,96,141,141,610,141,1,2,2,122,0,727,159438,1,141
2011-05-01,summer,2011,May,10,Sunday,Holiday,Mist,0.48,0.4697,0.63,0.194,109,155,264,264,610,264,1,3,2,132,2,727,126257,1,264
2011-05-01,summer,2011,May,11,Sunday,Holiday,Clear,0.46,0.4545,0.82,0.1045,109,141,250,250,610,250,1,3,2,132,0,727,151320,1,250
2011-05-01,summer,2011,May,12,Sunday,Holiday,Mist,0.48,0.4697,0.77,0.1045,109,172,281,281,610,281,1,3,2,132,0,728,184414,1,281
2011-05-01,summer,2011,May,13,Sunday,Holiday,Mist,0.5,0.4848,0.63,0.1642,123,209,332,332,610,332,1,4,2,142,2,729,184919,1,332
2011-05-01,summer,2011,May,14,Sunday,Holiday,Mist,0.5,0.4848,0.68,0.1045,85,153,238,238,610,238,1,3,2,132,0,729,175652,1,238
2011-05-01,summer,2011,May,15,Sunday,Holiday,Mist,0.5,0.4848,0.72,0.0,113,153,266,266,610,266,1,3,2,132,0,729,183149,1,266
2011-05-01,summer,2011,May,16,Sunday,Holiday,Mist,0.5,0.4848,0.72,0.194,75,139,214,214,610,214,1,3,2,132,0,730,227748,1,214
2011-05-01,summer,2011,May,17,Sunday,Holiday,Mist,0.48,0.4697,0.82,0.2537,60,136,196,196,610,196,1,3,2,132,0,730,336860,1,196
2011-05-01,summer,2011,May,18,Sunday,Holiday,Mist,0.46,0.4545,0.82,0.0896,33,126,159,159,610,159,1,3,2,132,0,728,309772,1,159
2011-05-01,summer,2011,May,19,Sunday,Holiday,Mist,0.46,0.4545,0.84,0.1045,47,131,178,178,610,178,1,3,2,132,0,728,226789,1,178
2011-05-01,summer,2011,May,20,Sunday,Holiday,Mist,0.46,0.4545,0.82,0.0,35,86,121,121,610,121,1,2,2,122,0,728,164550,1,121
2011-05-01,summer,2011,May,21,Sunday,Holiday,Mist,0.46,0.4545,0.82,0.0,23,82,105,105,610,105,1,2,2,122,0,728,125445,1,105
2011-05-01,summer,2011,May,22,Sunday,Holiday,Mist,0.46,0.4545,0.82,0.0,32,68,100,100,610,100,1,2,2,122,0,728,95612,1,100
2011-05-01,summer,2011,May,23,Sunday,Holiday,Clear,0.46,0.4545,0.77,0.194,64,82,146,146,610,146,1,3,2,132,0,728,63941,1,146
2011-05-02,summer,2011,May,0,Monday,Workingday,Clear,0.46,0.4545,0.72,0.1343,68,109,177,177,609,177,1,3,2,132,0,726,39130,1,177
2011-05-02,summer,2011,May,1,Monday,Workingday,Clear,0.46,0.4545,0.72,0.1343,41,73,114,114,609,114,1,2,2,122,0,724,24164,1,114
2011-05-02,summer,2011,May,2,Monday,Workingday,Mist,0.44,0.4394,0.77,0.2239,16,19,35,35,609,35,1,1,2,112,0,715,16352,1,35
2011-05-02,summer,2011,May,3,Monday,Workingday,Clear,0.44,0.4394,0.77,0.1343,9,7,16,16,609,16,1,1,2,112,0,697,8174,1,16
2011-05-02,summer,2011,May,4,Monday,Workingday,Clear,0.44,0.4394,0.77,0.1642,9,8,17,17,609,17,1,1,2,112,0,697,4428,1,17
2011-05-02,summer,2011,May,5,Monday,Workingday,Mist,0.44,0.4394,0.77,0.1343,4,16,20,20,609,20,1,1,2,112,0,717,14261,1,20
2011-05-02,summer,2011,May,6,Monday,Workingday,Clear,0.44,0.4394,0.88,0.1045,3,59,62,62,609,62,1,2,2,122,0,725,55132,1,62
2011-05-02,summer,2011,May,7,Monday,Workingday,Mist,0.46,0.4545,0.82,0.3284,16,193,209,209,609,209,1,3,2,132,0,727,154171,1,209
2011-05-02,summer,2011,May,8,Monday,Workingday,Mist,0.48,0.4697,0.77,0.2239,21,350,371,371,609,371,1,4,2,142,0,727,261001,1,371
2011-05-02,summer,2011,May,9,Monday,Workingday,Mist,0.5,0.4848,0.77,0.2836,41,131,172,172,609,172,1,3,2,132,0,727,159438,1,172
2011-05-02,summer,2011,May,10,Monday,Workingday,Mist,0.54,0.5152,0.77,0.2239,31,77,108,108,609,108,1,2,3,123,0,727,126257,1,108
2011-05-02,summer,2011,May,11,Monday,Workingday,Clear,0.58,0.5455,0.73,0.2985,34,96,130,130,609,130,1,2,3,123,0,727,151320,1,130
2011-05-02,summer,2011,May,12,Monday,Workingday,Clear,0.62,0.6061,0.69,0.2239,40,147,187,187,609,187,1,3,3,133,0,728,184414,1,187
2011-05-02,summer,2011,May,13,Monday,Workingday,Mist,0.62,0.6061,0.69,0.194,51,119,170,170,609,170,1,3,3,133,0,729,184919,1,170
2011-05-02,summer,2011,May,14,Monday,Workingday,Clear,0.64,0.6061,0.69,0.2239,48,133,181,181,609,181,1,3,3,133,0,729,175652,1,181
2011-05-02,summer,2011,May,15,Monday,Workingday,Clear,0.66,0.6212,0.61,0.194,45,110,155,155,609,155,1,3,3,133,0,729,183149,1,155
2011-05-02,summer,2011,May,16,Monday,Workingday,Clear,0.66,0.6212,0.61,0.2239,49,220,269,269,609,269,1,3,3,133,2,730,227748,1,269
2011-05-02,summer,2011,May,17,Monday,Workingday,Clear,0.66,0.6212,0.65,0.194,65,472,537,537,609,537,1,4,3,143,2,730,336860,1,537
2011-05-02,summer,2011,May,18,Monday,Workingday,Mist,0.64,0.6061,0.65,0.194,68,450,518,518,609,518,1,4,3,143,2,728,309772,1,518
2011-05-02,summer,2011,May,19,Monday,Workingday,Mist,0.62,0.6061,0.69,0.1343,46,268,314,314,609,314,1,4,3,143,0,728,226789,1,314
2011-05-02,summer,2011,May,20,Monday,Workingday,Mist,0.62,0.6061,0.69,0.1343,44,174,218,218,609,218,1,3,3,133,0,728,164550,1,218
2011-05-02,summer,2011,May,21,Monday,Workingday,Mist,0.6,0.5909,0.73,0.1045,54,178,232,232,609,232,1,3,3,133,0,728,125445,1,232
2011-05-02,summer,2011,May,22,Monday,Workingday,Mist,0.6,0.5909,0.73,0.0,28,97,125,125,609,125,1,2,3,123,0,728,95612,1,125
2011-05-02,summer,2011,May,23,Monday,Workingday,Mist,0.56,0.5303,0.83,0.194,16,48,64,64,609,64,1,2,3,123,0,728,63941,1,64
2011-05-03,summer,2011,May,0,Tuesday,Workingday,Mist,0.56,0.5303,0.83,0.2239,0,16,16,16,608,16,1,1,3,113,0,726,39130,1,16
2011-05-03,summer,2011,May,1,Tuesday,Workingday,Mist,0.56,0.5303,0.78,0.2537,0,14,14,14,608,14,1,1,3,113,0,724,24164,1,14
2011-05-03,summer,2011,May,2,Tuesday,Workingday,Mist,0.56,0.5303,0.78,0.2537,0,5,5,5,608,5,1,1,3,113,0,715,16352,1,5
2011-05-03,summer,2011,May,3,Tuesday,Workingday,Clear,0.54,0.5152,0.83,0.2836,0,2,2,2,608,2,1,1,3,113,0,697,8174,1,2
2011-05-03,summer,2011,May,4,Tuesday,Workingday,Clear,0.52,0.5,0.88,0.2239,3,1,4,4,608,4,1,1,3,113,0,697,4428,1,4
2011-05-03,summer,2011,May,5,Tuesday,Workingday,Clear,0.52,0.5,0.88,0.1343,0,14,14,14,608,14,1,1,3,113,0,717,14261,1,14
2011-05-03,summer,2011,May,6,Tuesday,Workingday,Mist,0.52,0.5,0.94,0.1642,7,102,109,109,608,109,1,2,3,123,0,725,55132,1,109
2011-05-03,summer,2011,May,7,Tuesday,Workingday,Mist,0.54,0.5152,0.88,0.2239,17,248,265,265,608,265,1,3,3,133,0,727,154171,1,265
2011-05-03,summer,2011,May,8,Tuesday,Workingday,Mist,0.56,0.5303,0.83,0.2836,24,435,459,459,608,459,1,4,3,143,0,727,261001,1,459
2011-05-03,summer,2011,May,9,Tuesday,Workingday,Mist,0.6,0.5758,0.78,0.3582,29,157,186,186,608,186,1,3,3,133,0,727,159438,1,186
2011-05-03,summer,2011,May,10,Tuesday,Workingday,Mist,0.64,0.6061,0.69,0.3582,36,91,127,127,608,127,1,2,3,123,0,727,126257,1,127
2011-05-03,summer,2011,May,11,Tuesday,Workingday,Mist,0.66,0.6212,0.65,0.3284,20,120,140,140,608,140,1,2,3,123,0,727,151320,1,140
2011-05-03,summer,2011,May,12,Tuesday,Workingday,Mist,0.68,0.6364,0.61,0.4925,48,169,217,217,608,217,1,3,4,134,2,728,184414,1,217
2011-05-03,summer,2011,May,13,Tuesday,Workingday,Mist,0.7,0.6515,0.58,0.6119,50,144,194,194,608,194,1,3,4,134,2,729,184919,1,194
2011-05-03,summer,2011,May,14,Tuesday,Workingday,Mist,0.7,0.6515,0.58,0.5224,36,122,158,158,608,158,1,3,4,134,2,729,175652,1,158
2011-05-03,summer,2011,May,15,Tuesday,Workingday,Mist,0.7,0.6515,0.58,0.4478,37,117,154,154,608,154,1,3,4,134,2,729,183149,1,154
2011-05-03,summer,2011,May,16,Tuesday,Workingday,Clear,0.72,0.6667,0.54,0.4627,46,225,271,271,608,271,1,3,4,134,2,730,227748,1,271
2011-05-03,summer,2011,May,17,Tuesday,Workingday,Clear,0.7,0.6515,0.54,0.4627,53,464,517,517,608,517,1,4,4,144,2,730,336860,1,517
2011-05-03,summer,2011,May,18,Tuesday,Workingday,Clear,0.7,0.6515,0.48,0.4179,59,485,544,544,608,544,1,4,4,144,2,728,309772,1,544
2011-05-03,summer,2011,May,19,Tuesday,Workingday,Clear,0.68,0.6364,0.57,0.3582,42,323,365,365,608,365,1,4,4,144,2,728,226789,1,365
2011-05-03,summer,2011,May,20,Tuesday,Workingday,Clear,0.66,0.6212,0.61,0.194,28,262,290,290,608,290,1,4,3,143,2,728,164550,1,290
2011-05-03,summer,2011,May,21,Tuesday,Workingday,Mist,0.64,0.6212,0.61,0.4478,42,183,225,225,608,225,1,3,3,133,2,728,125445,1,225
2011-05-03,summer,2011,May,22,Tuesday,Workingday,Mist,0.58,0.5455,0.6,0.3881,14,99,113,113,608,113,1,2,3,123,0,728,95612,1,113
2011-05-03,summer,2011,May,23,Tuesday,Workingday,Mist,0.56,0.5303,0.68,0.3284,12,50,62,62,608,62,1,2,3,123,0,728,63941,1,62
2011-05-04,summer,2011,May,0,Wednesday,Workingday,Light Snow,0.52,0.5,0.77,0.1642,5,22,27,27,607,27,1,1,3,113,0,726,39130,1,27
2011-05-04,summer,2011,May,1,Wednesday,Workingday,Light Snow,0.5,0.4848,0.82,0.2836,1,6,7,7,607,7,1,1,2,112,0,724,24164,1,7
2011-05-04,summer,2011,May,2,Wednesday,Workingday,Light Snow,0.5,0.4848,0.82,0.2836,0,4,4,4,607,4,1,1,2,112,0,715,16352,1,4
2011-05-04,summer,2011,May,3,Wednesday,Workingday,Light Snow,0.42,0.4242,0.88,0.5224,0,1,1,1,607,1,1,1,2,112,1,697,8174,1,1
2011-05-04,summer,2011,May,4,Wednesday,Workingday,Light Snow,0.38,0.3939,0.94,0.3284,1,2,3,3,607,3,1,1,2,112,0,697,4428,1,3
2011-05-04,summer,2011,May,5,Wednesday,Workingday,Light Snow,0.36,0.3333,0.87,0.3284,1,8,9,9,607,9,1,1,1,111,1,717,14261,1,9
2011-05-04,summer,2011,May,6,Wednesday,Workingday,Light Snow,0.34,0.303,0.93,0.3881,0,21,21,21,607,21,1,1,1,111,1,725,55132,1,21
2011-05-04,summer,2011,May,7,Wednesday,Workingday,Light Snow,0.34,0.303,0.93,0.3582,6,46,52,52,607,52,1,2,1,121,1,727,154171,1,52
2011-05-04,summer,2011,May,8,Wednesday,Workingday,Light Snow,0.34,0.303,0.93,0.3881,5,74,79,79,607,79,1,2,1,121,1,727,261001,1,79
2011-05-04,summer,2011,May,9,Wednesday,Workingday,Light Snow,0.34,0.303,0.93,0.3582,5,35,40,40,607,40,1,1,1,111,1,727,159438,1,40
2011-05-04,summer,2011,May,10,Wednesday,Workingday,Mist,0.34,0.3182,0.93,0.2836,5,26,31,31,607,31,1,1,1,111,1,727,126257,1,31
2011-05-04,summer,2011,May,11,Wednesday,Workingday,Clear,0.4,0.4091,0.82,0.3284,3,69,72,72,607,72,1,2,2,122,1,727,151320,1,72
2011-05-04,summer,2011,May,12,Wednesday,Workingday,Mist,0.44,0.4394,0.62,0.3582,19,105,124,124,607,124,1,2,2,122,1,728,184414,1,124
2011-05-04,summer,2011,May,13,Wednesday,Workingday,Mist,0.46,0.4545,0.59,0.4478,15,128,143,143,607,143,1,3,2,132,1,729,184919,1,143
2011-05-04,summer,2011,May,14,Wednesday,Workingday,Clear,0.5,0.4848,0.51,0.3881,13,94,107,107,607,107,1,2,2,122,1,729,175652,1,107
2011-05-04,summer,2011,May,15,Wednesday,Workingday,Clear,0.48,0.4697,0.51,0.4179,22,107,129,129,607,129,1,2,2,122,1,729,183149,1,129
2011-05-04,summer,2011,May,16,Wednesday,Workingday,Clear,0.5,0.4848,0.45,0.4627,22,173,195,195,607,195,1,3,2,132,1,730,227748,1,195
2011-05-04,summer,2011,May,17,Wednesday,Workingday,Clear,0.4,0.4091,0.71,0.2537,22,388,410,410,607,410,1,4,2,142,1,730,336860,1,410
2011-05-04,summer,2011,May,18,Wednesday,Workingday,Clear,0.42,0.4242,0.67,0.2537,29,367,396,396,607,396,1,4,2,142,1,728,309772,1,396
2011-05-04,summer,2011,May,19,Wednesday,Workingday,Clear,0.42,0.4242,0.58,0.3582,30,266,296,296,607,296,1,4,2,142,1,728,226789,1,296
2011-05-04,summer,2011,May,20,Wednesday,Workingday,Clear,0.4,0.4091,0.62,0.3284,17,174,191,191,607,191,1,3,2,132,1,728,164550,1,191
2011-05-04,summer,2011,May,21,Wednesday,Workingday,Clear,0.4,0.4091,0.62,0.1642,17,133,150,150,607,150,1,3,2,132,1,728,125445,1,150
2011-05-04,summer,2011,May,22,Wednesday,Workingday,Clear,0.38,0.3939,0.62,0.2239,9,80,89,89,607,89,1,2,2,122,1,728,95612,1,89
2011-05-04,summer,2011,May,23,Wednesday,Workingday,Clear,0.36,0.3485,0.62,0.2239,8,49,57,57,607,57,1,2,2,122,1,728,63941,1,57
2011-05-05,summer,2011,May,0,Thursday,Workingday,Clear,0.36,0.3485,0.66,0.194,4,23,27,27,606,27,1,1,2,112,1,726,39130,1,27
2011-05-05,summer,2011,May,1,Thursday,Workingday,Clear,0.34,0.3333,0.71,0.194,4,6,10,10,606,10,1,1,1,111,1,724,24164,1,10
2011-05-05,summer,2011,May,2,Thursday,Workingday,Clear,0.34,0.3182,0.66,0.2239,1,4,5,5,606,5,1,1,1,111,1,715,16352,1,5
2011-05-05,summer,2011,May,3,Thursday,Workingday,Clear,0.34,0.3182,0.66,0.2537,0,4,4,4,606,4,1,1,1,111,1,697,8174,1,4
2011-05-05,summer,2011,May,4,Thursday,Workingday,Clear,0.34,0.3182,0.66,0.2537,4,3,7,7,606,7,1,1,1,111,1,697,4428,1,7
2011-05-05,summer,2011,May,5,Thursday,Workingday,Clear,0.34,0.3182,0.66,0.2537,1,29,30,30,606,30,1,1,1,111,1,717,14261,1,30
2011-05-05,summer,2011,May,6,Thursday,Workingday,Clear,0.34,0.3182,0.66,0.2537,3,86,89,89,606,89,1,2,1,121,1,725,55132,1,89
2011-05-05,summer,2011,May,7,Thursday,Workingday,Clear,0.38,0.3939,0.58,0.2537,16,255,271,271,606,271,1,3,2,132,1,727,154171,1,271
2011-05-05,summer,2011,May,8,Thursday,Workingday,Clear,0.42,0.4242,0.5,0.2537,25,415,440,440,606,440,1,4,2,142,1,727,261001,1,440
2011-05-05,summer,2011,May,9,Thursday,Workingday,Clear,0.46,0.4545,0.44,0.2836,20,164,184,184,606,184,1,3,2,132,1,727,159438,1,184
2011-05-05,summer,2011,May,10,Thursday,Workingday,Clear,0.5,0.4848,0.39,0.2836,30,98,128,128,606,128,1,2,2,122,1,727,126257,1,128
2011-05-05,summer,2011,May,11,Thursday,Workingday,Clear,0.52,0.5,0.36,0.4478,43,105,148,148,606,148,1,3,3,133,2,727,151320,1,148
2011-05-05,summer,2011,May,12,Thursday,Workingday,Clear,0.52,0.5,0.34,0.3582,27,169,196,196,606,196,1,3,3,133,2,728,184414,1,196
2011-05-05,summer,2011,May,13,Thursday,Workingday,Clear,0.54,0.5152,0.3,0.5821,50,142,192,192,606,192,1,3,3,133,2,729,184919,1,192
2011-05-05,summer,2011,May,14,Thursday,Workingday,Clear,0.54,0.5152,0.28,0.4478,19,135,154,154,606,154,1,3,3,133,2,729,175652,1,154
2011-05-05,summer,2011,May,15,Thursday,Workingday,Clear,0.56,0.5303,0.26,0.4925,27,120,147,147,606,147,1,3,3,133,2,729,183149,1,147
2011-05-05,summer,2011,May,16,Thursday,Workingday,Clear,0.58,0.5455,0.24,0.4179,36,233,269,269,606,269,1,3,3,133,2,730,227748,1,269
2011-05-05,summer,2011,May,17,Thursday,Workingday,Clear,0.56,0.5303,0.26,0.3881,66,467,533,533,606,533,1,4,3,143,2,730,336860,1,533
2011-05-05,summer,2011,May,18,Thursday,Workingday,Clear,0.56,0.5303,0.26,0.2836,64,456,520,520,606,520,1,4,3,143,2,728,309772,1,520
2011-05-05,summer,2011,May,19,Thursday,Workingday,Clear,0.54,0.5152,0.28,0.2239,56,305,361,361,606,361,1,4,3,143,2,728,226789,1,361
2011-05-05,summer,2011,May,20,Thursday,Workingday,Clear,0.5,0.4848,0.34,0.1642,33,225,258,258,606,258,1,3,2,132,2,728,164550,1,258
2011-05-05,summer,2011,May,21,Thursday,Workingday,Clear,0.5,0.4848,0.36,0.194,39,141,180,180,606,180,1,3,2,132,1,728,125445,1,180
2011-05-05,summer,2011,May,22,Thursday,Workingday,Clear,0.48,0.4697,0.39,0.194,30,135,165,165,606,165,1,3,2,132,1,728,95612,1,165
2011-05-05,summer,2011,May,23,Thursday,Workingday,Clear,0.46,0.4545,0.41,0.194,16,99,115,115,606,115,1,2,2,122,1,728,63941,1,115
2011-05-06,summer,2011,May,0,Friday,Workingday,Clear,0.44,0.4394,0.44,0.1642,13,43,56,56,605,56,1,2,2,122,1,726,39130,1,56
2011-05-06,summer,2011,May,1,Friday,Workingday,Clear,0.4,0.4091,0.62,0.1642,8,24,32,32,605,32,1,1,2,112,1,724,24164,1,32
2011-05-06,summer,2011,May,2,Friday,Workingday,Clear,0.38,0.3939,0.62,0.1045,1,15,16,16,605,16,1,1,2,112,1,715,16352,1,16
2011-05-06,summer,2011,May,3,Friday,Workingday,Clear,0.36,0.3636,0.71,0.1045,3,6,9,9,605,9,1,1,2,112,1,697,8174,1,9
2011-05-06,summer,2011,May,4,Friday,Workingday,Clear,0.36,0.3636,0.71,0.1045,0,1,1,1,605,1,1,1,2,112,1,697,4428,1,1
2011-05-06,summer,2011,May,5,Friday,Workingday,Clear,0.34,0.3485,0.81,0.1045,0,16,16,16,605,16,1,1,2,112,1,717,14261,1,16
2011-05-06,summer,2011,May,6,Friday,Workingday,Clear,0.36,0.3636,0.81,0.0896,8,74,82,82,605,82,1,2,2,122,0,725,55132,1,82
2011-05-06,summer,2011,May,7,Friday,Workingday,Clear,0.4,0.4091,0.82,0.0,20,202,222,222,605,222,1,3,2,132,0,727,154171,1,222
2011-05-06,summer,2011,May,8,Friday,Workingday,Clear,0.42,0.4242,0.77,0.2537,35,415,450,450,605,450,1,4,2,142,0,727,261001,1,450
2011-05-06,summer,2011,May,9,Friday,Workingday,Clear,0.46,0.4545,0.67,0.2836,27,161,188,188,605,188,1,3,2,132,1,727,159438,1,188
2011-05-06,summer,2011,May,10,Friday,Workingday,Mist,0.54,0.5152,0.49,0.3284,30,97,127,127,605,127,1,2,3,123,1,727,126257,1,127
2011-05-06,summer,2011,May,11,Friday,Workingday,Mist,0.54,0.5152,0.49,0.3284,42,123,165,165,605,165,1,3,3,133,2,727,151320,1,165
2011-05-06,summer,2011,May,12,Friday,Workingday,Clear,0.56,0.5303,0.49,0.3582,48,198,246,246,605,246,1,3,3,133,2,728,184414,1,246
2011-05-06,summer,2011,May,13,Friday,Workingday,Clear,0.58,0.5455,0.4,0.3284,71,182,253,253,605,253,1,3,3,133,2,729,184919,1,253
2011-05-06,summer,2011,May,14,Friday,Workingday,Clear,0.6,0.6212,0.4,0.4478,86,127,213,213,605,213,1,3,3,133,2,729,175652,1,213
2011-05-06,summer,2011,May,15,Friday,Workingday,Clear,0.6,0.6212,0.38,0.3881,89,171,260,260,605,260,1,3,3,133,2,729,183149,1,260
2011-05-06,summer,2011,May,16,Friday,Workingday,Clear,0.6,0.6212,0.4,0.2537,82,262,344,344,605,344,1,4,3,143,2,730,227748,1,344
2011-05-06,summer,2011,May,17,Friday,Workingday,Clear,0.58,0.5455,0.4,0.3582,83,470,553,553,605,553,1,4,3,143,2,730,336860,1,553
2011-05-06,summer,2011,May,18,Friday,Workingday,Light Snow,0.54,0.5152,0.52,0.3582,85,385,470,470,605,470,1,4,3,143,2,728,309772,1,470
2011-05-06,summer,2011,May,19,Friday,Workingday,Light Snow,0.54,0.5152,0.52,0.3582,39,253,292,292,605,292,1,4,3,143,2,728,226789,1,292
2011-05-06,summer,2011,May,20,Friday,Workingday,Clear,0.52,0.5,0.48,0.1045,29,161,190,190,605,190,1,3,3,133,0,728,164550,1,190
2011-05-06,summer,2011,May,21,Friday,Workingday,Clear,0.48,0.4697,0.67,0.1343,22,130,152,152,605,152,1,3,2,132,0,728,125445,1,152
2011-05-06,summer,2011,May,22,Friday,Workingday,Clear,0.46,0.4545,0.72,0.2239,46,105,151,151,605,151,1,3,2,132,0,728,95612,1,151
2011-05-06,summer,2011,May,23,Friday,Workingday,Clear,0.44,0.4394,0.82,0.1343,27,93,120,120,605,120,1,2,2,122,0,728,63941,1,120
2011-05-07,summer,2011,May,0,Saturday,Holiday,Clear,0.42,0.4242,0.82,0.1343,10,76,86,86,604,86,1,2,2,122,0,726,39130,1,86
2011-05-07,summer,2011,May,1,Saturday,Holiday,Clear,0.42,0.4242,0.82,0.1045,8,50,58,58,604,58,1,2,2,122,0,724,24164,1,58
2011-05-07,summer,2011,May,2,Saturday,Holiday,Clear,0.42,0.4242,0.82,0.0896,5,47,52,52,604,52,1,2,2,122,0,715,16352,1,52
2011-05-07,summer,2011,May,3,Saturday,Holiday,Clear,0.42,0.4242,0.77,0.0896,9,9,18,18,604,18,1,1,2,112,0,697,8174,1,18
2011-05-07,summer,2011,May,4,Saturday,Holiday,Clear,0.4,0.4091,0.82,0.1045,1,4,5,5,604,5,1,1,2,112,0,697,4428,1,5
2011-05-07,summer,2011,May,5,Saturday,Holiday,Clear,0.46,0.4545,0.59,0.1343,4,3,7,7,604,7,1,1,2,112,0,717,14261,1,7
2011-05-07,summer,2011,May,6,Saturday,Holiday,Clear,0.42,0.4242,0.77,0.0896,1,12,13,13,604,13,1,1,2,112,0,725,55132,1,13
2011-05-07,summer,2011,May,7,Saturday,Holiday,Clear,0.48,0.4697,0.59,0.0,8,32,40,40,604,40,1,1,2,112,0,727,154171,1,40
2011-05-07,summer,2011,May,8,Saturday,Holiday,Clear,0.52,0.5,0.52,0.194,19,96,115,115,604,115,1,2,3,123,0,727,261001,1,115
2011-05-07,summer,2011,May,9,Saturday,Holiday,Clear,0.54,0.5152,0.49,0.2836,54,164,218,218,604,218,1,3,3,133,2,727,159438,1,218
2011-05-07,summer,2011,May,10,Saturday,Holiday,Clear,0.56,0.5303,0.49,0.2985,90,208,298,298,604,298,1,4,3,143,2,727,126257,1,298
2011-05-07,summer,2011,May,11,Saturday,Holiday,Clear,0.56,0.5303,0.43,0.0,132,215,347,347,604,347,1,4,3,143,2,727,151320,1,347
2011-05-07,summer,2011,May,12,Saturday,Holiday,Clear,0.6,0.6212,0.4,0.194,129,244,373,373,604,373,1,4,3,143,2,728,184414,1,373
2011-05-07,summer,2011,May,13,Saturday,Holiday,Clear,0.6,0.6212,0.35,0.2836,196,240,436,436,604,436,1,4,3,143,2,729,184919,1,436
2011-05-07,summer,2011,May,14,Saturday,Holiday,Light Snow,0.6,0.6212,0.35,0.1642,143,235,378,378,604,378,1,4,3,143,2,729,175652,1,378
2011-05-07,summer,2011,May,15,Saturday,Holiday,Clear,0.6,0.6212,0.38,0.2537,148,230,378,378,604,378,1,4,3,143,2,729,183149,1,378
2011-05-07,summer,2011,May,16,Saturday,Holiday,Clear,0.6,0.6212,0.38,0.194,119,223,342,342,604,342,1,4,3,143,2,730,227748,1,342
2011-05-07,summer,2011,May,17,Saturday,Holiday,Clear,0.58,0.5455,0.4,0.2239,138,216,354,354,604,354,1,4,3,143,2,730,336860,1,354
2011-05-07,summer,2011,May,18,Saturday,Holiday,Clear,0.58,0.5455,0.37,0.1642,114,175,289,289,604,289,1,4,3,143,2,728,309772,1,289
2011-05-07,summer,2011,May,19,Saturday,Holiday,Clear,0.56,0.5303,0.43,0.194,88,179,267,267,604,267,1,3,3,133,2,728,226789,1,267
2011-05-07,summer,2011,May,20,Saturday,Holiday,Clear,0.56,0.5303,0.43,0.1343,82,137,219,219,604,219,1,3,3,133,2,728,164550,1,219
2011-05-07,summer,2011,May,21,Saturday,Holiday,Clear,0.54,0.5152,0.49,0.2239,58,124,182,182,604,182,1,3,3,133,2,728,125445,1,182
2011-05-07,summer,2011,May,22,Saturday,Holiday,Clear,0.54,0.5152,0.49,0.194,26,94,120,120,604,120,1,2,3,123,0,728,95612,1,120
2011-05-07,summer,2011,May,23,Saturday,Holiday,Clear,0.5,0.4848,0.59,0.1045,30,89,119,119,604,119,1,2,2,122,0,728,63941,1,119
2011-05-08,summer,2011,May,0,Sunday,Holiday,Mist,0.5,0.4848,0.59,0.1045,22,78,100,100,603,100,1,2,2,122,0,726,39130,1,100
2011-05-08,summer,2011,May,1,Sunday,Holiday,Mist,0.52,0.5,0.55,0.0,8,56,64,64,603,64,1,2,3,123,0,724,24164,1,64
2011-05-08,summer,2011,May,2,Sunday,Holiday,Clear,0.48,0.4697,0.63,0.0,17,42,59,59,603,59,1,2,2,122,0,715,16352,1,59
2011-05-08,summer,2011,May,3,Sunday,Holiday,Clear,0.46,0.4545,0.72,0.0896,10,21,31,31,603,31,1,1,2,112,0,697,8174,1,31
2011-05-08,summer,2011,May,4,Sunday,Holiday,Clear,0.42,0.4242,0.82,0.0,2,8,10,10,603,10,1,1,2,112,0,697,4428,1,10
2011-05-08,summer,2011,May,5,Sunday,Holiday,Mist,0.44,0.4394,0.77,0.0,0,5,5,5,603,5,1,1,2,112,0,717,14261,1,5
2011-05-08,summer,2011,May,6,Sunday,Holiday,Mist,0.44,0.4394,0.82,0.0,2,4,6,6,603,6,1,1,2,112,0,725,55132,1,6
2011-05-08,summer,2011,May,7,Sunday,Holiday,Mist,0.46,0.4545,0.82,0.0,8,15,23,23,603,23,1,1,2,112,0,727,154171,1,23
2011-05-08,summer,2011,May,8,Sunday,Holiday,Clear,0.52,0.5,0.63,0.1343,28,58,86,86,603,86,1,2,3,123,0,727,261001,1,86
2011-05-08,summer,2011,May,9,Sunday,Holiday,Clear,0.56,0.5303,0.52,0.2239,48,112,160,160,603,160,1,3,3,133,0,727,159438,1,160
2011-05-08,summer,2011,May,10,Sunday,Holiday,Clear,0.58,0.5455,0.49,0.1343,91,153,244,244,603,244,1,3,3,133,2,727,126257,1,244
2011-05-08,summer,2011,May,11,Sunday,Holiday,Clear,0.58,0.5455,0.49,0.0896,142,198,340,340,603,340,1,4,3,143,2,727,151320,1,340
2011-05-08,summer,2011,May,12,Sunday,Holiday,Clear,0.6,0.6212,0.46,0.0896,139,243,382,382,603,382,1,4,3,143,2,728,184414,1,382
2011-05-08,summer,2011,May,13,Sunday,Holiday,Clear,0.6,0.6212,0.49,0.1343,166,224,390,390,603,390,1,4,3,143,2,729,184919,1,390
2011-05-08,summer,2011,May,14,Sunday,Holiday,Clear,0.6,0.6212,0.49,0.0,126,240,366,366,603,366,1,4,3,143,2,729,175652,1,366
2011-05-08,summer,2011,May,15,Sunday,Holiday,Clear,0.6,0.6212,0.49,0.0,128,230,358,358,603,358,1,4,3,143,2,729,183149,1,358
2011-05-08,summer,2011,May,16,Sunday,Holiday,Clear,0.6,0.6212,0.46,0.1045,122,263,385,385,603,385,1,4,3,143,2,730,227748,1,385
2011-05-08,summer,2011,May,17,Sunday,Holiday,Light Snow,0.58,0.5455,0.49,0.2836,106,245,351,351,603,351,1,4,3,143,2,730,336860,1,351
2011-05-08,summer,2011,May,18,Sunday,Holiday,Clear,0.58,0.5455,0.49,0.0,63,205,268,268,603,268,1,3,3,133,2,728,309772,1,268
2011-05-08,summer,2011,May,19,Sunday,Holiday,Clear,0.56,0.5303,0.64,0.0,61,178,239,239,603,239,1,3,3,133,0,728,226789,1,239
2011-05-08,summer,2011,May,20,Sunday,Holiday,Clear,0.52,0.5,0.77,0.1343,42,132,174,174,603,174,1,3,3,133,0,728,164550,1,174
2011-05-08,summer,2011,May,21,Sunday,Holiday,Clear,0.52,0.5,0.77,0.0896,32,95,127,127,603,127,1,2,3,123,0,728,125445,1,127
2011-05-08,summer,2011,May,22,Sunday,Holiday,Clear,0.5,0.4848,0.88,0.0896,29,86,115,115,603,115,1,2,2,122,0,728,95612,1,115
2011-05-08,summer,2011,May,23,Sunday,Holiday,Clear,0.46,0.4545,0.88,0.0896,9,41,50,50,603,50,1,2,2,122,0,728,63941,1,50
2011-05-09,summer,2011,May,0,Monday,Workingday,Clear,0.46,0.4545,0.82,0.0896,31,22,53,53,602,53,1,2,2,122,0,726,39130,1,53
2011-05-09,summer,2011,May,1,Monday,Workingday,Clear,0.44,0.4394,0.88,0.0,25,8,33,33,602,33,1,1,2,112,0,724,24164,1,33
2011-05-09,summer,2011,May,2,Monday,Workingday,Clear,0.44,0.4394,0.94,0.0,6,2,8,8,602,8,1,1,2,112,0,715,16352,1,8
2011-05-09,summer,2011,May,3,Monday,Workingday,Clear,0.46,0.4545,0.82,0.0896,0,7,7,7,602,7,1,1,2,112,0,697,8174,1,7
2011-05-09,summer,2011,May,4,Monday,Workingday,Clear,0.42,0.4242,0.82,0.1642,0,4,4,4,602,4,1,1,2,112,0,697,4428,1,4
2011-05-09,summer,2011,May,5,Monday,Workingday,Clear,0.42,0.4242,0.77,0.1642,0,23,23,23,602,23,1,1,2,112,0,717,14261,1,23
2011-05-09,summer,2011,May,6,Monday,Workingday,Clear,0.44,0.4394,0.72,0.2537,2,87,89,89,602,89,1,2,2,122,0,725,55132,1,89
2011-05-09,summer,2011,May,7,Monday,Workingday,Clear,0.48,0.4697,0.63,0.2537,16,221,237,237,602,237,1,3,2,132,0,727,154171,1,237
2011-05-09,summer,2011,May,8,Monday,Workingday,Clear,0.52,0.5,0.55,0.2239,23,351,374,374,602,374,1,4,3,143,2,727,261001,1,374
2011-05-09,summer,2011,May,9,Monday,Workingday,Clear,0.54,0.5152,0.56,0.1642,36,142,178,178,602,178,1,3,3,133,0,727,159438,1,178
2011-05-09,summer,2011,May,10,Monday,Workingday,Clear,0.56,0.5303,0.52,0.194,24,95,119,119,602,119,1,2,3,123,0,727,126257,1,119
2011-05-09,summer,2011,May,11,Monday,Workingday,Clear,0.6,0.6212,0.46,0.2239,26,99,125,125,602,125,1,2,3,123,0,727,151320,1,125
2011-05-09,summer,2011,May,12,Monday,Workingday,Clear,0.6,0.6212,0.43,0.194,35,160,195,195,602,195,1,3,3,133,2,728,184414,1,195
2011-05-09,summer,2011,May,13,Monday,Workingday,Clear,0.62,0.6212,0.38,0.2836,36,138,174,174,602,174,1,3,3,133,2,729,184919,1,174
2011-05-09,summer,2011,May,14,Monday,Workingday,Clear,0.62,0.6212,0.41,0.2239,44,118,162,162,602,162,1,3,3,133,2,729,175652,1,162
2011-05-09,summer,2011,May,15,Monday,Workingday,Clear,0.62,0.6212,0.41,0.2239,51,148,199,199,602,199,1,3,3,133,2,729,183149,1,199
2011-05-09,summer,2011,May,16,Monday,Workingday,Clear,0.64,0.6212,0.38,0.2239,49,255,304,304,602,304,1,4,3,143,2,730,227748,1,304
2011-05-09,summer,2011,May,17,Monday,Workingday,Clear,0.62,0.6212,0.38,0.2537,59,539,598,598,602,598,1,4,3,143,2,730,336860,1,598
2011-05-09,summer,2011,May,18,Monday,Workingday,Clear,0.62,0.6212,0.38,0.2985,66,458,524,524,602,524,1,4,3,143,2,728,309772,1,524
2011-05-09,summer,2011,May,19,Monday,Workingday,Clear,0.58,0.5455,0.43,0.194,45,339,384,384,602,384,1,4,3,143,2,728,226789,1,384
2011-05-09,summer,2011,May,20,Monday,Workingday,Clear,0.54,0.5152,0.49,0.194,25,214,239,239,602,239,1,3,3,133,0,728,164550,1,239
2011-05-09,summer,2011,May,21,Monday,Workingday,Clear,0.52,0.5,0.59,0.1343,28,128,156,156,602,156,1,3,3,133,0,728,125445,1,156
2011-05-09,summer,2011,May,22,Monday,Workingday,Clear,0.52,0.5,0.68,0.0896,21,95,116,116,602,116,1,2,3,123,0,728,95612,1,116
2011-05-09,summer,2011,May,23,Monday,Workingday,Clear,0.5,0.4848,0.68,0.0896,16,45,61,61,602,61,1,2,2,122,0,728,63941,1,61
2011-05-10,summer,2011,May,0,Tuesday,Workingday,Clear,0.48,0.4697,0.63,0.0,6,12,18,18,601,18,1,1,2,112,0,726,39130,1,18
2011-05-10,summer,2011,May,1,Tuesday,Workingday,Clear,0.46,0.4545,0.59,0.0896,3,12,15,15,601,15,1,1,2,112,0,724,24164,1,15
2011-05-10,summer,2011,May,2,Tuesday,Workingday,Clear,0.44,0.4394,0.58,0.1343,1,4,5,5,601,5,1,1,2,112,1,715,16352,1,5
2011-05-10,summer,2011,May,3,Tuesday,Workingday,Clear,0.44,0.4394,0.54,0.194,1,3,4,4,601,4,1,1,2,112,1,697,8174,1,4
2011-05-10,summer,2011,May,4,Tuesday,Workingday,Clear,0.42,0.4242,0.62,0.2537,0,2,2,2,601,2,1,1,2,112,1,697,4428,1,2
2011-05-10,summer,2011,May,5,Tuesday,Workingday,Clear,0.4,0.4091,0.66,0.2239,1,28,29,29,601,29,1,1,2,112,1,717,14261,1,29
2011-05-10,summer,2011,May,6,Tuesday,Workingday,Clear,0.42,0.4242,0.67,0.1343,9,103,112,112,601,112,1,2,2,122,0,725,55132,1,112
2011-05-10,summer,2011,May,7,Tuesday,Workingday,Mist,0.44,0.4394,0.62,0.1343,13,301,314,314,601,314,1,4,2,142,0,727,154171,1,314
2011-05-10,summer,2011,May,8,Tuesday,Workingday,Mist,0.5,0.4848,0.51,0.1045,28,397,425,425,601,425,1,4,2,142,2,727,261001,1,425
2011-05-10,summer,2011,May,9,Tuesday,Workingday,Mist,0.52,0.5,0.48,0.1045,29,176,205,205,601,205,1,3,3,133,0,727,159438,1,205
2011-05-10,summer,2011,May,10,Tuesday,Workingday,Mist,0.56,0.5303,0.37,0.0896,27,100,127,127,601,127,1,2,3,123,0,727,126257,1,127
2011-05-10,summer,2011,May,11,Tuesday,Workingday,Mist,0.56,0.5303,0.43,0.1343,17,108,125,125,601,125,1,2,3,123,0,727,151320,1,125
2011-05-10,summer,2011,May,12,Tuesday,Workingday,Mist,0.6,0.6212,0.38,0.0,47,170,217,217,601,217,1,3,3,133,2,728,184414,1,217
2011-05-10,summer,2011,May,13,Tuesday,Workingday,Mist,0.62,0.6212,0.38,0.2537,50,152,202,202,601,202,1,3,3,133,2,729,184919,1,202
2011-05-10,summer,2011,May,14,Tuesday,Workingday,Mist,0.62,0.6212,0.33,0.0,42,134,176,176,601,176,1,3,3,133,2,729,175652,1,176
2011-05-10,summer,2011,May,15,Tuesday,Workingday,Mist,0.64,0.6212,0.33,0.0896,28,152,180,180,601,180,1,3,3,133,2,729,183149,1,180
2011-05-10,summer,2011,May,16,Tuesday,Workingday,Clear,0.66,0.6212,0.31,0.1045,56,271,327,327,601,327,1,4,3,143,2,730,227748,1,327
2011-05-10,summer,2011,May,17,Tuesday,Workingday,Clear,0.64,0.6212,0.33,0.0,79,532,611,611,601,611,1,4,3,143,2,730,336860,1,611
2011-05-10,summer,2011,May,18,Tuesday,Workingday,Clear,0.64,0.6212,0.29,0.1343,70,480,550,550,601,550,1,4,3,143,2,728,309772,1,550
2011-05-10,summer,2011,May,19,Tuesday,Workingday,Clear,0.6,0.6212,0.43,0.2239,69,365,434,434,601,434,1,4,3,143,2,728,226789,1,434
2011-05-10,summer,2011,May,20,Tuesday,Workingday,Clear,0.54,0.5152,0.6,0.1343,50,241,291,291,601,291,1,4,3,143,0,728,164550,1,291
2011-05-10,summer,2011,May,21,Tuesday,Workingday,Clear,0.54,0.5152,0.52,0.0,30,173,203,203,601,203,1,3,3,133,0,728,125445,1,203
2011-05-10,summer,2011,May,22,Tuesday,Workingday,Clear,0.52,0.5,0.55,0.1045,29,121,150,150,601,150,1,3,3,133,0,728,95612,1,150
2011-05-10,summer,2011,May,23,Tuesday,Workingday,Mist,0.52,0.5,0.59,0.1343,9,72,81,81,601,81,1,2,3,123,0,728,63941,1,81
2011-05-11,summer,2011,May,0,Wednesday,Workingday,Mist,0.52,0.5,0.55,0.1343,8,30,38,38,600,38,1,1,3,113,0,726,39130,1,38
2011-05-11,summer,2011,May,1,Wednesday,Workingday,Mist,0.5,0.4848,0.59,0.1045,4,16,20,20,600,20,1,1,2,112,0,724,24164,1,20
2011-05-11,summer,2011,May,2,Wednesday,Workingday,Clear,0.52,0.5,0.59,0.0,6,4,10,10,600,10,1,1,3,113,0,715,16352,1,10
2011-05-11,summer,2011,May,3,Wednesday,Workingday,Clear,0.5,0.4848,0.63,0.2239,0,3,3,3,600,3,1,1,2,112,0,697,8174,1,3
2011-05-11,summer,2011,May,4,Wednesday,Workingday,Mist,0.48,0.4697,0.88,0.1343,0,2,2,2,600,2,1,1,2,112,0,697,4428,1,2
2011-05-11,summer,2011,May,5,Wednesday,Workingday,Clear,0.46,0.4545,0.88,0.1343,0,20,20,20,600,20,1,1,2,112,0,717,14261,1,20
2011-05-11,summer,2011,May,6,Wednesday,Workingday,Clear,0.46,0.4545,0.82,0.1343,6,93,99,99,600,99,1,2,2,122,0,725,55132,1,99
2011-05-11,summer,2011,May,7,Wednesday,Workingday,Clear,0.48,0.4697,0.72,0.194,25,293,318,318,600,318,1,4,2,142,0,727,154171,1,318
2011-05-11,summer,2011,May,8,Wednesday,Workingday,Clear,0.48,0.4697,0.77,0.2537,21,421,442,442,600,442,1,4,2,142,0,727,261001,1,442
2011-05-11,summer,2011,May,9,Wednesday,Workingday,Clear,0.52,0.5,0.72,0.1343,21,182,203,203,600,203,1,3,3,133,0,727,159438,1,203
2011-05-11,summer,2011,May,10,Wednesday,Workingday,Clear,0.54,0.5152,0.68,0.0896,30,124,154,154,600,154,1,3,3,133,0,727,126257,1,154
2011-05-11,summer,2011,May,11,Wednesday,Workingday,Clear,0.56,0.5303,0.64,0.0896,18,123,141,141,600,141,1,2,3,123,0,727,151320,1,141
2011-05-11,summer,2011,May,12,Wednesday,Workingday,Clear,0.6,0.6212,0.56,0.0,41,185,226,226,600,226,1,3,3,133,0,728,184414,1,226
2011-05-11,summer,2011,May,13,Wednesday,Workingday,Clear,0.62,0.6212,0.5,0.0,36,157,193,193,600,193,1,3,3,133,0,729,184919,1,193
2011-05-11,summer,2011,May,14,Wednesday,Workingday,Clear,0.62,0.6212,0.53,0.0896,36,141,177,177,600,177,1,3,3,133,0,729,175652,1,177
2011-05-11,summer,2011,May,15,Wednesday,Workingday,Clear,0.64,0.6212,0.41,0.0,48,131,179,179,600,179,1,3,3,133,2,729,183149,1,179
2011-05-11,summer,2011,May,16,Wednesday,Workingday,Clear,0.66,0.6212,0.39,0.0,49,240,289,289,600,289,1,4,3,143,2,730,227748,1,289
2011-05-11,summer,2011,May,17,Wednesday,Workingday,Clear,0.64,0.6212,0.47,0.1045,17,242,259,259,600,259,1,3,3,133,2,730,336860,1,259
2011-05-11,summer,2011,May,18,Wednesday,Workingday,Clear,0.62,0.6212,0.5,0.2985,40,234,274,274,600,274,1,3,3,133,2,728,309772,1,274
2011-05-11,summer,2011,May,19,Wednesday,Workingday,Clear,0.56,0.5303,0.52,0.1343,60,341,401,401,600,401,1,4,3,143,2,728,226789,1,401
2011-05-11,summer,2011,May,20,Wednesday,Workingday,Clear,0.54,0.5152,0.64,0.1343,28,245,273,273,600,273,1,3,3,133,0,728,164550,1,273
2011-05-11,summer,2011,May,21,Wednesday,Workingday,Clear,0.54,0.5152,0.6,0.0,32,202,234,234,600,234,1,3,3,133,0,728,125445,1,234
2011-05-11,summer,2011,May,22,Wednesday,Workingday,Clear,0.5,0.4848,0.72,0.2537,12,134,146,146,600,146,1,3,2,132,0,728,95612,1,146
2011-05-11,summer,2011,May,23,Wednesday,Workingday,Clear,0.46,0.4545,0.88,0.2537,12,69,81,81,600,81,1,2,2,122,0,728,63941,1,81
2011-05-12,summer,2011,May,0,Thursday,Workingday,Mist,0.46,0.4545,0.88,0.2239,5,39,44,44,599,44,1,2,2,122,0,726,39130,1,44
2011-05-12,summer,2011,May,1,Thursday,Workingday,Clear,0.46,0.4545,0.88,0.2239,1,16,17,17,599,17,1,1,2,112,0,724,24164,1,17
2011-05-12,summer,2011,May,2,Thursday,Workingday,Clear,0.44,0.4394,0.94,0.194,1,14,15,15,599,15,1,1,2,112,0,715,16352,1,15
2011-05-12,summer,2011,May,3,Thursday,Workingday,Clear,0.44,0.4394,0.88,0.1343,0,5,5,5,599,5,1,1,2,112,0,697,8174,1,5
2011-05-12,summer,2011,May,4,Thursday,Workingday,Clear,0.42,0.4242,0.94,0.0,1,5,6,6,599,6,1,1,2,112,0,697,4428,1,6
2011-05-12,summer,2011,May,5,Thursday,Workingday,Clear,0.42,0.4242,0.94,0.1343,2,27,29,29,599,29,1,1,2,112,0,717,14261,1,29
2011-05-12,summer,2011,May,6,Thursday,Workingday,Clear,0.44,0.4394,0.88,0.0,9,103,112,112,599,112,1,2,2,122,0,725,55132,1,112
2011-05-12,summer,2011,May,7,Thursday,Workingday,Clear,0.46,0.4545,0.88,0.1343,14,283,297,297,599,297,1,4,2,142,0,727,154171,1,297
2011-05-12,summer,2011,May,8,Thursday,Workingday,Clear,0.48,0.4697,0.82,0.194,27,394,421,421,599,421,1,4,2,142,0,727,261001,1,421
2011-05-12,summer,2011,May,9,Thursday,Workingday,Mist,0.5,0.4848,0.77,0.2836,21,191,212,212,599,212,1,3,2,132,0,727,159438,1,212
2011-05-12,summer,2011,May,10,Thursday,Workingday,Mist,0.54,0.5152,0.68,0.2239,28,119,147,147,599,147,1,3,3,133,0,727,126257,1,147
2011-05-12,summer,2011,May,11,Thursday,Workingday,Clear,0.58,0.5455,0.6,0.2239,43,136,179,179,599,179,1,3,3,133,0,727,151320,1,179
2011-05-12,summer,2011,May,12,Thursday,Workingday,Clear,0.58,0.5455,0.6,0.2239,43,164,207,207,599,207,1,3,3,133,0,728,184414,1,207
2011-05-12,summer,2011,May,13,Thursday,Workingday,Mist,0.62,0.6212,0.57,0.2985,48,170,218,218,599,218,1,3,3,133,2,729,184919,1,218
2011-05-12,summer,2011,May,14,Thursday,Workingday,Mist,0.62,0.6061,0.61,0.2239,43,148,191,191,599,191,1,3,3,133,0,729,175652,1,191
2011-05-12,summer,2011,May,15,Thursday,Workingday,Mist,0.64,0.6212,0.53,0.2537,54,163,217,217,599,217,1,3,3,133,2,729,183149,1,217
2011-05-12,summer,2011,May,16,Thursday,Workingday,Mist,0.64,0.6212,0.57,0.2537,50,238,288,288,599,288,1,4,3,143,2,730,227748,1,288
2011-05-12,summer,2011,May,17,Thursday,Workingday,Mist,0.64,0.6212,0.57,0.194,54,540,594,594,599,594,1,4,3,143,2,730,336860,1,594
2011-05-12,summer,2011,May,18,Thursday,Workingday,Clear,0.62,0.6061,0.69,0.2239,64,463,527,527,599,527,1,4,3,143,2,728,309772,1,527
2011-05-12,summer,2011,May,19,Thursday,Workingday,Mist,0.6,0.6061,0.64,0.194,59,305,364,364,599,364,1,4,3,143,2,728,226789,1,364
2011-05-12,summer,2011,May,20,Thursday,Workingday,Clear,0.6,0.6061,0.64,0.194,56,220,276,276,599,276,1,3,3,133,2,728,164550,1,276
2011-05-12,summer,2011,May,21,Thursday,Workingday,Clear,0.56,0.5303,0.83,0.1343,31,192,223,223,599,223,1,3,3,133,0,728,125445,1,223
2011-05-12,summer,2011,May,22,Thursday,Workingday,Clear,0.54,0.5152,0.83,0.194,25,147,172,172,599,172,1,3,3,133,0,728,95612,1,172
2011-05-12,summer,2011,May,23,Thursday,Workingday,Mist,0.54,0.5152,0.77,0.194,16,87,103,103,599,103,1,2,3,123,0,728,63941,1,103
2011-05-13,summer,2011,May,0,Friday,Workingday,Mist,0.52,0.5,0.83,0.1642,6,46,52,52,598,52,1,2,3,123,0,726,39130,1,52
2011-05-13,summer,2011,May,1,Friday,Workingday,Clear,0.52,0.5,0.83,0.1642,5,15,20,20,598,20,1,1,3,113,0,724,24164,1,20
2011-05-13,summer,2011,May,2,Friday,Workingday,Mist,0.5,0.4848,0.88,0.1343,3,8,11,11,598,11,1,1,2,112,0,715,16352,1,11
2011-05-13,summer,2011,May,3,Friday,Workingday,Mist,0.5,0.4848,0.88,0.1343,2,2,4,4,598,4,1,1,2,112,0,697,8174,1,4
2011-05-13,summer,2011,May,4,Friday,Workingday,Light Snow,0.5,0.4848,0.88,0.1642,2,3,5,5,598,5,1,1,2,112,0,697,4428,1,5
2011-05-13,summer,2011,May,5,Friday,Workingday,Mist,0.5,0.4848,0.88,0.194,1,24,25,25,598,25,1,1,2,112,0,717,14261,1,25
2011-05-13,summer,2011,May,6,Friday,Workingday,Light Snow,0.5,0.4848,0.88,0.1343,6,76,82,82,598,82,1,2,2,122,0,725,55132,1,82
2011-05-13,summer,2011,May,7,Friday,Workingday,Light Snow,0.5,0.4848,0.88,0.1642,16,141,157,157,598,157,1,3,2,132,0,727,154171,1,157
2011-05-13,summer,2011,May,8,Friday,Workingday,Mist,0.5,0.4848,0.88,0.194,26,361,387,387,598,387,1,4,2,142,0,727,261001,1,387
2011-05-13,summer,2011,May,9,Friday,Workingday,Mist,0.5,0.4848,0.88,0.194,18,215,233,233,598,233,1,3,2,132,0,727,159438,1,233
2011-05-13,summer,2011,May,10,Friday,Workingday,Mist,0.52,0.5,0.83,0.1343,31,99,130,130,598,130,1,2,3,123,0,727,126257,1,130
2011-05-13,summer,2011,May,11,Friday,Workingday,Mist,0.52,0.5,0.83,0.1642,56,90,146,146,598,146,1,3,3,133,0,727,151320,1,146
2011-05-13,summer,2011,May,12,Friday,Workingday,Mist,0.52,0.5,0.88,0.194,53,170,223,223,598,223,1,3,3,133,0,728,184414,1,223
2011-05-13,summer,2011,May,13,Friday,Workingday,Mist,0.52,0.5,0.88,0.3881,69,157,226,226,598,226,1,3,3,133,0,729,184919,1,226
2011-05-13,summer,2011,May,14,Friday,Workingday,Mist,0.52,0.5,0.87,0.2836,70,120,190,190,598,190,1,3,3,133,0,729,175652,1,190
2011-05-13,summer,2011,May,15,Friday,Workingday,Mist,0.52,0.5,0.88,0.1642,56,142,198,198,598,198,1,3,3,133,0,729,183149,1,198
2011-05-13,summer,2011,May,16,Friday,Workingday,Mist,0.52,0.5,0.88,0.1343,44,256,300,300,598,300,1,4,3,143,0,730,227748,1,300
2011-05-13,summer,2011,May,17,Friday,Workingday,Light Snow,0.52,0.5,0.88,0.1642,62,429,491,491,598,491,1,4,3,143,0,730,336860,1,491
2011-05-13,summer,2011,May,18,Friday,Workingday,Light Snow,0.52,0.5,0.88,0.1642,39,359,398,398,598,398,1,4,3,143,0,728,309772,1,398
2011-05-13,summer,2011,May,19,Friday,Workingday,Mist,0.52,0.5,0.83,0.194,25,245,270,270,598,270,1,3,3,133,0,728,226789,1,270
2011-05-13,summer,2011,May,20,Friday,Workingday,Mist,0.52,0.5,0.83,0.1343,22,130,152,152,598,152,1,3,3,133,0,728,164550,1,152
2011-05-13,summer,2011,May,21,Friday,Workingday,Mist,0.52,0.5,0.84,0.1642,24,130,154,154,598,154,1,3,3,133,0,728,125445,1,154
2011-05-13,summer,2011,May,22,Friday,Workingday,Mist,0.52,0.5,0.83,0.2239,25,107,132,132,598,132,1,2,3,123,0,728,95612,1,132
2011-05-13,summer,2011,May,23,Friday,Workingday,Light Snow,0.5,0.4848,0.88,0.1642,31,88,119,119,598,119,1,2,2,122,0,728,63941,1,119
2011-05-14,summer,2011,May,0,Saturday,Holiday,Mist,0.5,0.4848,0.88,0.1343,24,78,102,102,597,102,1,2,2,122,0,726,39130,1,102
2011-05-14,summer,2011,May,1,Saturday,Holiday,Mist,0.5,0.4848,0.88,0.1343,18,64,82,82,597,82,1,2,2,122,0,724,24164,1,82
2011-05-14,summer,2011,May,2,Saturday,Holiday,Mist,0.5,0.4848,0.88,0.1343,15,37,52,52,597,52,1,2,2,122,0,715,16352,1,52
2011-05-14,summer,2011,May,3,Saturday,Holiday,Mist,0.5,0.4848,0.88,0.1343,5,30,35,35,597,35,1,1,2,112,0,697,8174,1,35
2011-05-14,summer,2011,May,4,Saturday,Holiday,Mist,0.5,0.4848,0.82,0.1642,1,4,5,5,597,5,1,1,2,112,0,697,4428,1,5
2011-05-14,summer,2011,May,5,Saturday,Holiday,Mist,0.5,0.4848,0.82,0.1045,7,7,14,14,597,14,1,1,2,112,0,717,14261,1,14
2011-05-14,summer,2011,May,6,Saturday,Holiday,Mist,0.5,0.4848,0.88,0.1045,2,9,11,11,597,11,1,1,2,112,0,725,55132,1,11
2011-05-14,summer,2011,May,7,Saturday,Holiday,Light Snow,0.48,0.4697,1.0,0.0,4,28,32,32,597,32,1,1,2,112,0,727,154171,1,32
2011-05-14,summer,2011,May,8,Saturday,Holiday,Light Snow,0.5,0.4848,0.94,0.0,16,72,88,88,597,88,1,2,2,122,0,727,261001,1,88
2011-05-14,summer,2011,May,9,Saturday,Holiday,Mist,0.52,0.5,0.94,0.0896,14,86,100,100,597,100,1,2,3,123,0,727,159438,1,100
2011-05-14,summer,2011,May,10,Saturday,Holiday,Mist,0.52,0.5,0.94,0.1642,34,133,167,167,597,167,1,3,3,133,0,727,126257,1,167
2011-05-14,summer,2011,May,11,Saturday,Holiday,Mist,0.52,0.5,0.94,0.1343,72,207,279,279,597,279,1,3,3,133,0,727,151320,1,279
2011-05-14,summer,2011,May,12,Saturday,Holiday,Light Snow,0.52,0.5,1.0,0.0896,75,204,279,279,597,279,1,3,3,133,0,728,184414,1,279
2011-05-14,summer,2011,May,13,Saturday,Holiday,Light Snow,0.52,0.5,1.0,0.0896,68,180,248,248,597,248,1,3,3,133,0,729,184919,1,248
2011-05-14,summer,2011,May,14,Saturday,Holiday,Mist,0.54,0.5152,0.94,0.1343,57,159,216,216,597,216,1,3,3,133,0,729,175652,1,216
2011-05-14,summer,2011,May,15,Saturday,Holiday,Mist,0.54,0.5152,0.94,0.1642,73,221,294,294,597,294,1,4,3,143,0,729,183149,1,294
2011-05-14,summer,2011,May,16,Saturday,Holiday,Mist,0.54,0.5152,0.94,0.194,107,188,295,295,597,295,1,4,3,143,0,730,227748,1,295
2011-05-14,summer,2011,May,17,Saturday,Holiday,Mist,0.56,0.5303,0.88,0.194,78,194,272,272,597,272,1,3,3,133,0,730,336860,1,272
2011-05-14,summer,2011,May,18,Saturday,Holiday,Mist,0.56,0.5303,0.88,0.2239,88,216,304,304,597,304,1,4,3,143,0,728,309772,1,304
2011-05-14,summer,2011,May,19,Saturday,Holiday,Light Snow,0.54,0.5152,0.94,0.1343,69,179,248,248,597,248,1,3,3,133,0,728,226789,1,248
2011-05-14,summer,2011,May,20,Saturday,Holiday,Light Snow,0.54,0.5152,0.94,0.1343,42,115,157,157,597,157,1,3,3,133,0,728,164550,1,157
2011-05-14,summer,2011,May,21,Saturday,Holiday,Light Snow,0.54,0.5152,0.94,0.2239,15,44,59,59,597,59,1,2,3,123,0,728,125445,1,59
2011-05-14,summer,2011,May,22,Saturday,Holiday,Light Snow,0.54,0.5152,0.94,0.1642,7,19,26,26,597,26,1,1,3,113,0,728,95612,1,26
2011-05-14,summer,2011,May,23,Saturday,Holiday,Light Snow,0.52,0.5,1.0,0.194,11,33,44,44,597,44,1,2,3,123,0,728,63941,1,44
2011-05-15,summer,2011,May,0,Sunday,Holiday,Mist,0.52,0.5,1.0,0.0,5,34,39,39,596,39,1,1,3,113,0,726,39130,1,39
2011-05-15,summer,2011,May,1,Sunday,Holiday,Mist,0.52,0.5,1.0,0.1045,4,43,47,47,596,47,1,2,3,123,0,724,24164,1,47
2011-05-15,summer,2011,May,2,Sunday,Holiday,Mist,0.52,0.5,1.0,0.1343,13,37,50,50,596,50,1,2,3,123,0,715,16352,1,50
2011-05-15,summer,2011,May,3,Sunday,Holiday,Mist,0.52,0.5,1.0,0.0,11,21,32,32,596,32,1,1,3,113,0,697,8174,1,32
2011-05-15,summer,2011,May,4,Sunday,Holiday,Mist,0.52,0.5,1.0,0.0,5,8,13,13,596,13,1,1,3,113,0,697,4428,1,13
2011-05-15,summer,2011,May,5,Sunday,Holiday,Light Snow,0.52,0.5,1.0,0.1045,3,11,14,14,596,14,1,1,3,113,0,717,14261,1,14
2011-05-15,summer,2011,May,6,Sunday,Holiday,Mist,0.52,0.5,1.0,0.1343,3,14,17,17,596,17,1,1,3,113,0,725,55132,1,17
2011-05-15,summer,2011,May,7,Sunday,Holiday,Mist,0.52,0.5,1.0,0.1343,4,38,42,42,596,42,1,2,3,123,0,727,154171,1,42
2011-05-15,summer,2011,May,8,Sunday,Holiday,Mist,0.54,0.5152,0.94,0.1343,24,46,70,70,596,70,1,2,3,123,0,727,261001,1,70
2011-05-15,summer,2011,May,9,Sunday,Holiday,Clear,0.58,0.5455,0.83,0.2537,36,98,134,134,596,134,1,2,3,123,0,727,159438,1,134
2011-05-15,summer,2011,May,10,Sunday,Holiday,Clear,0.58,0.5455,0.83,0.2239,73,153,226,226,596,226,1,3,3,133,0,727,126257,1,226
2011-05-15,summer,2011,May,11,Sunday,Holiday,Clear,0.6,0.5758,0.78,0.2239,120,202,322,322,596,322,1,4,3,143,2,727,151320,1,322
2011-05-15,summer,2011,May,12,Sunday,Holiday,Clear,0.62,0.5909,0.73,0.2985,120,247,367,367,596,367,1,4,3,143,2,728,184414,1,367
2011-05-15,summer,2011,May,13,Sunday,Holiday,Clear,0.62,0.5909,0.73,0.2836,195,261,456,456,596,456,1,4,3,143,2,729,184919,1,456
2011-05-15,summer,2011,May,14,Sunday,Holiday,Clear,0.64,0.6061,0.73,0.194,183,254,437,437,596,437,1,4,3,143,2,729,175652,1,437
2011-05-15,summer,2011,May,15,Sunday,Holiday,Clear,0.66,0.6212,0.69,0.2537,206,253,459,459,596,459,1,4,3,143,2,729,183149,1,459
2011-05-15,summer,2011,May,16,Sunday,Holiday,Clear,0.64,0.6061,0.69,0.2537,158,282,440,440,596,440,1,4,3,143,2,730,227748,1,440
2011-05-15,summer,2011,May,17,Sunday,Holiday,Light Snow,0.56,0.5303,0.78,0.3582,137,255,392,392,596,392,1,4,3,143,2,730,336860,1,392
2011-05-15,summer,2011,May,18,Sunday,Holiday,Clear,0.56,0.5303,0.78,0.2537,60,177,237,237,596,237,1,3,3,133,0,728,309772,1,237
2011-05-15,summer,2011,May,19,Sunday,Holiday,Clear,0.56,0.5303,0.83,0.1045,78,153,231,231,596,231,1,3,3,133,0,728,226789,1,231
2011-05-15,summer,2011,May,20,Sunday,Holiday,Clear,0.54,0.5152,0.88,0.0,53,138,191,191,596,191,1,3,3,133,0,728,164550,1,191
2011-05-15,summer,2011,May,21,Sunday,Holiday,Clear,0.54,0.5152,0.88,0.0,44,107,151,151,596,151,1,3,3,133,0,728,125445,1,151
2011-05-15,summer,2011,May,22,Sunday,Holiday,Clear,0.56,0.5303,0.83,0.0,29,88,117,117,596,117,1,2,3,123,0,728,95612,1,117
2011-05-15,summer,2011,May,23,Sunday,Holiday,Clear,0.54,0.5152,0.88,0.2239,18,51,69,69,596,69,1,2,3,123,0,728,63941,1,69
2011-05-16,summer,2011,May,0,Monday,Workingday,Clear,0.52,0.5,0.94,0.1045,17,21,38,38,595,38,1,1,3,113,0,726,39130,1,38
2011-05-16,summer,2011,May,1,Monday,Workingday,Clear,0.52,0.5,0.94,0.1343,6,8,14,14,595,14,1,1,3,113,0,724,24164,1,14
2011-05-16,summer,2011,May,2,Monday,Workingday,Clear,0.5,0.4848,1.0,0.0896,4,9,13,13,595,13,1,1,2,112,0,715,16352,1,13
2011-05-16,summer,2011,May,3,Monday,Workingday,Clear,0.5,0.4848,0.94,0.1642,1,3,4,4,595,4,1,1,2,112,0,697,8174,1,4
2011-05-16,summer,2011,May,4,Monday,Workingday,Clear,0.5,0.4848,1.0,0.1343,1,5,6,6,595,6,1,1,2,112,0,697,4428,1,6
2011-05-16,summer,2011,May,5,Monday,Workingday,Clear,0.5,0.4848,0.93,0.194,1,20,21,21,595,21,1,1,2,112,0,717,14261,1,21
2011-05-16,summer,2011,May,6,Monday,Workingday,Clear,0.52,0.5,0.88,0.1642,11,93,104,104,595,104,1,2,3,123,0,725,55132,1,104
2011-05-16,summer,2011,May,7,Monday,Workingday,Clear,0.52,0.5,0.83,0.2836,27,245,272,272,595,272,1,3,3,133,0,727,154171,1,272
2011-05-16,summer,2011,May,8,Monday,Workingday,Clear,0.56,0.5303,0.73,0.2985,28,366,394,394,595,394,1,4,3,143,2,727,261001,1,394
2011-05-16,summer,2011,May,9,Monday,Workingday,Clear,0.6,0.5909,0.69,0.194,38,156,194,194,595,194,1,3,3,133,0,727,159438,1,194
2011-05-16,summer,2011,May,10,Monday,Workingday,Clear,0.62,0.6061,0.65,0.0896,37,75,112,112,595,112,1,2,3,123,0,727,126257,1,112
2011-05-16,summer,2011,May,11,Monday,Workingday,Clear,0.64,0.6212,0.57,0.0,56,129,185,185,595,185,1,3,3,133,0,727,151320,1,185
2011-05-16,summer,2011,May,12,Monday,Workingday,Clear,0.66,0.6212,0.54,0.0896,72,137,209,209,595,209,1,3,3,133,2,728,184414,1,209
2011-05-16,summer,2011,May,13,Monday,Workingday,Clear,0.68,0.6364,0.51,0.0,61,153,214,214,595,214,1,3,4,134,2,729,184919,1,214
2011-05-16,summer,2011,May,14,Monday,Workingday,Clear,0.68,0.6364,0.51,0.0,76,117,193,193,595,193,1,3,4,134,2,729,175652,1,193
2011-05-16,summer,2011,May,15,Monday,Workingday,Clear,0.72,0.6667,0.51,0.0,55,110,165,165,595,165,1,3,4,134,0,729,183149,1,165
2011-05-16,summer,2011,May,16,Monday,Workingday,Light Snow,0.6,0.5758,0.78,0.2537,45,181,226,226,595,226,1,3,3,133,0,730,227748,1,226
2011-05-16,summer,2011,May,17,Monday,Workingday,Clear,0.58,0.5455,0.88,0.2239,47,227,274,274,595,274,1,3,3,133,0,730,336860,1,274
2011-05-16,summer,2011,May,18,Monday,Workingday,Light Snow,0.58,0.5455,0.83,0.194,55,398,453,453,595,453,1,4,3,143,2,728,309772,1,453
2011-05-16,summer,2011,May,19,Monday,Workingday,Clear,0.58,0.5455,0.83,0.2537,36,272,308,308,595,308,1,4,3,143,0,728,226789,1,308
2011-05-16,summer,2011,May,20,Monday,Workingday,Clear,0.58,0.5455,0.83,0.0,31,167,198,198,595,198,1,3,3,133,0,728,164550,1,198
2011-05-16,summer,2011,May,21,Monday,Workingday,Clear,0.58,0.5455,0.83,0.0,28,149,177,177,595,177,1,3,3,133,0,728,125445,1,177
2011-05-16,summer,2011,May,22,Monday,Workingday,Clear,0.56,0.5303,0.88,0.0896,22,105,127,127,595,127,1,2,3,123,0,728,95612,1,127
2011-05-16,summer,2011,May,23,Monday,Workingday,Clear,0.56,0.5303,0.88,0.0896,18,39,57,57,595,57,1,2,3,123,0,728,63941,1,57
2011-05-17,summer,2011,May,0,Tuesday,Workingday,Mist,0.56,0.5303,0.88,0.0,13,18,31,31,594,31,1,1,3,113,0,726,39130,1,31
2011-05-17,summer,2011,May,1,Tuesday,Workingday,Light Snow,0.56,0.5303,0.88,0.0,7,6,13,13,594,13,1,1,3,113,0,724,24164,1,13
2011-05-17,summer,2011,May,2,Tuesday,Workingday,Light Snow,0.56,0.5303,0.88,0.0,4,4,8,8,594,8,1,1,3,113,0,715,16352,1,8
2011-05-17,summer,2011,May,3,Tuesday,Workingday,Light Snow,0.54,0.5152,0.94,0.2537,1,3,4,4,594,4,1,1,3,113,0,697,8174,1,4
2011-05-17,summer,2011,May,4,Tuesday,Workingday,Light Snow,0.54,0.5152,0.94,0.2537,2,2,4,4,594,4,1,1,3,113,0,697,4428,1,4
2011-05-17,summer,2011,May,5,Tuesday,Workingday,Light Snow,0.52,0.5,0.94,0.2537,0,22,22,22,594,22,1,1,3,113,0,717,14261,1,22
2011-05-17,summer,2011,May,6,Tuesday,Workingday,Light Snow,0.52,0.5,0.94,0.2537,0,49,49,49,594,49,1,2,3,123,0,725,55132,1,49
2011-05-17,summer,2011,May,7,Tuesday,Workingday,Mist,0.52,0.5,0.94,0.2537,13,138,151,151,594,151,1,3,3,133,0,727,154171,1,151
2011-05-17,summer,2011,May,8,Tuesday,Workingday,Mist,0.52,0.5,0.94,0.2985,22,325,347,347,594,347,1,4,3,143,0,727,261001,1,347
2011-05-17,summer,2011,May,9,Tuesday,Workingday,Mist,0.54,0.5152,0.88,0.2537,17,190,207,207,594,207,1,3,3,133,0,727,159438,1,207
2011-05-17,summer,2011,May,10,Tuesday,Workingday,Light Snow,0.54,0.5152,0.88,0.2537,31,73,104,104,594,104,1,2,3,123,0,727,126257,1,104
2011-05-17,summer,2011,May,11,Tuesday,Workingday,Mist,0.56,0.5303,0.83,0.4179,26,104,130,130,594,130,1,2,3,123,0,727,151320,1,130
2011-05-17,summer,2011,May,12,Tuesday,Workingday,Light Snow,0.56,0.5303,0.83,0.4179,38,115,153,153,594,153,1,3,3,133,0,728,184414,1,153
2011-05-17,summer,2011,May,13,Tuesday,Workingday,Mist,0.56,0.5303,0.88,0.3284,31,141,172,172,594,172,1,3,3,133,0,729,184919,1,172
2011-05-17,summer,2011,May,14,Tuesday,Workingday,Clear,0.62,0.5909,0.73,0.4627,61,123,184,184,594,184,1,3,3,133,2,729,175652,1,184
2011-05-17,summer,2011,May,15,Tuesday,Workingday,Clear,0.62,0.6061,0.69,0.4478,79,131,210,210,594,210,1,3,3,133,2,729,183149,1,210
2011-05-17,summer,2011,May,16,Tuesday,Workingday,Clear,0.62,0.6061,0.61,0.3284,73,217,290,290,594,290,1,4,3,143,2,730,227748,1,290
2011-05-17,summer,2011,May,17,Tuesday,Workingday,Clear,0.62,0.6061,0.65,0.4179,83,521,604,604,594,604,1,4,3,143,2,730,336860,1,604
2011-05-17,summer,2011,May,18,Tuesday,Workingday,Clear,0.6,0.5909,0.69,0.2985,54,426,480,480,594,480,1,4,3,143,2,728,309772,1,480
2011-05-17,summer,2011,May,19,Tuesday,Workingday,Clear,0.6,0.5909,0.69,0.2537,51,298,349,349,594,349,1,4,3,143,2,728,226789,1,349
2011-05-17,summer,2011,May,20,Tuesday,Workingday,Clear,0.58,0.5455,0.83,0.4179,30,253,283,283,594,283,1,4,3,143,0,728,164550,1,283
2011-05-17,summer,2011,May,21,Tuesday,Workingday,Clear,0.54,0.5152,0.88,0.2537,23,151,174,174,594,174,1,3,3,133,0,728,125445,1,174
2011-05-17,summer,2011,May,22,Tuesday,Workingday,Mist,0.54,0.5152,0.88,0.2836,12,86,98,98,594,98,1,2,3,123,0,728,95612,1,98
2011-05-17,summer,2011,May,23,Tuesday,Workingday,Mist,0.54,0.5152,0.88,0.2537,7,49,56,56,594,56,1,2,3,123,0,728,63941,1,56
2011-05-18,summer,2011,May,0,Wednesday,Workingday,Mist,0.54,0.5152,0.88,0.2239,8,15,23,23,593,23,1,1,3,113,0,726,39130,1,23
2011-05-18,summer,2011,May,1,Wednesday,Workingday,Mist,0.54,0.5152,0.88,0.2537,3,9,12,12,593,12,1,1,3,113,0,724,24164,1,12
2011-05-18,summer,2011,May,2,Wednesday,Workingday,Light Snow,0.52,0.5,0.94,0.2239,1,5,6,6,593,6,1,1,3,113,0,715,16352,1,6
2011-05-18,summer,2011,May,3,Wednesday,Workingday,Light Snow,0.52,0.5,0.94,0.2985,6,3,9,9,593,9,1,1,3,113,0,697,8174,1,9
2011-05-18,summer,2011,May,4,Wednesday,Workingday,Light Snow,0.52,0.5,0.94,0.2985,1,2,3,3,593,3,1,1,3,113,0,697,4428,1,3
2011-05-18,summer,2011,May,5,Wednesday,Workingday,Clear,0.52,0.5,1.0,0.2239,0,9,9,9,593,9,1,1,3,113,0,717,14261,1,9
2011-05-18,summer,2011,May,6,Wednesday,Workingday,Clear,0.52,0.5,1.0,0.1343,2,99,101,101,593,101,1,2,3,123,0,725,55132,1,101
2011-05-18,summer,2011,May,7,Wednesday,Workingday,Clear,0.54,0.5152,0.88,0.194,14,260,274,274,593,274,1,3,3,133,0,727,154171,1,274
2011-05-18,summer,2011,May,8,Wednesday,Workingday,Clear,0.56,0.5303,0.88,0.2836,25,428,453,453,593,453,1,4,3,143,0,727,261001,1,453
2011-05-18,summer,2011,May,9,Wednesday,Workingday,Light Snow,0.56,0.5303,0.83,0.2537,26,176,202,202,593,202,1,3,3,133,0,727,159438,1,202
2011-05-18,summer,2011,May,10,Wednesday,Workingday,Light Snow,0.54,0.5152,0.88,0.2836,33,73,106,106,593,106,1,2,3,123,0,727,126257,1,106
2011-05-18,summer,2011,May,11,Wednesday,Workingday,Mist,0.54,0.5152,0.94,0.0896,6,17,23,23,593,23,1,1,3,113,0,727,151320,1,23
2011-05-18,summer,2011,May,12,Wednesday,Workingday,Clear,0.56,0.5303,0.94,0.2985,12,42,54,54,593,54,1,2,3,123,0,728,184414,1,54
2011-05-18,summer,2011,May,13,Wednesday,Workingday,Mist,0.56,0.5303,0.83,0.3284,30,92,122,122,593,122,1,2,3,123,0,729,184919,1,122
2011-05-18,summer,2011,May,14,Wednesday,Workingday,Mist,0.58,0.5455,0.78,0.2836,44,94,138,138,593,138,1,2,3,123,0,729,175652,1,138
2011-05-18,summer,2011,May,15,Wednesday,Workingday,Clear,0.6,0.5758,0.78,0.2537,34,133,167,167,593,167,1,3,3,133,0,729,183149,1,167
2011-05-18,summer,2011,May,16,Wednesday,Workingday,Clear,0.6,0.5909,0.73,0.194,53,241,294,294,593,294,1,4,3,143,0,730,227748,1,294
2011-05-18,summer,2011,May,17,Wednesday,Workingday,Clear,0.6,0.5909,0.69,0.1343,78,487,565,565,593,565,1,4,3,143,2,730,336860,1,565
2011-05-18,summer,2011,May,18,Wednesday,Workingday,Clear,0.6,0.5909,0.73,0.2239,58,431,489,489,593,489,1,4,3,143,2,728,309772,1,489
2011-05-18,summer,2011,May,19,Wednesday,Workingday,Light Snow,0.56,0.5303,0.88,0.1343,43,288,331,331,593,331,1,4,3,143,0,728,226789,1,331
2011-05-18,summer,2011,May,20,Wednesday,Workingday,Light Snow,0.56,0.5303,0.88,0.1343,24,189,213,213,593,213,1,3,3,133,0,728,164550,1,213
2011-05-18,summer,2011,May,21,Wednesday,Workingday,Clear,0.52,0.5,0.88,0.0,11,74,85,85,593,85,1,2,3,123,0,728,125445,1,85
2011-05-18,summer,2011,May,22,Wednesday,Workingday,Clear,0.52,0.5,0.83,0.0,14,103,117,117,593,117,1,2,3,123,0,728,95612,1,117
2011-05-18,summer,2011,May,23,Wednesday,Workingday,Clear,0.52,0.5,0.94,0.0896,10,49,59,59,593,59,1,2,3,123,0,728,63941,1,59
2011-05-19,summer,2011,May,0,Thursday,Workingday,Clear,0.52,0.5,0.94,0.1045,6,23,29,29,592,29,1,1,3,113,0,726,39130,1,29
2011-05-19,summer,2011,May,1,Thursday,Workingday,Clear,0.5,0.4848,0.94,0.0,2,4,6,6,592,6,1,1,2,112,0,724,24164,1,6
2011-05-19,summer,2011,May,2,Thursday,Workingday,Clear,0.5,0.4848,0.94,0.0,3,12,15,15,592,15,1,1,2,112,0,715,16352,1,15
2011-05-19,summer,2011,May,3,Thursday,Workingday,Clear,0.48,0.4697,1.0,0.0,1,3,4,4,592,4,1,1,2,112,0,697,8174,1,4
2011-05-19,summer,2011,May,4,Thursday,Workingday,Clear,0.48,0.4697,0.94,0.0,2,3,5,5,592,5,1,1,2,112,0,697,4428,1,5
2011-05-19,summer,2011,May,5,Thursday,Workingday,Clear,0.48,0.4697,0.94,0.0,2,24,26,26,592,26,1,1,2,112,0,717,14261,1,26
2011-05-19,summer,2011,May,6,Thursday,Workingday,Mist,0.5,0.4848,0.94,0.0,17,86,103,103,592,103,1,2,2,122,0,725,55132,1,103
2011-05-19,summer,2011,May,7,Thursday,Workingday,Mist,0.5,0.4848,1.0,0.0,18,239,257,257,592,257,1,3,2,132,0,727,154171,1,257
2011-05-19,summer,2011,May,8,Thursday,Workingday,Mist,0.52,0.5,0.88,0.0,34,453,487,487,592,487,1,4,3,143,0,727,261001,1,487
2011-05-19,summer,2011,May,9,Thursday,Workingday,Mist,0.54,0.5152,0.88,0.0896,40,176,216,216,592,216,1,3,3,133,0,727,159438,1,216
2011-05-19,summer,2011,May,10,Thursday,Workingday,Mist,0.54,0.5152,0.83,0.0,35,95,130,130,592,130,1,2,3,123,0,727,126257,1,130
2011-05-19,summer,2011,May,11,Thursday,Workingday,Light Snow,0.54,0.5152,0.88,0.1642,53,111,164,164,592,164,1,3,3,133,0,727,151320,1,164
2011-05-19,summer,2011,May,12,Thursday,Workingday,Mist,0.58,0.5455,0.78,0.1045,38,130,168,168,592,168,1,3,3,133,0,728,184414,1,168
2011-05-19,summer,2011,May,13,Thursday,Workingday,Light Snow,0.58,0.5455,0.64,0.2537,44,139,183,183,592,183,1,3,3,133,0,729,184919,1,183
2011-05-19,summer,2011,May,14,Thursday,Workingday,Light Snow,0.54,0.5152,0.73,0.194,43,137,180,180,592,180,1,3,3,133,0,729,175652,1,180
2011-05-19,summer,2011,May,15,Thursday,Workingday,Clear,0.56,0.5303,0.78,0.1642,63,125,188,188,592,188,1,3,3,133,0,729,183149,1,188
2011-05-19,summer,2011,May,16,Thursday,Workingday,Clear,0.58,0.5455,0.64,0.194,55,247,302,302,592,302,1,4,3,143,2,730,227748,1,302
2011-05-19,summer,2011,May,17,Thursday,Workingday,Clear,0.56,0.5303,0.78,0.1642,60,487,547,547,592,547,1,4,3,143,2,730,336860,1,547
2011-05-19,summer,2011,May,18,Thursday,Workingday,Clear,0.6,0.6212,0.55,0.1642,59,454,513,513,592,513,1,4,3,143,2,728,309772,1,513
2011-05-19,summer,2011,May,19,Thursday,Workingday,Clear,0.58,0.5455,0.6,0.1343,65,345,410,410,592,410,1,4,3,143,2,728,226789,1,410
2011-05-19,summer,2011,May,20,Thursday,Workingday,Clear,0.54,0.5152,0.77,0.2836,46,236,282,282,592,282,1,4,3,143,0,728,164550,1,282
2011-05-19,summer,2011,May,21,Thursday,Workingday,Clear,0.54,0.5152,0.77,0.2836,29,180,209,209,592,209,1,3,3,133,0,728,125445,1,209
2011-05-19,summer,2011,May,22,Thursday,Workingday,Light Snow,0.5,0.4848,0.82,0.2985,11,68,79,79,592,79,1,2,2,122,0,728,95612,1,79
2011-05-19,summer,2011,May,23,Thursday,Workingday,Clear,0.48,0.4697,0.94,0.0,9,63,72,72,592,72,1,2,2,122,0,728,63941,1,72
2011-05-20,summer,2011,May,0,Friday,Workingday,Clear,0.46,0.4545,0.94,0.0896,15,33,48,48,591,48,1,2,2,122,0,726,39130,1,48
2011-05-20,summer,2011,May,1,Friday,Workingday,Clear,0.46,0.4545,1.0,0.0,8,17,25,25,591,25,1,1,2,112,0,724,24164,1,25
2011-05-20,summer,2011,May,2,Friday,Workingday,Clear,0.44,0.4394,1.0,0.0896,4,4,8,8,591,8,1,1,2,112,0,715,16352,1,8
2011-05-20,summer,2011,May,3,Friday,Workingday,Clear,0.44,0.4394,1.0,0.0,1,4,5,5,591,5,1,1,2,112,0,697,8174,1,5
2011-05-20,summer,2011,May,4,Friday,Workingday,Clear,0.44,0.4394,0.94,0.0896,1,4,5,5,591,5,1,1,2,112,0,697,4428,1,5
2011-05-20,summer,2011,May,5,Friday,Workingday,Clear,0.44,0.4394,0.94,0.1045,0,28,28,28,591,28,1,1,2,112,0,717,14261,1,28
2011-05-20,summer,2011,May,6,Friday,Workingday,Clear,0.46,0.4545,0.88,0.1045,15,102,117,117,591,117,1,2,2,122,0,725,55132,1,117
2011-05-20,summer,2011,May,7,Friday,Workingday,Clear,0.5,0.4848,0.77,0.1642,30,289,319,319,591,319,1,4,2,142,0,727,154171,1,319
2011-05-20,summer,2011,May,8,Friday,Workingday,Clear,0.54,0.5152,0.68,0.0,41,476,517,517,591,517,1,4,3,143,2,727,261001,1,517
2011-05-20,summer,2011,May,9,Friday,Workingday,Clear,0.54,0.5152,0.68,0.2239,35,199,234,234,591,234,1,3,3,133,0,727,159438,1,234
2011-05-20,summer,2011,May,10,Friday,Workingday,Clear,0.56,0.5303,0.64,0.194,44,104,148,148,591,148,1,3,3,133,0,727,126257,1,148
2011-05-20,summer,2011,May,11,Friday,Workingday,Mist,0.58,0.5455,0.6,0.194,63,133,196,196,591,196,1,3,3,133,0,727,151320,1,196
2011-05-20,summer,2011,May,12,Friday,Workingday,Mist,0.6,0.6212,0.56,0.2537,69,186,255,255,591,255,1,3,3,133,2,728,184414,1,255
2011-05-20,summer,2011,May,13,Friday,Workingday,Light Snow,0.6,0.6212,0.56,0.2836,60,172,232,232,591,232,1,3,3,133,2,729,184919,1,232
2011-05-20,summer,2011,May,14,Friday,Workingday,Clear,0.62,0.6212,0.53,0.2239,66,131,197,197,591,197,1,3,3,133,2,729,175652,1,197
2011-05-20,summer,2011,May,15,Friday,Workingday,Mist,0.6,0.6212,0.56,0.194,74,168,242,242,591,242,1,3,3,133,2,729,183149,1,242
2011-05-20,summer,2011,May,16,Friday,Workingday,Mist,0.6,0.6212,0.53,0.1642,61,269,330,330,591,330,1,4,3,143,2,730,227748,1,330
2011-05-20,summer,2011,May,17,Friday,Workingday,Clear,0.62,0.6212,0.53,0.0,71,483,554,554,591,554,1,4,3,143,2,730,336860,1,554
2011-05-20,summer,2011,May,18,Friday,Workingday,Clear,0.6,0.6212,0.56,0.1642,79,394,473,473,591,473,1,4,3,143,2,728,309772,1,473
2011-05-20,summer,2011,May,19,Friday,Workingday,Clear,0.58,0.5455,0.64,0.0896,49,253,302,302,591,302,1,4,3,143,0,728,226789,1,302
2011-05-20,summer,2011,May,20,Friday,Workingday,Clear,0.58,0.5455,0.64,0.1045,40,180,220,220,591,220,1,3,3,133,0,728,164550,1,220
2011-05-20,summer,2011,May,21,Friday,Workingday,Clear,0.56,0.5303,0.64,0.1045,40,155,195,195,591,195,1,3,3,133,0,728,125445,1,195
2011-05-20,summer,2011,May,22,Friday,Workingday,Clear,0.54,0.5152,0.73,0.0,28,124,152,152,591,152,1,3,3,133,0,728,95612,1,152
2011-05-20,summer,2011,May,23,Friday,Workingday,Clear,0.52,0.5,0.72,0.1642,15,100,115,115,591,115,1,2,3,123,0,728,63941,1,115
2011-05-21,summer,2011,May,0,Saturday,Holiday,Clear,0.52,0.5,0.77,0.1045,20,78,98,98,590,98,1,2,3,123,0,726,39130,1,98
2011-05-21,summer,2011,May,1,Saturday,Holiday,Clear,0.52,0.5,0.72,0.0,8,64,72,72,590,72,1,2,3,123,0,724,24164,1,72
2011-05-21,summer,2011,May,2,Saturday,Holiday,Clear,0.52,0.5,0.72,0.1045,5,35,40,40,590,40,1,1,3,113,0,715,16352,1,40
2011-05-21,summer,2011,May,3,Saturday,Holiday,Clear,0.48,0.4697,0.82,0.1045,7,12,19,19,590,19,1,1,2,112,0,697,8174,1,19
2011-05-21,summer,2011,May,4,Saturday,Holiday,Clear,0.46,0.4545,0.88,0.1343,1,6,7,7,590,7,1,1,2,112,0,697,4428,1,7
2011-05-21,summer,2011,May,5,Saturday,Holiday,Clear,0.46,0.4545,0.88,0.1045,1,4,5,5,590,5,1,1,2,112,0,717,14261,1,5
2011-05-21,summer,2011,May,6,Saturday,Holiday,Clear,0.5,0.4848,0.82,0.1343,6,22,28,28,590,28,1,1,2,112,0,725,55132,1,28
2011-05-21,summer,2011,May,7,Saturday,Holiday,Clear,0.54,0.5152,0.73,0.1343,10,33,43,43,590,43,1,2,3,123,0,727,154171,1,43
2011-05-21,summer,2011,May,8,Saturday,Holiday,Clear,0.56,0.5303,0.68,0.2836,29,97,126,126,590,126,1,2,3,123,0,727,261001,1,126
2011-05-21,summer,2011,May,9,Saturday,Holiday,Clear,0.6,0.6061,0.64,0.2239,60,165,225,225,590,225,1,3,3,133,2,727,159438,1,225
2011-05-21,summer,2011,May,10,Saturday,Holiday,Clear,0.62,0.6061,0.61,0.1045,122,201,323,323,590,323,1,4,3,143,2,727,126257,1,323
2011-05-21,summer,2011,May,11,Saturday,Holiday,Clear,0.64,0.6212,0.53,0.1343,173,245,418,418,590,418,1,4,3,143,2,727,151320,1,418
2011-05-21,summer,2011,May,12,Saturday,Holiday,Clear,0.66,0.6212,0.5,0.0,222,271,493,493,590,493,1,4,3,143,2,728,184414,1,493
2011-05-21,summer,2011,May,13,Saturday,Holiday,Clear,0.7,0.6364,0.45,0.0,191,271,462,462,590,462,1,4,4,144,2,729,184919,1,462
2011-05-21,summer,2011,May,14,Saturday,Holiday,Clear,0.72,0.6515,0.42,0.0,187,269,456,456,590,456,1,4,4,144,2,729,175652,1,456
2011-05-21,summer,2011,May,15,Saturday,Holiday,Clear,0.72,0.6515,0.45,0.2537,232,274,506,506,590,506,1,4,4,144,2,729,183149,1,506
2011-05-21,summer,2011,May,16,Saturday,Holiday,Mist,0.72,0.6515,0.39,0.2537,204,267,471,471,590,471,1,4,4,144,2,730,227748,1,471
2011-05-21,summer,2011,May,17,Saturday,Holiday,Mist,0.72,0.6515,0.42,0.1642,191,253,444,444,590,444,1,4,4,144,2,730,336860,1,444
2011-05-21,summer,2011,May,18,Saturday,Holiday,Mist,0.7,0.6364,0.45,0.1642,191,253,444,444,590,444,1,4,4,144,2,728,309772,1,444
2011-05-21,summer,2011,May,19,Saturday,Holiday,Clear,0.68,0.6364,0.47,0.1642,117,184,301,301,590,301,1,4,4,144,2,728,226789,1,301
2011-05-21,summer,2011,May,20,Saturday,Holiday,Clear,0.62,0.6061,0.61,0.0,84,164,248,248,590,248,1,3,3,133,0,728,164550,1,248
2011-05-21,summer,2011,May,21,Saturday,Holiday,Clear,0.62,0.6061,0.61,0.1045,77,150,227,227,590,227,1,3,3,133,2,728,125445,1,227
2011-05-21,summer,2011,May,22,Saturday,Holiday,Clear,0.6,0.5909,0.69,0.1343,78,126,204,204,590,204,1,3,3,133,0,728,95612,1,204
2011-05-21,summer,2011,May,23,Saturday,Holiday,Clear,0.58,0.5455,0.78,0.0896,42,103,145,145,590,145,1,3,3,133,0,728,63941,1,145
2011-05-22,summer,2011,May,0,Sunday,Holiday,Clear,0.54,0.5152,0.88,0.1642,31,100,131,131,589,131,1,2,3,123,0,726,39130,1,131
2011-05-22,summer,2011,May,1,Sunday,Holiday,Clear,0.52,0.5,0.94,0.1343,17,81,98,98,589,98,1,2,3,123,0,724,24164,1,98
2011-05-22,summer,2011,May,2,Sunday,Holiday,Clear,0.52,0.5,0.94,0.1045,18,50,68,68,589,68,1,2,3,123,0,715,16352,1,68
2011-05-22,summer,2011,May,3,Sunday,Holiday,Clear,0.5,0.4848,1.0,0.1045,10,23,33,33,589,33,1,1,2,112,0,697,8174,1,33
2011-05-22,summer,2011,May,4,Sunday,Holiday,Clear,0.5,0.4848,1.0,0.0,3,9,12,12,589,12,1,1,2,112,0,697,4428,1,12
2011-05-22,summer,2011,May,5,Sunday,Holiday,Clear,0.5,0.4848,1.0,0.1045,1,5,6,6,589,6,1,1,2,112,0,717,14261,1,6
2011-05-22,summer,2011,May,6,Sunday,Holiday,Clear,0.52,0.5,0.94,0.1045,5,13,18,18,589,18,1,1,3,113,0,725,55132,1,18
2011-05-22,summer,2011,May,7,Sunday,Holiday,Clear,0.54,0.5152,0.88,0.1045,13,27,40,40,589,40,1,1,3,113,0,727,154171,1,40
2011-05-22,summer,2011,May,8,Sunday,Holiday,Clear,0.6,0.5909,0.73,0.0896,29,65,94,94,589,94,1,2,3,123,0,727,261001,1,94
2011-05-22,summer,2011,May,9,Sunday,Holiday,Clear,0.62,0.6061,0.69,0.1045,59,130,189,189,589,189,1,3,3,133,0,727,159438,1,189
2011-05-22,summer,2011,May,10,Sunday,Holiday,Clear,0.64,0.6061,0.65,0.1343,135,170,305,305,589,305,1,4,3,143,2,727,126257,1,305
2011-05-22,summer,2011,May,11,Sunday,Holiday,Clear,0.7,0.6515,0.54,0.194,164,209,373,373,589,373,1,4,4,144,2,727,151320,1,373
2011-05-22,summer,2011,May,12,Sunday,Holiday,Mist,0.72,0.6667,0.51,0.194,146,255,401,401,589,401,1,4,4,144,2,728,184414,1,401
2011-05-22,summer,2011,May,13,Sunday,Holiday,Mist,0.66,0.6212,0.54,0.2239,180,275,455,455,589,455,1,4,3,143,2,729,184919,1,455
2011-05-22,summer,2011,May,14,Sunday,Holiday,Light Snow,0.62,0.6061,0.69,0.194,125,191,316,316,589,316,1,4,3,143,2,729,175652,1,316
2011-05-22,summer,2011,May,15,Sunday,Holiday,Mist,0.66,0.6212,0.61,0.1642,110,221,331,331,589,331,1,4,3,143,2,729,183149,1,331
2011-05-22,summer,2011,May,16,Sunday,Holiday,Clear,0.68,0.6364,0.61,0.1343,72,201,273,273,589,273,1,3,4,134,2,730,227748,1,273
2011-05-22,summer,2011,May,17,Sunday,Holiday,Clear,0.7,0.6515,0.58,0.2537,93,213,306,306,589,306,1,4,4,144,2,730,336860,1,306
2011-05-22,summer,2011,May,18,Sunday,Holiday,Clear,0.66,0.6212,0.61,0.2239,120,238,358,358,589,358,1,4,3,143,2,728,309772,1,358
2011-05-22,summer,2011,May,19,Sunday,Holiday,Clear,0.66,0.6212,0.61,0.194,107,193,300,300,589,300,1,4,3,143,2,728,226789,1,300
2011-05-22,summer,2011,May,20,Sunday,Holiday,Clear,0.64,0.6061,0.65,0.1642,57,174,231,231,589,231,1,3,3,133,0,728,164550,1,231
2011-05-22,summer,2011,May,21,Sunday,Holiday,Clear,0.62,0.5909,0.73,0.194,27,109,136,136,589,136,1,2,3,123,0,728,125445,1,136
2011-05-22,summer,2011,May,22,Sunday,Holiday,Clear,0.6,0.5606,0.83,0.1343,35,86,121,121,589,121,1,2,3,123,0,728,95612,1,121
2011-05-22,summer,2011,May,23,Sunday,Holiday,Mist,0.58,0.5455,0.83,0.1343,19,46,65,65,589,65,1,2,3,123,0,728,63941,1,65
2011-05-23,summer,2011,May,0,Monday,Workingday,Mist,0.56,0.5303,0.88,0.1343,23,18,41,41,588,41,1,2,3,123,0,726,39130,1,41
2011-05-23,summer,2011,May,1,Monday,Workingday,Clear,0.56,0.5303,0.88,0.1045,4,5,9,9,588,9,1,1,3,113,0,724,24164,1,9
2011-05-23,summer,2011,May,2,Monday,Workingday,Light Snow,0.56,0.5303,0.88,0.1642,2,3,5,5,588,5,1,1,3,113,0,715,16352,1,5
2011-05-23,summer,2011,May,3,Monday,Workingday,Light Snow,0.54,0.5152,0.94,0.1642,0,4,4,4,588,4,1,1,3,113,0,697,8174,1,4
2011-05-23,summer,2011,May,4,Monday,Workingday,Mist,0.54,0.5152,0.94,0.0,2,2,4,4,588,4,1,1,3,113,0,697,4428,1,4
2011-05-23,summer,2011,May,5,Monday,Workingday,Mist,0.54,0.5152,0.94,0.0,0,11,11,11,588,11,1,1,3,113,0,717,14261,1,11
2011-05-23,summer,2011,May,6,Monday,Workingday,Mist,0.54,0.5152,1.0,0.0,4,92,96,96,588,96,1,2,3,123,0,725,55132,1,96
2011-05-23,summer,2011,May,7,Monday,Workingday,Mist,0.56,0.5303,0.94,0.1045,13,223,236,236,588,236,1,3,3,133,0,727,154171,1,236
2011-05-23,summer,2011,May,8,Monday,Workingday,Clear,0.6,0.5455,0.88,0.194,50,359,409,409,588,409,1,4,3,143,0,727,261001,1,409
2011-05-23,summer,2011,May,9,Monday,Workingday,Clear,0.6,0.5455,0.88,0.2239,36,131,167,167,588,167,1,3,3,133,0,727,159438,1,167
2011-05-23,summer,2011,May,10,Monday,Workingday,Clear,0.66,0.6212,0.74,0.2985,49,72,121,121,588,121,1,2,3,123,0,727,126257,1,121
2011-05-23,summer,2011,May,11,Monday,Workingday,Clear,0.68,0.6364,0.69,0.3881,73,107,180,180,588,180,1,3,4,134,2,727,151320,1,180
2011-05-23,summer,2011,May,12,Monday,Workingday,Clear,0.68,0.6364,0.69,0.3881,65,139,204,204,588,204,1,3,4,134,2,728,184414,1,204
2011-05-23,summer,2011,May,13,Monday,Workingday,Mist,0.74,0.6818,0.58,0.4179,49,155,204,204,588,204,1,3,4,134,2,729,184919,1,204
2011-05-23,summer,2011,May,14,Monday,Workingday,Mist,0.72,0.6818,0.62,0.5224,57,130,187,187,588,187,1,3,4,134,2,729,175652,1,187
2011-05-23,summer,2011,May,15,Monday,Workingday,Mist,0.72,0.6818,0.62,0.4478,57,119,176,176,588,176,1,3,4,134,2,729,183149,1,176
2011-05-23,summer,2011,May,16,Monday,Workingday,Mist,0.72,0.6818,0.62,0.2985,56,223,279,279,588,279,1,3,4,134,2,730,227748,1,279
2011-05-23,summer,2011,May,17,Monday,Workingday,Light Snow,0.72,0.6818,0.7,0.3881,56,373,429,429,588,429,1,4,4,144,2,730,336860,1,429
2011-05-23,summer,2011,May,18,Monday,Workingday,Clear,0.7,0.6667,0.74,0.2836,68,385,453,453,588,453,1,4,4,144,2,728,309772,1,453
2011-05-23,summer,2011,May,19,Monday,Workingday,Clear,0.7,0.6667,0.74,0.2239,56,302,358,358,588,358,1,4,4,144,2,728,226789,1,358
2011-05-23,summer,2011,May,20,Monday,Workingday,Clear,0.64,0.5758,0.83,0.2239,39,271,310,310,588,310,1,4,3,143,0,728,164550,1,310
2011-05-23,summer,2011,May,21,Monday,Workingday,Clear,0.64,0.5758,0.89,0.2239,33,155,188,188,588,188,1,3,3,133,0,728,125445,1,188
2011-05-23,summer,2011,May,22,Monday,Workingday,Clear,0.62,0.5455,0.94,0.2239,25,106,131,131,588,131,1,2,3,123,0,728,95612,1,131
2011-05-23,summer,2011,May,23,Monday,Workingday,Mist,0.62,0.5606,0.88,0.194,19,53,72,72,588,72,1,2,3,123,0,728,63941,1,72
2011-05-24,summer,2011,May,0,Tuesday,Workingday,Mist,0.6,0.5152,0.94,0.194,12,23,35,35,587,35,1,1,3,113,0,726,39130,1,35
2011-05-24,summer,2011,May,1,Tuesday,Workingday,Mist,0.6,0.5152,0.94,0.1642,6,9,15,15,587,15,1,1,3,113,0,724,24164,1,15
2011-05-24,summer,2011,May,2,Tuesday,Workingday,Mist,0.6,0.5152,0.94,0.194,2,8,10,10,587,10,1,1,3,113,0,715,16352,1,10
2011-05-24,summer,2011,May,3,Tuesday,Workingday,Mist,0.58,0.5455,0.94,0.1045,0,2,2,2,587,2,1,1,3,113,0,697,8174,1,2
2011-05-24,summer,2011,May,4,Tuesday,Workingday,Clear,0.6,0.5455,0.88,0.1045,1,3,4,4,587,4,1,1,3,113,0,697,4428,1,4
2011-05-24,summer,2011,May,5,Tuesday,Workingday,Mist,0.58,0.5455,0.94,0.2537,2,22,24,24,587,24,1,1,3,113,0,717,14261,1,24
2011-05-24,summer,2011,May,6,Tuesday,Workingday,Mist,0.58,0.5455,0.94,0.194,10,102,112,112,587,112,1,2,3,123,0,725,55132,1,112
2011-05-24,summer,2011,May,7,Tuesday,Workingday,Light Snow,0.64,0.5909,0.78,0.194,26,288,314,314,587,314,1,4,3,143,0,727,154171,1,314
2011-05-24,summer,2011,May,8,Tuesday,Workingday,Light Snow,0.62,0.5758,0.83,0.2239,31,403,434,434,587,434,1,4,3,143,0,727,261001,1,434
2011-05-24,summer,2011,May,9,Tuesday,Workingday,Mist,0.64,0.6061,0.73,0.194,27,111,138,138,587,138,1,2,3,123,0,727,159438,1,138
2011-05-24,summer,2011,May,10,Tuesday,Workingday,Clear,0.7,0.6515,0.61,0.3284,18,90,108,108,587,108,1,2,4,124,0,727,126257,1,108
2011-05-24,summer,2011,May,11,Tuesday,Workingday,Clear,0.74,0.6667,0.51,0.2239,33,142,175,175,587,175,1,3,4,134,2,727,151320,1,175
2011-05-24,summer,2011,May,12,Tuesday,Workingday,Clear,0.76,0.6818,0.45,0.3881,41,129,170,170,587,170,1,3,4,134,2,728,184414,1,170
2011-05-24,summer,2011,May,13,Tuesday,Workingday,Clear,0.78,0.697,0.46,0.2537,38,152,190,190,587,190,1,3,4,134,2,729,184919,1,190
2011-05-24,summer,2011,May,14,Tuesday,Workingday,Clear,0.78,0.697,0.46,0.2836,27,126,153,153,587,153,1,3,4,134,2,729,175652,1,153
2011-05-24,summer,2011,May,15,Tuesday,Workingday,Light Snow,0.74,0.6818,0.55,0.4179,59,129,188,188,587,188,1,3,4,134,2,729,183149,1,188
2011-05-24,summer,2011,May,16,Tuesday,Workingday,Clear,0.66,0.6212,0.69,0.194,52,225,277,277,587,277,1,3,3,133,2,730,227748,1,277
2011-05-24,summer,2011,May,17,Tuesday,Workingday,Clear,0.7,0.6515,0.61,0.1045,56,492,548,548,587,548,1,4,4,144,2,730,336860,1,548
2011-05-24,summer,2011,May,18,Tuesday,Workingday,Clear,0.7,0.6515,0.7,0.194,74,490,564,564,587,564,1,4,4,144,2,728,309772,1,564
2011-05-24,summer,2011,May,19,Tuesday,Workingday,Clear,0.66,0.6212,0.74,0.194,45,310,355,355,587,355,1,4,3,143,2,728,226789,1,355
2011-05-24,summer,2011,May,20,Tuesday,Workingday,Clear,0.66,0.6212,0.74,0.0896,39,241,280,280,587,280,1,3,3,133,0,728,164550,1,280
2011-05-24,summer,2011,May,21,Tuesday,Workingday,Clear,0.64,0.5909,0.78,0.0896,21,168,189,189,587,189,1,3,3,133,0,728,125445,1,189
2011-05-24,summer,2011,May,22,Tuesday,Workingday,Light Snow,0.62,0.5606,0.88,0.2239,26,115,141,141,587,141,1,2,3,123,0,728,95612,1,141
2011-05-24,summer,2011,May,23,Tuesday,Workingday,Light Snow,0.66,0.6212,0.74,0.1642,13,53,66,66,587,66,1,2,3,123,0,728,63941,1,66
2011-05-25,summer,2011,May,0,Wednesday,Workingday,Light Snow,0.6,0.5606,0.83,0.2239,3,32,35,35,586,35,1,1,3,113,0,726,39130,1,35
2011-05-25,summer,2011,May,1,Wednesday,Workingday,Light Snow,0.58,0.5455,0.83,0.194,6,2,8,8,586,8,1,1,3,113,0,724,24164,1,8
2011-05-25,summer,2011,May,2,Wednesday,Workingday,Mist,0.56,0.5303,0.94,0.0,0,8,8,8,586,8,1,1,3,113,0,715,16352,1,8
2011-05-25,summer,2011,May,3,Wednesday,Workingday,Clear,0.54,0.5152,1.0,0.1343,0,9,9,9,586,9,1,1,3,113,0,697,8174,1,9
2011-05-25,summer,2011,May,4,Wednesday,Workingday,Clear,0.54,0.5152,1.0,0.1045,0,3,3,3,586,3,1,1,3,113,0,697,4428,1,3
2011-05-25,summer,2011,May,5,Wednesday,Workingday,Clear,0.56,0.5303,0.88,0.0896,2,23,25,25,586,25,1,1,3,113,0,717,14261,1,25
2011-05-25,summer,2011,May,6,Wednesday,Workingday,Clear,0.56,0.5303,0.94,0.0896,4,113,117,117,586,117,1,2,3,123,0,725,55132,1,117
2011-05-25,summer,2011,May,7,Wednesday,Workingday,Clear,0.62,0.5909,0.73,0.1343,29,284,313,313,586,313,1,4,3,143,0,727,154171,1,313
2011-05-25,summer,2011,May,8,Wednesday,Workingday,Clear,0.64,0.6061,0.69,0.2239,36,495,531,531,586,531,1,4,3,143,2,727,261001,1,531
2011-05-25,summer,2011,May,9,Wednesday,Workingday,Clear,0.68,0.6364,0.65,0.0896,27,207,234,234,586,234,1,3,4,134,0,727,159438,1,234
2011-05-25,summer,2011,May,10,Wednesday,Workingday,Clear,0.7,0.6515,0.61,0.0896,30,105,135,135,586,135,1,2,4,124,0,727,126257,1,135
2011-05-25,summer,2011,May,11,Wednesday,Workingday,Clear,0.74,0.6667,0.51,0.0896,36,104,140,140,586,140,1,2,4,124,0,727,151320,1,140
2011-05-25,summer,2011,May,12,Wednesday,Workingday,Clear,0.74,0.6818,0.55,0.1343,32,178,210,210,586,210,1,3,4,134,2,728,184414,1,210
2011-05-25,summer,2011,May,13,Wednesday,Workingday,Clear,0.74,0.6818,0.55,0.1343,39,163,202,202,586,202,1,3,4,134,2,729,184919,1,202
2011-05-25,summer,2011,May,14,Wednesday,Workingday,Clear,0.74,0.6818,0.55,0.1642,47,121,168,168,586,168,1,3,4,134,2,729,175652,1,168
2011-05-25,summer,2011,May,15,Wednesday,Workingday,Clear,0.76,0.697,0.52,0.2537,37,145,182,182,586,182,1,3,4,134,2,729,183149,1,182
2011-05-25,summer,2011,May,16,Wednesday,Workingday,Clear,0.74,0.6667,0.51,0.2836,61,238,299,299,586,299,1,4,4,144,2,730,227748,1,299
2011-05-25,summer,2011,May,17,Wednesday,Workingday,Clear,0.74,0.6667,0.51,0.2239,77,524,601,601,586,601,1,4,4,144,2,730,336860,1,601
2011-05-25,summer,2011,May,18,Wednesday,Workingday,Clear,0.72,0.6667,0.58,0.2239,66,451,517,517,586,517,1,4,4,144,2,728,309772,1,517
2011-05-25,summer,2011,May,19,Wednesday,Workingday,Clear,0.7,0.6515,0.61,0.1343,73,332,405,405,586,405,1,4,4,144,2,728,226789,1,405
2011-05-25,summer,2011,May,20,Wednesday,Workingday,Clear,0.7,0.6515,0.61,0.1642,56,284,340,340,586,340,1,4,4,144,2,728,164550,1,340
2011-05-25,summer,2011,May,21,Wednesday,Workingday,Clear,0.66,0.6212,0.69,0.1343,33,203,236,236,586,236,1,3,3,133,0,728,125445,1,236
2011-05-25,summer,2011,May,22,Wednesday,Workingday,Clear,0.66,0.6212,0.69,0.2537,34,140,174,174,586,174,1,3,3,133,0,728,95612,1,174
2011-05-25,summer,2011,May,23,Wednesday,Workingday,Clear,0.64,0.6061,0.73,0.1343,12,74,86,86,586,86,1,2,3,123,0,728,63941,1,86
2011-05-26,summer,2011,May,0,Thursday,Workingday,Clear,0.64,0.6061,0.73,0.1343,11,34,45,45,585,45,1,2,3,123,0,726,39130,1,45
2011-05-26,summer,2011,May,1,Thursday,Workingday,Clear,0.64,0.6061,0.73,0.1343,3,13,16,16,585,16,1,1,3,113,0,724,24164,1,16
2011-05-26,summer,2011,May,2,Thursday,Workingday,Clear,0.62,0.5758,0.83,0.1045,7,7,14,14,585,14,1,1,3,113,0,715,16352,1,14
2011-05-26,summer,2011,May,3,Thursday,Workingday,Clear,0.6,0.5455,0.88,0.0896,0,4,4,4,585,4,1,1,3,113,0,697,8174,1,4
2011-05-26,summer,2011,May,4,Thursday,Workingday,Clear,0.6,0.5455,0.88,0.0,0,2,2,2,585,2,1,1,3,113,0,697,4428,1,2
2011-05-26,summer,2011,May,5,Thursday,Workingday,Mist,0.6,0.5455,0.88,0.0896,2,25,27,27,585,27,1,1,3,113,0,717,14261,1,27
2011-05-26,summer,2011,May,6,Thursday,Workingday,Mist,0.6,0.5,1.0,0.0896,4,94,98,98,585,98,1,2,3,123,0,725,55132,1,98
2011-05-26,summer,2011,May,7,Thursday,Workingday,Mist,0.62,0.5455,0.94,0.2537,16,270,286,286,585,286,1,4,3,143,0,727,154171,1,286
2011-05-26,summer,2011,May,8,Thursday,Workingday,Mist,0.66,0.6061,0.83,0.1642,31,458,489,489,585,489,1,4,3,143,2,727,261001,1,489
2011-05-26,summer,2011,May,9,Thursday,Workingday,Clear,0.72,0.6818,0.7,0.1642,22,194,216,216,585,216,1,3,4,134,0,727,159438,1,216
2011-05-26,summer,2011,May,10,Thursday,Workingday,Clear,0.7,0.6667,0.74,0.2836,49,94,143,143,585,143,1,3,4,134,0,727,126257,1,143
2011-05-26,summer,2011,May,11,Thursday,Workingday,Clear,0.74,0.697,0.66,0.2239,36,124,160,160,585,160,1,3,4,134,0,727,151320,1,160
2011-05-26,summer,2011,May,12,Thursday,Workingday,Clear,0.78,0.7424,0.59,0.3284,53,141,194,194,585,194,1,3,4,134,2,728,184414,1,194
2011-05-26,summer,2011,May,13,Thursday,Workingday,Clear,0.82,0.7727,0.52,0.2836,52,145,197,197,585,197,1,3,4,134,2,729,184919,1,197
2011-05-26,summer,2011,May,14,Thursday,Workingday,Clear,0.82,0.7727,0.52,0.2836,44,145,189,189,585,189,1,3,4,134,2,729,175652,1,189
2011-05-26,summer,2011,May,15,Thursday,Workingday,Mist,0.82,0.7576,0.46,0.2836,40,101,141,141,585,141,1,2,4,124,2,729,183149,1,141
2011-05-26,summer,2011,May,16,Thursday,Workingday,Mist,0.8,0.7424,0.49,0.3582,58,233,291,291,585,291,1,4,4,144,2,730,227748,1,291
2011-05-26,summer,2011,May,17,Thursday,Workingday,Clear,0.8,0.7273,0.46,0.2836,49,445,494,494,585,494,1,4,4,144,2,730,336860,1,494
2011-05-26,summer,2011,May,18,Thursday,Workingday,Clear,0.8,0.7273,0.46,0.3284,74,404,478,478,585,478,1,4,4,144,2,728,309772,1,478
2011-05-26,summer,2011,May,19,Thursday,Workingday,Clear,0.78,0.697,0.46,0.3284,67,311,378,378,585,378,1,4,4,144,2,728,226789,1,378
2011-05-26,summer,2011,May,20,Thursday,Workingday,Clear,0.72,0.6667,0.58,0.1642,55,267,322,322,585,322,1,4,4,144,2,728,164550,1,322
2011-05-26,summer,2011,May,21,Thursday,Workingday,Clear,0.72,0.6818,0.62,0.0896,45,178,223,223,585,223,1,3,4,134,0,728,125445,1,223
2011-05-26,summer,2011,May,22,Thursday,Workingday,Clear,0.7,0.6515,0.65,0.1343,23,157,180,180,585,180,1,3,4,134,0,728,95612,1,180
2011-05-26,summer,2011,May,23,Thursday,Workingday,Clear,0.7,0.6515,0.65,0.194,17,73,90,90,585,90,1,2,4,124,0,728,63941,1,90
2011-05-27,summer,2011,May,0,Friday,Workingday,Clear,0.68,0.6364,0.69,0.2537,14,55,69,69,584,69,1,2,4,124,0,726,39130,1,69
2011-05-27,summer,2011,May,1,Friday,Workingday,Clear,0.7,0.6515,0.58,0.2985,14,36,50,50,584,50,1,2,4,124,0,724,24164,1,50
2011-05-27,summer,2011,May,2,Friday,Workingday,Clear,0.68,0.6364,0.61,0.2239,6,12,18,18,584,18,1,1,4,114,0,715,16352,1,18
2011-05-27,summer,2011,May,3,Friday,Workingday,Clear,0.66,0.6212,0.65,0.0896,1,11,12,12,584,12,1,1,3,113,0,697,8174,1,12
2011-05-27,summer,2011,May,4,Friday,Workingday,Clear,0.64,0.6061,0.69,0.1343,2,5,7,7,584,7,1,1,3,113,0,697,4428,1,7
2011-05-27,summer,2011,May,5,Friday,Workingday,Clear,0.64,0.6061,0.65,0.2836,2,29,31,31,584,31,1,1,3,113,0,717,14261,1,31
2011-05-27,summer,2011,May,6,Friday,Workingday,Clear,0.64,0.6061,0.69,0.0896,8,73,81,81,584,81,1,2,3,123,0,725,55132,1,81
2011-05-27,summer,2011,May,7,Friday,Workingday,Clear,0.64,0.6061,0.73,0.1642,20,229,249,249,584,249,1,3,3,133,0,727,154171,1,249
2011-05-27,summer,2011,May,8,Friday,Workingday,Clear,0.66,0.6212,0.74,0.2836,25,393,418,418,584,418,1,4,3,143,2,727,261001,1,418
2011-05-27,summer,2011,May,9,Friday,Workingday,Clear,0.7,0.6515,0.65,0.2836,37,190,227,227,584,227,1,3,4,134,2,727,159438,1,227
2011-05-27,summer,2011,May,10,Friday,Workingday,Clear,0.72,0.6667,0.54,0.3881,42,111,153,153,584,153,1,3,4,134,2,727,126257,1,153
2011-05-27,summer,2011,May,11,Friday,Workingday,Mist,0.74,0.6818,0.55,0.3284,40,126,166,166,584,166,1,3,4,134,2,727,151320,1,166
2011-05-27,summer,2011,May,12,Friday,Workingday,Mist,0.76,0.697,0.55,0.2985,53,190,243,243,584,243,1,3,4,134,2,728,184414,1,243
2011-05-27,summer,2011,May,13,Friday,Workingday,Clear,0.74,0.6818,0.58,0.194,51,158,209,209,584,209,1,3,4,134,2,729,184919,1,209
2011-05-27,summer,2011,May,14,Friday,Workingday,Clear,0.76,0.697,0.55,0.2537,51,188,239,239,584,239,1,3,4,134,2,729,175652,1,239
2011-05-27,summer,2011,May,15,Friday,Workingday,Clear,0.78,0.7121,0.49,0.2836,98,258,356,356,584,356,1,4,4,144,2,729,183149,1,356
2011-05-27,summer,2011,May,16,Friday,Workingday,Mist,0.76,0.697,0.55,0.3881,63,356,419,419,584,419,1,4,4,144,2,730,227748,1,419
2011-05-27,summer,2011,May,17,Friday,Workingday,Clear,0.74,0.6818,0.58,0.3881,77,414,491,491,584,491,1,4,4,144,2,730,336860,1,491
2011-05-27,summer,2011,May,18,Friday,Workingday,Mist,0.72,0.6818,0.62,0.2985,89,310,399,399,584,399,1,4,4,144,2,728,309772,1,399
2011-05-27,summer,2011,May,19,Friday,Workingday,Light Snow,0.6,0.5758,0.78,0.2537,69,210,279,279,584,279,1,3,3,133,0,728,226789,1,279
2011-05-27,summer,2011,May,20,Friday,Workingday,Mist,0.62,0.5909,0.73,0.2239,24,120,144,144,584,144,1,3,3,133,0,728,164550,1,144
2011-05-27,summer,2011,May,21,Friday,Workingday,Clear,0.6,0.5606,0.83,0.1045,37,114,151,151,584,151,1,3,3,133,0,728,125445,1,151
2011-05-27,summer,2011,May,22,Friday,Workingday,Clear,0.6,0.5758,0.78,0.1343,25,116,141,141,584,141,1,2,3,123,0,728,95612,1,141
2011-05-27,summer,2011,May,23,Friday,Workingday,Clear,0.58,0.5455,0.88,0.1343,23,104,127,127,584,127,1,2,3,123,0,728,63941,1,127
2011-05-28,summer,2011,May,0,Saturday,Holiday,Clear,0.58,0.5455,0.88,0.1343,15,79,94,94,583,94,1,2,3,123,0,726,39130,1,94
2011-05-28,summer,2011,May,1,Saturday,Holiday,Clear,0.58,0.5455,0.88,0.194,8,47,55,55,583,55,1,2,3,123,0,724,24164,1,55
2011-05-28,summer,2011,May,2,Saturday,Holiday,Clear,0.56,0.5303,0.94,0.194,13,35,48,48,583,48,1,2,3,123,0,715,16352,1,48
2011-05-28,summer,2011,May,3,Saturday,Holiday,Clear,0.56,0.5303,0.88,0.2239,2,13,15,15,583,15,1,1,3,113,0,697,8174,1,15
2011-05-28,summer,2011,May,4,Saturday,Holiday,Clear,0.56,0.5303,0.88,0.2537,0,4,4,4,583,4,1,1,3,113,0,697,4428,1,4
2011-05-28,summer,2011,May,5,Saturday,Holiday,Clear,0.56,0.5303,0.88,0.2239,4,3,7,7,583,7,1,1,3,113,0,717,14261,1,7
2011-05-28,summer,2011,May,6,Saturday,Holiday,Clear,0.58,0.5455,0.83,0.2537,3,16,19,19,583,19,1,1,3,113,0,725,55132,1,19
2011-05-28,summer,2011,May,7,Saturday,Holiday,Clear,0.6,0.5606,0.83,0.2537,17,33,50,50,583,50,1,2,3,123,0,727,154171,1,50
2011-05-28,summer,2011,May,8,Saturday,Holiday,Clear,0.62,0.5909,0.78,0.194,27,75,102,102,583,102,1,2,3,123,0,727,261001,1,102
2011-05-28,summer,2011,May,9,Saturday,Holiday,Clear,0.64,0.6061,0.73,0.2537,61,116,177,177,583,177,1,3,3,133,0,727,159438,1,177
2011-05-28,summer,2011,May,10,Saturday,Holiday,Clear,0.7,0.6515,0.65,0.2239,110,166,276,276,583,276,1,3,4,134,2,727,126257,1,276
2011-05-28,summer,2011,May,11,Saturday,Holiday,Clear,0.7,0.6515,0.65,0.2239,171,178,349,349,583,349,1,4,4,144,2,727,151320,1,349
2011-05-28,summer,2011,May,12,Saturday,Holiday,Clear,0.72,0.6667,0.58,0.2537,145,213,358,358,583,358,1,4,4,144,2,728,184414,1,358
2011-05-28,summer,2011,May,13,Saturday,Holiday,Clear,0.72,0.6818,0.62,0.2239,168,217,385,385,583,385,1,4,4,144,2,729,184919,1,385
2011-05-28,summer,2011,May,14,Saturday,Holiday,Clear,0.74,0.6818,0.58,0.2239,172,210,382,382,583,382,1,4,4,144,2,729,175652,1,382
2011-05-28,summer,2011,May,15,Saturday,Holiday,Clear,0.74,0.6818,0.55,0.2239,187,187,374,374,583,374,1,4,4,144,2,729,183149,1,374
2011-05-28,summer,2011,May,16,Saturday,Holiday,Clear,0.76,0.697,0.55,0.2836,201,201,402,402,583,402,1,4,4,144,2,730,227748,1,402
2011-05-28,summer,2011,May,17,Saturday,Holiday,Clear,0.74,0.6818,0.55,0.2985,180,161,341,341,583,341,1,4,4,144,2,730,336860,1,341
2011-05-28,summer,2011,May,18,Saturday,Holiday,Clear,0.72,0.6818,0.62,0.2537,173,212,385,385,583,385,1,4,4,144,2,728,309772,1,385
2011-05-28,summer,2011,May,19,Saturday,Holiday,Clear,0.7,0.6515,0.65,0.194,99,153,252,252,583,252,1,3,4,134,2,728,226789,1,252
2011-05-28,summer,2011,May,20,Saturday,Holiday,Clear,0.7,0.6515,0.65,0.2239,68,128,196,196,583,196,1,3,4,134,2,728,164550,1,196
2011-05-28,summer,2011,May,21,Saturday,Holiday,Clear,0.66,0.6212,0.74,0.2985,87,114,201,201,583,201,1,3,3,133,2,728,125445,1,201
2011-05-28,summer,2011,May,22,Saturday,Holiday,Clear,0.66,0.6061,0.78,0.2239,46,115,161,161,583,161,1,3,3,133,0,728,95612,1,161
2011-05-28,summer,2011,May,23,Saturday,Holiday,Clear,0.64,0.5758,0.83,0.194,44,81,125,125,583,125,1,2,3,123,0,728,63941,1,125
2011-05-29,summer,2011,May,0,Sunday,Holiday,Clear,0.64,0.5758,0.83,0.2239,32,51,83,83,582,83,1,2,3,123,0,726,39130,1,83
2011-05-29,summer,2011,May,1,Sunday,Holiday,Clear,0.62,0.5606,0.88,0.1642,17,49,66,66,582,66,1,2,3,123,0,724,24164,1,66
2011-05-29,summer,2011,May,2,Sunday,Holiday,Clear,0.62,0.5606,0.88,0.1045,12,49,61,61,582,61,1,2,3,123,0,715,16352,1,61
2011-05-29,summer,2011,May,3,Sunday,Holiday,Clear,0.62,0.5606,0.88,0.1045,2,24,26,26,582,26,1,1,3,113,0,697,8174,1,26
2011-05-29,summer,2011,May,4,Sunday,Holiday,Clear,0.6,0.5455,0.88,0.0896,13,10,23,23,582,23,1,1,3,113,0,697,4428,1,23
2011-05-29,summer,2011,May,5,Sunday,Holiday,Clear,0.6,0.5152,0.94,0.1642,3,3,6,6,582,6,1,1,3,113,0,717,14261,1,6
2011-05-29,summer,2011,May,6,Sunday,Holiday,Mist,0.62,0.5606,0.88,0.194,5,10,15,15,582,15,1,1,3,113,0,725,55132,1,15
2011-05-29,summer,2011,May,7,Sunday,Holiday,Mist,0.62,0.5606,0.88,0.2537,13,17,30,30,582,30,1,1,3,113,0,727,154171,1,30
2011-05-29,summer,2011,May,8,Sunday,Holiday,Mist,0.62,0.5606,0.88,0.2239,34,62,96,96,582,96,1,2,3,123,0,727,261001,1,96
2011-05-29,summer,2011,May,9,Sunday,Holiday,Mist,0.62,0.5455,0.94,0.2537,74,78,152,152,582,152,1,3,3,133,0,727,159438,1,152
2011-05-29,summer,2011,May,10,Sunday,Holiday,Mist,0.66,0.6061,0.83,0.2239,130,121,251,251,582,251,1,3,3,133,2,727,126257,1,251
2011-05-29,summer,2011,May,11,Sunday,Holiday,Mist,0.66,0.6061,0.83,0.2836,139,180,319,319,582,319,1,4,3,143,2,727,151320,1,319
2011-05-29,summer,2011,May,12,Sunday,Holiday,Mist,0.7,0.6667,0.74,0.2239,216,186,402,402,582,402,1,4,4,144,2,728,184414,1,402
2011-05-29,summer,2011,May,13,Sunday,Holiday,Clear,0.72,0.6818,0.7,0.2836,237,181,418,418,582,418,1,4,4,144,2,729,184919,1,418
2011-05-29,summer,2011,May,14,Sunday,Holiday,Clear,0.74,0.697,0.7,0.2836,183,168,351,351,582,351,1,4,4,144,2,729,175652,1,351
2011-05-29,summer,2011,May,15,Sunday,Holiday,Clear,0.74,0.697,0.7,0.2985,221,155,376,376,582,376,1,4,4,144,2,729,183149,1,376
2011-05-29,summer,2011,May,16,Sunday,Holiday,Clear,0.74,0.697,0.7,0.2836,194,167,361,361,582,361,1,4,4,144,2,730,227748,1,361
2011-05-29,summer,2011,May,17,Sunday,Holiday,Clear,0.74,0.697,0.7,0.2836,214,169,383,383,582,383,1,4,4,144,2,730,336860,1,383
2011-05-29,summer,2011,May,18,Sunday,Holiday,Clear,0.72,0.697,0.74,0.2836,151,177,328,328,582,328,1,4,4,144,2,728,309772,1,328
2011-05-29,summer,2011,May,19,Sunday,Holiday,Clear,0.72,0.697,0.74,0.2537,141,146,287,287,582,287,1,4,4,144,2,728,226789,1,287
2011-05-29,summer,2011,May,20,Sunday,Holiday,Clear,0.7,0.6667,0.79,0.194,91,128,219,219,582,219,1,3,4,134,0,728,164550,1,219
2011-05-29,summer,2011,May,21,Sunday,Holiday,Clear,0.68,0.6364,0.83,0.1642,107,122,229,229,582,229,1,3,4,134,0,728,125445,1,229
2011-05-29,summer,2011,May,22,Sunday,Holiday,Clear,0.66,0.5909,0.89,0.1343,78,93,171,171,582,171,1,3,3,133,0,728,95612,1,171
2011-05-29,summer,2011,May,23,Sunday,Holiday,Clear,0.66,0.5909,0.89,0.1642,48,87,135,135,582,135,1,2,3,123,0,728,63941,1,135
2011-05-30,summer,2011,May,0,Monday,Holiday,Clear,0.64,0.5606,0.94,0.194,38,65,103,103,581,103,1,2,3,123,0,726,39130,1,103
2011-05-30,summer,2011,May,1,Monday,Holiday,Clear,0.64,0.5606,0.94,0.1343,26,53,79,79,581,79,1,2,3,123,0,724,24164,1,79
2011-05-30,summer,2011,May,2,Monday,Holiday,Clear,0.64,0.5606,0.94,0.194,17,28,45,45,581,45,1,2,3,123,0,715,16352,1,45
2011-05-30,summer,2011,May,3,Monday,Holiday,Clear,0.64,0.5606,0.94,0.194,10,8,18,18,581,18,1,1,3,113,0,697,8174,1,18
2011-05-30,summer,2011,May,4,Monday,Holiday,Clear,0.62,0.5455,0.94,0.1642,2,4,6,6,581,6,1,1,3,113,0,697,4428,1,6
2011-05-30,summer,2011,May,5,Monday,Holiday,Mist,0.62,0.5455,0.94,0.1045,1,6,7,7,581,7,1,1,3,113,0,717,14261,1,7
2011-05-30,summer,2011,May,6,Monday,Holiday,Mist,0.64,0.5606,0.94,0.0896,6,10,16,16,581,16,1,1,3,113,0,725,55132,1,16
2011-05-30,summer,2011,May,7,Monday,Holiday,Mist,0.64,0.5606,0.94,0.0,12,19,31,31,581,31,1,1,3,113,0,727,154171,1,31
2011-05-30,summer,2011,May,8,Monday,Holiday,Mist,0.66,0.5909,0.89,0.1045,36,58,94,94,581,94,1,2,3,123,0,727,261001,1,94
2011-05-30,summer,2011,May,9,Monday,Holiday,Clear,0.72,0.697,0.74,0.0896,47,81,128,128,581,128,1,2,4,124,0,727,159438,1,128
2011-05-30,summer,2011,May,10,Monday,Holiday,Clear,0.8,0.7576,0.55,0.2537,116,153,269,269,581,269,1,3,4,134,2,727,126257,1,269
2011-05-30,summer,2011,May,11,Monday,Holiday,Clear,0.82,0.7727,0.52,0.0,153,168,321,321,581,321,1,4,4,144,2,727,151320,1,321
2011-05-30,summer,2011,May,12,Monday,Holiday,Clear,0.86,0.803,0.47,0.1045,179,187,366,366,581,366,1,4,4,144,2,728,184414,1,366
2011-05-30,summer,2011,May,13,Monday,Holiday,Clear,0.86,0.7879,0.44,0.0896,133,217,350,350,581,350,1,4,4,144,2,729,184919,1,350
2011-05-30,summer,2011,May,14,Monday,Holiday,Clear,0.88,0.803,0.39,0.0,142,185,327,327,581,327,1,4,4,144,2,729,175652,1,327
2011-05-30,summer,2011,May,15,Monday,Holiday,Clear,0.88,0.803,0.39,0.2537,132,179,311,311,581,311,1,4,4,144,2,729,183149,1,311
2011-05-30,summer,2011,May,16,Monday,Holiday,Clear,0.88,0.7879,0.37,0.2836,101,208,309,309,581,309,1,4,4,144,2,730,227748,1,309
2011-05-30,summer,2011,May,17,Monday,Holiday,Clear,0.86,0.7879,0.41,0.2239,102,202,304,304,581,304,1,4,4,144,2,730,336860,1,304
2011-05-30,summer,2011,May,18,Monday,Holiday,Clear,0.86,0.7879,0.41,0.1642,77,172,249,249,581,249,1,3,4,134,2,728,309772,1,249
2011-05-30,summer,2011,May,19,Monday,Holiday,Mist,0.52,0.5,0.48,0.1045,68,157,225,225,581,225,1,3,3,133,2,728,226789,1,225
2011-05-30,summer,2011,May,20,Monday,Holiday,Clear,0.76,0.7121,0.58,0.0,69,168,237,237,581,237,1,3,4,134,2,728,164550,1,237
2011-05-30,summer,2011,May,21,Monday,Holiday,Clear,0.74,0.697,0.7,0.1343,42,107,149,149,581,149,1,3,4,134,0,728,125445,1,149
2011-05-30,summer,2011,May,22,Monday,Holiday,Clear,0.72,0.697,0.74,0.1642,26,80,106,106,581,106,1,2,4,124,0,728,95612,1,106
2011-05-30,summer,2011,May,23,Monday,Holiday,Clear,0.7,0.6667,0.84,0.1045,14,34,48,48,581,48,1,2,4,124,0,728,63941,1,48
2011-05-31,summer,2011,May,0,Tuesday,Workingday,Clear,0.7,0.6667,0.79,0.0896,9,20,29,29,580,29,1,1,4,114,0,726,39130,1,29
2011-05-31,summer,2011,May,1,Tuesday,Workingday,Clear,0.68,0.6364,0.89,0.0896,8,9,17,17,580,17,1,1,4,114,0,724,24164,1,17
2011-05-31,summer,2011,May,2,Tuesday,Workingday,Mist,0.66,0.5909,0.94,0.1343,5,7,12,12,580,12,1,1,3,113,0,715,16352,1,12
2011-05-31,summer,2011,May,3,Tuesday,Workingday,Mist,0.64,0.5606,0.94,0.0,1,3,4,4,580,4,1,1,3,113,0,697,8174,1,4
2011-05-31,summer,2011,May,4,Tuesday,Workingday,Clear,0.66,0.6061,0.83,0.0896,0,3,3,3,580,3,1,1,3,113,0,697,4428,1,3
2011-05-31,summer,2011,May,5,Tuesday,Workingday,Clear,0.66,0.6061,0.83,0.0896,0,26,26,26,580,26,1,1,3,113,0,717,14261,1,26
2011-05-31,summer,2011,May,6,Tuesday,Workingday,Clear,0.68,0.6364,0.79,0.0896,11,98,109,109,580,109,1,2,4,124,0,725,55132,1,109
2011-05-31,summer,2011,May,7,Tuesday,Workingday,Clear,0.74,0.697,0.66,0.1045,16,219,235,235,580,235,1,3,4,134,0,727,154171,1,235
2011-05-31,summer,2011,May,8,Tuesday,Workingday,Clear,0.78,0.7424,0.59,0.1343,34,372,406,406,580,406,1,4,4,144,2,727,261001,1,406
2011-05-31,summer,2011,May,9,Tuesday,Workingday,Clear,0.8,0.7576,0.55,0.1343,22,153,175,175,580,175,1,3,4,134,2,727,159438,1,175
2011-05-31,summer,2011,May,10,Tuesday,Workingday,Clear,0.82,0.7879,0.56,0.1343,37,72,109,109,580,109,1,2,4,124,0,727,126257,1,109
2011-05-31,summer,2011,May,11,Tuesday,Workingday,Clear,0.86,0.803,0.47,0.0,28,78,106,106,580,106,1,2,4,124,0,727,151320,1,106
2011-05-31,summer,2011,May,12,Tuesday,Workingday,Clear,0.86,0.803,0.47,0.1343,37,125,162,162,580,162,1,3,4,134,2,728,184414,1,162
2011-05-31,summer,2011,May,13,Tuesday,Workingday,Clear,0.9,0.8333,0.39,0.1642,37,110,147,147,580,147,1,3,4,134,2,729,184919,1,147
2011-05-31,summer,2011,May,14,Tuesday,Workingday,Clear,0.9,0.8182,0.37,0.0,41,99,140,140,580,140,1,2,4,124,2,729,175652,1,140
2011-05-31,summer,2011,May,15,Tuesday,Workingday,Clear,0.9,0.8182,0.37,0.1642,42,133,175,175,580,175,1,3,4,134,2,729,183149,1,175
2011-05-31,summer,2011,May,16,Tuesday,Workingday,Clear,0.9,0.8333,0.39,0.1343,44,205,249,249,580,249,1,3,4,134,2,730,227748,1,249
2011-05-31,summer,2011,May,17,Tuesday,Workingday,Clear,0.84,0.803,0.53,0.2239,67,428,495,495,580,495,1,4,4,144,2,730,336860,1,495
2011-05-31,summer,2011,May,18,Tuesday,Workingday,Clear,0.84,0.803,0.53,0.194,55,362,417,417,580,417,1,4,4,144,2,728,309772,1,417
2011-05-31,summer,2011,May,19,Tuesday,Workingday,Clear,0.78,0.7424,0.62,0.1045,39,246,285,285,580,285,1,4,4,144,2,728,226789,1,285
2011-05-31,summer,2011,May,20,Tuesday,Workingday,Clear,0.78,0.7424,0.62,0.1045,38,213,251,251,580,251,1,3,4,134,2,728,164550,1,251
2011-05-31,summer,2011,May,21,Tuesday,Workingday,Clear,0.76,0.7273,0.66,0.1045,45,165,210,210,580,210,1,3,4,134,0,728,125445,1,210
2011-05-31,summer,2011,May,22,Tuesday,Workingday,Clear,0.74,0.697,0.7,0.1642,42,117,159,159,580,159,1,3,4,134,0,728,95612,1,159
2011-05-31,summer,2011,May,23,Tuesday,Workingday,Clear,0.72,0.697,0.79,0.0896,15,46,61,61,580,61,1,2,4,124,0,728,63941,1,61
2011-06-01,summer,2011,June,0,Wednesday,Workingday,Clear,0.7,0.6667,0.79,0.1642,9,25,34,34,579,34,1,1,4,114,0,726,39130,1,34
2011-06-01,summer,2011,June,1,Wednesday,Workingday,Clear,0.7,0.6667,0.84,0.2537,8,9,17,17,579,17,1,1,4,114,0,724,24164,1,17
2011-06-01,summer,2011,June,2,Wednesday,Workingday,Clear,0.7,0.6667,0.79,0.1642,0,3,3,3,579,3,1,1,4,114,0,715,16352,1,3
2011-06-01,summer,2011,June,3,Wednesday,Workingday,Clear,0.68,0.6364,0.89,0.194,0,6,6,6,579,6,1,1,4,114,0,697,8174,1,6
2011-06-01,summer,2011,June,4,Wednesday,Workingday,Mist,0.68,0.6364,0.89,0.2239,0,4,4,4,579,4,1,1,4,114,0,697,4428,1,4
2011-06-01,summer,2011,June,5,Wednesday,Workingday,Mist,0.66,0.5909,0.89,0.0896,2,19,21,21,579,21,1,1,3,113,0,717,14261,1,21
2011-06-01,summer,2011,June,6,Wednesday,Workingday,Mist,0.68,0.6364,0.89,0.0896,7,121,128,128,579,128,1,2,4,124,0,725,55132,1,128
2011-06-01,summer,2011,June,7,Wednesday,Workingday,Mist,0.7,0.6667,0.79,0.1642,19,265,284,284,579,284,1,4,4,144,0,727,154171,1,284
2011-06-01,summer,2011,June,8,Wednesday,Workingday,Mist,0.72,0.697,0.79,0.194,37,417,454,454,579,454,1,4,4,144,2,727,261001,1,454
2011-06-01,summer,2011,June,9,Wednesday,Workingday,Mist,0.74,0.7121,0.74,0.2239,34,173,207,207,579,207,1,3,4,134,0,727,159438,1,207
2011-06-01,summer,2011,June,10,Wednesday,Workingday,Mist,0.76,0.7424,0.75,0.2537,31,84,115,115,579,115,1,2,4,124,0,727,126257,1,115
2011-06-01,summer,2011,June,11,Wednesday,Workingday,Mist,0.82,0.803,0.59,0.2239,26,86,112,112,579,112,1,2,4,124,2,727,151320,1,112
2011-06-01,summer,2011,June,12,Wednesday,Workingday,Clear,0.86,0.8333,0.53,0.0,32,137,169,169,579,169,1,3,4,134,2,728,184414,1,169
2011-06-01,summer,2011,June,13,Wednesday,Workingday,Clear,0.9,0.8182,0.37,0.194,29,125,154,154,579,154,1,3,4,134,2,729,184919,1,154
2011-06-01,summer,2011,June,14,Wednesday,Workingday,Clear,0.9,0.8182,0.37,0.2537,40,105,145,145,579,145,1,3,4,134,2,729,175652,1,145
2011-06-01,summer,2011,June,15,Wednesday,Workingday,Clear,0.9,0.8333,0.39,0.2985,25,127,152,152,579,152,1,3,4,134,2,729,183149,1,152
2011-06-01,summer,2011,June,16,Wednesday,Workingday,Clear,0.86,0.803,0.47,0.2985,39,227,266,266,579,266,1,3,4,134,2,730,227748,1,266
2011-06-01,summer,2011,June,17,Wednesday,Workingday,Clear,0.86,0.803,0.47,0.2985,52,434,486,486,579,486,1,4,4,144,2,730,336860,1,486
2011-06-01,summer,2011,June,18,Wednesday,Workingday,Light Snow,0.82,0.7879,0.56,0.3881,31,278,309,309,579,309,1,4,4,144,2,728,309772,1,309
2011-06-01,summer,2011,June,19,Wednesday,Workingday,Mist,0.74,0.7121,0.79,0.1642,16,248,264,264,579,264,1,3,4,134,0,728,226789,1,264
2011-06-01,summer,2011,June,20,Wednesday,Workingday,Mist,0.74,0.7121,0.79,0.2537,23,233,256,256,579,256,1,3,4,134,0,728,164550,1,256
2011-06-01,summer,2011,June,21,Wednesday,Workingday,Clear,0.74,0.697,0.7,0.2836,29,161,190,190,579,190,1,3,4,134,0,728,125445,1,190
2011-06-01,summer,2011,June,22,Wednesday,Workingday,Clear,0.74,0.697,0.66,0.1343,14,115,129,129,579,129,1,2,4,124,0,728,95612,1,129
2011-06-01,summer,2011,June,23,Wednesday,Workingday,Clear,0.74,0.6667,0.51,0.1642,10,59,69,69,579,69,1,2,4,124,0,728,63941,1,69
2011-06-02,summer,2011,June,0,Thursday,Workingday,Clear,0.74,0.6515,0.4,0.3582,11,31,42,42,578,42,1,2,4,124,2,726,39130,1,42
2011-06-02,summer,2011,June,1,Thursday,Workingday,Clear,0.72,0.6515,0.38,0.1045,3,12,15,15,578,15,1,1,4,114,0,724,24164,1,15
2011-06-02,summer,2011,June,2,Thursday,Workingday,Clear,0.7,0.6364,0.39,0.0,0,6,6,6,578,6,1,1,4,114,0,715,16352,1,6
2011-06-02,summer,2011,June,3,Thursday,Workingday,Clear,0.66,0.6212,0.44,0.1045,0,4,4,4,578,4,1,1,3,113,0,697,8174,1,4
2011-06-02,summer,2011,June,4,Thursday,Workingday,Clear,0.66,0.6212,0.41,0.194,0,3,3,3,578,3,1,1,3,113,0,697,4428,1,3
2011-06-02,summer,2011,June,5,Thursday,Workingday,Clear,0.66,0.6212,0.39,0.2239,3,28,31,31,578,31,1,1,3,113,0,717,14261,1,31
2011-06-02,summer,2011,June,6,Thursday,Workingday,Clear,0.66,0.6212,0.39,0.1343,7,106,113,113,578,113,1,2,3,123,0,725,55132,1,113
2011-06-02,summer,2011,June,7,Thursday,Workingday,Clear,0.7,0.6364,0.34,0.2537,19,285,304,304,578,304,1,4,4,144,2,727,154171,1,304
2011-06-02,summer,2011,June,8,Thursday,Workingday,Clear,0.7,0.6364,0.32,0.2985,25,442,467,467,578,467,1,4,4,144,2,727,261001,1,467
2011-06-02,summer,2011,June,9,Thursday,Workingday,Clear,0.72,0.6364,0.26,0.3582,28,197,225,225,578,225,1,3,4,134,2,727,159438,1,225
2011-06-02,summer,2011,June,10,Thursday,Workingday,Clear,0.72,0.6515,0.28,0.4925,33,106,139,139,578,139,1,2,4,124,2,727,126257,1,139
2011-06-02,summer,2011,June,11,Thursday,Workingday,Clear,0.74,0.6515,0.28,0.3881,42,123,165,165,578,165,1,3,4,134,2,727,151320,1,165
2011-06-02,summer,2011,June,12,Thursday,Workingday,Clear,0.76,0.6667,0.25,0.4627,39,193,232,232,578,232,1,3,4,134,2,728,184414,1,232
2011-06-02,summer,2011,June,13,Thursday,Workingday,Clear,0.8,0.6818,0.24,0.3582,35,168,203,203,578,203,1,3,4,134,2,729,184919,1,203
2011-06-02,summer,2011,June,14,Thursday,Workingday,Clear,0.78,0.6667,0.24,0.3284,43,142,185,185,578,185,1,3,4,134,2,729,175652,1,185
2011-06-02,summer,2011,June,15,Thursday,Workingday,Clear,0.8,0.6818,0.21,0.3881,44,144,188,188,578,188,1,3,4,134,2,729,183149,1,188
2011-06-02,summer,2011,June,16,Thursday,Workingday,Clear,0.8,0.6818,0.22,0.4925,63,255,318,318,578,318,1,4,4,144,2,730,227748,1,318
2011-06-02,summer,2011,June,17,Thursday,Workingday,Clear,0.76,0.6515,0.2,0.5224,88,484,572,572,578,572,1,4,4,144,2,730,336860,1,572
2011-06-02,summer,2011,June,18,Thursday,Workingday,Clear,0.74,0.6515,0.22,0.3881,74,451,525,525,578,525,1,4,4,144,2,728,309772,1,525
2011-06-02,summer,2011,June,19,Thursday,Workingday,Clear,0.72,0.6364,0.23,0.2985,58,321,379,379,578,379,1,4,4,144,2,728,226789,1,379
2011-06-02,summer,2011,June,20,Thursday,Workingday,Clear,0.7,0.6364,0.24,0.194,51,286,337,337,578,337,1,4,4,144,2,728,164550,1,337
2011-06-02,summer,2011,June,21,Thursday,Workingday,Clear,0.66,0.6212,0.31,0.194,33,215,248,248,578,248,1,3,3,133,2,728,125445,1,248
2011-06-02,summer,2011,June,22,Thursday,Workingday,Clear,0.64,0.6212,0.33,0.2537,14,141,155,155,578,155,1,3,3,133,2,728,95612,1,155
2011-06-02,summer,2011,June,23,Thursday,Workingday,Clear,0.62,0.6212,0.35,0.2239,23,89,112,112,578,112,1,2,3,123,2,728,63941,1,112
2011-06-03,summer,2011,June,0,Friday,Workingday,Clear,0.62,0.6212,0.38,0.2836,15,53,68,68,577,68,1,2,3,123,2,726,39130,1,68
2011-06-03,summer,2011,June,1,Friday,Workingday,Clear,0.6,0.6212,0.38,0.3582,7,15,22,22,577,22,1,1,3,113,0,724,24164,1,22
2011-06-03,summer,2011,June,2,Friday,Workingday,Clear,0.56,0.5303,0.43,0.2239,0,12,12,12,577,12,1,1,3,113,0,715,16352,1,12
2011-06-03,summer,2011,June,3,Friday,Workingday,Clear,0.54,0.5152,0.49,0.2239,0,5,5,5,577,5,1,1,3,113,0,697,8174,1,5
2011-06-03,summer,2011,June,4,Friday,Workingday,Clear,0.52,0.5,0.48,0.3284,1,5,6,6,577,6,1,1,3,113,1,697,4428,1,6
2011-06-03,summer,2011,June,5,Friday,Workingday,Clear,0.52,0.5,0.48,0.3582,4,24,28,28,577,28,1,1,3,113,1,717,14261,1,28
2011-06-03,summer,2011,June,6,Friday,Workingday,Clear,0.54,0.5152,0.45,0.2985,8,98,106,106,577,106,1,2,3,123,1,725,55132,1,106
2011-06-03,summer,2011,June,7,Friday,Workingday,Clear,0.54,0.5152,0.45,0.2537,25,252,277,277,577,277,1,3,3,133,2,727,154171,1,277
2011-06-03,summer,2011,June,8,Friday,Workingday,Mist,0.56,0.5303,0.43,0.3284,31,471,502,502,577,502,1,4,3,143,2,727,261001,1,502
2011-06-03,summer,2011,June,9,Friday,Workingday,Clear,0.58,0.5455,0.4,0.1642,36,194,230,230,577,230,1,3,3,133,2,727,159438,1,230
2011-06-03,summer,2011,June,10,Friday,Workingday,Clear,0.62,0.6212,0.33,0.2537,54,107,161,161,577,161,1,3,3,133,2,727,126257,1,161
2011-06-03,summer,2011,June,11,Friday,Workingday,Clear,0.64,0.6212,0.31,0.3284,57,135,192,192,577,192,1,3,3,133,2,727,151320,1,192
2011-06-03,summer,2011,June,12,Friday,Workingday,Clear,0.66,0.6212,0.27,0.2836,51,208,259,259,577,259,1,3,3,133,2,728,184414,1,259
2011-06-03,summer,2011,June,13,Friday,Workingday,Clear,0.68,0.6212,0.26,0.2537,58,190,248,248,577,248,1,3,3,133,2,729,184919,1,248
2011-06-03,summer,2011,June,14,Friday,Workingday,Clear,0.7,0.6364,0.28,0.2836,66,174,240,240,577,240,1,3,4,134,2,729,175652,1,240
2011-06-03,summer,2011,June,15,Friday,Workingday,Clear,0.7,0.6364,0.28,0.2836,56,156,212,212,577,212,1,3,4,134,2,729,183149,1,212
2011-06-03,summer,2011,June,16,Friday,Workingday,Clear,0.72,0.6364,0.26,0.3284,63,286,349,349,577,349,1,4,4,144,2,730,227748,1,349
2011-06-03,summer,2011,June,17,Friday,Workingday,Clear,0.72,0.6364,0.25,0.2836,73,485,558,558,577,558,1,4,4,144,2,730,336860,1,558
2011-06-03,summer,2011,June,18,Friday,Workingday,Clear,0.7,0.6364,0.24,0.2985,76,488,564,564,577,564,1,4,4,144,2,728,309772,1,564
2011-06-03,summer,2011,June,19,Friday,Workingday,Clear,0.68,0.6212,0.26,0.2836,53,338,391,391,577,391,1,4,3,143,2,728,226789,1,391
2011-06-03,summer,2011,June,20,Friday,Workingday,Clear,0.64,0.6212,0.29,0.1642,57,236,293,293,577,293,1,4,3,143,2,728,164550,1,293
2011-06-03,summer,2011,June,21,Friday,Workingday,Clear,0.64,0.6212,0.29,0.1045,51,196,247,247,577,247,1,3,3,133,2,728,125445,1,247
2011-06-03,summer,2011,June,22,Friday,Workingday,Clear,0.62,0.6212,0.35,0.0,26,145,171,171,577,171,1,3,3,133,2,728,95612,1,171
2011-06-03,summer,2011,June,23,Friday,Workingday,Clear,0.58,0.5455,0.46,0.1045,30,141,171,171,577,171,1,3,3,133,0,728,63941,1,171
2011-06-04,summer,2011,June,0,Saturday,Holiday,Clear,0.56,0.5303,0.52,0.0,24,69,93,93,576,93,1,2,3,123,0,726,39130,1,93
2011-06-04,summer,2011,June,1,Saturday,Holiday,Clear,0.54,0.5152,0.64,0.1045,14,80,94,94,576,94,1,2,3,123,0,724,24164,1,94
2011-06-04,summer,2011,June,2,Saturday,Holiday,Clear,0.54,0.5152,0.56,0.194,18,41,59,59,576,59,1,2,3,123,0,715,16352,1,59
2011-06-04,summer,2011,June,3,Saturday,Holiday,Clear,0.52,0.5,0.59,0.1045,8,10,18,18,576,18,1,1,3,113,0,697,8174,1,18
2011-06-04,summer,2011,June,4,Saturday,Holiday,Clear,0.52,0.5,0.59,0.0896,4,11,15,15,576,15,1,1,3,113,0,697,4428,1,15
2011-06-04,summer,2011,June,5,Saturday,Holiday,Clear,0.5,0.4848,0.64,0.0,3,5,8,8,576,8,1,1,2,112,0,717,14261,1,8
2011-06-04,summer,2011,June,6,Saturday,Holiday,Clear,0.54,0.5152,0.6,0.0,11,17,28,28,576,28,1,1,3,113,0,725,55132,1,28
2011-06-04,summer,2011,June,7,Saturday,Holiday,Clear,0.56,0.5303,0.56,0.0,27,60,87,87,576,87,1,2,3,123,0,727,154171,1,87
2011-06-04,summer,2011,June,8,Saturday,Holiday,Clear,0.6,0.6212,0.46,0.0896,29,96,125,125,576,125,1,2,3,123,0,727,261001,1,125
2011-06-04,summer,2011,June,9,Saturday,Holiday,Clear,0.62,0.6212,0.43,0.1343,55,169,224,224,576,224,1,3,3,133,2,727,159438,1,224
2011-06-04,summer,2011,June,10,Saturday,Holiday,Clear,0.64,0.6212,0.38,0.1045,115,202,317,317,576,317,1,4,3,143,2,727,126257,1,317
2011-06-04,summer,2011,June,11,Saturday,Holiday,Clear,0.66,0.6212,0.36,0.1343,120,249,369,369,576,369,1,4,3,143,2,727,151320,1,369
2011-06-04,summer,2011,June,12,Saturday,Holiday,Clear,0.7,0.6364,0.32,0.1642,150,270,420,420,576,420,1,4,4,144,2,728,184414,1,420
2011-06-04,summer,2011,June,13,Saturday,Holiday,Clear,0.74,0.6515,0.28,0.1343,188,268,456,456,576,456,1,4,4,144,2,729,184919,1,456
2011-06-04,summer,2011,June,14,Saturday,Holiday,Clear,0.74,0.6515,0.33,0.2239,193,258,451,451,576,451,1,4,4,144,2,729,175652,1,451
2011-06-04,summer,2011,June,15,Saturday,Holiday,Mist,0.74,0.6515,0.27,0.4179,180,224,404,404,576,404,1,4,4,144,2,729,183149,1,404
2011-06-04,summer,2011,June,16,Saturday,Holiday,Mist,0.72,0.6515,0.3,0.1343,168,272,440,440,576,440,1,4,4,144,2,730,227748,1,440
2011-06-04,summer,2011,June,17,Saturday,Holiday,Mist,0.72,0.6515,0.34,0.2537,142,202,344,344,576,344,1,4,4,144,2,730,336860,1,344
2011-06-04,summer,2011,June,18,Saturday,Holiday,Mist,0.74,0.6515,0.3,0.1642,127,214,341,341,576,341,1,4,4,144,2,728,309772,1,341
2011-06-04,summer,2011,June,19,Saturday,Holiday,Mist,0.7,0.6364,0.39,0.0896,79,206,285,285,576,285,1,4,4,144,2,728,226789,1,285
2011-06-04,summer,2011,June,20,Saturday,Holiday,Mist,0.7,0.6515,0.48,0.0896,90,149,239,239,576,239,1,3,4,134,2,728,164550,1,239
2011-06-04,summer,2011,June,21,Saturday,Holiday,Mist,0.66,0.6212,0.47,0.1045,46,139,185,185,576,185,1,3,3,133,2,728,125445,1,185
2011-06-04,summer,2011,June,22,Saturday,Holiday,Clear,0.64,0.6212,0.57,0.2239,49,141,190,190,576,190,1,3,3,133,2,728,95612,1,190
2011-06-04,summer,2011,June,23,Saturday,Holiday,Mist,0.64,0.6212,0.57,0.0,29,121,150,150,576,150,1,3,3,133,0,728,63941,1,150
2011-06-05,summer,2011,June,0,Sunday,Holiday,Clear,0.64,0.6212,0.57,0.0896,23,90,113,113,575,113,1,2,3,123,0,726,39130,1,113
2011-06-05,summer,2011,June,1,Sunday,Holiday,Mist,0.64,0.6212,0.61,0.1642,26,70,96,96,575,96,1,2,3,123,0,724,24164,1,96
2011-06-05,summer,2011,June,2,Sunday,Holiday,Mist,0.64,0.6212,0.61,0.1642,16,48,64,64,575,64,1,2,3,123,0,715,16352,1,64
2011-06-05,summer,2011,June,3,Sunday,Holiday,Mist,0.62,0.6061,0.65,0.1642,22,25,47,47,575,47,1,2,3,123,0,697,8174,1,47
2011-06-05,summer,2011,June,4,Sunday,Holiday,Mist,0.62,0.6061,0.65,0.1642,4,8,12,12,575,12,1,1,3,113,0,697,4428,1,12
2011-06-05,summer,2011,June,5,Sunday,Holiday,Mist,0.62,0.6061,0.61,0.1343,1,5,6,6,575,6,1,1,3,113,0,717,14261,1,6
2011-06-05,summer,2011,June,6,Sunday,Holiday,Mist,0.62,0.6061,0.61,0.1045,10,11,21,21,575,21,1,1,3,113,0,725,55132,1,21
2011-06-05,summer,2011,June,7,Sunday,Holiday,Mist,0.6,0.5909,0.73,0.2537,8,19,27,27,575,27,1,1,3,113,0,727,154171,1,27
2011-06-05,summer,2011,June,8,Sunday,Holiday,Mist,0.6,0.5909,0.73,0.2537,24,74,98,98,575,98,1,2,3,123,0,727,261001,1,98
2011-06-05,summer,2011,June,9,Sunday,Holiday,Mist,0.6,0.5758,0.78,0.194,53,111,164,164,575,164,1,3,3,133,0,727,159438,1,164
2011-06-05,summer,2011,June,10,Sunday,Holiday,Mist,0.62,0.5909,0.73,0.0896,83,168,251,251,575,251,1,3,3,133,0,727,126257,1,251
2011-06-05,summer,2011,June,11,Sunday,Holiday,Mist,0.64,0.6061,0.69,0.1045,121,214,335,335,575,335,1,4,3,143,2,727,151320,1,335
2011-06-05,summer,2011,June,12,Sunday,Holiday,Mist,0.64,0.6061,0.69,0.1045,123,212,335,335,575,335,1,4,3,143,2,728,184414,1,335
2011-06-05,summer,2011,June,13,Sunday,Holiday,Clear,0.66,0.6212,0.65,0.1045,154,213,367,367,575,367,1,4,3,143,2,729,184919,1,367
2011-06-05,summer,2011,June,14,Sunday,Holiday,Clear,0.7,0.6515,0.58,0.1642,161,224,385,385,575,385,1,4,4,144,2,729,175652,1,385
2011-06-05,summer,2011,June,15,Sunday,Holiday,Clear,0.7,0.6515,0.54,0.0,161,256,417,417,575,417,1,4,4,144,2,729,183149,1,417
2011-06-05,summer,2011,June,16,Sunday,Holiday,Clear,0.72,0.6667,0.51,0.0896,138,260,398,398,575,398,1,4,4,144,2,730,227748,1,398
2011-06-05,summer,2011,June,17,Sunday,Holiday,Clear,0.74,0.6667,0.51,0.0,126,264,390,390,575,390,1,4,4,144,2,730,336860,1,390
2011-06-05,summer,2011,June,18,Sunday,Holiday,Clear,0.7,0.6515,0.58,0.1045,124,239,363,363,575,363,1,4,4,144,2,728,309772,1,363
2011-06-05,summer,2011,June,19,Sunday,Holiday,Clear,0.68,0.6364,0.65,0.1642,108,249,357,357,575,357,1,4,4,144,2,728,226789,1,357
2011-06-05,summer,2011,June,20,Sunday,Holiday,Clear,0.66,0.6212,0.69,0.194,84,195,279,279,575,279,1,3,3,133,2,728,164550,1,279
2011-06-05,summer,2011,June,21,Sunday,Holiday,Clear,0.64,0.6061,0.73,0.1642,54,111,165,165,575,165,1,3,3,133,0,728,125445,1,165
2011-06-05,summer,2011,June,22,Sunday,Holiday,Clear,0.64,0.5909,0.78,0.2239,36,94,130,130,575,130,1,2,3,123,0,728,95612,1,130
2011-06-05,summer,2011,June,23,Sunday,Holiday,Clear,0.62,0.5909,0.78,0.1343,25,61,86,86,575,86,1,2,3,123,0,728,63941,1,86
2011-06-06,summer,2011,June,0,Monday,Workingday,Clear,0.62,0.5909,0.78,0.1343,11,18,29,29,574,29,1,1,3,113,0,726,39130,1,29
2011-06-06,summer,2011,June,1,Monday,Workingday,Clear,0.6,0.5606,0.83,0.1343,9,5,14,14,574,14,1,1,3,113,0,724,24164,1,14
2011-06-06,summer,2011,June,2,Monday,Workingday,Clear,0.58,0.5455,0.88,0.1045,4,4,8,8,574,8,1,1,3,113,0,715,16352,1,8
2011-06-06,summer,2011,June,3,Monday,Workingday,Clear,0.58,0.5455,0.88,0.0,2,3,5,5,574,5,1,1,3,113,0,697,8174,1,5
2011-06-06,summer,2011,June,4,Monday,Workingday,Clear,0.56,0.5303,0.94,0.1045,4,4,8,8,574,8,1,1,3,113,0,697,4428,1,8
2011-06-06,summer,2011,June,5,Monday,Workingday,Clear,0.56,0.5303,0.88,0.0896,7,24,31,31,574,31,1,1,3,113,0,717,14261,1,31
2011-06-06,summer,2011,June,6,Monday,Workingday,Clear,0.58,0.5455,0.88,0.0,11,101,112,112,574,112,1,2,3,123,0,725,55132,1,112
2011-06-06,summer,2011,June,7,Monday,Workingday,Clear,0.62,0.5909,0.78,0.1045,18,281,299,299,574,299,1,4,3,143,0,727,154171,1,299
2011-06-06,summer,2011,June,8,Monday,Workingday,Clear,0.64,0.6061,0.73,0.0896,28,410,438,438,574,438,1,4,3,143,0,727,261001,1,438
2011-06-06,summer,2011,June,9,Monday,Workingday,Clear,0.7,0.6515,0.58,0.1642,26,162,188,188,574,188,1,3,4,134,0,727,159438,1,188
2011-06-06,summer,2011,June,10,Monday,Workingday,Clear,0.72,0.6667,0.51,0.2239,31,64,95,95,574,95,1,2,4,124,0,727,126257,1,95
2011-06-06,summer,2011,June,11,Monday,Workingday,Clear,0.74,0.6667,0.42,0.1343,39,72,111,111,574,111,1,2,4,124,2,727,151320,1,111
2011-06-06,summer,2011,June,12,Monday,Workingday,Clear,0.76,0.6667,0.37,0.1642,25,128,153,153,574,153,1,3,4,134,2,728,184414,1,153
2011-06-06,summer,2011,June,13,Monday,Workingday,Clear,0.78,0.6818,0.35,0.0,28,152,180,180,574,180,1,3,4,134,2,729,184919,1,180
2011-06-06,summer,2011,June,14,Monday,Workingday,Clear,0.78,0.6818,0.31,0.1343,46,99,145,145,574,145,1,3,4,134,2,729,175652,1,145
2011-06-06,summer,2011,June,15,Monday,Workingday,Clear,0.8,0.697,0.29,0.194,38,127,165,165,574,165,1,3,4,134,2,729,183149,1,165
2011-06-06,summer,2011,June,16,Monday,Workingday,Clear,0.76,0.6667,0.33,0.1343,34,233,267,267,574,267,1,3,4,134,2,730,227748,1,267
2011-06-06,summer,2011,June,17,Monday,Workingday,Clear,0.78,0.6818,0.33,0.2836,63,516,579,579,574,579,1,4,4,144,2,730,336860,1,579
2011-06-06,summer,2011,June,18,Monday,Workingday,Clear,0.76,0.6667,0.31,0.1343,56,500,556,556,574,556,1,4,4,144,2,728,309772,1,556
2011-06-06,summer,2011,June,19,Monday,Workingday,Clear,0.72,0.6667,0.54,0.194,64,343,407,407,574,407,1,4,4,144,2,728,226789,1,407
2011-06-06,summer,2011,June,20,Monday,Workingday,Clear,0.68,0.6364,0.61,0.1343,59,277,336,336,574,336,1,4,4,144,2,728,164550,1,336
2011-06-06,summer,2011,June,21,Monday,Workingday,Clear,0.66,0.6212,0.57,0.0896,29,160,189,189,574,189,1,3,3,133,0,728,125445,1,189
2011-06-06,summer,2011,June,22,Monday,Workingday,Clear,0.66,0.6212,0.61,0.0896,36,137,173,173,574,173,1,3,3,133,0,728,95612,1,173
2011-06-06,summer,2011,June,23,Monday,Workingday,Clear,0.64,0.6061,0.69,0.0896,5,55,60,60,574,60,1,2,3,123,0,728,63941,1,60
2011-06-07,summer,2011,June,0,Tuesday,Workingday,Clear,0.64,0.6061,0.65,0.0896,5,15,20,20,573,20,1,1,3,113,0,726,39130,1,20
2011-06-07,summer,2011,June,1,Tuesday,Workingday,Clear,0.62,0.6061,0.69,0.1343,2,2,4,4,573,4,1,1,3,113,0,724,24164,1,4
2011-06-07,summer,2011,June,2,Tuesday,Workingday,Clear,0.6,0.5909,0.73,0.0896,3,2,5,5,573,5,1,1,3,113,0,715,16352,1,5
2011-06-07,summer,2011,June,3,Tuesday,Workingday,Clear,0.6,0.5909,0.73,0.0896,1,1,2,2,573,2,1,1,3,113,0,697,8174,1,2
2011-06-07,summer,2011,June,4,Tuesday,Workingday,Clear,0.58,0.5455,0.83,0.1343,2,3,5,5,573,5,1,1,3,113,0,697,4428,1,5
2011-06-07,summer,2011,June,5,Tuesday,Workingday,Clear,0.58,0.5455,0.88,0.1642,2,30,32,32,573,32,1,1,3,113,0,717,14261,1,32
2011-06-07,summer,2011,June,6,Tuesday,Workingday,Clear,0.6,0.5758,0.78,0.1343,10,116,126,126,573,126,1,2,3,123,0,725,55132,1,126
2011-06-07,summer,2011,June,7,Tuesday,Workingday,Mist,0.64,0.6061,0.69,0.194,23,311,334,334,573,334,1,4,3,143,0,727,154171,1,334
2011-06-07,summer,2011,June,8,Tuesday,Workingday,Mist,0.68,0.6364,0.61,0.1343,45,432,477,477,573,477,1,4,4,144,2,727,261001,1,477
2011-06-07,summer,2011,June,9,Tuesday,Workingday,Mist,0.72,0.6667,0.58,0.2239,27,190,217,217,573,217,1,3,4,134,2,727,159438,1,217
2011-06-07,summer,2011,June,10,Tuesday,Workingday,Mist,0.76,0.6818,0.48,0.194,37,86,123,123,573,123,1,2,4,124,2,727,126257,1,123
2011-06-07,summer,2011,June,11,Tuesday,Workingday,Mist,0.76,0.697,0.52,0.2537,38,113,151,151,573,151,1,3,4,134,2,727,151320,1,151
2011-06-07,summer,2011,June,12,Tuesday,Workingday,Mist,0.8,0.7273,0.46,0.2836,42,141,183,183,573,183,1,3,4,134,2,728,184414,1,183
2011-06-07,summer,2011,June,13,Tuesday,Workingday,Mist,0.8,0.7273,0.43,0.2537,55,141,196,196,573,196,1,3,4,134,2,729,184919,1,196
2011-06-07,summer,2011,June,14,Tuesday,Workingday,Mist,0.8,0.7273,0.43,0.2836,34,112,146,146,573,146,1,3,4,134,2,729,175652,1,146
2011-06-07,summer,2011,June,15,Tuesday,Workingday,Mist,0.82,0.7424,0.41,0.3284,56,127,183,183,573,183,1,3,4,134,2,729,183149,1,183
2011-06-07,summer,2011,June,16,Tuesday,Workingday,Clear,0.8,0.7121,0.38,0.2239,55,253,308,308,573,308,1,4,4,144,2,730,227748,1,308
2011-06-07,summer,2011,June,17,Tuesday,Workingday,Clear,0.8,0.7273,0.43,0.2537,64,475,539,539,573,539,1,4,4,144,2,730,336860,1,539
2011-06-07,summer,2011,June,18,Tuesday,Workingday,Clear,0.78,0.697,0.46,0.2836,72,479,551,551,573,551,1,4,4,144,2,728,309772,1,551
2011-06-07,summer,2011,June,19,Tuesday,Workingday,Clear,0.76,0.6818,0.48,0.2537,69,355,424,424,573,424,1,4,4,144,2,728,226789,1,424
2011-06-07,summer,2011,June,20,Tuesday,Workingday,Clear,0.74,0.6818,0.56,0.1343,45,301,346,346,573,346,1,4,4,144,2,728,164550,1,346
2011-06-07,summer,2011,June,21,Tuesday,Workingday,Clear,0.72,0.6818,0.7,0.1343,31,187,218,218,573,218,1,3,4,134,0,728,125445,1,218
2011-06-07,summer,2011,June,22,Tuesday,Workingday,Clear,0.7,0.6515,0.65,0.1343,27,126,153,153,573,153,1,3,4,134,0,728,95612,1,153
2011-06-07,summer,2011,June,23,Tuesday,Workingday,Clear,0.68,0.6364,0.79,0.1045,18,72,90,90,573,90,1,2,4,124,0,728,63941,1,90
2011-06-08,summer,2011,June,0,Wednesday,Workingday,Clear,0.66,0.5909,0.89,0.1343,12,29,41,41,572,41,1,2,3,123,0,726,39130,1,41
2011-06-08,summer,2011,June,1,Wednesday,Workingday,Clear,0.66,0.6061,0.78,0.0,3,20,23,23,572,23,1,1,3,113,0,724,24164,1,23
2011-06-08,summer,2011,June,2,Wednesday,Workingday,Clear,0.64,0.5758,0.89,0.0896,0,7,7,7,572,7,1,1,3,113,0,715,16352,1,7
2011-06-08,summer,2011,June,3,Wednesday,Workingday,Clear,0.64,0.5758,0.89,0.0896,2,1,3,3,572,3,1,1,3,113,0,697,8174,1,3
2011-06-08,summer,2011,June,4,Wednesday,Workingday,Clear,0.62,0.5758,0.83,0.0,0,6,6,6,572,6,1,1,3,113,0,697,4428,1,6
2011-06-08,summer,2011,June,5,Wednesday,Workingday,Clear,0.62,0.5606,0.88,0.0,0,21,21,21,572,21,1,1,3,113,0,717,14261,1,21
2011-06-08,summer,2011,June,6,Wednesday,Workingday,Clear,0.64,0.5758,0.89,0.1343,13,103,116,116,572,116,1,2,3,123,0,725,55132,1,116
2011-06-08,summer,2011,June,7,Wednesday,Workingday,Clear,0.66,0.6212,0.74,0.1045,24,329,353,353,572,353,1,4,3,143,0,727,154171,1,353
2011-06-08,summer,2011,June,8,Wednesday,Workingday,Clear,0.76,0.7121,0.58,0.1642,46,435,481,481,572,481,1,4,4,144,2,727,261001,1,481
2011-06-08,summer,2011,June,9,Wednesday,Workingday,Clear,0.76,0.7121,0.58,0.1642,34,168,202,202,572,202,1,3,4,134,2,727,159438,1,202
2011-06-08,summer,2011,June,10,Wednesday,Workingday,Clear,0.82,0.7424,0.43,0.2239,27,63,90,90,572,90,1,2,4,124,2,727,126257,1,90
2011-06-08,summer,2011,June,11,Wednesday,Workingday,Clear,0.84,0.7576,0.41,0.194,28,106,134,134,572,134,1,2,4,124,2,727,151320,1,134
2011-06-08,summer,2011,June,12,Wednesday,Workingday,Clear,0.88,0.8182,0.42,0.1343,15,134,149,149,572,149,1,3,4,134,2,728,184414,1,149
2011-06-08,summer,2011,June,13,Wednesday,Workingday,Clear,0.9,0.8485,0.42,0.0,20,116,136,136,572,136,1,2,4,124,2,729,184919,1,136
2011-06-08,summer,2011,June,14,Wednesday,Workingday,Clear,0.92,0.8788,0.4,0.2537,44,111,155,155,572,155,1,3,4,134,2,729,175652,1,155
2011-06-08,summer,2011,June,15,Wednesday,Workingday,Clear,0.92,0.8788,0.4,0.1642,28,100,128,128,572,128,1,2,4,124,2,729,183149,1,128
2011-06-08,summer,2011,June,16,Wednesday,Workingday,Clear,0.92,0.8788,0.4,0.2239,34,199,233,233,572,233,1,3,4,134,2,730,227748,1,233
2011-06-08,summer,2011,June,17,Wednesday,Workingday,Clear,0.92,0.8485,0.35,0.2239,80,426,506,506,572,506,1,4,4,144,2,730,336860,1,506
2011-06-08,summer,2011,June,18,Wednesday,Workingday,Clear,0.9,0.8182,0.37,0.2239,61,398,459,459,572,459,1,4,4,144,2,728,309772,1,459
2011-06-08,summer,2011,June,19,Wednesday,Workingday,Clear,0.82,0.803,0.59,0.1343,61,323,384,384,572,384,1,4,4,144,2,728,226789,1,384
2011-06-08,summer,2011,June,20,Wednesday,Workingday,Clear,0.8,0.7879,0.63,0.1343,55,225,280,280,572,280,1,3,4,134,2,728,164550,1,280
2011-06-08,summer,2011,June,21,Wednesday,Workingday,Clear,0.8,0.803,0.66,0.1343,34,168,202,202,572,202,1,3,4,134,0,728,125445,1,202
2011-06-08,summer,2011,June,22,Wednesday,Workingday,Clear,0.76,0.7424,0.75,0.1642,37,139,176,176,572,176,1,3,4,134,0,728,95612,1,176
2011-06-08,summer,2011,June,23,Wednesday,Workingday,Clear,0.76,0.7424,0.75,0.194,18,98,116,116,572,116,1,2,4,124,0,728,63941,1,116
2011-06-09,summer,2011,June,0,Thursday,Workingday,Mist,0.74,0.7121,0.79,0.1343,7,40,47,47,571,47,1,2,4,124,0,726,39130,1,47
2011-06-09,summer,2011,June,1,Thursday,Workingday,Clear,0.74,0.7121,0.79,0.1045,3,13,16,16,571,16,1,1,4,114,0,724,24164,1,16
2011-06-09,summer,2011,June,2,Thursday,Workingday,Mist,0.72,0.7121,0.84,0.1642,0,6,6,6,571,6,1,1,4,114,0,715,16352,1,6
2011-06-09,summer,2011,June,3,Thursday,Workingday,Mist,0.72,0.7121,0.84,0.1045,0,2,2,2,571,2,1,1,4,114,0,697,8174,1,2
2011-06-09,summer,2011,June,4,Thursday,Workingday,Mist,0.72,0.697,0.79,0.0896,2,4,6,6,571,6,1,1,4,114,0,697,4428,1,6
2011-06-09,summer,2011,June,5,Thursday,Workingday,Mist,0.7,0.6667,0.84,0.0,1,19,20,20,571,20,1,1,4,114,0,717,14261,1,20
2011-06-09,summer,2011,June,6,Thursday,Workingday,Mist,0.72,0.7121,0.84,0.0896,13,105,118,118,571,118,1,2,4,124,0,725,55132,1,118
2011-06-09,summer,2011,June,7,Thursday,Workingday,Mist,0.72,0.697,0.79,0.1343,31,283,314,314,571,314,1,4,4,144,0,727,154171,1,314
2011-06-09,summer,2011,June,8,Thursday,Workingday,Mist,0.76,0.7273,0.7,0.1045,32,400,432,432,571,432,1,4,4,144,2,727,261001,1,432
2011-06-09,summer,2011,June,9,Thursday,Workingday,Clear,0.84,0.7879,0.49,0.0,20,148,168,168,571,168,1,3,4,134,2,727,159438,1,168
2011-06-09,summer,2011,June,10,Thursday,Workingday,Clear,0.86,0.8182,0.5,0.2836,20,74,94,94,571,94,1,2,4,124,2,727,126257,1,94
2011-06-09,summer,2011,June,11,Thursday,Workingday,Clear,0.9,0.8485,0.42,0.2239,36,82,118,118,571,118,1,2,4,124,2,727,151320,1,118
2011-06-09,summer,2011,June,12,Thursday,Workingday,Clear,0.92,0.8485,0.35,0.194,40,100,140,140,571,140,1,2,4,124,2,728,184414,1,140
2011-06-09,summer,2011,June,13,Thursday,Workingday,Clear,0.9,0.8182,0.37,0.0896,18,118,136,136,571,136,1,2,4,124,2,729,184919,1,136
2011-06-09,summer,2011,June,14,Thursday,Workingday,Clear,0.92,0.8788,0.4,0.194,25,93,118,118,571,118,1,2,4,124,2,729,175652,1,118
2011-06-09,summer,2011,June,15,Thursday,Workingday,Clear,0.94,0.8333,0.31,0.1642,18,86,104,104,571,104,1,2,4,124,2,729,183149,1,104
2011-06-09,summer,2011,June,16,Thursday,Workingday,Clear,0.92,0.8333,0.33,0.1343,30,170,200,200,571,200,1,3,4,134,2,730,227748,1,200
2011-06-09,summer,2011,June,17,Thursday,Workingday,Clear,0.9,0.8182,0.37,0.2537,54,355,409,409,571,409,1,4,4,144,2,730,336860,1,409
2011-06-09,summer,2011,June,18,Thursday,Workingday,Clear,0.88,0.803,0.39,0.2836,52,414,466,466,571,466,1,4,4,144,2,728,309772,1,466
2011-06-09,summer,2011,June,19,Thursday,Workingday,Mist,0.84,0.7424,0.39,0.3284,55,271,326,326,571,326,1,4,4,144,2,728,226789,1,326
2011-06-09,summer,2011,June,20,Thursday,Workingday,Mist,0.8,0.7273,0.43,0.194,40,214,254,254,571,254,1,3,4,134,2,728,164550,1,254
2011-06-09,summer,2011,June,21,Thursday,Workingday,Light Snow,0.76,0.697,0.52,0.0,29,142,171,171,571,171,1,3,4,134,0,728,125445,1,171
2011-06-09,summer,2011,June,22,Thursday,Workingday,Mist,0.74,0.6818,0.58,0.1642,22,131,153,153,571,153,1,3,4,134,0,728,95612,1,153
2011-06-09,summer,2011,June,23,Thursday,Workingday,Mist,0.74,0.697,0.57,0.1642,15,82,97,97,571,97,1,2,4,124,0,728,63941,1,97
2011-06-10,summer,2011,June,0,Friday,Workingday,Light Snow,0.7,0.6515,0.65,0.2239,8,61,69,69,570,69,1,2,4,124,0,726,39130,1,69
2011-06-10,summer,2011,June,1,Friday,Workingday,Light Snow,0.7,0.6515,0.65,0.2239,5,18,23,23,570,23,1,1,4,114,0,724,24164,1,23
2011-06-10,summer,2011,June,2,Friday,Workingday,Clear,0.68,0.6364,0.69,0.1642,6,7,13,13,570,13,1,1,4,114,0,715,16352,1,13
2011-06-10,summer,2011,June,3,Friday,Workingday,Clear,0.68,0.6364,0.69,0.1642,3,3,6,6,570,6,1,1,4,114,0,697,8174,1,6
2011-06-10,summer,2011,June,4,Friday,Workingday,Clear,0.66,0.6061,0.78,0.1642,0,4,4,4,570,4,1,1,3,113,0,697,4428,1,4
2011-06-10,summer,2011,June,5,Friday,Workingday,Clear,0.66,0.6061,0.78,0.1642,0,28,28,28,570,28,1,1,3,113,0,717,14261,1,28
2011-06-10,summer,2011,June,6,Friday,Workingday,Clear,0.66,0.6061,0.78,0.0896,10,94,104,104,570,104,1,2,3,123,0,725,55132,1,104
2011-06-10,summer,2011,June,7,Friday,Workingday,Clear,0.72,0.6818,0.66,0.1045,25,242,267,267,570,267,1,3,4,134,0,727,154171,1,267
2011-06-10,summer,2011,June,8,Friday,Workingday,Clear,0.74,0.6818,0.58,0.1343,29,423,452,452,570,452,1,4,4,144,2,727,261001,1,452
2011-06-10,summer,2011,June,9,Friday,Workingday,Clear,0.76,0.697,0.55,0.0,37,176,213,213,570,213,1,3,4,134,0,727,159438,1,213
2011-06-10,summer,2011,June,10,Friday,Workingday,Clear,0.78,0.7121,0.52,0.0,23,88,111,111,570,111,1,2,4,124,0,727,126257,1,111
2011-06-10,summer,2011,June,11,Friday,Workingday,Clear,0.82,0.7576,0.46,0.0,46,107,153,153,570,153,1,3,4,134,2,727,151320,1,153
2011-06-10,summer,2011,June,12,Friday,Workingday,Clear,0.84,0.7576,0.44,0.1343,40,167,207,207,570,207,1,3,4,134,2,728,184414,1,207
2011-06-10,summer,2011,June,13,Friday,Workingday,Clear,0.84,0.7576,0.44,0.1045,40,149,189,189,570,189,1,3,4,134,2,729,184919,1,189
2011-06-10,summer,2011,June,14,Friday,Workingday,Clear,0.86,0.7727,0.39,0.0,44,121,165,165,570,165,1,3,4,134,2,729,175652,1,165
2011-06-10,summer,2011,June,15,Friday,Workingday,Clear,0.84,0.7576,0.44,0.1045,49,163,212,212,570,212,1,3,4,134,2,729,183149,1,212
2011-06-10,summer,2011,June,16,Friday,Workingday,Clear,0.82,0.7879,0.56,0.2985,46,239,285,285,570,285,1,4,4,144,2,730,227748,1,285
2011-06-10,summer,2011,June,17,Friday,Workingday,Clear,0.82,0.7727,0.52,0.2239,63,454,517,517,570,517,1,4,4,144,2,730,336860,1,517
2011-06-10,summer,2011,June,18,Friday,Workingday,Clear,0.8,0.7727,0.59,0.2239,96,367,463,463,570,463,1,4,4,144,2,728,309772,1,463
2011-06-10,summer,2011,June,19,Friday,Workingday,Clear,0.78,0.7424,0.59,0.194,61,245,306,306,570,306,1,4,4,144,2,728,226789,1,306
2011-06-10,summer,2011,June,20,Friday,Workingday,Clear,0.76,0.7121,0.62,0.1045,53,197,250,250,570,250,1,3,4,134,2,728,164550,1,250
2011-06-10,summer,2011,June,21,Friday,Workingday,Clear,0.76,0.7273,0.66,0.1343,55,163,218,218,570,218,1,3,4,134,2,728,125445,1,218
2011-06-10,summer,2011,June,22,Friday,Workingday,Clear,0.72,0.697,0.74,0.2537,40,145,185,185,570,185,1,3,4,134,0,728,95612,1,185
2011-06-10,summer,2011,June,23,Friday,Workingday,Clear,0.72,0.697,0.74,0.1642,36,110,146,146,570,146,1,3,4,134,0,728,63941,1,146
2011-06-11,summer,2011,June,0,Saturday,Holiday,Clear,0.7,0.6667,0.79,0.1343,28,89,117,117,569,117,1,2,4,124,0,726,39130,1,117
2011-06-11,summer,2011,June,1,Saturday,Holiday,Clear,0.7,0.6667,0.79,0.0896,10,67,77,77,569,77,1,2,4,124,0,724,24164,1,77
2011-06-11,summer,2011,June,2,Saturday,Holiday,Clear,0.7,0.6667,0.79,0.1045,10,50,60,60,569,60,1,2,4,124,0,715,16352,1,60
2011-06-11,summer,2011,June,3,Saturday,Holiday,Clear,0.68,0.6364,0.83,0.0896,10,18,28,28,569,28,1,1,4,114,0,697,8174,1,28
2011-06-11,summer,2011,June,4,Saturday,Holiday,Clear,0.68,0.6364,0.79,0.0896,4,9,13,13,569,13,1,1,4,114,0,697,4428,1,13
2011-06-11,summer,2011,June,5,Saturday,Holiday,Clear,0.68,0.6364,0.74,0.1343,4,12,16,16,569,16,1,1,4,114,0,717,14261,1,16
2011-06-11,summer,2011,June,6,Saturday,Holiday,Clear,0.7,0.6515,0.61,0.1343,9,31,40,40,569,40,1,1,4,114,0,725,55132,1,40
2011-06-11,summer,2011,June,7,Saturday,Holiday,Clear,0.72,0.6667,0.58,0.194,18,50,68,68,569,68,1,2,4,124,0,727,154171,1,68
2011-06-11,summer,2011,June,8,Saturday,Holiday,Clear,0.74,0.6818,0.58,0.194,32,111,143,143,569,143,1,3,4,134,0,727,261001,1,143
2011-06-11,summer,2011,June,9,Saturday,Holiday,Clear,0.74,0.6818,0.62,0.1343,59,171,230,230,569,230,1,3,4,134,2,727,159438,1,230
2011-06-11,summer,2011,June,10,Saturday,Holiday,Clear,0.74,0.6818,0.58,0.1642,91,173,264,264,569,264,1,3,4,134,2,727,126257,1,264
2011-06-11,summer,2011,June,11,Saturday,Holiday,Clear,0.76,0.7121,0.62,0.1343,110,215,325,325,569,325,1,4,4,144,2,727,151320,1,325
2011-06-11,summer,2011,June,12,Saturday,Holiday,Clear,0.8,0.7576,0.55,0.2239,112,235,347,347,569,347,1,4,4,144,2,728,184414,1,347
2011-06-11,summer,2011,June,13,Saturday,Holiday,Clear,0.8,0.7576,0.55,0.194,150,237,387,387,569,387,1,4,4,144,2,729,184919,1,387
2011-06-11,summer,2011,June,14,Saturday,Holiday,Clear,0.82,0.7727,0.49,0.1045,148,232,380,380,569,380,1,4,4,144,2,729,175652,1,380
2011-06-11,summer,2011,June,15,Saturday,Holiday,Clear,0.82,0.7727,0.49,0.1045,142,232,374,374,569,374,1,4,4,144,2,729,183149,1,374
2011-06-11,summer,2011,June,16,Saturday,Holiday,Mist,0.8,0.7273,0.46,0.194,169,225,394,394,569,394,1,4,4,144,2,730,227748,1,394
2011-06-11,summer,2011,June,17,Saturday,Holiday,Mist,0.74,0.6818,0.58,0.1642,147,190,337,337,569,337,1,4,4,144,2,730,336860,1,337
2011-06-11,summer,2011,June,18,Saturday,Holiday,Mist,0.72,0.6818,0.62,0.1343,131,155,286,286,569,286,1,4,4,144,2,728,309772,1,286
2011-06-11,summer,2011,June,19,Saturday,Holiday,Clear,0.7,0.6515,0.65,0.194,97,167,264,264,569,264,1,3,4,134,2,728,226789,1,264
2011-06-11,summer,2011,June,20,Saturday,Holiday,Clear,0.68,0.6364,0.74,0.2537,95,180,275,275,569,275,1,3,4,134,2,728,164550,1,275
2011-06-11,summer,2011,June,21,Saturday,Holiday,Clear,0.66,0.6212,0.74,0.2239,76,144,220,220,569,220,1,3,3,133,0,728,125445,1,220
2011-06-11,summer,2011,June,22,Saturday,Holiday,Clear,0.66,0.6061,0.78,0.2239,53,137,190,190,569,190,1,3,3,133,0,728,95612,1,190
2011-06-11,summer,2011,June,23,Saturday,Holiday,Clear,0.66,0.6212,0.74,0.1045,24,107,131,131,569,131,1,2,3,123,0,728,63941,1,131
2011-06-12,summer,2011,June,0,Sunday,Holiday,Clear,0.66,0.6061,0.78,0.2239,19,100,119,119,568,119,1,2,3,123,0,726,39130,1,119
2011-06-12,summer,2011,June,1,Sunday,Holiday,Clear,0.64,0.5758,0.83,0.1045,19,74,93,93,568,93,1,2,3,123,0,724,24164,1,93
2011-06-12,summer,2011,June,2,Sunday,Holiday,Clear,0.64,0.5758,0.89,0.2537,9,57,66,66,568,66,1,2,3,123,0,715,16352,1,66
2011-06-12,summer,2011,June,3,Sunday,Holiday,Clear,0.64,0.5758,0.89,0.2836,8,20,28,28,568,28,1,1,3,113,0,697,8174,1,28
2011-06-12,summer,2011,June,4,Sunday,Holiday,Clear,0.62,0.5606,0.88,0.1642,8,6,14,14,568,14,1,1,3,113,0,697,4428,1,14
2011-06-12,summer,2011,June,5,Sunday,Holiday,Clear,0.62,0.5606,0.88,0.2239,5,5,10,10,568,10,1,1,3,113,0,717,14261,1,10
2011-06-12,summer,2011,June,6,Sunday,Holiday,Clear,0.62,0.5606,0.88,0.1045,5,9,14,14,568,14,1,1,3,113,0,725,55132,1,14
2011-06-12,summer,2011,June,7,Sunday,Holiday,Clear,0.64,0.5909,0.78,0.1045,7,27,34,34,568,34,1,1,3,113,0,727,154171,1,34
2011-06-12,summer,2011,June,8,Sunday,Holiday,Clear,0.7,0.6667,0.74,0.0,28,64,92,92,568,92,1,2,4,124,0,727,261001,1,92
2011-06-12,summer,2011,June,9,Sunday,Holiday,Clear,0.72,0.6818,0.66,0.0,75,107,182,182,568,182,1,3,4,134,0,727,159438,1,182
2011-06-12,summer,2011,June,10,Sunday,Holiday,Clear,0.76,0.7121,0.58,0.0896,120,191,311,311,568,311,1,4,4,144,2,727,126257,1,311
2011-06-12,summer,2011,June,11,Sunday,Holiday,Clear,0.78,0.7273,0.55,0.1045,131,236,367,367,568,367,1,4,4,144,2,727,151320,1,367
2011-06-12,summer,2011,June,12,Sunday,Holiday,Clear,0.82,0.7576,0.46,0.0,176,244,420,420,568,420,1,4,4,144,2,728,184414,1,420
2011-06-12,summer,2011,June,13,Sunday,Holiday,Clear,0.78,0.7424,0.59,0.2836,109,264,373,373,568,373,1,4,4,144,2,729,184919,1,373
2011-06-12,summer,2011,June,14,Sunday,Holiday,Clear,0.82,0.7879,0.56,0.2537,96,219,315,315,568,315,1,4,4,144,2,729,175652,1,315
2011-06-12,summer,2011,June,15,Sunday,Holiday,Clear,0.8,0.7727,0.59,0.2985,142,218,360,360,568,360,1,4,4,144,2,729,183149,1,360
2011-06-12,summer,2011,June,16,Sunday,Holiday,Light Snow,0.68,0.6364,0.83,0.2836,115,235,350,350,568,350,1,4,4,144,2,730,227748,1,350
2011-06-12,summer,2011,June,17,Sunday,Holiday,Light Snow,0.68,0.6364,0.83,0.2836,94,158,252,252,568,252,1,3,4,134,2,730,336860,1,252
2011-06-12,summer,2011,June,18,Sunday,Holiday,Clear,0.7,0.6667,0.74,0.1642,69,187,256,256,568,256,1,3,4,134,0,728,309772,1,256
2011-06-12,summer,2011,June,19,Sunday,Holiday,Clear,0.7,0.6667,0.74,0.1045,67,156,223,223,568,223,1,3,4,134,0,728,226789,1,223
2011-06-12,summer,2011,June,20,Sunday,Holiday,Clear,0.66,0.6061,0.83,0.1642,62,144,206,206,568,206,1,3,3,133,0,728,164550,1,206
2011-06-12,summer,2011,June,21,Sunday,Holiday,Clear,0.66,0.6061,0.83,0.1045,39,101,140,140,568,140,1,2,3,123,0,728,125445,1,140
2011-06-12,summer,2011,June,22,Sunday,Holiday,Clear,0.64,0.5758,0.83,0.1343,31,97,128,128,568,128,1,2,3,123,0,728,95612,1,128
2011-06-12,summer,2011,June,23,Sunday,Holiday,Clear,0.64,0.5909,0.78,0.194,33,74,107,107,568,107,1,2,3,123,0,728,63941,1,107
2011-06-13,summer,2011,June,0,Monday,Workingday,Clear,0.64,0.5909,0.78,0.1343,8,20,28,28,567,28,1,1,3,113,0,726,39130,1,28
2011-06-13,summer,2011,June,1,Monday,Workingday,Clear,0.64,0.6061,0.73,0.2239,6,10,16,16,567,16,1,1,3,113,0,724,24164,1,16
2011-06-13,summer,2011,June,2,Monday,Workingday,Clear,0.62,0.5909,0.73,0.2836,2,8,10,10,567,10,1,1,3,113,0,715,16352,1,10
2011-06-13,summer,2011,June,3,Monday,Workingday,Clear,0.6,0.6061,0.6,0.4925,1,6,7,7,567,7,1,1,3,113,0,697,8174,1,7
2011-06-13,summer,2011,June,4,Monday,Workingday,Clear,0.56,0.5303,0.64,0.2985,1,3,4,4,567,4,1,1,3,113,0,697,4428,1,4
2011-06-13,summer,2011,June,5,Monday,Workingday,Clear,0.54,0.5152,0.64,0.3881,2,27,29,29,567,29,1,1,3,113,0,717,14261,1,29
2011-06-13,summer,2011,June,6,Monday,Workingday,Clear,0.54,0.5152,0.64,0.4179,7,98,105,105,567,105,1,2,3,123,0,725,55132,1,105
2011-06-13,summer,2011,June,7,Monday,Workingday,Clear,0.56,0.5303,0.56,0.3582,26,302,328,328,567,328,1,4,3,143,2,727,154171,1,328
2011-06-13,summer,2011,June,8,Monday,Workingday,Clear,0.58,0.5455,0.49,0.4478,44,432,476,476,567,476,1,4,3,143,2,727,261001,1,476
2011-06-13,summer,2011,June,9,Monday,Workingday,Clear,0.62,0.6212,0.46,0.3582,35,189,224,224,567,224,1,3,3,133,2,727,159438,1,224
2011-06-13,summer,2011,June,10,Monday,Workingday,Clear,0.64,0.6212,0.41,0.3284,38,80,118,118,567,118,1,2,3,123,2,727,126257,1,118
2011-06-13,summer,2011,June,11,Monday,Workingday,Clear,0.66,0.6212,0.41,0.2985,53,106,159,159,567,159,1,3,3,133,2,727,151320,1,159
2011-06-13,summer,2011,June,12,Monday,Workingday,Clear,0.66,0.6212,0.41,0.2836,35,161,196,196,567,196,1,3,3,133,2,728,184414,1,196
2011-06-13,summer,2011,June,13,Monday,Workingday,Clear,0.7,0.6364,0.37,0.0,53,174,227,227,567,227,1,3,4,134,2,729,184919,1,227
2011-06-13,summer,2011,June,14,Monday,Workingday,Clear,0.7,0.6364,0.34,0.2537,55,145,200,200,567,200,1,3,4,134,2,729,175652,1,200
2011-06-13,summer,2011,June,15,Monday,Workingday,Clear,0.7,0.6364,0.37,0.4478,58,127,185,185,567,185,1,3,4,134,2,729,183149,1,185
2011-06-13,summer,2011,June,16,Monday,Workingday,Clear,0.7,0.6364,0.37,0.4179,64,262,326,326,567,326,1,4,4,144,2,730,227748,1,326
2011-06-13,summer,2011,June,17,Monday,Workingday,Clear,0.7,0.6364,0.39,0.3284,72,529,601,601,567,601,1,4,4,144,2,730,336860,1,601
2011-06-13,summer,2011,June,18,Monday,Workingday,Clear,0.7,0.6364,0.37,0.3582,76,510,586,586,567,586,1,4,4,144,2,728,309772,1,586
2011-06-13,summer,2011,June,19,Monday,Workingday,Clear,0.66,0.6212,0.39,0.2836,75,348,423,423,567,423,1,4,3,143,2,728,226789,1,423
2011-06-13,summer,2011,June,20,Monday,Workingday,Clear,0.64,0.6212,0.44,0.2537,78,253,331,331,567,331,1,4,3,143,2,728,164550,1,331
2011-06-13,summer,2011,June,21,Monday,Workingday,Clear,0.64,0.6212,0.41,0.2537,40,178,218,218,567,218,1,3,3,133,2,728,125445,1,218
2011-06-13,summer,2011,June,22,Monday,Workingday,Clear,0.62,0.6212,0.46,0.2239,20,114,134,134,567,134,1,2,3,123,0,728,95612,1,134
2011-06-13,summer,2011,June,23,Monday,Workingday,Clear,0.62,0.6212,0.46,0.194,14,75,89,89,567,89,1,2,3,123,0,728,63941,1,89
2011-06-14,summer,2011,June,0,Tuesday,Workingday,Clear,0.6,0.6212,0.49,0.194,13,18,31,31,566,31,1,1,3,113,0,726,39130,1,31
2011-06-14,summer,2011,June,1,Tuesday,Workingday,Clear,0.6,0.6212,0.49,0.2537,3,10,13,13,566,13,1,1,3,113,0,724,24164,1,13
2011-06-14,summer,2011,June,2,Tuesday,Workingday,Clear,0.6,0.6212,0.49,0.2836,2,8,10,10,566,10,1,1,3,113,0,715,16352,1,10
2011-06-14,summer,2011,June,3,Tuesday,Workingday,Clear,0.58,0.5455,0.53,0.3284,1,1,2,2,566,2,1,1,3,113,0,697,8174,1,2
2011-06-14,summer,2011,June,4,Tuesday,Workingday,Clear,0.54,0.5152,0.6,0.2537,0,3,3,3,566,3,1,1,3,113,0,697,4428,1,3
2011-06-14,summer,2011,June,5,Tuesday,Workingday,Clear,0.54,0.5152,0.56,0.3284,3,23,26,26,566,26,1,1,3,113,0,717,14261,1,26
2011-06-14,summer,2011,June,6,Tuesday,Workingday,Clear,0.54,0.5152,0.56,0.2985,6,107,113,113,566,113,1,2,3,123,0,725,55132,1,113
2011-06-14,summer,2011,June,7,Tuesday,Workingday,Clear,0.56,0.5303,0.52,0.4179,19,346,365,365,566,365,1,4,3,143,2,727,154171,1,365
2011-06-14,summer,2011,June,8,Tuesday,Workingday,Clear,0.58,0.5455,0.49,0.3881,45,441,486,486,566,486,1,4,3,143,2,727,261001,1,486
2011-06-14,summer,2011,June,9,Tuesday,Workingday,Clear,0.62,0.6212,0.46,0.194,19,174,193,193,566,193,1,3,3,133,2,727,159438,1,193
2011-06-14,summer,2011,June,10,Tuesday,Workingday,Clear,0.62,0.6212,0.46,0.2239,33,97,130,130,566,130,1,2,3,123,2,727,126257,1,130
2011-06-14,summer,2011,June,11,Tuesday,Workingday,Clear,0.64,0.6212,0.41,0.2836,40,103,143,143,566,143,1,3,3,133,2,727,151320,1,143
2011-06-14,summer,2011,June,12,Tuesday,Workingday,Clear,0.64,0.6212,0.41,0.3582,30,139,169,169,566,169,1,3,3,133,2,728,184414,1,169
2011-06-14,summer,2011,June,13,Tuesday,Workingday,Clear,0.64,0.6212,0.44,0.2239,33,176,209,209,566,209,1,3,3,133,2,729,184919,1,209
2011-06-14,summer,2011,June,14,Tuesday,Workingday,Mist,0.64,0.6212,0.47,0.194,41,118,159,159,566,159,1,3,3,133,2,729,175652,1,159
2011-06-14,summer,2011,June,15,Tuesday,Workingday,Clear,0.64,0.6212,0.47,0.1642,42,136,178,178,566,178,1,3,3,133,2,729,183149,1,178
2011-06-14,summer,2011,June,16,Tuesday,Workingday,Clear,0.68,0.6364,0.41,0.194,51,279,330,330,566,330,1,4,4,144,2,730,227748,1,330
2011-06-14,summer,2011,June,17,Tuesday,Workingday,Light Snow,0.64,0.6212,0.5,0.2836,85,484,569,569,566,569,1,4,3,143,2,730,336860,1,569
2011-06-14,summer,2011,June,18,Tuesday,Workingday,Clear,0.62,0.6212,0.51,0.3284,65,473,538,538,566,538,1,4,3,143,2,728,309772,1,538
2011-06-14,summer,2011,June,19,Tuesday,Workingday,Clear,0.64,0.6212,0.5,0.3582,51,335,386,386,566,386,1,4,3,143,2,728,226789,1,386
2011-06-14,summer,2011,June,20,Tuesday,Workingday,Clear,0.6,0.6212,0.56,0.1642,60,237,297,297,566,297,1,4,3,143,2,728,164550,1,297
2011-06-14,summer,2011,June,21,Tuesday,Workingday,Clear,0.6,0.6212,0.56,0.2985,37,206,243,243,566,243,1,3,3,133,2,728,125445,1,243
2011-06-14,summer,2011,June,22,Tuesday,Workingday,Clear,0.58,0.5455,0.6,0.2239,29,159,188,188,566,188,1,3,3,133,0,728,95612,1,188
2011-06-14,summer,2011,June,23,Tuesday,Workingday,Clear,0.56,0.5303,0.68,0.2239,19,91,110,110,566,110,1,2,3,123,0,728,63941,1,110
2011-06-15,summer,2011,June,0,Wednesday,Workingday,Clear,0.56,0.5303,0.64,0.3582,8,44,52,52,565,52,1,2,3,123,0,726,39130,1,52
2011-06-15,summer,2011,June,1,Wednesday,Workingday,Clear,0.54,0.5152,0.64,0.2836,0,14,14,14,565,14,1,1,3,113,0,724,24164,1,14
2011-06-15,summer,2011,June,2,Wednesday,Workingday,Clear,0.52,0.5,0.63,0.2239,0,9,9,9,565,9,1,1,3,113,0,715,16352,1,9
2011-06-15,summer,2011,June,3,Wednesday,Workingday,Clear,0.5,0.4848,0.68,0.2537,0,1,1,1,565,1,1,1,2,112,0,697,8174,1,1
2011-06-15,summer,2011,June,4,Wednesday,Workingday,Clear,0.5,0.4848,0.63,0.2836,0,4,4,4,565,4,1,1,2,112,0,697,4428,1,4
2011-06-15,summer,2011,June,5,Wednesday,Workingday,Clear,0.48,0.4697,0.67,0.2836,1,20,21,21,565,21,1,1,2,112,0,717,14261,1,21
2011-06-15,summer,2011,June,6,Wednesday,Workingday,Clear,0.5,0.4848,0.63,0.2537,11,110,121,121,565,121,1,2,2,122,0,725,55132,1,121
2011-06-15,summer,2011,June,7,Wednesday,Workingday,Clear,0.54,0.5152,0.6,0.1343,22,348,370,370,565,370,1,4,3,143,0,727,154171,1,370
2011-06-15,summer,2011,June,8,Wednesday,Workingday,Clear,0.58,0.5455,0.53,0.1343,53,445,498,498,565,498,1,4,3,143,2,727,261001,1,498
2011-06-15,summer,2011,June,9,Wednesday,Workingday,Clear,0.6,0.6212,0.49,0.0,22,185,207,207,565,207,1,3,3,133,0,727,159438,1,207
2011-06-15,summer,2011,June,10,Wednesday,Workingday,Clear,0.64,0.6212,0.47,0.1642,27,108,135,135,565,135,1,2,3,123,0,727,126257,1,135
2011-06-15,summer,2011,June,11,Wednesday,Workingday,Clear,0.68,0.6364,0.36,0.0,49,115,164,164,565,164,1,3,4,134,2,727,151320,1,164
2011-06-15,summer,2011,June,12,Wednesday,Workingday,Clear,0.7,0.6364,0.34,0.2239,33,178,211,211,565,211,1,3,4,134,2,728,184414,1,211
2011-06-15,summer,2011,June,13,Wednesday,Workingday,Clear,0.74,0.6515,0.28,0.2836,43,146,189,189,565,189,1,3,4,134,2,729,184919,1,189
2011-06-15,summer,2011,June,14,Wednesday,Workingday,Clear,0.74,0.6515,0.28,0.0,50,128,178,178,565,178,1,3,4,134,2,729,175652,1,178
2011-06-15,summer,2011,June,15,Wednesday,Workingday,Clear,0.76,0.6667,0.27,0.0,33,131,164,164,565,164,1,3,4,134,2,729,183149,1,164
2011-06-15,summer,2011,June,16,Wednesday,Workingday,Clear,0.76,0.6667,0.27,0.1343,47,265,312,312,565,312,1,4,4,144,2,730,227748,1,312
2011-06-15,summer,2011,June,17,Wednesday,Workingday,Clear,0.74,0.6515,0.28,0.1045,83,555,638,638,565,638,1,4,4,144,2,730,336860,1,638
2011-06-15,summer,2011,June,18,Wednesday,Workingday,Clear,0.72,0.6515,0.32,0.1343,80,527,607,607,565,607,1,4,4,144,2,728,309772,1,607
2011-06-15,summer,2011,June,19,Wednesday,Workingday,Clear,0.7,0.6364,0.37,0.2836,54,362,416,416,565,416,1,4,4,144,2,728,226789,1,416
2011-06-15,summer,2011,June,20,Wednesday,Workingday,Clear,0.66,0.6212,0.44,0.1642,57,273,330,330,565,330,1,4,3,143,2,728,164550,1,330
2011-06-15,summer,2011,June,21,Wednesday,Workingday,Clear,0.64,0.6212,0.47,0.2239,48,209,257,257,565,257,1,3,3,133,2,728,125445,1,257
2011-06-15,summer,2011,June,22,Wednesday,Workingday,Clear,0.62,0.6212,0.5,0.1045,31,144,175,175,565,175,1,3,3,133,0,728,95612,1,175
2011-06-15,summer,2011,June,23,Wednesday,Workingday,Clear,0.62,0.6212,0.53,0.0,17,90,107,107,565,107,1,2,3,123,0,728,63941,1,107
2011-06-16,summer,2011,June,0,Thursday,Workingday,Clear,0.6,0.6212,0.56,0.1045,9,38,47,47,564,47,1,2,3,123,0,726,39130,1,47
2011-06-16,summer,2011,June,1,Thursday,Workingday,Clear,0.58,0.5455,0.6,0.0,4,13,17,17,564,17,1,1,3,113,0,724,24164,1,17
2011-06-16,summer,2011,June,2,Thursday,Workingday,Clear,0.6,0.6212,0.56,0.0896,1,4,5,5,564,5,1,1,3,113,0,715,16352,1,5
2011-06-16,summer,2011,June,3,Thursday,Workingday,Mist,0.56,0.5303,0.73,0.0896,0,4,4,4,564,4,1,1,3,113,0,697,8174,1,4
2011-06-16,summer,2011,June,4,Thursday,Workingday,Mist,0.56,0.5303,0.68,0.1045,0,6,6,6,564,6,1,1,3,113,0,697,4428,1,6
2011-06-16,summer,2011,June,5,Thursday,Workingday,Clear,0.6,0.6061,0.64,0.194,7,18,25,25,564,25,1,1,3,113,0,717,14261,1,25
2011-06-16,summer,2011,June,6,Thursday,Workingday,Light Snow,0.58,0.5455,0.73,0.1642,8,104,112,112,564,112,1,2,3,123,0,725,55132,1,112
2011-06-16,summer,2011,June,7,Thursday,Workingday,Light Snow,0.56,0.5303,0.78,0.1642,16,172,188,188,564,188,1,3,3,133,0,727,154171,1,188
2011-06-16,summer,2011,June,8,Thursday,Workingday,Mist,0.6,0.5909,0.69,0.1343,24,364,388,388,564,388,1,4,3,143,0,727,261001,1,388
2011-06-16,summer,2011,June,9,Thursday,Workingday,Mist,0.62,0.6061,0.65,0.194,29,232,261,261,564,261,1,3,3,133,0,727,159438,1,261
2011-06-16,summer,2011,June,10,Thursday,Workingday,Mist,0.66,0.6212,0.61,0.2537,18,103,121,121,564,121,1,2,3,123,0,727,126257,1,121
2011-06-16,summer,2011,June,11,Thursday,Workingday,Mist,0.68,0.6364,0.61,0.2985,33,117,150,150,564,150,1,3,4,134,0,727,151320,1,150
2011-06-16,summer,2011,June,12,Thursday,Workingday,Clear,0.72,0.6667,0.54,0.3881,41,165,206,206,564,206,1,3,4,134,2,728,184414,1,206
2011-06-16,summer,2011,June,13,Thursday,Workingday,Mist,0.72,0.6667,0.54,0.2537,37,114,151,151,564,151,1,3,4,134,2,729,184919,1,151
2011-06-16,summer,2011,June,14,Thursday,Workingday,Mist,0.72,0.6667,0.54,0.3284,39,114,153,153,564,153,1,3,4,134,2,729,175652,1,153
2011-06-16,summer,2011,June,15,Thursday,Workingday,Mist,0.7,0.6515,0.61,0.2985,32,127,159,159,564,159,1,3,4,134,0,729,183149,1,159
2011-06-16,summer,2011,June,16,Thursday,Workingday,Light Snow,0.66,0.6212,0.69,0.194,36,258,294,294,564,294,1,4,3,143,0,730,227748,1,294
2011-06-16,summer,2011,June,17,Thursday,Workingday,Mist,0.64,0.5909,0.78,0.1045,42,230,272,272,564,272,1,3,3,133,0,730,336860,1,272
2011-06-16,summer,2011,June,18,Thursday,Workingday,Clear,0.64,0.5758,0.83,0.2239,26,299,325,325,564,325,1,4,3,143,0,728,309772,1,325
2011-06-16,summer,2011,June,19,Thursday,Workingday,Clear,0.62,0.5758,0.83,0.2836,58,269,327,327,564,327,1,4,3,143,0,728,226789,1,327
2011-06-16,summer,2011,June,20,Thursday,Workingday,Clear,0.62,0.5758,0.83,0.3284,25,176,201,201,564,201,1,3,3,133,0,728,164550,1,201
2011-06-16,summer,2011,June,21,Thursday,Workingday,Light Snow,0.62,0.5758,0.83,0.2537,34,154,188,188,564,188,1,3,3,133,0,728,125445,1,188
2011-06-16,summer,2011,June,22,Thursday,Workingday,Light Snow,0.62,0.5758,0.83,0.2537,24,127,151,151,564,151,1,3,3,133,0,728,95612,1,151
2011-06-16,summer,2011,June,23,Thursday,Workingday,Light Snow,0.6,0.5606,0.83,0.2537,2,14,16,16,564,16,1,1,3,113,0,728,63941,1,16
2011-06-17,summer,2011,June,0,Friday,Workingday,Clear,0.56,0.5303,0.88,0.0896,3,21,24,24,563,24,1,1,3,113,0,726,39130,1,24
2011-06-17,summer,2011,June,1,Friday,Workingday,Clear,0.56,0.5303,0.94,0.1343,4,19,23,23,563,23,1,1,3,113,0,724,24164,1,23
2011-06-17,summer,2011,June,2,Friday,Workingday,Clear,0.56,0.5303,0.94,0.1045,2,11,13,13,563,13,1,1,3,113,0,715,16352,1,13
2011-06-17,summer,2011,June,3,Friday,Workingday,Clear,0.56,0.5303,0.94,0.1045,1,5,6,6,563,6,1,1,3,113,0,697,8174,1,6
2011-06-17,summer,2011,June,4,Friday,Workingday,Clear,0.54,0.5152,0.94,0.1343,1,5,6,6,563,6,1,1,3,113,0,697,4428,1,6
2011-06-17,summer,2011,June,5,Friday,Workingday,Clear,0.54,0.5152,1.0,0.0,1,12,13,13,563,13,1,1,3,113,0,717,14261,1,13
2011-06-17,summer,2011,June,6,Friday,Workingday,Clear,0.56,0.5303,0.94,0.0,8,89,97,97,563,97,1,2,3,123,0,725,55132,1,97
2011-06-17,summer,2011,June,7,Friday,Workingday,Clear,0.6,0.5606,0.83,0.0,25,225,250,250,563,250,1,3,3,133,0,727,154171,1,250
2011-06-17,summer,2011,June,8,Friday,Workingday,Mist,0.6,0.5606,0.83,0.0,28,426,454,454,563,454,1,4,3,143,0,727,261001,1,454
2011-06-17,summer,2011,June,9,Friday,Workingday,Clear,0.7,0.6515,0.58,0.194,28,196,224,224,563,224,1,3,4,134,2,727,159438,1,224
2011-06-17,summer,2011,June,10,Friday,Workingday,Clear,0.7,0.6515,0.58,0.194,44,126,170,170,563,170,1,3,4,134,0,727,126257,1,170
2011-06-17,summer,2011,June,11,Friday,Workingday,Clear,0.68,0.6364,0.69,0.2537,43,138,181,181,563,181,1,3,4,134,0,727,151320,1,181
2011-06-17,summer,2011,June,12,Friday,Workingday,Clear,0.7,0.6515,0.65,0.2537,49,194,243,243,563,243,1,3,4,134,2,728,184414,1,243
2011-06-17,summer,2011,June,13,Friday,Workingday,Clear,0.74,0.6818,0.62,0.2836,48,156,204,204,563,204,1,3,4,134,2,729,184919,1,204
2011-06-17,summer,2011,June,14,Friday,Workingday,Clear,0.76,0.697,0.52,0.194,73,142,215,215,563,215,1,3,4,134,2,729,175652,1,215
2011-06-17,summer,2011,June,15,Friday,Workingday,Clear,0.78,0.697,0.43,0.2239,62,181,243,243,563,243,1,3,4,134,2,729,183149,1,243
2011-06-17,summer,2011,June,16,Friday,Workingday,Clear,0.76,0.6818,0.45,0.1642,69,286,355,355,563,355,1,4,4,144,2,730,227748,1,355
2011-06-17,summer,2011,June,17,Friday,Workingday,Light Snow,0.76,0.6818,0.4,0.194,85,467,552,552,563,552,1,4,4,144,2,730,336860,1,552
2011-06-17,summer,2011,June,18,Friday,Workingday,Light Snow,0.76,0.6818,0.4,0.194,62,388,450,450,563,450,1,4,4,144,2,728,309772,1,450
2011-06-17,summer,2011,June,19,Friday,Workingday,Light Snow,0.64,0.5758,0.83,0.2537,53,275,328,328,563,328,1,4,3,143,0,728,226789,1,328
2011-06-17,summer,2011,June,20,Friday,Workingday,Clear,0.64,0.5909,0.78,0.1045,40,192,232,232,563,232,1,3,3,133,0,728,164550,1,232
2011-06-17,summer,2011,June,21,Friday,Workingday,Clear,0.64,0.5909,0.78,0.0896,49,159,208,208,563,208,1,3,3,133,0,728,125445,1,208
2011-06-17,summer,2011,June,22,Friday,Workingday,Clear,0.62,0.5606,0.88,0.1343,48,127,175,175,563,175,1,3,3,133,0,728,95612,1,175
2011-06-17,summer,2011,June,23,Friday,Workingday,Clear,0.62,0.5758,0.83,0.1343,37,141,178,178,563,178,1,3,3,133,0,728,63941,1,178
2011-06-18,summer,2011,June,0,Saturday,Holiday,Clear,0.62,0.5606,0.88,0.1343,21,83,104,104,562,104,1,2,3,123,0,726,39130,1,104
2011-06-18,summer,2011,June,1,Saturday,Holiday,Clear,0.62,0.5758,0.83,0.1045,15,80,95,95,562,95,1,2,3,123,0,724,24164,1,95
2011-06-18,summer,2011,June,2,Saturday,Holiday,Clear,0.6,0.5455,0.88,0.0,16,37,53,53,562,53,1,2,3,123,0,715,16352,1,53
2011-06-18,summer,2011,June,3,Saturday,Holiday,Clear,0.6,0.5455,0.88,0.0896,4,16,20,20,562,20,1,1,3,113,0,697,8174,1,20
2011-06-18,summer,2011,June,4,Saturday,Holiday,Clear,0.6,0.5455,0.88,0.0896,1,4,5,5,562,5,1,1,3,113,0,697,4428,1,5
2011-06-18,summer,2011,June,5,Saturday,Holiday,Clear,0.62,0.5758,0.83,0.0,1,6,7,7,562,7,1,1,3,113,0,717,14261,1,7
2011-06-18,summer,2011,June,6,Saturday,Holiday,Clear,0.62,0.5758,0.83,0.1045,9,18,27,27,562,27,1,1,3,113,0,725,55132,1,27
2011-06-18,summer,2011,June,7,Saturday,Holiday,Clear,0.64,0.5909,0.78,0.1343,12,45,57,57,562,57,1,2,3,123,0,727,154171,1,57
2011-06-18,summer,2011,June,8,Saturday,Holiday,Clear,0.66,0.6061,0.78,0.0896,28,103,131,131,562,131,1,2,3,123,0,727,261001,1,131
2011-06-18,summer,2011,June,9,Saturday,Holiday,Clear,0.7,0.6515,0.61,0.2239,62,156,218,218,562,218,1,3,4,134,2,727,159438,1,218
2011-06-18,summer,2011,June,10,Saturday,Holiday,Clear,0.72,0.6818,0.62,0.194,68,176,244,244,562,244,1,3,4,134,2,727,126257,1,244
2011-06-18,summer,2011,June,11,Saturday,Holiday,Clear,0.72,0.6818,0.62,0.1343,134,270,404,404,562,404,1,4,4,144,2,727,151320,1,404
2011-06-18,summer,2011,June,12,Saturday,Holiday,Clear,0.74,0.697,0.66,0.0896,162,258,420,420,562,420,1,4,4,144,2,728,184414,1,420
2011-06-18,summer,2011,June,13,Saturday,Holiday,Clear,0.76,0.697,0.55,0.0,135,192,327,327,562,327,1,4,4,144,2,729,184919,1,327
2011-06-18,summer,2011,June,14,Saturday,Holiday,Mist,0.8,0.7273,0.46,0.2836,138,196,334,334,562,334,1,4,4,144,2,729,175652,1,334
2011-06-18,summer,2011,June,15,Saturday,Holiday,Mist,0.82,0.7576,0.46,0.1343,153,214,367,367,562,367,1,4,4,144,2,729,183149,1,367
2011-06-18,summer,2011,June,16,Saturday,Holiday,Mist,0.76,0.697,0.52,0.2239,193,275,468,468,562,468,1,4,4,144,2,730,227748,1,468
2011-06-18,summer,2011,June,17,Saturday,Holiday,Mist,0.76,0.6818,0.48,0.1642,210,239,449,449,562,449,1,4,4,144,2,730,336860,1,449
2011-06-18,summer,2011,June,18,Saturday,Holiday,Mist,0.74,0.6818,0.55,0.194,118,263,381,381,562,381,1,4,4,144,2,728,309772,1,381
2011-06-18,summer,2011,June,19,Saturday,Holiday,Mist,0.74,0.6667,0.51,0.1045,99,227,326,326,562,326,1,4,4,144,2,728,226789,1,326
2011-06-18,summer,2011,June,20,Saturday,Holiday,Mist,0.72,0.6667,0.58,0.1343,61,127,188,188,562,188,1,3,4,134,2,728,164550,1,188
2011-06-18,summer,2011,June,21,Saturday,Holiday,Mist,0.72,0.6818,0.66,0.1045,58,125,183,183,562,183,1,3,4,134,0,728,125445,1,183
2011-06-18,summer,2011,June,22,Saturday,Holiday,Mist,0.72,0.6818,0.62,0.1343,56,105,161,161,562,161,1,3,4,134,0,728,95612,1,161
2011-06-18,summer,2011,June,23,Saturday,Holiday,Mist,0.72,0.6818,0.62,0.0,53,97,150,150,562,150,1,3,4,134,0,728,63941,1,150
2011-06-19,summer,2011,June,0,Sunday,Holiday,Clear,0.7,0.6515,0.65,0.0,18,71,89,89,561,89,1,2,4,124,0,726,39130,1,89
2011-06-19,summer,2011,June,1,Sunday,Holiday,Mist,0.7,0.6515,0.65,0.0896,17,59,76,76,561,76,1,2,4,124,0,724,24164,1,76
2011-06-19,summer,2011,June,2,Sunday,Holiday,Clear,0.68,0.6364,0.74,0.0896,13,59,72,72,561,72,1,2,4,124,0,715,16352,1,72
2011-06-19,summer,2011,June,3,Sunday,Holiday,Mist,0.66,0.6061,0.78,0.1343,14,16,30,30,561,30,1,1,3,113,0,697,8174,1,30
2011-06-19,summer,2011,June,4,Sunday,Holiday,Mist,0.66,0.6212,0.74,0.1343,7,10,17,17,561,17,1,1,3,113,0,697,4428,1,17
2011-06-19,summer,2011,June,5,Sunday,Holiday,Mist,0.66,0.6061,0.78,0.0,7,12,19,19,561,19,1,1,3,113,0,717,14261,1,19
2011-06-19,summer,2011,June,6,Sunday,Holiday,Mist,0.66,0.6061,0.78,0.1642,11,22,33,33,561,33,1,1,3,113,0,725,55132,1,33
2011-06-19,summer,2011,June,7,Sunday,Holiday,Mist,0.66,0.6061,0.78,0.1642,35,36,71,71,561,71,1,2,3,123,0,727,154171,1,71
2011-06-19,summer,2011,June,8,Sunday,Holiday,Light Snow,0.68,0.6364,0.74,0.1045,25,59,84,84,561,84,1,2,4,124,0,727,261001,1,84
2011-06-19,summer,2011,June,9,Sunday,Holiday,Mist,0.68,0.6364,0.74,0.1045,58,111,169,169,561,169,1,3,4,134,0,727,159438,1,169
2011-06-19,summer,2011,June,10,Sunday,Holiday,Mist,0.7,0.6515,0.61,0.1045,86,158,244,244,561,244,1,3,4,134,2,727,126257,1,244
2011-06-19,summer,2011,June,11,Sunday,Holiday,Mist,0.72,0.6667,0.58,0.0896,141,236,377,377,561,377,1,4,4,144,2,727,151320,1,377
2011-06-19,summer,2011,June,12,Sunday,Holiday,Mist,0.74,0.6818,0.55,0.0896,141,255,396,396,561,396,1,4,4,144,2,728,184414,1,396
2011-06-19,summer,2011,June,13,Sunday,Holiday,Mist,0.74,0.6667,0.51,0.0,149,214,363,363,561,363,1,4,4,144,2,729,184919,1,363
2011-06-19,summer,2011,June,14,Sunday,Holiday,Light Snow,0.74,0.6818,0.58,0.1045,124,193,317,317,561,317,1,4,4,144,2,729,175652,1,317
2011-06-19,summer,2011,June,15,Sunday,Holiday,Mist,0.74,0.6818,0.55,0.1045,146,216,362,362,561,362,1,4,4,144,2,729,183149,1,362
2011-06-19,summer,2011,June,16,Sunday,Holiday,Mist,0.76,0.6818,0.48,0.0,121,257,378,378,561,378,1,4,4,144,2,730,227748,1,378
2011-06-19,summer,2011,June,17,Sunday,Holiday,Clear,0.74,0.6667,0.51,0.0,159,238,397,397,561,397,1,4,4,144,2,730,336860,1,397
2011-06-19,summer,2011,June,18,Sunday,Holiday,Mist,0.74,0.6818,0.58,0.0896,78,218,296,296,561,296,1,4,4,144,2,728,309772,1,296
2011-06-19,summer,2011,June,19,Sunday,Holiday,Clear,0.72,0.6818,0.62,0.1343,94,217,311,311,561,311,1,4,4,144,2,728,226789,1,311
2011-06-19,summer,2011,June,20,Sunday,Holiday,Clear,0.7,0.6515,0.7,0.194,86,146,232,232,561,232,1,3,4,134,2,728,164550,1,232
2011-06-19,summer,2011,June,21,Sunday,Holiday,Clear,0.68,0.6364,0.79,0.1343,57,110,167,167,561,167,1,3,4,134,0,728,125445,1,167
2011-06-19,summer,2011,June,22,Sunday,Holiday,Clear,0.66,0.6061,0.78,0.2239,38,114,152,152,561,152,1,3,3,133,0,728,95612,1,152
2011-06-19,summer,2011,June,23,Sunday,Holiday,Clear,0.66,0.6061,0.78,0.194,14,78,92,92,561,92,1,2,3,123,0,728,63941,1,92
2011-06-20,summer,2011,June,0,Monday,Workingday,Clear,0.66,0.6061,0.83,0.1642,7,19,26,26,560,26,1,1,3,113,0,726,39130,1,26
2011-06-20,summer,2011,June,1,Monday,Workingday,Clear,0.64,0.5758,0.89,0.0896,9,3,12,12,560,12,1,1,3,113,0,724,24164,1,12
2011-06-20,summer,2011,June,2,Monday,Workingday,Clear,0.64,0.5758,0.89,0.0896,2,0,2,2,560,2,1,1,3,113,0,715,16352,1,2
2011-06-20,summer,2011,June,3,Monday,Workingday,Light Snow,0.64,0.5758,0.89,0.0,1,0,1,1,560,1,1,1,3,113,0,697,8174,1,1
2011-06-20,summer,2011,June,4,Monday,Workingday,Light Snow,0.62,0.5606,0.88,0.1642,1,2,3,3,560,3,1,1,3,113,0,697,4428,1,3
2011-06-20,summer,2011,June,5,Monday,Workingday,Light Snow,0.62,0.5758,0.83,0.1343,0,3,3,3,560,3,1,1,3,113,0,717,14261,1,3
2011-06-20,summer,2011,June,6,Monday,Workingday,Light Snow,0.6,0.5758,0.78,0.1343,1,25,26,26,560,26,1,1,3,113,0,725,55132,1,26
2011-06-20,summer,2011,June,7,Monday,Workingday,Light Snow,0.56,0.5303,0.88,0.194,0,46,46,46,560,46,1,2,3,123,0,727,154171,1,46
2011-06-20,summer,2011,June,8,Monday,Workingday,Light Snow,0.56,0.5303,0.83,0.194,12,209,221,221,560,221,1,3,3,133,0,727,261001,1,221
2011-06-20,summer,2011,June,9,Monday,Workingday,Mist,0.6,0.5758,0.78,0.2537,19,200,219,219,560,219,1,3,3,133,0,727,159438,1,219
2011-06-20,summer,2011,June,10,Monday,Workingday,Mist,0.6,0.5758,0.78,0.2537,33,58,91,91,560,91,1,2,3,123,0,727,126257,1,91
2011-06-20,summer,2011,June,11,Monday,Workingday,Mist,0.6,0.5758,0.78,0.1045,27,67,94,94,560,94,1,2,3,123,0,727,151320,1,94
2011-06-20,summer,2011,June,12,Monday,Workingday,Mist,0.62,0.6061,0.69,0.1045,33,129,162,162,560,162,1,3,3,133,0,728,184414,1,162
2011-06-20,summer,2011,June,13,Monday,Workingday,Clear,0.64,0.6061,0.65,0.1045,50,129,179,179,560,179,1,3,3,133,0,729,184919,1,179
2011-06-20,summer,2011,June,14,Monday,Workingday,Clear,0.66,0.6212,0.61,0.1045,45,130,175,175,560,175,1,3,3,133,0,729,175652,1,175
2011-06-20,summer,2011,June,15,Monday,Workingday,Clear,0.66,0.6212,0.61,0.1343,66,139,205,205,560,205,1,3,3,133,2,729,183149,1,205
2011-06-20,summer,2011,June,16,Monday,Workingday,Clear,0.7,0.6515,0.58,0.1642,61,238,299,299,560,299,1,4,4,144,2,730,227748,1,299
2011-06-20,summer,2011,June,17,Monday,Workingday,Clear,0.7,0.6515,0.54,0.0,81,484,565,565,560,565,1,4,4,144,2,730,336860,1,565
2011-06-20,summer,2011,June,18,Monday,Workingday,Clear,0.7,0.6515,0.61,0.2537,64,474,538,538,560,538,1,4,4,144,2,728,309772,1,538
2011-06-20,summer,2011,June,19,Monday,Workingday,Clear,0.66,0.6212,0.65,0.2239,62,369,431,431,560,431,1,4,3,143,2,728,226789,1,431
2011-06-20,summer,2011,June,20,Monday,Workingday,Clear,0.66,0.6212,0.69,0.2239,52,264,316,316,560,316,1,4,3,143,2,728,164550,1,316
2011-06-20,summer,2011,June,21,Monday,Workingday,Clear,0.64,0.6061,0.73,0.1642,39,167,206,206,560,206,1,3,3,133,0,728,125445,1,206
2011-06-20,summer,2011,June,22,Monday,Workingday,Mist,0.64,0.6061,0.73,0.2239,24,106,130,130,560,130,1,2,3,123,0,728,95612,1,130
2011-06-20,summer,2011,June,23,Monday,Workingday,Clear,0.62,0.5909,0.78,0.2537,10,50,60,60,560,60,1,2,3,123,0,728,63941,1,60
2011-06-21,fall,2011,June,0,Tuesday,Workingday,Clear,0.62,0.5909,0.78,0.1642,10,23,33,33,559,33,1,1,3,113,0,726,39130,1,33
2011-06-21,fall,2011,June,1,Tuesday,Workingday,Light Snow,0.62,0.5909,0.78,0.1642,2,12,14,14,559,14,1,1,3,113,0,724,24164,1,14
2011-06-21,fall,2011,June,2,Tuesday,Workingday,Light Snow,0.62,0.5758,0.83,0.1642,1,5,6,6,559,6,1,1,3,113,0,715,16352,1,6
2011-06-21,fall,2011,June,3,Tuesday,Workingday,Light Snow,0.62,0.5758,0.83,0.1642,0,2,2,2,559,2,1,1,3,113,0,697,8174,1,2
2011-06-21,fall,2011,June,4,Tuesday,Workingday,Mist,0.6,0.5455,0.88,0.1045,2,7,9,9,559,9,1,1,3,113,0,697,4428,1,9
2011-06-21,fall,2011,June,5,Tuesday,Workingday,Mist,0.6,0.5455,0.88,0.1343,3,22,25,25,559,25,1,1,3,113,0,717,14261,1,25
2011-06-21,fall,2011,June,6,Tuesday,Workingday,Mist,0.6,0.5455,0.88,0.1343,8,107,115,115,559,115,1,2,3,123,0,725,55132,1,115
2011-06-21,fall,2011,June,7,Tuesday,Workingday,Mist,0.6,0.5152,0.94,0.0,21,288,309,309,559,309,1,4,3,143,0,727,154171,1,309
2011-06-21,fall,2011,June,8,Tuesday,Workingday,Mist,0.62,0.5606,0.88,0.1045,33,368,401,401,559,401,1,4,3,143,0,727,261001,1,401
2011-06-21,fall,2011,June,9,Tuesday,Workingday,Mist,0.62,0.5606,0.88,0.2537,32,243,275,275,559,275,1,3,3,133,0,727,159438,1,275
2011-06-21,fall,2011,June,10,Tuesday,Workingday,Mist,0.64,0.5758,0.83,0.194,41,120,161,161,559,161,1,3,3,133,0,727,126257,1,161
2011-06-21,fall,2011,June,11,Tuesday,Workingday,Clear,0.66,0.6061,0.83,0.1642,52,119,171,171,559,171,1,3,3,133,0,727,151320,1,171
2011-06-21,fall,2011,June,12,Tuesday,Workingday,Clear,0.7,0.6667,0.74,0.1642,40,149,189,189,559,189,1,3,4,134,0,728,184414,1,189
2011-06-21,fall,2011,June,13,Tuesday,Workingday,Clear,0.74,0.697,0.66,0.1642,49,158,207,207,559,207,1,3,4,134,0,729,184919,1,207
2011-06-21,fall,2011,June,14,Tuesday,Workingday,Clear,0.76,0.7121,0.62,0.2239,44,108,152,152,559,152,1,3,4,134,2,729,175652,1,152
2011-06-21,fall,2011,June,15,Tuesday,Workingday,Clear,0.78,0.7424,0.59,0.2537,42,128,170,170,559,170,1,3,4,134,2,729,183149,1,170
2011-06-21,fall,2011,June,16,Tuesday,Workingday,Clear,0.8,0.7727,0.59,0.2239,62,273,335,335,559,335,1,4,4,144,2,730,227748,1,335
2011-06-21,fall,2011,June,17,Tuesday,Workingday,Clear,0.78,0.7576,0.66,0.2239,65,507,572,572,559,572,1,4,4,144,2,730,336860,1,572
2011-06-21,fall,2011,June,18,Tuesday,Workingday,Mist,0.76,0.7273,0.7,0.2537,67,469,536,536,559,536,1,4,4,144,2,728,309772,1,536
2011-06-21,fall,2011,June,19,Tuesday,Workingday,Mist,0.74,0.7121,0.74,0.2239,67,358,425,425,559,425,1,4,4,144,2,728,226789,1,425
2011-06-21,fall,2011,June,20,Tuesday,Workingday,Light Snow,0.74,0.697,0.7,0.2239,72,254,326,326,559,326,1,4,4,144,2,728,164550,1,326
2011-06-21,fall,2011,June,21,Tuesday,Workingday,Clear,0.72,0.697,0.74,0.194,38,191,229,229,559,229,1,3,4,134,0,728,125445,1,229
2011-06-21,fall,2011,June,22,Tuesday,Workingday,Clear,0.7,0.6667,0.79,0.1045,12,97,109,109,559,109,1,2,4,124,0,728,95612,1,109
2011-06-21,fall,2011,June,23,Tuesday,Workingday,Clear,0.7,0.6667,0.74,0.1045,11,53,64,64,559,64,1,2,4,124,0,728,63941,1,64
2011-06-22,fall,2011,June,0,Wednesday,Workingday,Clear,0.66,0.6061,0.78,0.194,15,18,33,33,558,33,1,1,3,113,0,726,39130,1,33
2011-06-22,fall,2011,June,1,Wednesday,Workingday,Clear,0.66,0.6061,0.78,0.1343,2,19,21,21,558,21,1,1,3,113,0,724,24164,1,21
2011-06-22,fall,2011,June,2,Wednesday,Workingday,Clear,0.66,0.6061,0.78,0.0,2,5,7,7,558,7,1,1,3,113,0,715,16352,1,7
2011-06-22,fall,2011,June,3,Wednesday,Workingday,Clear,0.66,0.6061,0.78,0.1343,0,7,7,7,558,7,1,1,3,113,0,697,8174,1,7
2011-06-22,fall,2011,June,4,Wednesday,Workingday,Clear,0.64,0.5758,0.83,0.0,3,8,11,11,558,11,1,1,3,113,0,697,4428,1,11
2011-06-22,fall,2011,June,5,Wednesday,Workingday,Clear,0.64,0.5758,0.89,0.0,2,21,23,23,558,23,1,1,3,113,0,717,14261,1,23
2011-06-22,fall,2011,June,6,Wednesday,Workingday,Clear,0.66,0.6061,0.83,0.0,12,110,122,122,558,122,1,2,3,123,0,725,55132,1,122
2011-06-22,fall,2011,June,7,Wednesday,Workingday,Clear,0.7,0.6667,0.79,0.0,23,288,311,311,558,311,1,4,4,144,0,727,154171,1,311
2011-06-22,fall,2011,June,8,Wednesday,Workingday,Clear,0.72,0.697,0.74,0.1045,27,396,423,423,558,423,1,4,4,144,2,727,261001,1,423
2011-06-22,fall,2011,June,9,Wednesday,Workingday,Clear,0.72,0.697,0.79,0.1642,14,205,219,219,558,219,1,3,4,134,0,727,159438,1,219
2011-06-22,fall,2011,June,10,Wednesday,Workingday,Clear,0.74,0.697,0.7,0.2537,31,104,135,135,558,135,1,2,4,124,0,727,126257,1,135
2011-06-22,fall,2011,June,11,Wednesday,Workingday,Clear,0.74,0.697,0.7,0.1642,37,108,145,145,558,145,1,3,4,134,0,727,151320,1,145
2011-06-22,fall,2011,June,12,Wednesday,Workingday,Mist,0.8,0.7727,0.59,0.2239,44,144,188,188,558,188,1,3,4,134,2,728,184414,1,188
2011-06-22,fall,2011,June,13,Wednesday,Workingday,Mist,0.82,0.7879,0.56,0.2537,34,113,147,147,558,147,1,3,4,134,2,729,184919,1,147
2011-06-22,fall,2011,June,14,Wednesday,Workingday,Mist,0.82,0.7727,0.52,0.2836,32,113,145,145,558,145,1,3,4,134,2,729,175652,1,145
2011-06-22,fall,2011,June,15,Wednesday,Workingday,Mist,0.82,0.7879,0.56,0.2836,32,114,146,146,558,146,1,3,4,134,2,729,183149,1,146
2011-06-22,fall,2011,June,16,Wednesday,Workingday,Mist,0.82,0.803,0.59,0.3284,34,224,258,258,558,258,1,3,4,134,2,730,227748,1,258
2011-06-22,fall,2011,June,17,Wednesday,Workingday,Mist,0.8,0.7576,0.55,0.3881,67,462,529,529,558,529,1,4,4,144,2,730,336860,1,529
2011-06-22,fall,2011,June,18,Wednesday,Workingday,Mist,0.8,0.7727,0.59,0.2537,66,447,513,513,558,513,1,4,4,144,2,728,309772,1,513
2011-06-22,fall,2011,June,19,Wednesday,Workingday,Mist,0.8,0.7424,0.52,0.2537,62,280,342,342,558,342,1,4,4,144,2,728,226789,1,342
2011-06-22,fall,2011,June,20,Wednesday,Workingday,Clear,0.74,0.7121,0.74,0.1343,52,230,282,282,558,282,1,4,4,144,0,728,164550,1,282
2011-06-22,fall,2011,June,21,Wednesday,Workingday,Clear,0.74,0.7121,0.79,0.1642,31,216,247,247,558,247,1,3,4,134,0,728,125445,1,247
2011-06-22,fall,2011,June,22,Wednesday,Workingday,Mist,0.72,0.697,0.79,0.194,25,123,148,148,558,148,1,3,4,134,0,728,95612,1,148
2011-06-22,fall,2011,June,23,Wednesday,Workingday,Mist,0.72,0.697,0.79,0.2239,14,91,105,105,558,105,1,2,4,124,0,728,63941,1,105
2011-06-23,fall,2011,June,0,Thursday,Workingday,Clear,0.72,0.697,0.79,0.2239,5,44,49,49,557,49,1,2,4,124,0,726,39130,1,49
2011-06-23,fall,2011,June,1,Thursday,Workingday,Clear,0.72,0.697,0.74,0.2239,5,26,31,31,557,31,1,1,4,114,0,724,24164,1,31
2011-06-23,fall,2011,June,2,Thursday,Workingday,Clear,0.72,0.697,0.74,0.2239,0,4,4,4,557,4,1,1,4,114,0,715,16352,1,4
2011-06-23,fall,2011,June,3,Thursday,Workingday,Mist,0.72,0.697,0.74,0.1642,1,4,5,5,557,5,1,1,4,114,0,697,8174,1,5
2011-06-23,fall,2011,June,4,Thursday,Workingday,Mist,0.7,0.6667,0.79,0.1343,0,7,7,7,557,7,1,1,4,114,0,697,4428,1,7
2011-06-23,fall,2011,June,5,Thursday,Workingday,Clear,0.72,0.697,0.74,0.1642,2,22,24,24,557,24,1,1,4,114,0,717,14261,1,24
2011-06-23,fall,2011,June,6,Thursday,Workingday,Clear,0.72,0.697,0.74,0.1642,8,92,100,100,557,100,1,2,4,124,0,725,55132,1,100
2011-06-23,fall,2011,June,7,Thursday,Workingday,Mist,0.72,0.697,0.74,0.1343,26,301,327,327,557,327,1,4,4,144,0,727,154171,1,327
2011-06-23,fall,2011,June,8,Thursday,Workingday,Mist,0.74,0.697,0.7,0.194,20,412,432,432,557,432,1,4,4,144,2,727,261001,1,432
2011-06-23,fall,2011,June,9,Thursday,Workingday,Mist,0.74,0.697,0.7,0.1343,33,194,227,227,557,227,1,3,4,134,0,727,159438,1,227
2011-06-23,fall,2011,June,10,Thursday,Workingday,Mist,0.76,0.7273,0.66,0.1343,39,88,127,127,557,127,1,2,4,124,0,727,126257,1,127
2011-06-23,fall,2011,June,11,Thursday,Workingday,Light Snow,0.76,0.7273,0.66,0.2537,28,108,136,136,557,136,1,2,4,124,0,727,151320,1,136
2011-06-23,fall,2011,June,12,Thursday,Workingday,Mist,0.76,0.7273,0.66,0.2836,30,130,160,160,557,160,1,3,4,134,0,728,184414,1,160
2011-06-23,fall,2011,June,13,Thursday,Workingday,Mist,0.76,0.7121,0.62,0.2836,37,149,186,186,557,186,1,3,4,134,2,729,184919,1,186
2011-06-23,fall,2011,June,14,Thursday,Workingday,Mist,0.76,0.7273,0.66,0.2985,46,103,149,149,557,149,1,3,4,134,2,729,175652,1,149
2011-06-23,fall,2011,June,15,Thursday,Workingday,Mist,0.76,0.697,0.52,0.3582,62,127,189,189,557,189,1,3,4,134,2,729,183149,1,189
2011-06-23,fall,2011,June,16,Thursday,Workingday,Mist,0.74,0.6818,0.62,0.2985,58,217,275,275,557,275,1,3,4,134,2,730,227748,1,275
2011-06-23,fall,2011,June,17,Thursday,Workingday,Mist,0.72,0.6818,0.7,0.3582,74,495,569,569,557,569,1,4,4,144,2,730,336860,1,569
2011-06-23,fall,2011,June,18,Thursday,Workingday,Clear,0.72,0.6818,0.7,0.4179,57,483,540,540,557,540,1,4,4,144,2,728,309772,1,540
2011-06-23,fall,2011,June,19,Thursday,Workingday,Clear,0.72,0.6818,0.7,0.3582,56,344,400,400,557,400,1,4,4,144,2,728,226789,1,400
2011-06-23,fall,2011,June,20,Thursday,Workingday,Clear,0.7,0.6667,0.74,0.2239,75,277,352,352,557,352,1,4,4,144,2,728,164550,1,352
2011-06-23,fall,2011,June,21,Thursday,Workingday,Clear,0.7,0.6667,0.74,0.194,46,188,234,234,557,234,1,3,4,134,0,728,125445,1,234
2011-06-23,fall,2011,June,22,Thursday,Workingday,Mist,0.7,0.6667,0.74,0.2239,23,139,162,162,557,162,1,3,4,134,0,728,95612,1,162
2011-06-23,fall,2011,June,23,Thursday,Workingday,Clear,0.7,0.6667,0.74,0.2836,15,90,105,105,557,105,1,2,4,124,0,728,63941,1,105
2011-06-24,fall,2011,June,0,Friday,Workingday,Clear,0.68,0.6364,0.79,0.194,10,53,63,63,556,63,1,2,4,124,0,726,39130,1,63
2011-06-24,fall,2011,June,1,Friday,Workingday,Clear,0.66,0.6061,0.83,0.3284,8,20,28,28,556,28,1,1,3,113,0,724,24164,1,28
2011-06-24,fall,2011,June,2,Friday,Workingday,Clear,0.66,0.6061,0.83,0.3284,4,10,14,14,556,14,1,1,3,113,0,715,16352,1,14
2011-06-24,fall,2011,June,3,Friday,Workingday,Clear,0.66,0.6061,0.83,0.1642,1,4,5,5,556,5,1,1,3,113,0,697,8174,1,5
2011-06-24,fall,2011,June,4,Friday,Workingday,Clear,0.66,0.6061,0.83,0.0896,1,8,9,9,556,9,1,1,3,113,0,697,4428,1,9
2011-06-24,fall,2011,June,5,Friday,Workingday,Clear,0.64,0.5758,0.89,0.0896,2,18,20,20,556,20,1,1,3,113,0,717,14261,1,20
2011-06-24,fall,2011,June,6,Friday,Workingday,Clear,0.66,0.6061,0.83,0.1343,4,87,91,91,556,91,1,2,3,123,0,725,55132,1,91
2011-06-24,fall,2011,June,7,Friday,Workingday,Mist,0.66,0.6061,0.83,0.2239,21,247,268,268,556,268,1,3,3,133,0,727,154171,1,268
2011-06-24,fall,2011,June,8,Friday,Workingday,Clear,0.7,0.6667,0.74,0.2239,27,439,466,466,556,466,1,4,4,144,2,727,261001,1,466
2011-06-24,fall,2011,June,9,Friday,Workingday,Clear,0.74,0.6818,0.62,0.1343,28,203,231,231,556,231,1,3,4,134,0,727,159438,1,231
2011-06-24,fall,2011,June,10,Friday,Workingday,Clear,0.8,0.7273,0.43,0.2836,43,102,145,145,556,145,1,3,4,134,2,727,126257,1,145
2011-06-24,fall,2011,June,11,Friday,Workingday,Clear,0.8,0.7121,0.38,0.3284,56,147,203,203,556,203,1,3,4,134,2,727,151320,1,203
2011-06-24,fall,2011,June,12,Friday,Workingday,Clear,0.8,0.7121,0.41,0.2836,51,150,201,201,556,201,1,3,4,134,2,728,184414,1,201
2011-06-24,fall,2011,June,13,Friday,Workingday,Clear,0.8,0.7121,0.36,0.2239,43,178,221,221,556,221,1,3,4,134,2,729,184919,1,221
2011-06-24,fall,2011,June,14,Friday,Workingday,Clear,0.78,0.697,0.43,0.2836,67,162,229,229,556,229,1,3,4,134,2,729,175652,1,229
2011-06-24,fall,2011,June,15,Friday,Workingday,Clear,0.82,0.7273,0.34,0.3881,69,147,216,216,556,216,1,3,4,134,2,729,183149,1,216
2011-06-24,fall,2011,June,16,Friday,Workingday,Clear,0.8,0.697,0.33,0.4179,80,247,327,327,556,327,1,4,4,144,2,730,227748,1,327
2011-06-24,fall,2011,June,17,Friday,Workingday,Clear,0.76,0.6667,0.37,0.2537,85,472,557,557,556,557,1,4,4,144,2,730,336860,1,557
2011-06-24,fall,2011,June,18,Friday,Workingday,Clear,0.76,0.6667,0.37,0.2985,87,365,452,452,556,452,1,4,4,144,2,728,309772,1,452
2011-06-24,fall,2011,June,19,Friday,Workingday,Clear,0.74,0.6515,0.4,0.2239,92,293,385,385,556,385,1,4,4,144,2,728,226789,1,385
2011-06-24,fall,2011,June,20,Friday,Workingday,Clear,0.72,0.6515,0.45,0.1642,66,222,288,288,556,288,1,4,4,144,2,728,164550,1,288
2011-06-24,fall,2011,June,21,Friday,Workingday,Clear,0.7,0.6515,0.48,0.1343,50,183,233,233,556,233,1,3,4,134,2,728,125445,1,233
2011-06-24,fall,2011,June,22,Friday,Workingday,Clear,0.7,0.6515,0.48,0.0,41,126,167,167,556,167,1,3,4,134,0,728,95612,1,167
2011-06-24,fall,2011,June,23,Friday,Workingday,Clear,0.68,0.6364,0.51,0.1343,33,139,172,172,556,172,1,3,4,134,0,728,63941,1,172
2011-06-25,fall,2011,June,0,Saturday,Holiday,Clear,0.68,0.6364,0.47,0.1642,19,97,116,116,555,116,1,2,4,124,0,726,39130,1,116
2011-06-25,fall,2011,June,1,Saturday,Holiday,Clear,0.66,0.6212,0.5,0.1642,20,75,95,95,555,95,1,2,3,123,0,724,24164,1,95
2011-06-25,fall,2011,June,2,Saturday,Holiday,Mist,0.66,0.6212,0.5,0.194,8,51,59,59,555,59,1,2,3,123,0,715,16352,1,59
2011-06-25,fall,2011,June,3,Saturday,Holiday,Clear,0.64,0.6212,0.57,0.194,18,21,39,39,555,39,1,1,3,113,0,697,8174,1,39
2011-06-25,fall,2011,June,4,Saturday,Holiday,Clear,0.64,0.6212,0.57,0.194,7,4,11,11,555,11,1,1,3,113,0,697,4428,1,11
2011-06-25,fall,2011,June,5,Saturday,Holiday,Clear,0.62,0.6061,0.61,0.1343,6,8,14,14,555,14,1,1,3,113,0,717,14261,1,14
2011-06-25,fall,2011,June,6,Saturday,Holiday,Clear,0.64,0.6212,0.57,0.2239,12,17,29,29,555,29,1,1,3,113,0,725,55132,1,29
2011-06-25,fall,2011,June,7,Saturday,Holiday,Clear,0.64,0.6212,0.57,0.2836,7,35,42,42,555,42,1,2,3,123,0,727,154171,1,42
2011-06-25,fall,2011,June,8,Saturday,Holiday,Clear,0.7,0.6515,0.48,0.2537,27,85,112,112,555,112,1,2,4,124,2,727,261001,1,112
2011-06-25,fall,2011,June,9,Saturday,Holiday,Clear,0.72,0.6515,0.45,0.2537,47,139,186,186,555,186,1,3,4,134,2,727,159438,1,186
2011-06-25,fall,2011,June,10,Saturday,Holiday,Clear,0.72,0.6515,0.45,0.194,99,203,302,302,555,302,1,4,4,144,2,727,126257,1,302
2011-06-25,fall,2011,June,11,Saturday,Holiday,Clear,0.74,0.6667,0.42,0.0,122,209,331,331,555,331,1,4,4,144,2,727,151320,1,331
2011-06-25,fall,2011,June,12,Saturday,Holiday,Clear,0.74,0.6515,0.4,0.2836,140,252,392,392,555,392,1,4,4,144,2,728,184414,1,392
2011-06-25,fall,2011,June,13,Saturday,Holiday,Clear,0.74,0.6515,0.4,0.2836,140,231,371,371,555,371,1,4,4,144,2,729,184919,1,371
2011-06-25,fall,2011,June,14,Saturday,Holiday,Clear,0.74,0.6667,0.45,0.2985,151,232,383,383,555,383,1,4,4,144,2,729,175652,1,383
2011-06-25,fall,2011,June,15,Saturday,Holiday,Clear,0.74,0.6667,0.45,0.0,157,235,392,392,555,392,1,4,4,144,2,729,183149,1,392
2011-06-25,fall,2011,June,16,Saturday,Holiday,Clear,0.76,0.6818,0.43,0.2985,175,235,410,410,555,410,1,4,4,144,2,730,227748,1,410
2011-06-25,fall,2011,June,17,Saturday,Holiday,Clear,0.74,0.6667,0.42,0.2239,152,247,399,399,555,399,1,4,4,144,2,730,336860,1,399
2011-06-25,fall,2011,June,18,Saturday,Holiday,Clear,0.72,0.6515,0.45,0.2537,108,199,307,307,555,307,1,4,4,144,2,728,309772,1,307
2011-06-25,fall,2011,June,19,Saturday,Holiday,Clear,0.72,0.6667,0.48,0.2836,121,254,375,375,555,375,1,4,4,144,2,728,226789,1,375
2011-06-25,fall,2011,June,20,Saturday,Holiday,Clear,0.7,0.6515,0.48,0.194,74,195,269,269,555,269,1,3,4,134,2,728,164550,1,269
2011-06-25,fall,2011,June,21,Saturday,Holiday,Clear,0.68,0.6364,0.51,0.1642,62,140,202,202,555,202,1,3,4,134,2,728,125445,1,202
2011-06-25,fall,2011,June,22,Saturday,Holiday,Clear,0.68,0.6364,0.47,0.194,61,126,187,187,555,187,1,3,4,134,2,728,95612,1,187
2011-06-25,fall,2011,June,23,Saturday,Holiday,Mist,0.66,0.6212,0.5,0.2985,49,130,179,179,555,179,1,3,3,133,2,728,63941,1,179
2011-06-26,fall,2011,June,0,Sunday,Holiday,Clear,0.64,0.6212,0.53,0.0,30,85,115,115,554,115,1,2,3,123,0,726,39130,1,115
2011-06-26,fall,2011,June,1,Sunday,Holiday,Clear,0.64,0.6212,0.53,0.1045,17,73,90,90,554,90,1,2,3,123,0,724,24164,1,90
2011-06-26,fall,2011,June,2,Sunday,Holiday,Clear,0.62,0.6212,0.57,0.1045,17,70,87,87,554,87,1,2,3,123,0,715,16352,1,87
2011-06-26,fall,2011,June,3,Sunday,Holiday,Clear,0.6,0.6061,0.64,0.1045,12,22,34,34,554,34,1,1,3,113,0,697,8174,1,34
2011-06-26,fall,2011,June,4,Sunday,Holiday,Clear,0.6,0.6061,0.64,0.0896,3,8,11,11,554,11,1,1,3,113,0,697,4428,1,11
2011-06-26,fall,2011,June,5,Sunday,Holiday,Clear,0.6,0.6061,0.64,0.0,3,9,12,12,554,12,1,1,3,113,0,717,14261,1,12
2011-06-26,fall,2011,June,6,Sunday,Holiday,Clear,0.6,0.6061,0.64,0.0,7,13,20,20,554,20,1,1,3,113,0,725,55132,1,20
2011-06-26,fall,2011,June,7,Sunday,Holiday,Clear,0.62,0.6061,0.61,0.0,24,27,51,51,554,51,1,2,3,123,0,727,154171,1,51
2011-06-26,fall,2011,June,8,Sunday,Holiday,Clear,0.64,0.6212,0.61,0.194,29,78,107,107,554,107,1,2,3,123,0,727,261001,1,107
2011-06-26,fall,2011,June,9,Sunday,Holiday,Clear,0.66,0.6212,0.54,0.0896,75,131,206,206,554,206,1,3,3,133,2,727,159438,1,206
2011-06-26,fall,2011,June,10,Sunday,Holiday,Clear,0.72,0.6667,0.48,0.1045,136,196,332,332,554,332,1,4,4,144,2,727,126257,1,332
2011-06-26,fall,2011,June,11,Sunday,Holiday,Clear,0.72,0.6515,0.45,0.1343,127,219,346,346,554,346,1,4,4,144,2,727,151320,1,346
2011-06-26,fall,2011,June,12,Sunday,Holiday,Clear,0.74,0.6515,0.4,0.1642,175,268,443,443,554,443,1,4,4,144,2,728,184414,1,443
2011-06-26,fall,2011,June,13,Sunday,Holiday,Clear,0.74,0.6515,0.4,0.0,197,245,442,442,554,442,1,4,4,144,2,729,184919,1,442
2011-06-26,fall,2011,June,14,Sunday,Holiday,Clear,0.74,0.6515,0.4,0.1343,197,246,443,443,554,443,1,4,4,144,2,729,175652,1,443
2011-06-26,fall,2011,June,15,Sunday,Holiday,Clear,0.74,0.6515,0.4,0.0,174,229,403,403,554,403,1,4,4,144,2,729,183149,1,403
2011-06-26,fall,2011,June,16,Sunday,Holiday,Clear,0.74,0.6667,0.42,0.194,177,278,455,455,554,455,1,4,4,144,2,730,227748,1,455
2011-06-26,fall,2011,June,17,Sunday,Holiday,Mist,0.72,0.6515,0.42,0.1642,178,243,421,421,554,421,1,4,4,144,2,730,336860,1,421
2011-06-26,fall,2011,June,18,Sunday,Holiday,Mist,0.72,0.6515,0.45,0.2537,117,265,382,382,554,382,1,4,4,144,2,728,309772,1,382
2011-06-26,fall,2011,June,19,Sunday,Holiday,Mist,0.72,0.6667,0.48,0.1343,89,228,317,317,554,317,1,4,4,144,2,728,226789,1,317
2011-06-26,fall,2011,June,20,Sunday,Holiday,Mist,0.7,0.6515,0.48,0.1045,55,158,213,213,554,213,1,3,4,134,2,728,164550,1,213
2011-06-26,fall,2011,June,21,Sunday,Holiday,Mist,0.7,0.6515,0.54,0.1045,48,135,183,183,554,183,1,3,4,134,2,728,125445,1,183
2011-06-26,fall,2011,June,22,Sunday,Holiday,Clear,0.7,0.6515,0.51,0.0,19,95,114,114,554,114,1,2,4,124,0,728,95612,1,114
2011-06-26,fall,2011,June,23,Sunday,Holiday,Clear,0.7,0.6515,0.54,0.0896,14,64,78,78,554,78,1,2,4,124,0,728,63941,1,78
2011-06-27,fall,2011,June,0,Monday,Workingday,Light Snow,0.64,0.6061,0.73,0.2836,7,25,32,32,553,32,1,1,3,113,0,726,39130,1,32
2011-06-27,fall,2011,June,1,Monday,Workingday,Mist,0.62,0.5909,0.78,0.1343,4,11,15,15,553,15,1,1,3,113,0,724,24164,1,15
2011-06-27,fall,2011,June,2,Monday,Workingday,Light Snow,0.62,0.5909,0.78,0.1343,3,3,6,6,553,6,1,1,3,113,0,715,16352,1,6
2011-06-27,fall,2011,June,3,Monday,Workingday,Light Snow,0.62,0.5909,0.78,0.1343,0,2,2,2,553,2,1,1,3,113,0,697,8174,1,2
2011-06-27,fall,2011,June,4,Monday,Workingday,Mist,0.6,0.5606,0.83,0.1642,1,8,9,9,553,9,1,1,3,113,0,697,4428,1,9
2011-06-27,fall,2011,June,5,Monday,Workingday,Mist,0.62,0.5758,0.83,0.1642,1,21,22,22,553,22,1,1,3,113,0,717,14261,1,22
2011-06-27,fall,2011,June,6,Monday,Workingday,Mist,0.62,0.5909,0.78,0.1642,4,90,94,94,553,94,1,2,3,123,0,725,55132,1,94
2011-06-27,fall,2011,June,7,Monday,Workingday,Mist,0.64,0.6061,0.73,0.2239,14,247,261,261,553,261,1,3,3,133,0,727,154171,1,261
2011-06-27,fall,2011,June,8,Monday,Workingday,Clear,0.66,0.6212,0.74,0.194,29,418,447,447,553,447,1,4,3,143,2,727,261001,1,447
2011-06-27,fall,2011,June,9,Monday,Workingday,Mist,0.72,0.6667,0.54,0.0,37,150,187,187,553,187,1,3,4,134,0,727,159438,1,187
2011-06-27,fall,2011,June,10,Monday,Workingday,Mist,0.72,0.6667,0.54,0.1343,55,95,150,150,553,150,1,3,4,134,2,727,126257,1,150
2011-06-27,fall,2011,June,11,Monday,Workingday,Mist,0.7,0.6515,0.58,0.0,55,95,150,150,553,150,1,3,4,134,0,727,151320,1,150
2011-06-27,fall,2011,June,12,Monday,Workingday,Mist,0.72,0.6667,0.54,0.0,40,130,170,170,553,170,1,3,4,134,0,728,184414,1,170
2011-06-27,fall,2011,June,13,Monday,Workingday,Mist,0.72,0.6667,0.58,0.2239,37,127,164,164,553,164,1,3,4,134,2,729,184919,1,164
2011-06-27,fall,2011,June,14,Monday,Workingday,Mist,0.72,0.6667,0.58,0.0896,58,100,158,158,553,158,1,3,4,134,0,729,175652,1,158
2011-06-27,fall,2011,June,15,Monday,Workingday,Mist,0.74,0.6818,0.55,0.0,76,126,202,202,553,202,1,3,4,134,2,729,183149,1,202
2011-06-27,fall,2011,June,16,Monday,Workingday,Clear,0.74,0.6818,0.55,0.1045,53,222,275,275,553,275,1,3,4,134,2,730,227748,1,275
2011-06-27,fall,2011,June,17,Monday,Workingday,Clear,0.74,0.6818,0.55,0.1343,90,514,604,604,553,604,1,4,4,144,2,730,336860,1,604
2011-06-27,fall,2011,June,18,Monday,Workingday,Clear,0.74,0.6667,0.51,0.0,79,512,591,591,553,591,1,4,4,144,2,728,309772,1,591
2011-06-27,fall,2011,June,19,Monday,Workingday,Clear,0.72,0.6818,0.62,0.194,56,340,396,396,553,396,1,4,4,144,2,728,226789,1,396
2011-06-27,fall,2011,June,20,Monday,Workingday,Clear,0.7,0.6515,0.65,0.1045,54,251,305,305,553,305,1,4,4,144,2,728,164550,1,305
2011-06-27,fall,2011,June,21,Monday,Workingday,Clear,0.7,0.6515,0.65,0.0,52,190,242,242,553,242,1,3,4,134,0,728,125445,1,242
2011-06-27,fall,2011,June,22,Monday,Workingday,Clear,0.68,0.6364,0.69,0.0,33,112,145,145,553,145,1,3,4,134,0,728,95612,1,145
2011-06-27,fall,2011,June,23,Monday,Workingday,Clear,0.68,0.6364,0.69,0.0,16,65,81,81,553,81,1,2,4,124,0,728,63941,1,81
2011-06-28,fall,2011,June,0,Tuesday,Workingday,Mist,0.66,0.6061,0.78,0.1343,5,25,30,30,552,30,1,1,3,113,0,726,39130,1,30
2011-06-28,fall,2011,June,1,Tuesday,Workingday,Clear,0.66,0.6212,0.74,0.0,5,8,13,13,552,13,1,1,3,113,0,724,24164,1,13
2011-06-28,fall,2011,June,2,Tuesday,Workingday,Mist,0.66,0.6212,0.74,0.0,2,9,11,11,552,11,1,1,3,113,0,715,16352,1,11
2011-06-28,fall,2011,June,3,Tuesday,Workingday,Mist,0.66,0.6212,0.74,0.0,0,2,2,2,552,2,1,1,3,113,0,697,8174,1,2
2011-06-28,fall,2011,June,4,Tuesday,Workingday,Clear,0.66,0.6212,0.74,0.0,1,7,8,8,552,8,1,1,3,113,0,697,4428,1,8
2011-06-28,fall,2011,June,5,Tuesday,Workingday,Clear,0.66,0.6061,0.78,0.0,1,20,21,21,552,21,1,1,3,113,0,717,14261,1,21
2011-06-28,fall,2011,June,6,Tuesday,Workingday,Clear,0.66,0.6061,0.83,0.1642,7,117,124,124,552,124,1,2,3,123,0,725,55132,1,124
2011-06-28,fall,2011,June,7,Tuesday,Workingday,Clear,0.68,0.6364,0.83,0.194,27,320,347,347,552,347,1,4,4,144,0,727,154171,1,347
2011-06-28,fall,2011,June,8,Tuesday,Workingday,Clear,0.7,0.6667,0.79,0.1642,39,417,456,456,552,456,1,4,4,144,2,727,261001,1,456
2011-06-28,fall,2011,June,9,Tuesday,Workingday,Clear,0.74,0.697,0.7,0.0,38,208,246,246,552,246,1,3,4,134,0,727,159438,1,246
2011-06-28,fall,2011,June,10,Tuesday,Workingday,Clear,0.8,0.7424,0.49,0.1642,45,112,157,157,552,157,1,3,4,134,2,727,126257,1,157
2011-06-28,fall,2011,June,11,Tuesday,Workingday,Clear,0.82,0.7576,0.46,0.0,49,118,167,167,552,167,1,3,4,134,2,727,151320,1,167
2011-06-28,fall,2011,June,12,Tuesday,Workingday,Clear,0.84,0.7727,0.47,0.2239,41,161,202,202,552,202,1,3,4,134,2,728,184414,1,202
2011-06-28,fall,2011,June,13,Tuesday,Workingday,Clear,0.84,0.7576,0.44,0.0,33,156,189,189,552,189,1,3,4,134,2,729,184919,1,189
2011-06-28,fall,2011,June,14,Tuesday,Workingday,Clear,0.86,0.7879,0.44,0.2239,43,117,160,160,552,160,1,3,4,134,2,729,175652,1,160
2011-06-28,fall,2011,June,15,Tuesday,Workingday,Clear,0.86,0.7879,0.41,0.0,39,127,166,166,552,166,1,3,4,134,2,729,183149,1,166
2011-06-28,fall,2011,June,16,Tuesday,Workingday,Clear,0.86,0.803,0.47,0.2836,41,220,261,261,552,261,1,3,4,134,2,730,227748,1,261
2011-06-28,fall,2011,June,17,Tuesday,Workingday,Light Snow,0.82,0.7879,0.56,0.2836,70,509,579,579,552,579,1,4,4,144,2,730,336860,1,579
2011-06-28,fall,2011,June,18,Tuesday,Workingday,Light Snow,0.8,0.7576,0.55,0.2985,68,436,504,504,552,504,1,4,4,144,2,728,309772,1,504
2011-06-28,fall,2011,June,19,Tuesday,Workingday,Mist,0.74,0.6818,0.58,0.4627,44,255,299,299,552,299,1,4,4,144,2,728,226789,1,299
2011-06-28,fall,2011,June,20,Tuesday,Workingday,Clear,0.74,0.6818,0.62,0.0,50,246,296,296,552,296,1,4,4,144,2,728,164550,1,296
2011-06-28,fall,2011,June,21,Tuesday,Workingday,Clear,0.74,0.697,0.66,0.2836,31,164,195,195,552,195,1,3,4,134,2,728,125445,1,195
2011-06-28,fall,2011,June,22,Tuesday,Workingday,Clear,0.7,0.6515,0.7,0.2985,30,104,134,134,552,134,1,2,4,124,0,728,95612,1,134
2011-06-28,fall,2011,June,23,Tuesday,Workingday,Clear,0.7,0.6515,0.7,0.2836,23,58,81,81,552,81,1,2,4,124,0,728,63941,1,81
2011-06-29,fall,2011,June,0,Wednesday,Workingday,Mist,0.68,0.6364,0.79,0.2836,11,25,36,36,551,36,1,1,4,114,0,726,39130,1,36
2011-06-29,fall,2011,June,1,Wednesday,Workingday,Clear,0.68,0.6364,0.79,0.2985,10,18,28,28,551,28,1,1,4,114,0,724,24164,1,28
2011-06-29,fall,2011,June,2,Wednesday,Workingday,Clear,0.66,0.6061,0.83,0.2239,7,9,16,16,551,16,1,1,3,113,0,715,16352,1,16
2011-06-29,fall,2011,June,3,Wednesday,Workingday,Mist,0.66,0.6061,0.83,0.1045,2,3,5,5,551,5,1,1,3,113,0,697,8174,1,5
2011-06-29,fall,2011,June,4,Wednesday,Workingday,Clear,0.66,0.6061,0.83,0.1045,0,5,5,5,551,5,1,1,3,113,0,697,4428,1,5
2011-06-29,fall,2011,June,5,Wednesday,Workingday,Clear,0.64,0.5758,0.83,0.194,3,19,22,22,551,22,1,1,3,113,0,717,14261,1,22
2011-06-29,fall,2011,June,6,Wednesday,Workingday,Clear,0.66,0.6212,0.69,0.2985,12,104,116,116,551,116,1,2,3,123,0,725,55132,1,116
2011-06-29,fall,2011,June,7,Wednesday,Workingday,Clear,0.7,0.6515,0.54,0.2239,18,318,336,336,551,336,1,4,4,144,2,727,154171,1,336
2011-06-29,fall,2011,June,8,Wednesday,Workingday,Clear,0.7,0.6515,0.48,0.2836,41,499,540,540,551,540,1,4,4,144,2,727,261001,1,540
2011-06-29,fall,2011,June,9,Wednesday,Workingday,Clear,0.72,0.6515,0.45,0.3881,32,189,221,221,551,221,1,3,4,134,2,727,159438,1,221
2011-06-29,fall,2011,June,10,Wednesday,Workingday,Clear,0.74,0.6667,0.42,0.2836,31,95,126,126,551,126,1,2,4,124,2,727,126257,1,126
2011-06-29,fall,2011,June,11,Wednesday,Workingday,Clear,0.76,0.6667,0.35,0.2239,53,117,170,170,551,170,1,3,4,134,2,727,151320,1,170
2011-06-29,fall,2011,June,12,Wednesday,Workingday,Clear,0.76,0.6667,0.35,0.2537,55,188,243,243,551,243,1,3,4,134,2,728,184414,1,243
2011-06-29,fall,2011,June,13,Wednesday,Workingday,Clear,0.8,0.697,0.31,0.3284,45,186,231,231,551,231,1,3,4,134,2,729,184919,1,231
2011-06-29,fall,2011,June,14,Wednesday,Workingday,Clear,0.8,0.697,0.31,0.194,50,138,188,188,551,188,1,3,4,134,2,729,175652,1,188
2011-06-29,fall,2011,June,15,Wednesday,Workingday,Clear,0.82,0.7121,0.3,0.1642,43,146,189,189,551,189,1,3,4,134,2,729,183149,1,189
2011-06-29,fall,2011,June,16,Wednesday,Workingday,Clear,0.82,0.7121,0.3,0.4179,60,268,328,328,551,328,1,4,4,144,2,730,227748,1,328
2011-06-29,fall,2011,June,17,Wednesday,Workingday,Clear,0.82,0.7121,0.26,0.4179,78,492,570,570,551,570,1,4,4,144,2,730,336860,1,570
2011-06-29,fall,2011,June,18,Wednesday,Workingday,Clear,0.8,0.697,0.29,0.2985,78,510,588,588,551,588,1,4,4,144,2,728,309772,1,588
2011-06-29,fall,2011,June,19,Wednesday,Workingday,Clear,0.76,0.6667,0.35,0.3881,60,341,401,401,551,401,1,4,4,144,2,728,226789,1,401
2011-06-29,fall,2011,June,20,Wednesday,Workingday,Clear,0.74,0.6515,0.37,0.2985,69,264,333,333,551,333,1,4,4,144,2,728,164550,1,333
2011-06-29,fall,2011,June,21,Wednesday,Workingday,Clear,0.72,0.6515,0.39,0.2239,26,195,221,221,551,221,1,3,4,134,2,728,125445,1,221
2011-06-29,fall,2011,June,22,Wednesday,Workingday,Clear,0.7,0.6364,0.42,0.194,32,151,183,183,551,183,1,3,4,134,2,728,95612,1,183
2011-06-29,fall,2011,June,23,Wednesday,Workingday,Clear,0.68,0.6364,0.47,0.194,32,97,129,129,551,129,1,2,4,124,2,728,63941,1,129
2011-06-30,fall,2011,June,0,Thursday,Workingday,Clear,0.66,0.6212,0.5,0.1642,15,39,54,54,550,54,1,2,3,123,0,726,39130,1,54
2011-06-30,fall,2011,June,1,Thursday,Workingday,Clear,0.64,0.6212,0.53,0.1343,13,19,32,32,550,32,1,1,3,113,0,724,24164,1,32
2011-06-30,fall,2011,June,2,Thursday,Workingday,Clear,0.62,0.6212,0.57,0.1343,2,6,8,8,550,8,1,1,3,113,0,715,16352,1,8
2011-06-30,fall,2011,June,3,Thursday,Workingday,Clear,0.6,0.6061,0.6,0.1642,2,7,9,9,550,9,1,1,3,113,0,697,8174,1,9
2011-06-30,fall,2011,June,4,Thursday,Workingday,Clear,0.58,0.5455,0.64,0.1343,2,4,6,6,550,6,1,1,3,113,0,697,4428,1,6
2011-06-30,fall,2011,June,5,Thursday,Workingday,Clear,0.58,0.5455,0.64,0.2537,1,24,25,25,550,25,1,1,3,113,0,717,14261,1,25
2011-06-30,fall,2011,June,6,Thursday,Workingday,Clear,0.6,0.6061,0.64,0.2537,4,119,123,123,550,123,1,2,3,123,0,725,55132,1,123
2011-06-30,fall,2011,June,7,Thursday,Workingday,Clear,0.62,0.6061,0.61,0.2239,29,291,320,320,550,320,1,4,3,143,2,727,154171,1,320
2011-06-30,fall,2011,June,8,Thursday,Workingday,Clear,0.68,0.6364,0.47,0.2239,44,511,555,555,550,555,1,4,4,144,2,727,261001,1,555
2011-06-30,fall,2011,June,9,Thursday,Workingday,Clear,0.7,0.6364,0.42,0.2239,33,227,260,260,550,260,1,3,4,134,2,727,159438,1,260
2011-06-30,fall,2011,June,10,Thursday,Workingday,Clear,0.72,0.6515,0.42,0.194,35,97,132,132,550,132,1,2,4,124,2,727,126257,1,132
2011-06-30,fall,2011,June,11,Thursday,Workingday,Clear,0.74,0.6515,0.37,0.1343,47,122,169,169,550,169,1,3,4,134,2,727,151320,1,169
2011-06-30,fall,2011,June,12,Thursday,Workingday,Clear,0.76,0.6667,0.35,0.1642,50,183,233,233,550,233,1,3,4,134,2,728,184414,1,233
2011-06-30,fall,2011,June,13,Thursday,Workingday,Clear,0.76,0.6667,0.33,0.194,70,162,232,232,550,232,1,3,4,134,2,729,184919,1,232
2011-06-30,fall,2011,June,14,Thursday,Workingday,Clear,0.78,0.6818,0.31,0.194,46,117,163,163,550,163,1,3,4,134,2,729,175652,1,163
2011-06-30,fall,2011,June,15,Thursday,Workingday,Clear,0.78,0.6667,0.25,0.2537,64,176,240,240,550,240,1,3,4,134,2,729,183149,1,240
2011-06-30,fall,2011,June,16,Thursday,Workingday,Clear,0.8,0.697,0.26,0.1343,63,260,323,323,550,323,1,4,4,144,2,730,227748,1,323
2011-06-30,fall,2011,June,17,Thursday,Workingday,Clear,0.78,0.6818,0.27,0.3582,98,496,594,594,550,594,1,4,4,144,2,730,336860,1,594
2011-06-30,fall,2011,June,18,Thursday,Workingday,Clear,0.76,0.6667,0.29,0.2537,114,472,586,586,550,586,1,4,4,144,2,728,309772,1,586
2011-06-30,fall,2011,June,19,Thursday,Workingday,Clear,0.74,0.6515,0.33,0.194,89,366,455,455,550,455,1,4,4,144,2,728,226789,1,455
2011-06-30,fall,2011,June,20,Thursday,Workingday,Clear,0.74,0.6515,0.33,0.194,55,285,340,340,550,340,1,4,4,144,2,728,164550,1,340
2011-06-30,fall,2011,June,21,Thursday,Workingday,Clear,0.72,0.6515,0.37,0.1045,81,242,323,323,550,323,1,4,4,144,2,728,125445,1,323
2011-06-30,fall,2011,June,22,Thursday,Workingday,Clear,0.7,0.6364,0.42,0.1642,43,164,207,207,550,207,1,3,4,134,2,728,95612,1,207
2011-06-30,fall,2011,June,23,Thursday,Workingday,Clear,0.66,0.6212,0.5,0.0,27,99,126,126,550,126,1,2,3,123,0,728,63941,1,126
2011-07-01,fall,2011,July,0,Friday,Workingday,Clear,0.66,0.6212,0.5,0.0,20,48,68,68,549,68,1,2,3,123,0,726,39130,1,68
2011-07-01,fall,2011,July,1,Friday,Workingday,Clear,0.66,0.6212,0.5,0.0,15,16,31,31,549,31,1,1,3,113,0,724,24164,1,31
2011-07-01,fall,2011,July,2,Friday,Workingday,Clear,0.62,0.6061,0.69,0.0,6,7,13,13,549,13,1,1,3,113,0,715,16352,1,13
2011-07-01,fall,2011,July,3,Friday,Workingday,Clear,0.64,0.6212,0.53,0.0,5,6,11,11,549,11,1,1,3,113,0,697,8174,1,11
2011-07-01,fall,2011,July,4,Friday,Workingday,Clear,0.62,0.6212,0.57,0.0,1,5,6,6,549,6,1,1,3,113,0,697,4428,1,6
2011-07-01,fall,2011,July,5,Friday,Workingday,Clear,0.6,0.6061,0.64,0.1343,3,27,30,30,549,30,1,1,3,113,0,717,14261,1,30
2011-07-01,fall,2011,July,6,Friday,Workingday,Clear,0.62,0.6061,0.61,0.1343,11,97,108,108,549,108,1,2,3,123,0,725,55132,1,108
2011-07-01,fall,2011,July,7,Friday,Workingday,Clear,0.66,0.6212,0.54,0.1045,25,218,243,243,549,243,1,3,3,133,0,727,154171,1,243
2011-07-01,fall,2011,July,8,Friday,Workingday,Clear,0.7,0.6364,0.42,0.1642,39,453,492,492,549,492,1,4,4,144,2,727,261001,1,492
2011-07-01,fall,2011,July,9,Friday,Workingday,Clear,0.74,0.6515,0.35,0.1642,58,202,260,260,549,260,1,3,4,134,2,727,159438,1,260
2011-07-01,fall,2011,July,10,Friday,Workingday,Clear,0.76,0.6667,0.33,0.1642,61,109,170,170,549,170,1,3,4,134,2,727,126257,1,170
2011-07-01,fall,2011,July,11,Friday,Workingday,Clear,0.8,0.697,0.26,0.0,68,146,214,214,549,214,1,3,4,134,2,727,151320,1,214
2011-07-01,fall,2011,July,12,Friday,Workingday,Clear,0.8,0.697,0.26,0.0,83,180,263,263,549,263,1,3,4,134,2,728,184414,1,263
2011-07-01,fall,2011,July,13,Friday,Workingday,Clear,0.8,0.6818,0.24,0.0,83,209,292,292,549,292,1,4,4,144,2,729,184919,1,292
2011-07-01,fall,2011,July,14,Friday,Workingday,Clear,0.82,0.697,0.23,0.194,78,225,303,303,549,303,1,4,4,144,2,729,175652,1,303
2011-07-01,fall,2011,July,15,Friday,Workingday,Clear,0.82,0.697,0.21,0.2537,82,299,381,381,549,381,1,4,4,144,2,729,183149,1,381
2011-07-01,fall,2011,July,16,Friday,Workingday,Clear,0.82,0.697,0.17,0.0,85,342,427,427,549,427,1,4,4,144,2,730,227748,1,427
2011-07-01,fall,2011,July,17,Friday,Workingday,Clear,0.82,0.697,0.21,0.194,99,362,461,461,549,461,1,4,4,144,2,730,336860,1,461
2011-07-01,fall,2011,July,18,Friday,Workingday,Clear,0.8,0.6818,0.24,0.2537,98,324,422,422,549,422,1,4,4,144,2,728,309772,1,422
2011-07-01,fall,2011,July,19,Friday,Workingday,Clear,0.78,0.6667,0.25,0.194,80,238,318,318,549,318,1,4,4,144,2,728,226789,1,318
2011-07-01,fall,2011,July,20,Friday,Workingday,Clear,0.72,0.6515,0.42,0.2239,84,185,269,269,549,269,1,3,4,134,2,728,164550,1,269
2011-07-01,fall,2011,July,21,Friday,Workingday,Clear,0.7,0.6364,0.45,0.194,69,149,218,218,549,218,1,3,4,134,2,728,125445,1,218
2011-07-01,fall,2011,July,22,Friday,Workingday,Clear,0.7,0.6364,0.42,0.0,49,173,222,222,549,222,1,3,4,134,2,728,95612,1,222
2011-07-01,fall,2011,July,23,Friday,Workingday,Clear,0.68,0.6364,0.47,0.0896,44,96,140,140,549,140,1,2,4,124,0,728,63941,1,140
2011-07-02,fall,2011,July,0,Saturday,Holiday,Clear,0.68,0.6364,0.47,0.0896,31,84,115,115,548,115,1,2,4,124,0,726,39130,1,115
2011-07-02,fall,2011,July,1,Saturday,Holiday,Clear,0.66,0.6212,0.54,0.0,20,58,78,78,548,78,1,2,3,123,0,724,24164,1,78
2011-07-02,fall,2011,July,2,Saturday,Holiday,Clear,0.64,0.6212,0.53,0.0,9,43,52,52,548,52,1,2,3,123,0,715,16352,1,52
2011-07-02,fall,2011,July,3,Saturday,Holiday,Clear,0.64,0.6212,0.53,0.0,5,21,26,26,548,26,1,1,3,113,0,697,8174,1,26
2011-07-02,fall,2011,July,4,Saturday,Holiday,Clear,0.62,0.6061,0.61,0.0,3,8,11,11,548,11,1,1,3,113,0,697,4428,1,11
2011-07-02,fall,2011,July,5,Saturday,Holiday,Clear,0.58,0.5455,0.73,0.1045,1,13,14,14,548,14,1,1,3,113,0,717,14261,1,14
2011-07-02,fall,2011,July,6,Saturday,Holiday,Clear,0.62,0.6061,0.69,0.1045,11,21,32,32,548,32,1,1,3,113,0,725,55132,1,32
2011-07-02,fall,2011,July,7,Saturday,Holiday,Clear,0.64,0.6061,0.65,0.0,10,35,45,45,548,45,1,2,3,123,0,727,154171,1,45
2011-07-02,fall,2011,July,8,Saturday,Holiday,Clear,0.68,0.6364,0.57,0.0,38,94,132,132,548,132,1,2,4,124,0,727,261001,1,132
2011-07-02,fall,2011,July,9,Saturday,Holiday,Clear,0.74,0.6667,0.51,0.0896,55,124,179,179,548,179,1,3,4,134,2,727,159438,1,179
2011-07-02,fall,2011,July,10,Saturday,Holiday,Clear,0.8,0.7121,0.36,0.0,103,168,271,271,548,271,1,3,4,134,2,727,126257,1,271
2011-07-02,fall,2011,July,11,Saturday,Holiday,Clear,0.8,0.7121,0.36,0.0896,144,213,357,357,548,357,1,4,4,144,2,727,151320,1,357
2011-07-02,fall,2011,July,12,Saturday,Holiday,Clear,0.82,0.7121,0.3,0.1343,142,232,374,374,548,374,1,4,4,144,2,728,184414,1,374
2011-07-02,fall,2011,July,13,Saturday,Holiday,Clear,0.82,0.7121,0.3,0.1045,178,226,404,404,548,404,1,4,4,144,2,729,184919,1,404
2011-07-02,fall,2011,July,14,Saturday,Holiday,Clear,0.84,0.7121,0.2,0.0,177,215,392,392,548,392,1,4,4,144,2,729,175652,1,392
2011-07-02,fall,2011,July,15,Saturday,Holiday,Clear,0.86,0.7273,0.19,0.1642,168,163,331,331,548,331,1,4,4,144,2,729,183149,1,331
2011-07-02,fall,2011,July,16,Saturday,Holiday,Clear,0.88,0.7424,0.22,0.2239,206,192,398,398,548,398,1,4,4,144,2,730,227748,1,398
2011-07-02,fall,2011,July,17,Saturday,Holiday,Clear,0.84,0.7273,0.3,0.2239,179,170,349,349,548,349,1,4,4,144,2,730,336860,1,349
2011-07-02,fall,2011,July,18,Saturday,Holiday,Clear,0.82,0.7121,0.3,0.2836,193,190,383,383,548,383,1,4,4,144,2,728,309772,1,383
2011-07-02,fall,2011,July,19,Saturday,Holiday,Clear,0.8,0.697,0.33,0.2239,156,149,305,305,548,305,1,4,4,144,2,728,226789,1,305
2011-07-02,fall,2011,July,20,Saturday,Holiday,Clear,0.76,0.6818,0.45,0.2836,136,148,284,284,548,284,1,4,4,144,2,728,164550,1,284
2011-07-02,fall,2011,July,21,Saturday,Holiday,Clear,0.74,0.6667,0.48,0.194,95,137,232,232,548,232,1,3,4,134,2,728,125445,1,232
2011-07-02,fall,2011,July,22,Saturday,Holiday,Clear,0.72,0.6667,0.51,0.1642,78,123,201,201,548,201,1,3,4,134,2,728,95612,1,201
2011-07-02,fall,2011,July,23,Saturday,Holiday,Clear,0.72,0.6667,0.54,0.2836,66,88,154,154,548,154,1,3,4,134,2,728,63941,1,154
2011-07-03,fall,2011,July,0,Sunday,Holiday,Clear,0.7,0.6515,0.58,0.2239,47,97,144,144,547,144,1,3,4,134,0,726,39130,1,144
2011-07-03,fall,2011,July,1,Sunday,Holiday,Mist,0.7,0.6515,0.61,0.1642,23,55,78,78,547,78,1,2,4,124,0,724,24164,1,78
2011-07-03,fall,2011,July,2,Sunday,Holiday,Clear,0.7,0.6515,0.58,0.194,19,50,69,69,547,69,1,2,4,124,0,715,16352,1,69
2011-07-03,fall,2011,July,3,Sunday,Holiday,Light Snow,0.68,0.6364,0.65,0.0896,8,25,33,33,547,33,1,1,4,114,0,697,8174,1,33
2011-07-03,fall,2011,July,4,Sunday,Holiday,Light Snow,0.68,0.6364,0.65,0.0896,3,2,5,5,547,5,1,1,4,114,0,697,4428,1,5
2011-07-03,fall,2011,July,5,Sunday,Holiday,Light Snow,0.62,0.5758,0.83,0.194,0,1,1,1,547,1,1,1,3,113,0,717,14261,1,1
2011-07-03,fall,2011,July,6,Sunday,Holiday,Mist,0.62,0.5455,0.94,0.0896,0,3,3,3,547,3,1,1,3,113,0,725,55132,1,3
2011-07-03,fall,2011,July,7,Sunday,Holiday,Mist,0.64,0.5758,0.89,0.194,3,22,25,25,547,25,1,1,3,113,0,727,154171,1,25
2011-07-03,fall,2011,July,8,Sunday,Holiday,Clear,0.68,0.6364,0.79,0.2239,39,53,92,92,547,92,1,2,4,124,0,727,261001,1,92
2011-07-03,fall,2011,July,9,Sunday,Holiday,Clear,0.7,0.6667,0.74,0.2537,82,99,181,181,547,181,1,3,4,134,2,727,159438,1,181
2011-07-03,fall,2011,July,10,Sunday,Holiday,Clear,0.74,0.697,0.66,0.1642,131,133,264,264,547,264,1,3,4,134,2,727,126257,1,264
2011-07-03,fall,2011,July,11,Sunday,Holiday,Clear,0.76,0.7121,0.62,0.1045,215,175,390,390,547,390,1,4,4,144,2,727,151320,1,390
2011-07-03,fall,2011,July,12,Sunday,Holiday,Clear,0.8,0.7576,0.55,0.1045,198,206,404,404,547,404,1,4,4,144,2,728,184414,1,404
2011-07-03,fall,2011,July,13,Sunday,Holiday,Clear,0.8,0.7727,0.59,0.2239,248,173,421,421,547,421,1,4,4,144,2,729,184919,1,421
2011-07-03,fall,2011,July,14,Sunday,Holiday,Clear,0.82,0.7879,0.56,0.2537,225,150,375,375,547,375,1,4,4,144,2,729,175652,1,375
2011-07-03,fall,2011,July,15,Sunday,Holiday,Clear,0.84,0.803,0.53,0.2985,194,182,376,376,547,376,1,4,4,144,2,729,183149,1,376
2011-07-03,fall,2011,July,16,Sunday,Holiday,Clear,0.84,0.803,0.53,0.2985,195,219,414,414,547,414,1,4,4,144,2,730,227748,1,414
2011-07-03,fall,2011,July,17,Sunday,Holiday,Light Snow,0.8,0.7424,0.49,0.8507,181,177,358,358,547,358,1,4,4,144,2,730,336860,1,358
2011-07-03,fall,2011,July,18,Sunday,Holiday,Light Snow,0.8,0.7424,0.49,0.8507,74,107,181,181,547,181,1,3,4,134,2,728,309772,1,181
2011-07-03,fall,2011,July,19,Sunday,Holiday,Mist,0.66,0.6061,0.83,0.194,100,83,183,183,547,183,1,3,3,133,0,728,226789,1,183
2011-07-03,fall,2011,July,20,Sunday,Holiday,Light Snow,0.66,0.6061,0.83,0.0,83,93,176,176,547,176,1,3,3,133,0,728,164550,1,176
2011-07-03,fall,2011,July,21,Sunday,Holiday,Mist,0.66,0.6061,0.83,0.1642,75,92,167,167,547,167,1,3,3,133,0,728,125445,1,167
2011-07-03,fall,2011,July,22,Sunday,Holiday,Mist,0.66,0.6061,0.78,0.1045,69,93,162,162,547,162,1,3,3,133,0,728,95612,1,162
2011-07-03,fall,2011,July,23,Sunday,Holiday,Clear,0.64,0.5758,0.83,0.1642,70,77,147,147,547,147,1,3,3,133,0,728,63941,1,147
2011-07-04,fall,2011,July,0,Monday,Holiday,Clear,0.64,0.5758,0.83,0.1343,63,77,140,140,546,140,2,2,3,223,0,726,39130,2,140
2011-07-04,fall,2011,July,1,Monday,Holiday,Clear,0.64,0.5758,0.83,0.0896,43,76,119,119,546,119,2,2,3,223,0,724,24164,2,119
2011-07-04,fall,2011,July,2,Monday,Holiday,Clear,0.64,0.5758,0.83,0.0,33,30,63,63,546,63,2,2,3,223,0,715,16352,2,63
2011-07-04,fall,2011,July,3,Monday,Holiday,Clear,0.64,0.5909,0.78,0.0,13,13,26,26,546,26,2,1,3,213,0,697,8174,2,26
2011-07-04,fall,2011,July,4,Monday,Holiday,Mist,0.66,0.6061,0.78,0.0896,8,4,12,12,546,12,2,1,3,213,0,697,4428,2,12
2011-07-04,fall,2011,July,5,Monday,Holiday,Mist,0.64,0.5758,0.83,0.1343,1,3,4,4,546,4,2,1,3,213,0,717,14261,2,4
2011-07-04,fall,2011,July,6,Monday,Holiday,Clear,0.64,0.5758,0.89,0.1642,5,11,16,16,546,16,2,1,3,213,0,725,55132,2,16
2011-07-04,fall,2011,July,7,Monday,Holiday,Clear,0.66,0.6061,0.83,0.1343,17,19,36,36,546,36,2,1,3,213,0,727,154171,2,36
2011-07-04,fall,2011,July,8,Monday,Holiday,Clear,0.7,0.6667,0.74,0.1045,42,44,86,86,546,86,2,2,4,224,0,727,261001,2,86
2011-07-04,fall,2011,July,9,Monday,Holiday,Mist,0.72,0.6818,0.66,0.0896,142,96,238,238,546,238,2,3,4,234,2,727,159438,2,238
2011-07-04,fall,2011,July,10,Monday,Holiday,Mist,0.76,0.697,0.55,0.0896,166,114,280,280,546,280,2,3,4,234,2,727,126257,2,280
2011-07-04,fall,2011,July,11,Monday,Holiday,Mist,0.76,0.697,0.55,0.0896,177,172,349,349,546,349,2,4,4,244,2,727,151320,2,349
2011-07-04,fall,2011,July,12,Monday,Holiday,Mist,0.78,0.7121,0.52,0.0,237,210,447,447,546,447,2,4,4,244,2,728,184414,2,447
2011-07-04,fall,2011,July,13,Monday,Holiday,Mist,0.78,0.7121,0.49,0.0,242,181,423,423,546,423,2,4,4,244,2,729,184919,2,423
2011-07-04,fall,2011,July,14,Monday,Holiday,Clear,0.8,0.7273,0.46,0.0,235,173,408,408,546,408,2,4,4,244,2,729,175652,2,408
2011-07-04,fall,2011,July,15,Monday,Holiday,Clear,0.82,0.7424,0.43,0.0896,224,184,408,408,546,408,2,4,4,244,2,729,183149,2,408
2011-07-04,fall,2011,July,16,Monday,Holiday,Clear,0.82,0.7424,0.41,0.0,236,216,452,452,546,452,2,4,4,244,2,730,227748,2,452
2011-07-04,fall,2011,July,17,Monday,Holiday,Clear,0.8,0.7273,0.46,0.0,240,196,436,436,546,436,2,4,4,244,2,730,336860,2,436
2011-07-04,fall,2011,July,18,Monday,Holiday,Clear,0.8,0.7273,0.46,0.1343,222,196,418,418,546,418,2,4,4,244,2,728,309772,2,418
2011-07-04,fall,2011,July,19,Monday,Holiday,Mist,0.78,0.7121,0.49,0.1642,170,205,375,375,546,375,2,4,4,244,2,728,226789,2,375
2011-07-04,fall,2011,July,20,Monday,Holiday,Mist,0.76,0.697,0.55,0.1045,195,191,386,386,546,386,2,4,4,244,2,728,164550,2,386
2011-07-04,fall,2011,July,21,Monday,Holiday,Mist,0.74,0.6818,0.62,0.1045,195,262,457,457,546,457,2,4,4,244,2,728,125445,2,457
2011-07-04,fall,2011,July,22,Monday,Holiday,Mist,0.74,0.6818,0.62,0.1343,115,211,326,326,546,326,2,4,4,244,2,728,95612,2,326
2011-07-04,fall,2011,July,23,Monday,Holiday,Mist,0.72,0.6818,0.7,0.1045,44,94,138,138,546,138,2,2,4,224,0,728,63941,2,138
2011-07-05,fall,2011,July,0,Tuesday,Workingday,Mist,0.7,0.6515,0.65,0.1642,19,36,55,55,545,55,2,2,4,224,0,726,39130,2,55
2011-07-05,fall,2011,July,1,Tuesday,Workingday,Clear,0.7,0.6515,0.65,0.1045,15,24,39,39,545,39,2,1,4,214,0,724,24164,2,39
2011-07-05,fall,2011,July,2,Tuesday,Workingday,Clear,0.66,0.6212,0.74,0.0896,8,5,13,13,545,13,2,1,3,213,0,715,16352,2,13
2011-07-05,fall,2011,July,3,Tuesday,Workingday,Clear,0.66,0.6212,0.74,0.2239,1,7,8,8,545,8,2,1,3,213,0,697,8174,2,8
2011-07-05,fall,2011,July,4,Tuesday,Workingday,Clear,0.66,0.6212,0.69,0.1642,1,4,5,5,545,5,2,1,3,213,0,697,4428,2,5
2011-07-05,fall,2011,July,5,Tuesday,Workingday,Clear,0.66,0.6212,0.69,0.0,1,19,20,20,545,20,2,1,3,213,0,717,14261,2,20
2011-07-05,fall,2011,July,6,Tuesday,Workingday,Clear,0.66,0.6212,0.74,0.0896,3,91,94,94,545,94,2,2,3,223,0,725,55132,2,94
2011-07-05,fall,2011,July,7,Tuesday,Workingday,Clear,0.7,0.6515,0.65,0.0896,22,248,270,270,545,270,2,3,4,234,0,727,154171,2,270
2011-07-05,fall,2011,July,8,Tuesday,Workingday,Clear,0.72,0.6818,0.62,0.1343,41,391,432,432,545,432,2,4,4,244,2,727,261001,2,432
2011-07-05,fall,2011,July,9,Tuesday,Workingday,Clear,0.74,0.6818,0.58,0.1343,50,177,227,227,545,227,2,3,4,234,2,727,159438,2,227
2011-07-05,fall,2011,July,10,Tuesday,Workingday,Clear,0.76,0.697,0.52,0.1045,55,84,139,139,545,139,2,2,4,224,2,727,126257,2,139
2011-07-05,fall,2011,July,11,Tuesday,Workingday,Clear,0.78,0.697,0.46,0.1045,75,97,172,172,545,172,2,3,4,234,2,727,151320,2,172
2011-07-05,fall,2011,July,12,Tuesday,Workingday,Clear,0.8,0.7273,0.43,0.1045,71,130,201,201,545,201,2,3,4,234,2,728,184414,2,201
2011-07-05,fall,2011,July,13,Tuesday,Workingday,Clear,0.82,0.7424,0.43,0.1045,67,136,203,203,545,203,2,3,4,234,2,729,184919,2,203
2011-07-05,fall,2011,July,14,Tuesday,Workingday,Clear,0.8,0.7424,0.49,0.1642,66,112,178,178,545,178,2,3,4,234,2,729,175652,2,178
2011-07-05,fall,2011,July,15,Tuesday,Workingday,Clear,0.82,0.7424,0.43,0.0,51,111,162,162,545,162,2,3,4,234,2,729,183149,2,162
2011-07-05,fall,2011,July,16,Tuesday,Workingday,Clear,0.82,0.7576,0.46,0.1045,79,202,281,281,545,281,2,3,4,234,2,730,227748,2,281
2011-07-05,fall,2011,July,17,Tuesday,Workingday,Clear,0.82,0.7576,0.46,0.1045,79,466,545,545,545,545,2,4,4,244,2,730,336860,2,545
2011-07-05,fall,2011,July,18,Tuesday,Workingday,Clear,0.8,0.7576,0.55,0.1642,70,426,496,496,545,496,2,4,4,244,2,728,309772,2,496
2011-07-05,fall,2011,July,19,Tuesday,Workingday,Clear,0.8,0.7727,0.59,0.1343,71,297,368,368,545,368,2,4,4,244,2,728,226789,2,368
2011-07-05,fall,2011,July,20,Tuesday,Workingday,Clear,0.76,0.7273,0.66,0.1045,59,225,284,284,545,284,2,4,4,244,2,728,164550,2,284
2011-07-05,fall,2011,July,21,Tuesday,Workingday,Clear,0.78,0.7424,0.62,0.2537,77,168,245,245,545,245,2,3,4,234,2,728,125445,2,245
2011-07-05,fall,2011,July,22,Tuesday,Workingday,Clear,0.76,0.7273,0.66,0.2239,31,124,155,155,545,155,2,3,4,234,0,728,95612,2,155
2011-07-05,fall,2011,July,23,Tuesday,Workingday,Clear,0.74,0.697,0.66,0.1642,19,54,73,73,545,73,2,2,4,224,0,728,63941,2,73
2011-07-06,fall,2011,July,0,Wednesday,Workingday,Clear,0.72,0.697,0.74,0.194,11,26,37,37,544,37,2,1,4,214,0,726,39130,2,37
2011-07-06,fall,2011,July,1,Wednesday,Workingday,Clear,0.7,0.6667,0.74,0.1343,4,11,15,15,544,15,2,1,4,214,0,724,24164,2,15
2011-07-06,fall,2011,July,2,Wednesday,Workingday,Clear,0.7,0.6667,0.79,0.0896,1,4,5,5,544,5,2,1,4,214,0,715,16352,2,5
2011-07-06,fall,2011,July,3,Wednesday,Workingday,Clear,0.7,0.6667,0.79,0.0,0,6,6,6,544,6,2,1,4,214,0,697,8174,2,6
2011-07-06,fall,2011,July,4,Wednesday,Workingday,Mist,0.68,0.6364,0.83,0.0896,0,6,6,6,544,6,2,1,4,214,0,697,4428,2,6
2011-07-06,fall,2011,July,5,Wednesday,Workingday,Clear,0.68,0.6364,0.83,0.0896,5,30,35,35,544,35,2,1,4,214,0,717,14261,2,35
2011-07-06,fall,2011,July,6,Wednesday,Workingday,Clear,0.7,0.6667,0.79,0.0896,9,112,121,121,544,121,2,2,4,224,0,725,55132,2,121
2011-07-06,fall,2011,July,7,Wednesday,Workingday,Mist,0.72,0.697,0.79,0.0,24,288,312,312,544,312,2,4,4,244,0,727,154171,2,312
2011-07-06,fall,2011,July,8,Wednesday,Workingday,Mist,0.72,0.697,0.74,0.1045,31,397,428,428,544,428,2,4,4,244,2,727,261001,2,428
2011-07-06,fall,2011,July,9,Wednesday,Workingday,Light Snow,0.7,0.6667,0.79,0.194,31,158,189,189,544,189,2,3,4,234,0,727,159438,2,189
2011-07-06,fall,2011,July,10,Wednesday,Workingday,Light Snow,0.7,0.6667,0.79,0.0896,13,30,43,43,544,43,2,2,4,224,0,727,126257,2,43
2011-07-06,fall,2011,July,11,Wednesday,Workingday,Mist,0.72,0.697,0.74,0.0,24,103,127,127,544,127,2,2,4,224,0,727,151320,2,127
2011-07-06,fall,2011,July,12,Wednesday,Workingday,Mist,0.74,0.697,0.66,0.0896,38,114,152,152,544,152,2,3,4,234,0,728,184414,2,152
2011-07-06,fall,2011,July,13,Wednesday,Workingday,Mist,0.74,0.697,0.7,0.1045,33,107,140,140,544,140,2,2,4,224,0,729,184919,2,140
2011-07-06,fall,2011,July,14,Wednesday,Workingday,Clear,0.76,0.7273,0.66,0.2836,50,113,163,163,544,163,2,3,4,234,2,729,175652,2,163
2011-07-06,fall,2011,July,15,Wednesday,Workingday,Clear,0.76,0.7273,0.7,0.2836,55,130,185,185,544,185,2,3,4,234,2,729,183149,2,185
2011-07-06,fall,2011,July,16,Wednesday,Workingday,Clear,0.76,0.7273,0.7,0.2537,57,218,275,275,544,275,2,3,4,234,2,730,227748,2,275
2011-07-06,fall,2011,July,17,Wednesday,Workingday,Clear,0.78,0.7424,0.59,0.2239,79,517,596,596,544,596,2,4,4,244,2,730,336860,2,596
2011-07-06,fall,2011,July,18,Wednesday,Workingday,Clear,0.76,0.7121,0.62,0.194,77,486,563,563,544,563,2,4,4,244,2,728,309772,2,563
2011-07-06,fall,2011,July,19,Wednesday,Workingday,Clear,0.74,0.697,0.7,0.2239,71,323,394,394,544,394,2,4,4,244,2,728,226789,2,394
2011-07-06,fall,2011,July,20,Wednesday,Workingday,Clear,0.72,0.697,0.74,0.2537,55,257,312,312,544,312,2,4,4,244,2,728,164550,2,312
2011-07-06,fall,2011,July,21,Wednesday,Workingday,Clear,0.7,0.6667,0.79,0.194,66,175,241,241,544,241,2,3,4,234,0,728,125445,2,241
2011-07-06,fall,2011,July,22,Wednesday,Workingday,Clear,0.7,0.6667,0.79,0.194,30,156,186,186,544,186,2,3,4,234,0,728,95612,2,186
2011-07-06,fall,2011,July,23,Wednesday,Workingday,Clear,0.68,0.6364,0.83,0.2239,20,78,98,98,544,98,2,2,4,224,0,728,63941,2,98
2011-07-07,fall,2011,July,0,Thursday,Workingday,Clear,0.66,0.5909,0.89,0.1343,6,29,35,35,543,35,2,1,3,213,0,726,39130,2,35
2011-07-07,fall,2011,July,1,Thursday,Workingday,Clear,0.66,0.5909,0.89,0.194,2,14,16,16,543,16,2,1,3,213,0,724,24164,2,16
2011-07-07,fall,2011,July,2,Thursday,Workingday,Clear,0.66,0.5909,0.89,0.194,1,7,8,8,543,8,2,1,3,213,0,715,16352,2,8
2011-07-07,fall,2011,July,3,Thursday,Workingday,Clear,0.64,0.5606,0.94,0.1045,2,2,4,4,543,4,2,1,3,213,0,697,8174,2,4
2011-07-07,fall,2011,July,4,Thursday,Workingday,Clear,0.64,0.5758,0.89,0.1045,0,4,4,4,543,4,2,1,3,213,0,697,4428,2,4
2011-07-07,fall,2011,July,5,Thursday,Workingday,Clear,0.64,0.5758,0.89,0.1045,2,30,32,32,543,32,2,1,3,213,0,717,14261,2,32
2011-07-07,fall,2011,July,6,Thursday,Workingday,Mist,0.64,0.5758,0.89,0.1343,11,107,118,118,543,118,2,2,3,223,0,725,55132,2,118
2011-07-07,fall,2011,July,7,Thursday,Workingday,Mist,0.66,0.5909,0.89,0.1045,13,279,292,292,543,292,2,4,3,243,0,727,154171,2,292
2011-07-07,fall,2011,July,8,Thursday,Workingday,Mist,0.7,0.6667,0.79,0.194,28,415,443,443,543,443,2,4,4,244,2,727,261001,2,443
2011-07-07,fall,2011,July,9,Thursday,Workingday,Clear,0.74,0.697,0.7,0.1642,25,154,179,179,543,179,2,3,4,234,0,727,159438,2,179
2011-07-07,fall,2011,July,10,Thursday,Workingday,Clear,0.78,0.7424,0.62,0.0,29,72,101,101,543,101,2,2,4,224,0,727,126257,2,101
2011-07-07,fall,2011,July,11,Thursday,Workingday,Clear,0.82,0.7727,0.52,0.1343,30,112,142,142,543,142,2,2,4,224,2,727,151320,2,142
2011-07-07,fall,2011,July,12,Thursday,Workingday,Clear,0.84,0.7727,0.41,0.0,32,139,171,171,543,171,2,3,4,234,2,728,184414,2,171
2011-07-07,fall,2011,July,13,Thursday,Workingday,Clear,0.86,0.7879,0.41,0.0,48,107,155,155,543,155,2,3,4,234,2,729,184919,2,155
2011-07-07,fall,2011,July,14,Thursday,Workingday,Clear,0.86,0.7879,0.41,0.2537,39,121,160,160,543,160,2,3,4,234,2,729,175652,2,160
2011-07-07,fall,2011,July,15,Thursday,Workingday,Clear,0.86,0.7879,0.41,0.2537,47,119,166,166,543,166,2,3,4,234,2,729,183149,2,166
2011-07-07,fall,2011,July,16,Thursday,Workingday,Clear,0.86,0.7727,0.39,0.2239,47,218,265,265,543,265,2,3,4,234,2,730,227748,2,265
2011-07-07,fall,2011,July,17,Thursday,Workingday,Clear,0.86,0.7576,0.36,0.2537,80,489,569,569,543,569,2,4,4,244,2,730,336860,2,569
2011-07-07,fall,2011,July,18,Thursday,Workingday,Clear,0.84,0.7576,0.44,0.2985,70,492,562,562,543,562,2,4,4,244,2,728,309772,2,562
2011-07-07,fall,2011,July,19,Thursday,Workingday,Clear,0.82,0.7727,0.52,0.2836,79,286,365,365,543,365,2,4,4,244,2,728,226789,2,365
2011-07-07,fall,2011,July,20,Thursday,Workingday,Clear,0.76,0.7121,0.58,0.3582,61,224,285,285,543,285,2,4,4,244,2,728,164550,2,285
2011-07-07,fall,2011,July,21,Thursday,Workingday,Clear,0.74,0.6818,0.62,0.1642,39,170,209,209,543,209,2,3,4,234,0,728,125445,2,209
2011-07-07,fall,2011,July,22,Thursday,Workingday,Clear,0.74,0.6818,0.62,0.1642,32,150,182,182,543,182,2,3,4,234,0,728,95612,2,182
2011-07-07,fall,2011,July,23,Thursday,Workingday,Clear,0.72,0.6818,0.66,0.0,31,98,129,129,543,129,2,2,4,224,0,728,63941,2,129
2011-07-08,fall,2011,July,0,Friday,Workingday,Clear,0.74,0.697,0.66,0.1045,6,41,47,47,542,47,2,2,4,224,0,726,39130,2,47
2011-07-08,fall,2011,July,1,Friday,Workingday,Clear,0.72,0.697,0.79,0.0,9,25,34,34,542,34,2,1,4,214,0,724,24164,2,34
2011-07-08,fall,2011,July,2,Friday,Workingday,Mist,0.7,0.6667,0.74,0.1642,10,12,22,22,542,22,2,1,4,214,0,715,16352,2,22
2011-07-08,fall,2011,July,3,Friday,Workingday,Clear,0.68,0.6364,0.79,0.1045,2,4,6,6,542,6,2,1,4,214,0,697,8174,2,6
2011-07-08,fall,2011,July,4,Friday,Workingday,Clear,0.7,0.6667,0.79,0.2537,7,4,11,11,542,11,2,1,4,214,0,697,4428,2,11
2011-07-08,fall,2011,July,5,Friday,Workingday,Clear,0.68,0.6364,0.79,0.2537,3,24,27,27,542,27,2,1,4,214,0,717,14261,2,27
2011-07-08,fall,2011,July,6,Friday,Workingday,Clear,0.7,0.6667,0.74,0.1045,11,91,102,102,542,102,2,2,4,224,0,725,55132,2,102
2011-07-08,fall,2011,July,7,Friday,Workingday,Mist,0.7,0.6667,0.79,0.194,30,302,332,332,542,332,2,4,4,244,0,727,154171,2,332
2011-07-08,fall,2011,July,8,Friday,Workingday,Mist,0.72,0.697,0.74,0.2537,36,421,457,457,542,457,2,4,4,244,2,727,261001,2,457
2011-07-08,fall,2011,July,9,Friday,Workingday,Mist,0.76,0.7273,0.7,0.2985,30,211,241,241,542,241,2,3,4,234,2,727,159438,2,241
2011-07-08,fall,2011,July,10,Friday,Workingday,Mist,0.74,0.697,0.7,0.3582,30,108,138,138,542,138,2,2,4,224,0,727,126257,2,138
2011-07-08,fall,2011,July,11,Friday,Workingday,Mist,0.74,0.7121,0.74,0.2537,61,104,165,165,542,165,2,3,4,234,0,727,151320,2,165
2011-07-08,fall,2011,July,12,Friday,Workingday,Mist,0.76,0.7273,0.7,0.2836,49,164,213,213,542,213,2,3,4,234,2,728,184414,2,213
2011-07-08,fall,2011,July,13,Friday,Workingday,Mist,0.78,0.7576,0.66,0.2836,54,175,229,229,542,229,2,3,4,234,2,729,184919,2,229
2011-07-08,fall,2011,July,14,Friday,Workingday,Mist,0.8,0.7879,0.63,0.3582,53,163,216,216,542,216,2,3,4,234,2,729,175652,2,216
2011-07-08,fall,2011,July,15,Friday,Workingday,Mist,0.8,0.7879,0.63,0.3582,39,102,141,141,542,141,2,2,4,224,2,729,183149,2,141
2011-07-08,fall,2011,July,16,Friday,Workingday,Light Snow,0.68,0.6364,0.83,0.4478,27,105,132,132,542,132,2,2,4,224,0,730,227748,2,132
2011-07-08,fall,2011,July,17,Friday,Workingday,Light Snow,0.66,0.5909,0.89,0.4478,6,161,167,167,542,167,2,3,3,233,0,730,336860,2,167
2011-07-08,fall,2011,July,18,Friday,Workingday,Clear,0.66,0.6061,0.83,0.0896,35,281,316,316,542,316,2,4,3,243,0,728,309772,2,316
2011-07-08,fall,2011,July,19,Friday,Workingday,Clear,0.66,0.6061,0.83,0.0896,45,225,270,270,542,270,2,3,3,233,0,728,226789,2,270
2011-07-08,fall,2011,July,20,Friday,Workingday,Clear,0.66,0.6061,0.83,0.1642,30,220,250,250,542,250,2,3,3,233,0,728,164550,2,250
2011-07-08,fall,2011,July,21,Friday,Workingday,Mist,0.66,0.6061,0.83,0.2537,46,158,204,204,542,204,2,3,3,233,0,728,125445,2,204
2011-07-08,fall,2011,July,22,Friday,Workingday,Mist,0.66,0.6061,0.78,0.194,33,136,169,169,542,169,2,3,3,233,0,728,95612,2,169
2011-07-08,fall,2011,July,23,Friday,Workingday,Mist,0.66,0.6061,0.78,0.0896,40,111,151,151,542,151,2,3,3,233,0,728,63941,2,151
2011-07-09,fall,2011,July,0,Saturday,Holiday,Mist,0.66,0.6061,0.83,0.1343,31,90,121,121,541,121,2,2,3,223,0,726,39130,2,121
2011-07-09,fall,2011,July,1,Saturday,Holiday,Mist,0.64,0.5758,0.89,0.1045,5,48,53,53,541,53,2,2,3,223,0,724,24164,2,53
2011-07-09,fall,2011,July,2,Saturday,Holiday,Clear,0.64,0.5758,0.89,0.1642,12,43,55,55,541,55,2,2,3,223,0,715,16352,2,55
2011-07-09,fall,2011,July,3,Saturday,Holiday,Clear,0.64,0.5758,0.89,0.1343,7,23,30,30,541,30,2,1,3,213,0,697,8174,2,30
2011-07-09,fall,2011,July,4,Saturday,Holiday,Clear,0.64,0.5758,0.83,0.2239,2,4,6,6,541,6,2,1,3,213,0,697,4428,2,6
2011-07-09,fall,2011,July,5,Saturday,Holiday,Mist,0.62,0.5606,0.88,0.1642,4,11,15,15,541,15,2,1,3,213,0,717,14261,2,15
2011-07-09,fall,2011,July,6,Saturday,Holiday,Mist,0.64,0.5758,0.83,0.194,11,27,38,38,541,38,2,1,3,213,0,725,55132,2,38
2011-07-09,fall,2011,July,7,Saturday,Holiday,Clear,0.66,0.6061,0.78,0.194,21,50,71,71,541,71,2,2,3,223,0,727,154171,2,71
2011-07-09,fall,2011,July,8,Saturday,Holiday,Clear,0.7,0.6515,0.7,0.2537,68,114,182,182,541,182,2,3,4,234,2,727,261001,2,182
2011-07-09,fall,2011,July,9,Saturday,Holiday,Clear,0.74,0.6818,0.58,0.2836,77,170,247,247,541,247,2,3,4,234,2,727,159438,2,247
2011-07-09,fall,2011,July,10,Saturday,Holiday,Clear,0.76,0.697,0.52,0.1642,87,177,264,264,541,264,2,3,4,234,2,727,126257,2,264
2011-07-09,fall,2011,July,11,Saturday,Holiday,Clear,0.78,0.697,0.46,0.2985,101,189,290,290,541,290,2,4,4,244,2,727,151320,2,290
2011-07-09,fall,2011,July,12,Saturday,Holiday,Clear,0.8,0.7273,0.46,0.2537,145,221,366,366,541,366,2,4,4,244,2,728,184414,2,366
2011-07-09,fall,2011,July,13,Saturday,Holiday,Clear,0.82,0.7424,0.41,0.2239,167,249,416,416,541,416,2,4,4,244,2,729,184919,2,416
2011-07-09,fall,2011,July,14,Saturday,Holiday,Clear,0.84,0.7424,0.36,0.1343,158,215,373,373,541,373,2,4,4,244,2,729,175652,2,373
2011-07-09,fall,2011,July,15,Saturday,Holiday,Clear,0.84,0.7273,0.34,0.0896,182,220,402,402,541,402,2,4,4,244,2,729,183149,2,402
2011-07-09,fall,2011,July,16,Saturday,Holiday,Clear,0.82,0.7273,0.38,0.0,171,245,416,416,541,416,2,4,4,244,2,730,227748,2,416
2011-07-09,fall,2011,July,17,Saturday,Holiday,Clear,0.84,0.7273,0.32,0.0,160,241,401,401,541,401,2,4,4,244,2,730,336860,2,401
2011-07-09,fall,2011,July,18,Saturday,Holiday,Clear,0.82,0.7273,0.36,0.1045,132,246,378,378,541,378,2,4,4,244,2,728,309772,2,378
2011-07-09,fall,2011,July,19,Saturday,Holiday,Clear,0.76,0.697,0.55,0.1642,128,178,306,306,541,306,2,4,4,244,2,728,226789,2,306
2011-07-09,fall,2011,July,20,Saturday,Holiday,Clear,0.76,0.7121,0.58,0.2239,129,185,314,314,541,314,2,4,4,244,2,728,164550,2,314
2011-07-09,fall,2011,July,21,Saturday,Holiday,Clear,0.74,0.6818,0.58,0.1642,83,155,238,238,541,238,2,3,4,234,2,728,125445,2,238
2011-07-09,fall,2011,July,22,Saturday,Holiday,Clear,0.72,0.6818,0.62,0.1642,60,154,214,214,541,214,2,3,4,234,2,728,95612,2,214
2011-07-09,fall,2011,July,23,Saturday,Holiday,Clear,0.72,0.6667,0.58,0.194,47,93,140,140,541,140,2,2,4,224,0,728,63941,2,140
2011-07-10,fall,2011,July,0,Sunday,Holiday,Clear,0.7,0.6515,0.61,0.1642,42,112,154,154,540,154,2,3,4,234,0,726,39130,2,154
2011-07-10,fall,2011,July,1,Sunday,Holiday,Clear,0.7,0.6515,0.61,0.1343,19,94,113,113,540,113,2,2,4,224,0,724,24164,2,113
2011-07-10,fall,2011,July,2,Sunday,Holiday,Clear,0.68,0.6364,0.69,0.0896,28,68,96,96,540,96,2,2,4,224,0,715,16352,2,96
2011-07-10,fall,2011,July,3,Sunday,Holiday,Clear,0.66,0.6212,0.74,0.0896,6,19,25,25,540,25,2,1,3,213,0,697,8174,2,25
2011-07-10,fall,2011,July,4,Sunday,Holiday,Clear,0.66,0.6212,0.69,0.0896,0,5,5,5,540,5,2,1,3,213,0,697,4428,2,5
2011-07-10,fall,2011,July,5,Sunday,Holiday,Clear,0.66,0.6212,0.74,0.0,7,10,17,17,540,17,2,1,3,213,0,717,14261,2,17
2011-07-10,fall,2011,July,6,Sunday,Holiday,Clear,0.64,0.5909,0.78,0.0896,8,17,25,25,540,25,2,1,3,213,0,725,55132,2,25
2011-07-10,fall,2011,July,7,Sunday,Holiday,Clear,0.7,0.6515,0.7,0.0896,27,38,65,65,540,65,2,2,4,224,0,727,154171,2,65
2011-07-10,fall,2011,July,8,Sunday,Holiday,Clear,0.72,0.6818,0.66,0.0,27,65,92,92,540,92,2,2,4,224,0,727,261001,2,92
2011-07-10,fall,2011,July,9,Sunday,Holiday,Clear,0.74,0.697,0.66,0.0896,62,107,169,169,540,169,2,3,4,234,0,727,159438,2,169
2011-07-10,fall,2011,July,10,Sunday,Holiday,Clear,0.76,0.697,0.55,0.1343,95,173,268,268,540,268,2,3,4,234,2,727,126257,2,268
2011-07-10,fall,2011,July,11,Sunday,Holiday,Clear,0.78,0.7273,0.55,0.194,110,177,287,287,540,287,2,4,4,244,2,727,151320,2,287
2011-07-10,fall,2011,July,12,Sunday,Holiday,Clear,0.82,0.7576,0.46,0.2836,133,244,377,377,540,377,2,4,4,244,2,728,184414,2,377
2011-07-10,fall,2011,July,13,Sunday,Holiday,Clear,0.8,0.7273,0.46,0.2985,139,228,367,367,540,367,2,4,4,244,2,729,184919,2,367
2011-07-10,fall,2011,July,14,Sunday,Holiday,Clear,0.82,0.7424,0.41,0.3284,122,227,349,349,540,349,2,4,4,244,2,729,175652,2,349
2011-07-10,fall,2011,July,15,Sunday,Holiday,Clear,0.84,0.7424,0.39,0.2836,142,219,361,361,540,361,2,4,4,244,2,729,183149,2,361
2011-07-10,fall,2011,July,16,Sunday,Holiday,Clear,0.84,0.7576,0.41,0.2836,128,244,372,372,540,372,2,4,4,244,2,730,227748,2,372
2011-07-10,fall,2011,July,17,Sunday,Holiday,Clear,0.84,0.7424,0.36,0.2239,146,217,363,363,540,363,2,4,4,244,2,730,336860,2,363
2011-07-10,fall,2011,July,18,Sunday,Holiday,Clear,0.82,0.7424,0.43,0.2836,141,222,363,363,540,363,2,4,4,244,2,728,309772,2,363
2011-07-10,fall,2011,July,19,Sunday,Holiday,Clear,0.8,0.7424,0.49,0.3284,120,183,303,303,540,303,2,4,4,244,2,728,226789,2,303
2011-07-10,fall,2011,July,20,Sunday,Holiday,Clear,0.76,0.697,0.55,0.194,101,167,268,268,540,268,2,3,4,234,2,728,164550,2,268
2011-07-10,fall,2011,July,21,Sunday,Holiday,Clear,0.74,0.6818,0.62,0.2537,65,162,227,227,540,227,2,3,4,234,2,728,125445,2,227
2011-07-10,fall,2011,July,22,Sunday,Holiday,Clear,0.74,0.697,0.66,0.2239,56,87,143,143,540,143,2,3,4,234,0,728,95612,2,143
2011-07-10,fall,2011,July,23,Sunday,Holiday,Clear,0.72,0.6818,0.66,0.2537,19,53,72,72,540,72,2,2,4,224,0,728,63941,2,72
2011-07-11,fall,2011,July,0,Monday,Workingday,Clear,0.7,0.6515,0.65,0.194,10,25,35,35,539,35,2,1,4,214,0,726,39130,2,35
2011-07-11,fall,2011,July,1,Monday,Workingday,Clear,0.7,0.6515,0.61,0.2836,5,5,10,10,539,10,2,1,4,214,0,724,24164,2,10
2011-07-11,fall,2011,July,2,Monday,Workingday,Clear,0.7,0.6515,0.61,0.2239,8,4,12,12,539,12,2,1,4,214,0,715,16352,2,12
2011-07-11,fall,2011,July,3,Monday,Workingday,Clear,0.68,0.6364,0.65,0.1642,2,8,10,10,539,10,2,1,4,214,0,697,8174,2,10
2011-07-11,fall,2011,July,4,Monday,Workingday,Clear,0.66,0.6212,0.74,0.2239,0,4,4,4,539,4,2,1,3,213,0,697,4428,2,4
2011-07-11,fall,2011,July,5,Monday,Workingday,Clear,0.66,0.6212,0.74,0.1343,5,21,26,26,539,26,2,1,3,213,0,717,14261,2,26
2011-07-11,fall,2011,July,6,Monday,Workingday,Clear,0.68,0.6364,0.74,0.194,19,102,121,121,539,121,2,2,4,224,0,725,55132,2,121
2011-07-11,fall,2011,July,7,Monday,Workingday,Clear,0.7,0.6667,0.74,0.2537,28,289,317,317,539,317,2,4,4,244,2,727,154171,2,317
2011-07-11,fall,2011,July,8,Monday,Workingday,Clear,0.74,0.697,0.66,0.2836,35,385,420,420,539,420,2,4,4,244,2,727,261001,2,420
2011-07-11,fall,2011,July,9,Monday,Workingday,Clear,0.78,0.7424,0.59,0.2985,41,167,208,208,539,208,2,3,4,234,2,727,159438,2,208
2011-07-11,fall,2011,July,10,Monday,Workingday,Clear,0.8,0.7576,0.55,0.3582,44,73,117,117,539,117,2,2,4,224,2,727,126257,2,117
2011-07-11,fall,2011,July,11,Monday,Workingday,Clear,0.82,0.7879,0.56,0.2985,39,89,128,128,539,128,2,2,4,224,2,727,151320,2,128
2011-07-11,fall,2011,July,12,Monday,Workingday,Clear,0.84,0.803,0.53,0.2836,40,108,148,148,539,148,2,3,4,234,2,728,184414,2,148
2011-07-11,fall,2011,July,13,Monday,Workingday,Clear,0.86,0.8182,0.5,0.2537,22,119,141,141,539,141,2,2,4,224,2,729,184919,2,141
2011-07-11,fall,2011,July,14,Monday,Workingday,Clear,0.86,0.8333,0.53,0.2836,40,94,134,134,539,134,2,2,4,224,2,729,175652,2,134
2011-07-11,fall,2011,July,15,Monday,Workingday,Clear,0.86,0.8485,0.56,0.4179,38,108,146,146,539,146,2,3,4,234,2,729,183149,2,146
2011-07-11,fall,2011,July,16,Monday,Workingday,Clear,0.86,0.8485,0.56,0.3881,57,182,239,239,539,239,2,3,4,234,2,730,227748,2,239
2011-07-11,fall,2011,July,17,Monday,Workingday,Clear,0.86,0.8485,0.56,0.4179,59,455,514,514,539,514,2,4,4,244,2,730,336860,2,514
2011-07-11,fall,2011,July,18,Monday,Workingday,Clear,0.86,0.8333,0.53,0.3881,57,415,472,472,539,472,2,4,4,244,2,728,309772,2,472
2011-07-11,fall,2011,July,19,Monday,Workingday,Clear,0.84,0.8333,0.59,0.3284,80,293,373,373,539,373,2,4,4,244,2,728,226789,2,373
2011-07-11,fall,2011,July,20,Monday,Workingday,Clear,0.72,0.697,0.74,0.4179,42,194,236,236,539,236,2,3,4,234,2,728,164550,2,236
2011-07-11,fall,2011,July,21,Monday,Workingday,Clear,0.7,0.6667,0.79,0.4179,21,109,130,130,539,130,2,2,4,224,0,728,125445,2,130
2011-07-11,fall,2011,July,22,Monday,Workingday,Clear,0.72,0.697,0.74,0.1343,20,70,90,90,539,90,2,2,4,224,0,728,95612,2,90
2011-07-11,fall,2011,July,23,Monday,Workingday,Clear,0.7,0.6667,0.79,0.1343,11,44,55,55,539,55,2,2,4,224,0,728,63941,2,55
2011-07-12,fall,2011,July,0,Tuesday,Workingday,Clear,0.7,0.6667,0.79,0.1343,3,19,22,22,538,22,2,1,4,214,0,726,39130,2,22
2011-07-12,fall,2011,July,1,Tuesday,Workingday,Clear,0.7,0.6667,0.79,0.0896,6,8,14,14,538,14,2,1,4,214,0,724,24164,2,14
2011-07-12,fall,2011,July,2,Tuesday,Workingday,Clear,0.7,0.6667,0.79,0.1045,2,7,9,9,538,9,2,1,4,214,0,715,16352,2,9
2011-07-12,fall,2011,July,3,Tuesday,Workingday,Mist,0.7,0.6667,0.79,0.0,2,6,8,8,538,8,2,1,4,214,0,697,8174,2,8
2011-07-12,fall,2011,July,4,Tuesday,Workingday,Clear,0.7,0.6667,0.79,0.1642,0,6,6,6,538,6,2,1,4,214,0,697,4428,2,6
2011-07-12,fall,2011,July,5,Tuesday,Workingday,Clear,0.7,0.6667,0.79,0.0896,4,21,25,25,538,25,2,1,4,214,0,717,14261,2,25
2011-07-12,fall,2011,July,6,Tuesday,Workingday,Clear,0.74,0.6818,0.58,0.2239,13,102,115,115,538,115,2,2,4,224,0,725,55132,2,115
2011-07-12,fall,2011,July,7,Tuesday,Workingday,Clear,0.76,0.697,0.55,0.194,29,301,330,330,538,330,2,4,4,244,2,727,154171,2,330
2011-07-12,fall,2011,July,8,Tuesday,Workingday,Clear,0.76,0.7121,0.58,0.2239,35,382,417,417,538,417,2,4,4,244,2,727,261001,2,417
2011-07-12,fall,2011,July,9,Tuesday,Workingday,Clear,0.78,0.7273,0.55,0.4925,27,149,176,176,538,176,2,3,4,234,2,727,159438,2,176
2011-07-12,fall,2011,July,10,Tuesday,Workingday,Clear,0.82,0.7727,0.52,0.1642,38,85,123,123,538,123,2,2,4,224,2,727,126257,2,123
2011-07-12,fall,2011,July,11,Tuesday,Workingday,Clear,0.82,0.7727,0.52,0.1642,39,86,125,125,538,125,2,2,4,224,2,727,151320,2,125
2011-07-12,fall,2011,July,12,Tuesday,Workingday,Clear,0.86,0.7879,0.44,0.2985,38,125,163,163,538,163,2,3,4,234,2,728,184414,2,163
2011-07-12,fall,2011,July,13,Tuesday,Workingday,Clear,0.86,0.803,0.47,0.2239,32,104,136,136,538,136,2,2,4,224,2,729,184919,2,136
2011-07-12,fall,2011,July,14,Tuesday,Workingday,Clear,0.9,0.8485,0.42,0.2985,33,91,124,124,538,124,2,2,4,224,2,729,175652,2,124
2011-07-12,fall,2011,July,15,Tuesday,Workingday,Clear,0.9,0.8485,0.42,0.3582,37,111,148,148,538,148,2,3,4,234,2,729,183149,2,148
2011-07-12,fall,2011,July,16,Tuesday,Workingday,Clear,0.86,0.7879,0.44,0.2836,25,177,202,202,538,202,2,3,4,234,2,730,227748,2,202
2011-07-12,fall,2011,July,17,Tuesday,Workingday,Clear,0.88,0.8182,0.44,0.2836,48,380,428,428,538,428,2,4,4,244,2,730,336860,2,428
2011-07-12,fall,2011,July,18,Tuesday,Workingday,Clear,0.86,0.803,0.47,0.2985,39,472,511,511,538,511,2,4,4,244,2,728,309772,2,511
2011-07-12,fall,2011,July,19,Tuesday,Workingday,Clear,0.84,0.7576,0.44,0.2836,42,295,337,337,538,337,2,4,4,244,2,728,226789,2,337
2011-07-12,fall,2011,July,20,Tuesday,Workingday,Clear,0.82,0.7424,0.43,0.194,57,251,308,308,538,308,2,4,4,244,2,728,164550,2,308
2011-07-12,fall,2011,July,21,Tuesday,Workingday,Clear,0.82,0.7424,0.43,0.1045,49,209,258,258,538,258,2,3,4,234,2,728,125445,2,258
2011-07-12,fall,2011,July,22,Tuesday,Workingday,Clear,0.8,0.7273,0.46,0.1343,44,150,194,194,538,194,2,3,4,234,2,728,95612,2,194
2011-07-12,fall,2011,July,23,Tuesday,Workingday,Clear,0.78,0.7121,0.52,0.0,20,59,79,79,538,79,2,2,4,224,0,728,63941,2,79
2011-07-13,fall,2011,July,0,Wednesday,Workingday,Clear,0.76,0.7121,0.62,0.0,9,37,46,46,537,46,2,2,4,224,0,726,39130,2,46
2011-07-13,fall,2011,July,1,Wednesday,Workingday,Clear,0.76,0.697,0.55,0.0,1,11,12,12,537,12,2,1,4,214,0,724,24164,2,12
2011-07-13,fall,2011,July,2,Wednesday,Workingday,Clear,0.76,0.697,0.55,0.0,2,3,5,5,537,5,2,1,4,214,0,715,16352,2,5
2011-07-13,fall,2011,July,3,Wednesday,Workingday,Clear,0.74,0.6818,0.58,0.194,0,4,4,4,537,4,2,1,4,214,0,697,8174,2,4
2011-07-13,fall,2011,July,4,Wednesday,Workingday,Clear,0.74,0.6818,0.58,0.2537,0,5,5,5,537,5,2,1,4,214,0,697,4428,2,5
2011-07-13,fall,2011,July,5,Wednesday,Workingday,Clear,0.74,0.6818,0.58,0.194,4,22,26,26,537,26,2,1,4,214,0,717,14261,2,26
2011-07-13,fall,2011,July,6,Wednesday,Workingday,Clear,0.74,0.6818,0.58,0.1642,18,103,121,121,537,121,2,2,4,224,0,725,55132,2,121
2011-07-13,fall,2011,July,7,Wednesday,Workingday,Clear,0.76,0.697,0.55,0.2537,32,281,313,313,537,313,2,4,4,244,2,727,154171,2,313
2011-07-13,fall,2011,July,8,Wednesday,Workingday,Clear,0.8,0.7424,0.49,0.2537,31,418,449,449,537,449,2,4,4,244,2,727,261001,2,449
2011-07-13,fall,2011,July,9,Wednesday,Workingday,Clear,0.82,0.7424,0.41,0.194,23,163,186,186,537,186,2,3,4,234,2,727,159438,2,186
2011-07-13,fall,2011,July,10,Wednesday,Workingday,Clear,0.82,0.7576,0.46,0.194,33,80,113,113,537,113,2,2,4,224,2,727,126257,2,113
2011-07-13,fall,2011,July,11,Wednesday,Workingday,Clear,0.84,0.7424,0.39,0.1642,55,110,165,165,537,165,2,3,4,234,2,727,151320,2,165
2011-07-13,fall,2011,July,12,Wednesday,Workingday,Clear,0.84,0.7576,0.41,0.2836,40,134,174,174,537,174,2,3,4,234,2,728,184414,2,174
2011-07-13,fall,2011,July,13,Wednesday,Workingday,Light Snow,0.82,0.7576,0.46,0.1343,39,119,158,158,537,158,2,3,4,234,2,729,184919,2,158
2011-07-13,fall,2011,July,14,Wednesday,Workingday,Light Snow,0.82,0.7576,0.46,0.1343,27,89,116,116,537,116,2,2,4,224,2,729,175652,2,116
2011-07-13,fall,2011,July,15,Wednesday,Workingday,Light Snow,0.64,0.5606,0.94,0.1343,13,33,46,46,537,46,2,2,3,223,0,729,183149,2,46
2011-07-13,fall,2011,July,16,Wednesday,Workingday,Mist,0.66,0.5909,0.89,0.0,23,118,141,141,537,141,2,2,3,223,0,730,227748,2,141
2011-07-13,fall,2011,July,17,Wednesday,Workingday,Clear,0.7,0.6667,0.79,0.0,70,418,488,488,537,488,2,4,4,244,2,730,336860,2,488
2011-07-13,fall,2011,July,18,Wednesday,Workingday,Clear,0.72,0.697,0.79,0.1343,51,412,463,463,537,463,2,4,4,244,2,728,309772,2,463
2011-07-13,fall,2011,July,19,Wednesday,Workingday,Clear,0.7,0.6667,0.79,0.1045,79,340,419,419,537,419,2,4,4,244,2,728,226789,2,419
2011-07-13,fall,2011,July,20,Wednesday,Workingday,Clear,0.7,0.6667,0.84,0.1642,61,281,342,342,537,342,2,4,4,244,0,728,164550,2,342
2011-07-13,fall,2011,July,21,Wednesday,Workingday,Clear,0.7,0.6667,0.79,0.1045,56,194,250,250,537,250,2,3,4,234,0,728,125445,2,250
2011-07-13,fall,2011,July,22,Wednesday,Workingday,Clear,0.68,0.6364,0.83,0.194,48,136,184,184,537,184,2,3,4,234,0,728,95612,2,184
2011-07-13,fall,2011,July,23,Wednesday,Workingday,Clear,0.66,0.6061,0.83,0.2537,33,83,116,116,537,116,2,2,3,223,0,728,63941,2,116
2011-07-14,fall,2011,July,0,Thursday,Workingday,Clear,0.66,0.6212,0.69,0.2985,14,32,46,46,536,46,2,2,3,223,0,726,39130,2,46
2011-07-14,fall,2011,July,1,Thursday,Workingday,Clear,0.66,0.6212,0.61,0.2537,4,21,25,25,536,25,2,1,3,213,0,724,24164,2,25
2011-07-14,fall,2011,July,2,Thursday,Workingday,Clear,0.64,0.6212,0.57,0.2985,3,7,10,10,536,10,2,1,3,213,0,715,16352,2,10
2011-07-14,fall,2011,July,3,Thursday,Workingday,Clear,0.62,0.6212,0.57,0.2985,1,5,6,6,536,6,2,1,3,213,0,697,8174,2,6
2011-07-14,fall,2011,July,4,Thursday,Workingday,Clear,0.62,0.6212,0.53,0.2537,0,6,6,6,536,6,2,1,3,213,0,697,4428,2,6
2011-07-14,fall,2011,July,5,Thursday,Workingday,Clear,0.6,0.6212,0.56,0.2239,6,22,28,28,536,28,2,1,3,213,0,717,14261,2,28
2011-07-14,fall,2011,July,6,Thursday,Workingday,Clear,0.6,0.6061,0.6,0.2239,14,116,130,130,536,130,2,2,3,223,0,725,55132,2,130
2011-07-14,fall,2011,July,7,Thursday,Workingday,Clear,0.62,0.6212,0.53,0.2537,23,311,334,334,536,334,2,4,3,243,2,727,154171,2,334
2011-07-14,fall,2011,July,8,Thursday,Workingday,Clear,0.64,0.6212,0.5,0.3582,53,433,486,486,536,486,2,4,3,243,2,727,261001,2,486
2011-07-14,fall,2011,July,9,Thursday,Workingday,Clear,0.68,0.6364,0.47,0.2836,29,195,224,224,536,224,2,3,4,234,2,727,159438,2,224
2011-07-14,fall,2011,July,10,Thursday,Workingday,Clear,0.7,0.6364,0.42,0.2537,32,95,127,127,536,127,2,2,4,224,2,727,126257,2,127
2011-07-14,fall,2011,July,11,Thursday,Workingday,Clear,0.72,0.6515,0.37,0.2239,38,110,148,148,536,148,2,3,4,234,2,727,151320,2,148
2011-07-14,fall,2011,July,12,Thursday,Workingday,Clear,0.74,0.6515,0.35,0.2537,51,172,223,223,536,223,2,3,4,234,2,728,184414,2,223
2011-07-14,fall,2011,July,13,Thursday,Workingday,Clear,0.76,0.6667,0.33,0.3284,39,138,177,177,536,177,2,3,4,234,2,729,184919,2,177
2011-07-14,fall,2011,July,14,Thursday,Workingday,Clear,0.74,0.6515,0.35,0.2836,49,129,178,178,536,178,2,3,4,234,2,729,175652,2,178
2011-07-14,fall,2011,July,15,Thursday,Workingday,Clear,0.76,0.6667,0.33,0.2985,42,138,180,180,536,180,2,3,4,234,2,729,183149,2,180
2011-07-14,fall,2011,July,16,Thursday,Workingday,Clear,0.76,0.6667,0.33,0.1343,43,231,274,274,536,274,2,3,4,234,2,730,227748,2,274
2011-07-14,fall,2011,July,17,Thursday,Workingday,Clear,0.74,0.6515,0.37,0.1343,78,517,595,595,536,595,2,4,4,244,2,730,336860,2,595
2011-07-14,fall,2011,July,18,Thursday,Workingday,Clear,0.72,0.6515,0.42,0.194,94,484,578,578,536,578,2,4,4,244,2,728,309772,2,578
2011-07-14,fall,2011,July,19,Thursday,Workingday,Clear,0.72,0.6515,0.39,0.2239,67,333,400,400,536,400,2,4,4,244,2,728,226789,2,400
2011-07-14,fall,2011,July,20,Thursday,Workingday,Clear,0.7,0.6364,0.42,0.2239,81,267,348,348,536,348,2,4,4,244,2,728,164550,2,348
2011-07-14,fall,2011,July,21,Thursday,Workingday,Clear,0.66,0.6212,0.5,0.1343,58,203,261,261,536,261,2,3,3,233,2,728,125445,2,261
2011-07-14,fall,2011,July,22,Thursday,Workingday,Clear,0.64,0.6212,0.57,0.0896,42,134,176,176,536,176,2,3,3,233,0,728,95612,2,176
2011-07-14,fall,2011,July,23,Thursday,Workingday,Clear,0.64,0.6061,0.65,0.2537,27,97,124,124,536,124,2,2,3,223,0,728,63941,2,124
2011-07-15,fall,2011,July,0,Friday,Workingday,Clear,0.62,0.5909,0.73,0.2239,23,57,80,80,535,80,2,2,3,223,0,726,39130,2,80
2011-07-15,fall,2011,July,1,Friday,Workingday,Clear,0.62,0.5909,0.73,0.194,7,13,20,20,535,20,2,1,3,213,0,724,24164,2,20
2011-07-15,fall,2011,July,2,Friday,Workingday,Clear,0.6,0.5758,0.78,0.1642,16,22,38,38,535,38,2,1,3,213,0,715,16352,2,38
2011-07-15,fall,2011,July,3,Friday,Workingday,Clear,0.6,0.5909,0.73,0.194,1,6,7,7,535,7,2,1,3,213,0,697,8174,2,7
2011-07-15,fall,2011,July,4,Friday,Workingday,Clear,0.6,0.5909,0.73,0.1642,2,8,10,10,535,10,2,1,3,213,0,697,4428,2,10
2011-07-15,fall,2011,July,5,Friday,Workingday,Clear,0.6,0.5909,0.73,0.1343,7,16,23,23,535,23,2,1,3,213,0,717,14261,2,23
2011-07-15,fall,2011,July,6,Friday,Workingday,Mist,0.6,0.5909,0.73,0.1045,12,108,120,120,535,120,2,2,3,223,0,725,55132,2,120
2011-07-15,fall,2011,July,7,Friday,Workingday,Clear,0.64,0.6061,0.65,0.1045,17,257,274,274,535,274,2,3,3,233,0,727,154171,2,274
2011-07-15,fall,2011,July,8,Friday,Workingday,Clear,0.64,0.6061,0.65,0.2537,50,514,564,564,535,564,2,4,3,243,2,727,261001,2,564
2011-07-15,fall,2011,July,9,Friday,Workingday,Clear,0.68,0.6364,0.54,0.194,31,176,207,207,535,207,2,3,4,234,2,727,159438,2,207
2011-07-15,fall,2011,July,10,Friday,Workingday,Mist,0.66,0.6212,0.61,0.1642,59,107,166,166,535,166,2,3,3,233,0,727,126257,2,166
2011-07-15,fall,2011,July,11,Friday,Workingday,Clear,0.7,0.6515,0.54,0.1343,73,137,210,210,535,210,2,3,4,234,2,727,151320,2,210
2011-07-15,fall,2011,July,12,Friday,Workingday,Clear,0.7,0.6515,0.48,0.194,61,177,238,238,535,238,2,3,4,234,2,728,184414,2,238
2011-07-15,fall,2011,July,13,Friday,Workingday,Clear,0.7,0.6515,0.54,0.194,85,162,247,247,535,247,2,3,4,234,2,729,184919,2,247
2011-07-15,fall,2011,July,14,Friday,Workingday,Clear,0.7,0.6515,0.51,0.194,105,160,265,265,535,265,2,3,4,234,2,729,175652,2,265
2011-07-15,fall,2011,July,15,Friday,Workingday,Clear,0.72,0.6515,0.45,0.1642,74,163,237,237,535,237,2,3,4,234,2,729,183149,2,237
2011-07-15,fall,2011,July,16,Friday,Workingday,Clear,0.72,0.6667,0.51,0.194,96,265,361,361,535,361,2,4,4,244,2,730,227748,2,361
2011-07-15,fall,2011,July,17,Friday,Workingday,Clear,0.74,0.6667,0.42,0.2537,104,483,587,587,535,587,2,4,4,244,2,730,336860,2,587
2011-07-15,fall,2011,July,18,Friday,Workingday,Clear,0.72,0.6515,0.45,0.2239,102,394,496,496,535,496,2,4,4,244,2,728,309772,2,496
2011-07-15,fall,2011,July,19,Friday,Workingday,Clear,0.7,0.6364,0.45,0.2239,114,280,394,394,535,394,2,4,4,244,2,728,226789,2,394
2011-07-15,fall,2011,July,20,Friday,Workingday,Clear,0.7,0.6515,0.51,0.2239,92,251,343,343,535,343,2,4,4,244,2,728,164550,2,343
2011-07-15,fall,2011,July,21,Friday,Workingday,Clear,0.66,0.6212,0.54,0.1045,75,186,261,261,535,261,2,3,3,233,2,728,125445,2,261
2011-07-15,fall,2011,July,22,Friday,Workingday,Clear,0.66,0.6212,0.57,0.2239,71,152,223,223,535,223,2,3,3,233,2,728,95612,2,223
2011-07-15,fall,2011,July,23,Friday,Workingday,Clear,0.64,0.6212,0.61,0.1642,41,126,167,167,535,167,2,3,3,233,0,728,63941,2,167
2011-07-16,fall,2011,July,0,Saturday,Holiday,Clear,0.62,0.6061,0.65,0.194,42,68,110,110,534,110,2,2,3,223,0,726,39130,2,110
2011-07-16,fall,2011,July,1,Saturday,Holiday,Clear,0.6,0.5909,0.69,0.1045,24,51,75,75,534,75,2,2,3,223,0,724,24164,2,75
2011-07-16,fall,2011,July,2,Saturday,Holiday,Clear,0.6,0.5909,0.73,0.1343,10,48,58,58,534,58,2,2,3,223,0,715,16352,2,58
2011-07-16,fall,2011,July,3,Saturday,Holiday,Clear,0.6,0.5758,0.78,0.1343,6,20,26,26,534,26,2,1,3,213,0,697,8174,2,26
2011-07-16,fall,2011,July,4,Saturday,Holiday,Clear,0.6,0.5909,0.73,0.0896,9,7,16,16,534,16,2,1,3,213,0,697,4428,2,16
2011-07-16,fall,2011,July,5,Saturday,Holiday,Clear,0.58,0.5455,0.78,0.0896,4,6,10,10,534,10,2,1,3,213,0,717,14261,2,10
2011-07-16,fall,2011,July,6,Saturday,Holiday,Clear,0.6,0.5758,0.78,0.1642,16,21,37,37,534,37,2,1,3,213,0,725,55132,2,37
2011-07-16,fall,2011,July,7,Saturday,Holiday,Clear,0.62,0.5909,0.73,0.1343,14,38,52,52,534,52,2,2,3,223,0,727,154171,2,52
2011-07-16,fall,2011,July,8,Saturday,Holiday,Clear,0.66,0.6212,0.65,0.1642,37,90,127,127,534,127,2,2,3,223,0,727,261001,2,127
2011-07-16,fall,2011,July,9,Saturday,Holiday,Clear,0.7,0.6515,0.54,0.2239,72,150,222,222,534,222,2,3,4,234,2,727,159438,2,222
2011-07-16,fall,2011,July,10,Saturday,Holiday,Clear,0.72,0.6667,0.54,0.194,114,208,322,322,534,322,2,4,4,244,2,727,126257,2,322
2011-07-16,fall,2011,July,11,Saturday,Holiday,Clear,0.74,0.6667,0.48,0.2239,171,225,396,396,534,396,2,4,4,244,2,727,151320,2,396
2011-07-16,fall,2011,July,12,Saturday,Holiday,Clear,0.76,0.6818,0.43,0.2836,187,276,463,463,534,463,2,4,4,244,2,728,184414,2,463
2011-07-16,fall,2011,July,13,Saturday,Holiday,Clear,0.76,0.6818,0.45,0.2985,221,276,497,497,534,497,2,4,4,244,2,729,184919,2,497
2011-07-16,fall,2011,July,14,Saturday,Holiday,Clear,0.74,0.6667,0.45,0.2985,201,232,433,433,534,433,2,4,4,244,2,729,175652,2,433
2011-07-16,fall,2011,July,15,Saturday,Holiday,Clear,0.76,0.6818,0.45,0.3284,205,223,428,428,534,428,2,4,4,244,2,729,183149,2,428
2011-07-16,fall,2011,July,16,Saturday,Holiday,Clear,0.76,0.6818,0.45,0.2836,183,242,425,425,534,425,2,4,4,244,2,730,227748,2,425
2011-07-16,fall,2011,July,17,Saturday,Holiday,Clear,0.76,0.6818,0.45,0.2239,234,241,475,475,534,475,2,4,4,244,2,730,336860,2,475
2011-07-16,fall,2011,July,18,Saturday,Holiday,Clear,0.76,0.6818,0.45,0.2836,185,243,428,428,534,428,2,4,4,244,2,728,309772,2,428
2011-07-16,fall,2011,July,19,Saturday,Holiday,Clear,0.74,0.6818,0.48,0.194,164,242,406,406,534,406,2,4,4,244,2,728,226789,2,406
2011-07-16,fall,2011,July,20,Saturday,Holiday,Clear,0.72,0.6667,0.51,0.2239,108,188,296,296,534,296,2,4,4,244,2,728,164550,2,296
2011-07-16,fall,2011,July,21,Saturday,Holiday,Clear,0.7,0.6515,0.58,0.2239,85,167,252,252,534,252,2,3,4,234,2,728,125445,2,252
2011-07-16,fall,2011,July,22,Saturday,Holiday,Clear,0.7,0.6515,0.65,0.2836,65,136,201,201,534,201,2,3,4,234,2,728,95612,2,201
2011-07-16,fall,2011,July,23,Saturday,Holiday,Clear,0.68,0.6364,0.61,0.2239,61,107,168,168,534,168,2,3,4,234,2,728,63941,2,168
2011-07-17,fall,2011,July,0,Sunday,Holiday,Clear,0.66,0.6212,0.65,0.2239,34,91,125,125,533,125,2,2,3,223,0,726,39130,2,125
2011-07-17,fall,2011,July,1,Sunday,Holiday,Clear,0.64,0.6061,0.69,0.194,16,86,102,102,533,102,2,2,3,223,0,724,24164,2,102
2011-07-17,fall,2011,July,2,Sunday,Holiday,Clear,0.64,0.6061,0.69,0.2239,28,66,94,94,533,94,2,2,3,223,0,715,16352,2,94
2011-07-17,fall,2011,July,3,Sunday,Holiday,Clear,0.64,0.6061,0.69,0.2239,21,26,47,47,533,47,2,2,3,223,0,697,8174,2,47
2011-07-17,fall,2011,July,4,Sunday,Holiday,Clear,0.62,0.5909,0.73,0.1642,4,6,10,10,533,10,2,1,3,213,0,697,4428,2,10
2011-07-17,fall,2011,July,5,Sunday,Holiday,Clear,0.64,0.6061,0.69,0.2239,4,8,12,12,533,12,2,1,3,213,0,717,14261,2,12
2011-07-17,fall,2011,July,6,Sunday,Holiday,Clear,0.62,0.5909,0.73,0.1642,10,11,21,21,533,21,2,1,3,213,0,725,55132,2,21
2011-07-17,fall,2011,July,7,Sunday,Holiday,Clear,0.64,0.6061,0.73,0.1642,20,30,50,50,533,50,2,2,3,223,0,727,154171,2,50
2011-07-17,fall,2011,July,8,Sunday,Holiday,Clear,0.68,0.6364,0.65,0.2239,45,73,118,118,533,118,2,2,4,224,0,727,261001,2,118
2011-07-17,fall,2011,July,9,Sunday,Holiday,Clear,0.72,0.6667,0.58,0.2239,74,110,184,184,533,184,2,3,4,234,2,727,159438,2,184
2011-07-17,fall,2011,July,10,Sunday,Holiday,Clear,0.74,0.6818,0.6,0.2239,127,177,304,304,533,304,2,4,4,244,2,727,126257,2,304
2011-07-17,fall,2011,July,11,Sunday,Holiday,Clear,0.76,0.697,0.55,0.2836,147,244,391,391,533,391,2,4,4,244,2,727,151320,2,391
2011-07-17,fall,2011,July,12,Sunday,Holiday,Clear,0.76,0.697,0.55,0.2836,177,243,420,420,533,420,2,4,4,244,2,728,184414,2,420
2011-07-17,fall,2011,July,13,Sunday,Holiday,Clear,0.8,0.7424,0.49,0.2985,200,272,472,472,533,472,2,4,4,244,2,729,184919,2,472
2011-07-17,fall,2011,July,14,Sunday,Holiday,Clear,0.8,0.7424,0.49,0.3582,168,262,430,430,533,430,2,4,4,244,2,729,175652,2,430
2011-07-17,fall,2011,July,15,Sunday,Holiday,Clear,0.82,0.7424,0.43,0.2985,129,195,324,324,533,324,2,4,4,244,2,729,183149,2,324
2011-07-17,fall,2011,July,16,Sunday,Holiday,Clear,0.8,0.7273,0.46,0.2985,129,188,317,317,533,317,2,4,4,244,2,730,227748,2,317
2011-07-17,fall,2011,July,17,Sunday,Holiday,Clear,0.8,0.7424,0.49,0.3881,133,236,369,369,533,369,2,4,4,244,2,730,336860,2,369
2011-07-17,fall,2011,July,18,Sunday,Holiday,Clear,0.8,0.7273,0.46,0.2985,147,243,390,390,533,390,2,4,4,244,2,728,309772,2,390
2011-07-17,fall,2011,July,19,Sunday,Holiday,Clear,0.76,0.697,0.55,0.2836,145,234,379,379,533,379,2,4,4,244,2,728,226789,2,379
2011-07-17,fall,2011,July,20,Sunday,Holiday,Clear,0.76,0.7121,0.58,0.2537,85,177,262,262,533,262,2,3,4,234,2,728,164550,2,262
2011-07-17,fall,2011,July,21,Sunday,Holiday,Clear,0.74,0.6818,0.62,0.2239,59,148,207,207,533,207,2,3,4,234,2,728,125445,2,207
2011-07-17,fall,2011,July,22,Sunday,Holiday,Clear,0.72,0.6818,0.66,0.2239,65,116,181,181,533,181,2,3,4,234,2,728,95612,2,181
2011-07-17,fall,2011,July,23,Sunday,Holiday,Clear,0.7,0.6667,0.74,0.1343,39,54,93,93,533,93,2,2,4,224,0,728,63941,2,93
2011-07-18,fall,2011,July,0,Monday,Workingday,Clear,0.7,0.6667,0.74,0.1343,21,30,51,51,532,51,2,2,4,224,0,726,39130,2,51
2011-07-18,fall,2011,July,1,Monday,Workingday,Clear,0.7,0.6667,0.74,0.2239,17,8,25,25,532,25,2,1,4,214,0,724,24164,2,25
2011-07-18,fall,2011,July,2,Monday,Workingday,Clear,0.66,0.6061,0.83,0.2239,2,8,10,10,532,10,2,1,3,213,0,715,16352,2,10
2011-07-18,fall,2011,July,3,Monday,Workingday,Clear,0.66,0.6061,0.78,0.194,3,4,7,7,532,7,2,1,3,213,0,697,8174,2,7
2011-07-18,fall,2011,July,4,Monday,Workingday,Clear,0.64,0.5909,0.78,0.1642,1,3,4,4,532,4,2,1,3,213,0,697,4428,2,4
2011-07-18,fall,2011,July,5,Monday,Workingday,Clear,0.64,0.5909,0.78,0.1045,2,15,17,17,532,17,2,1,3,213,0,717,14261,2,17
2011-07-18,fall,2011,July,6,Monday,Workingday,Clear,0.64,0.5758,0.83,0.1045,10,95,105,105,532,105,2,2,3,223,0,725,55132,2,105
2011-07-18,fall,2011,July,7,Monday,Workingday,Clear,0.68,0.6364,0.74,0.2239,22,255,277,277,532,277,2,3,4,234,0,727,154171,2,277
2011-07-18,fall,2011,July,8,Monday,Workingday,Clear,0.7,0.6515,0.7,0.194,18,329,347,347,532,347,2,4,4,244,2,727,261001,2,347
2011-07-18,fall,2011,July,9,Monday,Workingday,Clear,0.74,0.697,0.67,0.2239,33,170,203,203,532,203,2,3,4,234,0,727,159438,2,203
2011-07-18,fall,2011,July,10,Monday,Workingday,Clear,0.76,0.7121,0.62,0.194,52,78,130,130,532,130,2,2,4,224,0,727,126257,2,130
2011-07-18,fall,2011,July,11,Monday,Workingday,Clear,0.8,0.7576,0.55,0.0896,42,99,141,141,532,141,2,2,4,224,2,727,151320,2,141
2011-07-18,fall,2011,July,12,Monday,Workingday,Clear,0.8,0.7727,0.59,0.194,39,126,165,165,532,165,2,3,4,234,2,728,184414,2,165
2011-07-18,fall,2011,July,13,Monday,Workingday,Clear,0.82,0.7879,0.56,0.2537,27,125,152,152,532,152,2,3,4,234,2,729,184919,2,152
2011-07-18,fall,2011,July,14,Monday,Workingday,Clear,0.82,0.7879,0.56,0.3284,32,106,138,138,532,138,2,2,4,224,2,729,175652,2,138
2011-07-18,fall,2011,July,15,Monday,Workingday,Clear,0.84,0.803,0.53,0.3284,53,111,164,164,532,164,2,3,4,234,2,729,183149,2,164
2011-07-18,fall,2011,July,16,Monday,Workingday,Clear,0.84,0.803,0.53,0.2836,45,220,265,265,532,265,2,3,4,234,2,730,227748,2,265
2011-07-18,fall,2011,July,17,Monday,Workingday,Clear,0.84,0.7879,0.49,0.3284,72,473,545,545,532,545,2,4,4,244,2,730,336860,2,545
2011-07-18,fall,2011,July,18,Monday,Workingday,Clear,0.82,0.7727,0.49,0.3582,80,478,558,558,532,558,2,4,4,244,2,728,309772,2,558
2011-07-18,fall,2011,July,19,Monday,Workingday,Clear,0.8,0.7576,0.55,0.2239,63,335,398,398,532,398,2,4,4,244,2,728,226789,2,398
2011-07-18,fall,2011,July,20,Monday,Workingday,Clear,0.78,0.7424,0.59,0.2239,91,232,323,323,532,323,2,4,4,244,2,728,164550,2,323
2011-07-18,fall,2011,July,21,Monday,Workingday,Clear,0.74,0.697,0.66,0.194,48,154,202,202,532,202,2,3,4,234,2,728,125445,2,202
2011-07-18,fall,2011,July,22,Monday,Workingday,Clear,0.76,0.7273,0.66,0.2239,36,104,140,140,532,140,2,2,4,224,0,728,95612,2,140
2011-07-18,fall,2011,July,23,Monday,Workingday,Clear,0.74,0.697,0.66,0.1642,32,59,91,91,532,91,2,2,4,224,0,728,63941,2,91
2011-07-19,fall,2011,July,0,Tuesday,Workingday,Clear,0.74,0.697,0.66,0.1045,25,26,51,51,531,51,2,2,4,224,0,726,39130,2,51
2011-07-19,fall,2011,July,1,Tuesday,Workingday,Mist,0.74,0.697,0.66,0.1343,7,6,13,13,531,13,2,1,4,214,0,724,24164,2,13
2011-07-19,fall,2011,July,2,Tuesday,Workingday,Clear,0.72,0.6818,0.7,0.1642,9,4,13,13,531,13,2,1,4,214,0,715,16352,2,13
2011-07-19,fall,2011,July,3,Tuesday,Workingday,Clear,0.72,0.6818,0.7,0.1642,2,1,3,3,531,3,2,1,4,214,0,697,8174,2,3
2011-07-19,fall,2011,July,4,Tuesday,Workingday,Clear,0.72,0.6818,0.7,0.1343,1,4,5,5,531,5,2,1,4,214,0,697,4428,2,5
2011-07-19,fall,2011,July,5,Tuesday,Workingday,Mist,0.7,0.6667,0.74,0.1045,0,19,19,19,531,19,2,1,4,214,0,717,14261,2,19
2011-07-19,fall,2011,July,6,Tuesday,Workingday,Mist,0.72,0.697,0.74,0.1045,8,126,134,134,531,134,2,2,4,224,0,725,55132,2,134
2011-07-19,fall,2011,July,7,Tuesday,Workingday,Mist,0.74,0.697,0.7,0.1642,28,287,315,315,531,315,2,4,4,244,2,727,154171,2,315
2011-07-19,fall,2011,July,8,Tuesday,Workingday,Mist,0.76,0.7273,0.7,0.1642,31,381,412,412,531,412,2,4,4,244,2,727,261001,2,412
2011-07-19,fall,2011,July,9,Tuesday,Workingday,Mist,0.8,0.7879,0.63,0.1343,22,177,199,199,531,199,2,3,4,234,0,727,159438,2,199
2011-07-19,fall,2011,July,10,Tuesday,Workingday,Mist,0.82,0.7879,0.56,0.1642,29,112,141,141,531,141,2,2,4,224,2,727,126257,2,141
2011-07-19,fall,2011,July,11,Tuesday,Workingday,Clear,0.82,0.803,0.59,0.0,29,98,127,127,531,127,2,2,4,224,0,727,151320,2,127
2011-07-19,fall,2011,July,12,Tuesday,Workingday,Clear,0.84,0.8182,0.56,0.0896,26,127,153,153,531,153,2,3,4,234,2,728,184414,2,153
2011-07-19,fall,2011,July,13,Tuesday,Workingday,Clear,0.86,0.8333,0.53,0.1045,33,139,172,172,531,172,2,3,4,234,2,729,184919,2,172
2011-07-19,fall,2011,July,14,Tuesday,Workingday,Clear,0.86,0.8182,0.5,0.194,41,111,152,152,531,152,2,3,4,234,2,729,175652,2,152
2011-07-19,fall,2011,July,15,Tuesday,Workingday,Clear,0.88,0.8182,0.44,0.194,48,110,158,158,531,158,2,3,4,234,2,729,183149,2,158
2011-07-19,fall,2011,July,16,Tuesday,Workingday,Clear,0.9,0.8485,0.42,0.2985,61,216,277,277,531,277,2,3,4,234,2,730,227748,2,277
2011-07-19,fall,2011,July,17,Tuesday,Workingday,Clear,0.8,0.803,0.66,0.0,68,445,513,513,531,513,2,4,4,244,2,730,336860,2,513
2011-07-19,fall,2011,July,18,Tuesday,Workingday,Clear,0.8,0.803,0.66,0.1343,80,450,530,530,531,530,2,4,4,244,2,728,309772,2,530
2011-07-19,fall,2011,July,19,Tuesday,Workingday,Clear,0.76,0.7424,0.75,0.194,54,334,388,388,531,388,2,4,4,244,2,728,226789,2,388
2011-07-19,fall,2011,July,20,Tuesday,Workingday,Clear,0.74,0.7273,0.74,0.0896,48,229,277,277,531,277,2,3,4,234,0,728,164550,2,277
2011-07-19,fall,2011,July,21,Tuesday,Workingday,Clear,0.74,0.7121,0.74,0.1343,47,194,241,241,531,241,2,3,4,234,0,728,125445,2,241
2011-07-19,fall,2011,July,22,Tuesday,Workingday,Clear,0.74,0.7121,0.74,0.0,36,120,156,156,531,156,2,3,4,234,0,728,95612,2,156
2011-07-19,fall,2011,July,23,Tuesday,Workingday,Light Snow,0.72,0.697,0.79,0.1642,19,73,92,92,531,92,2,2,4,224,0,728,63941,2,92
2011-07-20,fall,2011,July,0,Wednesday,Workingday,Clear,0.7,0.6667,0.84,0.1045,11,29,40,40,530,40,2,1,4,214,0,726,39130,2,40
2011-07-20,fall,2011,July,1,Wednesday,Workingday,Clear,0.7,0.6667,0.84,0.0,4,7,11,11,530,11,2,1,4,214,0,724,24164,2,11
2011-07-20,fall,2011,July,2,Wednesday,Workingday,Clear,0.7,0.6667,0.84,0.0,2,7,9,9,530,9,2,1,4,214,0,715,16352,2,9
2011-07-20,fall,2011,July,3,Wednesday,Workingday,Clear,0.7,0.6667,0.84,0.1045,2,4,6,6,530,6,2,1,4,214,0,697,8174,2,6
2011-07-20,fall,2011,July,4,Wednesday,Workingday,Clear,0.68,0.6364,0.83,0.0,0,4,4,4,530,4,2,1,4,214,0,697,4428,2,4
2011-07-20,fall,2011,July,5,Wednesday,Workingday,Clear,0.68,0.6364,0.83,0.1045,4,19,23,23,530,23,2,1,4,214,0,717,14261,2,23
2011-07-20,fall,2011,July,6,Wednesday,Workingday,Mist,0.68,0.6364,0.89,0.1045,5,111,116,116,530,116,2,2,4,224,0,725,55132,2,116
2011-07-20,fall,2011,July,7,Wednesday,Workingday,Mist,0.7,0.6667,0.84,0.1045,27,276,303,303,530,303,2,4,4,244,0,727,154171,2,303
2011-07-20,fall,2011,July,8,Wednesday,Workingday,Clear,0.74,0.7121,0.74,0.0,34,404,438,438,530,438,2,4,4,244,2,727,261001,2,438
2011-07-20,fall,2011,July,9,Wednesday,Workingday,Clear,0.74,0.697,0.7,0.0896,28,181,209,209,530,209,2,3,4,234,0,727,159438,2,209
2011-07-20,fall,2011,July,10,Wednesday,Workingday,Clear,0.76,0.7273,0.7,0.0,34,76,110,110,530,110,2,2,4,224,0,727,126257,2,110
2011-07-20,fall,2011,July,11,Wednesday,Workingday,Clear,0.8,0.7879,0.63,0.0896,26,116,142,142,530,142,2,2,4,224,0,727,151320,2,142
2011-07-20,fall,2011,July,12,Wednesday,Workingday,Clear,0.82,0.803,0.59,0.0,28,121,149,149,530,149,2,3,4,234,0,728,184414,2,149
2011-07-20,fall,2011,July,13,Wednesday,Workingday,Clear,0.84,0.8182,0.56,0.194,23,97,120,120,530,120,2,2,4,224,2,729,184919,2,120
2011-07-20,fall,2011,July,14,Wednesday,Workingday,Clear,0.86,0.8333,0.53,0.2239,44,83,127,127,530,127,2,2,4,224,2,729,175652,2,127
2011-07-20,fall,2011,July,15,Wednesday,Workingday,Clear,0.86,0.8182,0.5,0.1642,36,102,138,138,530,138,2,2,4,224,2,729,183149,2,138
2011-07-20,fall,2011,July,16,Wednesday,Workingday,Clear,0.84,0.8182,0.56,0.0,30,204,234,234,530,234,2,3,4,234,2,730,227748,2,234
2011-07-20,fall,2011,July,17,Wednesday,Workingday,Clear,0.84,0.8333,0.59,0.194,50,405,455,455,530,455,2,4,4,244,2,730,336860,2,455
2011-07-20,fall,2011,July,18,Wednesday,Workingday,Clear,0.84,0.8333,0.59,0.2239,68,429,497,497,530,497,2,4,4,244,2,728,309772,2,497
2011-07-20,fall,2011,July,19,Wednesday,Workingday,Clear,0.82,0.8485,0.67,0.1642,59,323,382,382,530,382,2,4,4,244,2,728,226789,2,382
2011-07-20,fall,2011,July,20,Wednesday,Workingday,Clear,0.8,0.8333,0.75,0.2239,45,264,309,309,530,309,2,4,4,244,2,728,164550,2,309
2011-07-20,fall,2011,July,21,Wednesday,Workingday,Clear,0.8,0.803,0.66,0.1642,33,209,242,242,530,242,2,3,4,234,2,728,125445,2,242
2011-07-20,fall,2011,July,22,Wednesday,Workingday,Clear,0.78,0.7727,0.7,0.2239,25,144,169,169,530,169,2,3,4,234,0,728,95612,2,169
2011-07-20,fall,2011,July,23,Wednesday,Workingday,Clear,0.76,0.7424,0.75,0.2537,26,73,99,99,530,99,2,2,4,224,0,728,63941,2,99
2011-07-21,fall,2011,July,0,Thursday,Workingday,Mist,0.76,0.7424,0.75,0.194,13,29,42,42,529,42,2,2,4,224,0,726,39130,2,42
2011-07-21,fall,2011,July,1,Thursday,Workingday,Mist,0.74,0.7273,0.84,0.2239,5,16,21,21,529,21,2,1,4,214,0,724,24164,2,21
2011-07-21,fall,2011,July,2,Thursday,Workingday,Mist,0.74,0.7273,0.84,0.2239,2,4,6,6,529,6,2,1,4,214,0,715,16352,2,6
2011-07-21,fall,2011,July,3,Thursday,Workingday,Mist,0.74,0.7121,0.79,0.1343,1,5,6,6,529,6,2,1,4,214,0,697,8174,2,6
2011-07-21,fall,2011,July,4,Thursday,Workingday,Mist,0.72,0.7121,0.84,0.1045,0,4,4,4,529,4,2,1,4,214,0,697,4428,2,4
2011-07-21,fall,2011,July,5,Thursday,Workingday,Mist,0.72,0.7121,0.84,0.1045,2,16,18,18,529,18,2,1,4,214,0,717,14261,2,18
2011-07-21,fall,2011,July,6,Thursday,Workingday,Mist,0.72,0.7121,0.84,0.1045,6,111,117,117,529,117,2,2,4,224,0,725,55132,2,117
2011-07-21,fall,2011,July,7,Thursday,Workingday,Mist,0.74,0.7273,0.84,0.1343,23,251,274,274,529,274,2,3,4,234,0,727,154171,2,274
2011-07-21,fall,2011,July,8,Thursday,Workingday,Mist,0.76,0.7576,0.79,0.1642,23,358,381,381,529,381,2,4,4,244,2,727,261001,2,381
2011-07-21,fall,2011,July,9,Thursday,Workingday,Mist,0.8,0.8182,0.75,0.2537,34,166,200,200,529,200,2,3,4,234,0,727,159438,2,200
2011-07-21,fall,2011,July,10,Thursday,Workingday,Mist,0.82,0.8636,0.71,0.2239,31,47,78,78,529,78,2,2,4,224,0,727,126257,2,78
2011-07-21,fall,2011,July,11,Thursday,Workingday,Mist,0.86,0.8939,0.63,0.2985,27,79,106,106,529,106,2,2,4,224,2,727,151320,2,106
2011-07-21,fall,2011,July,12,Thursday,Workingday,Clear,0.88,0.8939,0.56,0.3284,29,106,135,135,529,135,2,2,4,224,2,728,184414,2,135
2011-07-21,fall,2011,July,13,Thursday,Workingday,Clear,0.88,0.8939,0.56,0.2985,21,81,102,102,529,102,2,2,4,224,2,729,184919,2,102
2011-07-21,fall,2011,July,14,Thursday,Workingday,Clear,0.9,0.8939,0.5,0.3582,50,97,147,147,529,147,2,3,4,234,2,729,175652,2,147
2011-07-21,fall,2011,July,15,Thursday,Workingday,Clear,0.9,0.9242,0.53,0.2537,40,93,133,133,529,133,2,2,4,224,2,729,183149,2,133
2011-07-21,fall,2011,July,16,Thursday,Workingday,Clear,0.92,0.9242,0.48,0.2836,43,167,210,210,529,210,2,3,4,234,2,730,227748,2,210
2011-07-21,fall,2011,July,17,Thursday,Workingday,Clear,0.92,0.9091,0.45,0.2985,40,374,414,414,529,414,2,4,4,244,2,730,336860,2,414
2011-07-21,fall,2011,July,18,Thursday,Workingday,Clear,0.9,0.8939,0.5,0.2836,39,343,382,382,529,382,2,4,4,244,2,728,309772,2,382
2011-07-21,fall,2011,July,19,Thursday,Workingday,Clear,0.86,0.9242,0.67,0.2836,51,233,284,284,529,284,2,4,4,244,2,728,226789,2,284
2011-07-21,fall,2011,July,20,Thursday,Workingday,Clear,0.84,0.8939,0.71,0.2239,38,199,237,237,529,237,2,3,4,234,2,728,164550,2,237
2011-07-21,fall,2011,July,21,Thursday,Workingday,Clear,0.82,0.8939,0.75,0.2239,38,187,225,225,529,225,2,3,4,234,2,728,125445,2,225
2011-07-21,fall,2011,July,22,Thursday,Workingday,Clear,0.82,0.8636,0.71,0.1642,36,113,149,149,529,149,2,3,4,234,0,728,95612,2,149
2011-07-21,fall,2011,July,23,Thursday,Workingday,Clear,0.8,0.8182,0.71,0.1642,40,73,113,113,529,113,2,2,4,224,0,728,63941,2,113
2011-07-22,fall,2011,July,0,Friday,Workingday,Clear,0.82,0.8333,0.63,0.1343,9,51,60,60,528,60,2,2,4,224,0,726,39130,2,60
2011-07-22,fall,2011,July,1,Friday,Workingday,Clear,0.8,0.7879,0.63,0.0,7,17,24,24,528,24,2,1,4,214,0,724,24164,2,24
2011-07-22,fall,2011,July,2,Friday,Workingday,Clear,0.78,0.803,0.79,0.1343,0,14,14,14,528,14,2,1,4,214,0,715,16352,2,14
2011-07-22,fall,2011,July,3,Friday,Workingday,Clear,0.78,0.7879,0.75,0.1045,1,6,7,7,528,7,2,1,4,214,0,697,8174,2,7
2011-07-22,fall,2011,July,4,Friday,Workingday,Clear,0.76,0.7424,0.75,0.1045,8,5,13,13,528,13,2,1,4,214,0,697,4428,2,13
2011-07-22,fall,2011,July,5,Friday,Workingday,Clear,0.74,0.7121,0.79,0.1045,2,17,19,19,528,19,2,1,4,214,0,717,14261,2,19
2011-07-22,fall,2011,July,6,Friday,Workingday,Clear,0.76,0.7424,0.75,0.0896,13,83,96,96,528,96,2,2,4,224,0,725,55132,2,96
2011-07-22,fall,2011,July,7,Friday,Workingday,Mist,0.8,0.803,0.66,0.1045,20,232,252,252,528,252,2,3,4,234,0,727,154171,2,252
2011-07-22,fall,2011,July,8,Friday,Workingday,Mist,0.84,0.8485,0.63,0.1642,30,292,322,322,528,322,2,4,4,244,2,727,261001,2,322
2011-07-22,fall,2011,July,9,Friday,Workingday,Clear,0.86,0.8939,0.63,0.0896,31,177,208,208,528,208,2,3,4,234,2,727,159438,2,208
2011-07-22,fall,2011,July,10,Friday,Workingday,Clear,0.9,0.9242,0.53,0.0896,32,83,115,115,528,115,2,2,4,224,2,727,126257,2,115
2011-07-22,fall,2011,July,11,Friday,Workingday,Clear,0.9,0.8939,0.5,0.1045,23,86,109,109,528,109,2,2,4,224,2,727,151320,2,109
2011-07-22,fall,2011,July,12,Friday,Workingday,Clear,0.94,0.9545,0.48,0.1642,20,95,115,115,528,115,2,2,4,224,2,728,184414,2,115
2011-07-22,fall,2011,July,13,Friday,Workingday,Clear,0.94,0.9848,0.51,0.1642,25,98,123,123,528,123,2,2,4,224,2,729,184919,2,123
2011-07-22,fall,2011,July,14,Friday,Workingday,Clear,0.96,1.0,0.48,0.2985,24,77,101,101,528,101,2,2,4,224,2,729,175652,2,101
2011-07-22,fall,2011,July,15,Friday,Workingday,Clear,0.94,0.9848,0.51,0.2985,32,101,133,133,528,133,2,2,4,224,2,729,183149,2,133
2011-07-22,fall,2011,July,16,Friday,Workingday,Light Snow,0.9,0.8333,0.39,0.2985,29,153,182,182,528,182,2,3,4,234,2,730,227748,2,182
2011-07-22,fall,2011,July,17,Friday,Workingday,Clear,0.88,0.8485,0.47,0.1045,35,271,306,306,528,306,2,4,4,244,2,730,336860,2,306
2011-07-22,fall,2011,July,18,Friday,Workingday,Clear,0.9,0.8182,0.37,0.1642,34,250,284,284,528,284,2,4,4,244,2,728,309772,2,284
2011-07-22,fall,2011,July,19,Friday,Workingday,Mist,0.86,0.7879,0.41,0.1045,40,210,250,250,528,250,2,3,4,234,2,728,226789,2,250
2011-07-22,fall,2011,July,20,Friday,Workingday,Clear,0.84,0.8182,0.56,0.0,46,166,212,212,528,212,2,3,4,234,2,728,164550,2,212
2011-07-22,fall,2011,July,21,Friday,Workingday,Clear,0.82,0.803,0.59,0.0896,38,152,190,190,528,190,2,3,4,234,2,728,125445,2,190
2011-07-22,fall,2011,July,22,Friday,Workingday,Mist,0.84,0.7879,0.49,0.0896,44,105,149,149,528,149,2,3,4,234,2,728,95612,2,149
2011-07-22,fall,2011,July,23,Friday,Workingday,Clear,0.8,0.7879,0.63,0.194,19,84,103,103,528,103,2,2,4,224,0,728,63941,2,103
2011-07-23,fall,2011,July,0,Saturday,Holiday,Clear,0.82,0.7879,0.56,0.0,16,85,101,101,527,101,2,2,4,224,0,726,39130,2,101
2011-07-23,fall,2011,July,1,Saturday,Holiday,Clear,0.82,0.7727,0.52,0.1045,13,57,70,70,527,70,2,2,4,224,0,724,24164,2,70
2011-07-23,fall,2011,July,2,Saturday,Holiday,Clear,0.82,0.7727,0.52,0.0,13,48,61,61,527,61,2,2,4,224,0,715,16352,2,61
2011-07-23,fall,2011,July,3,Saturday,Holiday,Clear,0.78,0.7576,0.66,0.0896,6,16,22,22,527,22,2,1,4,214,0,697,8174,2,22
2011-07-23,fall,2011,July,4,Saturday,Holiday,Clear,0.76,0.7273,0.66,0.1045,5,4,9,9,527,9,2,1,4,214,0,697,4428,2,9
2011-07-23,fall,2011,July,5,Saturday,Holiday,Clear,0.76,0.7121,0.62,0.1343,1,6,7,7,527,7,2,1,4,214,0,717,14261,2,7
2011-07-23,fall,2011,July,6,Saturday,Holiday,Clear,0.8,0.7424,0.52,0.1343,6,19,25,25,527,25,2,1,4,214,0,725,55132,2,25
2011-07-23,fall,2011,July,7,Saturday,Holiday,Clear,0.8,0.7424,0.52,0.1045,7,38,45,45,527,45,2,2,4,224,0,727,154171,2,45
2011-07-23,fall,2011,July,8,Saturday,Holiday,Clear,0.84,0.7879,0.49,0.2537,24,85,109,109,527,109,2,2,4,224,2,727,261001,2,109
2011-07-23,fall,2011,July,9,Saturday,Holiday,Clear,0.84,0.7879,0.49,0.1642,30,102,132,132,527,132,2,2,4,224,2,727,159438,2,132
2011-07-23,fall,2011,July,10,Saturday,Holiday,Clear,0.86,0.7879,0.41,0.2239,61,137,198,198,527,198,2,3,4,234,2,727,126257,2,198
2011-07-23,fall,2011,July,11,Saturday,Holiday,Clear,0.9,0.8182,0.37,0.194,62,154,216,216,527,216,2,3,4,234,2,727,151320,2,216
2011-07-23,fall,2011,July,12,Saturday,Holiday,Clear,0.92,0.8636,0.37,0.1045,71,164,235,235,527,235,2,3,4,234,2,728,184414,2,235
2011-07-23,fall,2011,July,13,Saturday,Holiday,Clear,0.94,0.8788,0.38,0.1642,78,167,245,245,527,245,2,3,4,234,2,729,184919,2,245
2011-07-23,fall,2011,July,14,Saturday,Holiday,Clear,0.92,0.8939,0.42,0.0,84,152,236,236,527,236,2,3,4,234,2,729,175652,2,236
2011-07-23,fall,2011,July,15,Saturday,Holiday,Clear,0.94,0.8788,0.38,0.0,78,137,215,215,527,215,2,3,4,234,2,729,183149,2,215
2011-07-23,fall,2011,July,16,Saturday,Holiday,Clear,0.94,0.8788,0.38,0.1343,70,151,221,221,527,221,2,3,4,234,2,730,227748,2,221
2011-07-23,fall,2011,July,17,Saturday,Holiday,Clear,0.94,0.8788,0.38,0.1343,70,127,197,197,527,197,2,3,4,234,2,730,336860,2,197
2011-07-23,fall,2011,July,18,Saturday,Holiday,Clear,0.92,0.8788,0.4,0.2239,62,134,196,196,527,196,2,3,4,234,2,728,309772,2,196
2011-07-23,fall,2011,July,19,Saturday,Holiday,Mist,0.82,0.803,0.59,0.1343,80,137,217,217,527,217,2,3,4,234,2,728,226789,2,217
2011-07-23,fall,2011,July,20,Saturday,Holiday,Clear,0.82,0.803,0.59,0.2239,47,98,145,145,527,145,2,3,4,234,2,728,164550,2,145
2011-07-23,fall,2011,July,21,Saturday,Holiday,Clear,0.82,0.803,0.59,0.2239,39,115,154,154,527,154,2,3,4,234,2,728,125445,2,154
2011-07-23,fall,2011,July,22,Saturday,Holiday,Clear,0.8,0.7727,0.59,0.194,37,88,125,125,527,125,2,2,4,224,2,728,95612,2,125
2011-07-23,fall,2011,July,23,Saturday,Holiday,Clear,0.8,0.7727,0.59,0.1045,27,77,104,104,527,104,2,2,4,224,0,728,63941,2,104
2011-07-24,fall,2011,July,0,Sunday,Holiday,Clear,0.8,0.7727,0.59,0.1045,42,77,119,119,526,119,2,2,4,224,0,726,39130,2,119
2011-07-24,fall,2011,July,1,Sunday,Holiday,Clear,0.78,0.7576,0.66,0.1045,33,63,96,96,526,96,2,2,4,224,0,724,24164,2,96
2011-07-24,fall,2011,July,2,Sunday,Holiday,Clear,0.8,0.7879,0.63,0.0896,12,48,60,60,526,60,2,2,4,224,0,715,16352,2,60
2011-07-24,fall,2011,July,3,Sunday,Holiday,Clear,0.8,0.7879,0.63,0.0896,17,20,37,37,526,37,2,1,4,214,0,697,8174,2,37
2011-07-24,fall,2011,July,4,Sunday,Holiday,Clear,0.78,0.7576,0.66,0.1045,1,5,6,6,526,6,2,1,4,214,0,697,4428,2,6
2011-07-24,fall,2011,July,5,Sunday,Holiday,Clear,0.78,0.7576,0.66,0.0896,5,3,8,8,526,8,2,1,4,214,0,717,14261,2,8
2011-07-24,fall,2011,July,6,Sunday,Holiday,Mist,0.8,0.7879,0.63,0.0896,9,13,22,22,526,22,2,1,4,214,0,725,55132,2,22
2011-07-24,fall,2011,July,7,Sunday,Holiday,Clear,0.8,0.7727,0.59,0.1343,6,29,35,35,526,35,2,1,4,214,0,727,154171,2,35
2011-07-24,fall,2011,July,8,Sunday,Holiday,Clear,0.82,0.7879,0.56,0.2836,22,82,104,104,526,104,2,2,4,224,2,727,261001,2,104
2011-07-24,fall,2011,July,9,Sunday,Holiday,Clear,0.82,0.7879,0.56,0.3881,42,112,154,154,526,154,2,3,4,234,2,727,159438,2,154
2011-07-24,fall,2011,July,10,Sunday,Holiday,Clear,0.86,0.8182,0.5,0.3284,61,165,226,226,526,226,2,3,4,234,2,727,126257,2,226
2011-07-24,fall,2011,July,11,Sunday,Holiday,Clear,0.84,0.803,0.53,0.2537,74,169,243,243,526,243,2,3,4,234,2,727,151320,2,243
2011-07-24,fall,2011,July,12,Sunday,Holiday,Clear,0.9,0.8636,0.45,0.1642,85,161,246,246,526,246,2,3,4,234,2,728,184414,2,246
2011-07-24,fall,2011,July,13,Sunday,Holiday,Clear,0.86,0.803,0.47,0.2239,90,162,252,252,526,252,2,3,4,234,2,729,184919,2,252
2011-07-24,fall,2011,July,14,Sunday,Holiday,Clear,0.86,0.8182,0.5,0.2836,79,204,283,283,526,283,2,4,4,244,2,729,175652,2,283
2011-07-24,fall,2011,July,15,Sunday,Holiday,Clear,0.9,0.8485,0.42,0.2537,68,170,238,238,526,238,2,3,4,234,2,729,183149,2,238
2011-07-24,fall,2011,July,16,Sunday,Holiday,Clear,0.9,0.8485,0.42,0.2537,62,187,249,249,526,249,2,3,4,234,2,730,227748,2,249
2011-07-24,fall,2011,July,17,Sunday,Holiday,Clear,0.9,0.8333,0.39,0.1045,75,174,249,249,526,249,2,3,4,234,2,730,336860,2,249
2011-07-24,fall,2011,July,18,Sunday,Holiday,Clear,0.88,0.8182,0.42,0.1642,67,176,243,243,526,243,2,3,4,234,2,728,309772,2,243
2011-07-24,fall,2011,July,19,Sunday,Holiday,Clear,0.86,0.803,0.47,0.1642,70,170,240,240,526,240,2,3,4,234,2,728,226789,2,240
2011-07-24,fall,2011,July,20,Sunday,Holiday,Clear,0.84,0.7879,0.49,0.1642,52,143,195,195,526,195,2,3,4,234,2,728,164550,2,195
2011-07-24,fall,2011,July,21,Sunday,Holiday,Clear,0.8,0.7879,0.63,0.1343,42,111,153,153,526,153,2,3,4,234,0,728,125445,2,153
2011-07-24,fall,2011,July,22,Sunday,Holiday,Clear,0.78,0.7576,0.66,0.0,23,75,98,98,526,98,2,2,4,224,0,728,95612,2,98
2011-07-24,fall,2011,July,23,Sunday,Holiday,Mist,0.76,0.7273,0.7,0.0896,13,37,50,50,526,50,2,2,4,224,0,728,63941,2,50
2011-07-25,fall,2011,July,0,Monday,Workingday,Mist,0.76,0.7273,0.7,0.0,17,17,34,34,525,34,2,1,4,214,0,726,39130,2,34
2011-07-25,fall,2011,July,1,Monday,Workingday,Mist,0.76,0.7424,0.75,0.0896,4,8,12,12,525,12,2,1,4,214,0,724,24164,2,12
2011-07-25,fall,2011,July,2,Monday,Workingday,Mist,0.74,0.7121,0.79,0.0896,3,3,6,6,525,6,2,1,4,214,0,715,16352,2,6
2011-07-25,fall,2011,July,3,Monday,Workingday,Clear,0.74,0.7121,0.79,0.0,2,2,4,4,525,4,2,1,4,214,0,697,8174,2,4
2011-07-25,fall,2011,July,4,Monday,Workingday,Clear,0.72,0.7121,0.84,0.0896,0,6,6,6,525,6,2,1,4,214,0,697,4428,2,6
2011-07-25,fall,2011,July,5,Monday,Workingday,Clear,0.72,0.7121,0.84,0.0896,2,22,24,24,525,24,2,1,4,214,0,717,14261,2,24
2011-07-25,fall,2011,July,6,Monday,Workingday,Mist,0.72,0.7121,0.84,0.0896,7,100,107,107,525,107,2,2,4,224,0,725,55132,2,107
2011-07-25,fall,2011,July,7,Monday,Workingday,Mist,0.74,0.7121,0.79,0.0,20,257,277,277,525,277,2,3,4,234,0,727,154171,2,277
2011-07-25,fall,2011,July,8,Monday,Workingday,Mist,0.76,0.7424,0.75,0.0,34,353,387,387,525,387,2,4,4,244,0,727,261001,2,387
2011-07-25,fall,2011,July,9,Monday,Workingday,Clear,0.8,0.803,0.66,0.0,11,124,135,135,525,135,2,2,4,224,0,727,159438,2,135
2011-07-25,fall,2011,July,10,Monday,Workingday,Clear,0.82,0.803,0.59,0.0,30,54,84,84,525,84,2,2,4,224,0,727,126257,2,84
2011-07-25,fall,2011,July,11,Monday,Workingday,Mist,0.84,0.8333,0.59,0.194,24,83,107,107,525,107,2,2,4,224,0,727,151320,2,107
2011-07-25,fall,2011,July,12,Monday,Workingday,Mist,0.84,0.8333,0.59,0.194,17,50,67,67,525,67,2,2,4,224,0,728,184414,2,67
2011-07-25,fall,2011,July,13,Monday,Workingday,Mist,0.74,0.7121,0.74,0.1343,14,64,78,78,525,78,2,2,4,224,0,729,184919,2,78
2011-07-25,fall,2011,July,14,Monday,Workingday,Mist,0.72,0.697,0.79,0.194,28,62,90,90,525,90,2,2,4,224,0,729,175652,2,90
2011-07-25,fall,2011,July,15,Monday,Workingday,Clear,0.7,0.6667,0.84,0.3881,16,96,112,112,525,112,2,2,4,224,0,729,183149,2,112
2011-07-25,fall,2011,July,16,Monday,Workingday,Clear,0.7,0.6667,0.84,0.2239,37,161,198,198,525,198,2,3,4,234,0,730,227748,2,198
2011-07-25,fall,2011,July,17,Monday,Workingday,Clear,0.72,0.697,0.74,0.0,48,437,485,485,525,485,2,4,4,244,2,730,336860,2,485
2011-07-25,fall,2011,July,18,Monday,Workingday,Clear,0.74,0.7121,0.74,0.0896,60,473,533,533,525,533,2,4,4,244,2,728,309772,2,533
2011-07-25,fall,2011,July,19,Monday,Workingday,Clear,0.74,0.697,0.7,0.0896,62,324,386,386,525,386,2,4,4,244,2,728,226789,2,386
2011-07-25,fall,2011,July,20,Monday,Workingday,Clear,0.72,0.697,0.74,0.1343,55,247,302,302,525,302,2,4,4,244,2,728,164550,2,302
2011-07-25,fall,2011,July,21,Monday,Workingday,Clear,0.7,0.6667,0.84,0.0,41,153,194,194,525,194,2,3,4,234,0,728,125445,2,194
2011-07-25,fall,2011,July,22,Monday,Workingday,Clear,0.7,0.6667,0.84,0.0,13,112,125,125,525,125,2,2,4,224,0,728,95612,2,125
2011-07-25,fall,2011,July,23,Monday,Workingday,Clear,0.7,0.6667,0.84,0.0896,23,64,87,87,525,87,2,2,4,224,0,728,63941,2,87
2011-07-26,fall,2011,July,0,Tuesday,Workingday,Clear,0.7,0.6667,0.79,0.1045,8,20,28,28,524,28,2,1,4,214,0,726,39130,2,28
2011-07-26,fall,2011,July,1,Tuesday,Workingday,Clear,0.7,0.6667,0.79,0.1045,6,6,12,12,524,12,2,1,4,214,0,724,24164,2,12
2011-07-26,fall,2011,July,2,Tuesday,Workingday,Clear,0.68,0.6364,0.89,0.1045,1,6,7,7,524,7,2,1,4,214,0,715,16352,2,7
2011-07-26,fall,2011,July,3,Tuesday,Workingday,Clear,0.68,0.6364,0.89,0.1343,2,2,4,4,524,4,2,1,4,214,0,697,8174,2,4
2011-07-26,fall,2011,July,4,Tuesday,Workingday,Clear,0.68,0.6364,0.88,0.1642,0,6,6,6,524,6,2,1,4,214,0,697,4428,2,6
2011-07-26,fall,2011,July,5,Tuesday,Workingday,Clear,0.66,0.5909,0.89,0.0896,3,24,27,27,524,27,2,1,3,213,0,717,14261,2,27
2011-07-26,fall,2011,July,6,Tuesday,Workingday,Clear,0.68,0.6364,0.83,0.2239,2,108,110,110,524,110,2,2,4,224,0,725,55132,2,110
2011-07-26,fall,2011,July,7,Tuesday,Workingday,Clear,0.72,0.6818,0.66,0.2836,30,288,318,318,524,318,2,4,4,244,2,727,154171,2,318
2011-07-26,fall,2011,July,8,Tuesday,Workingday,Clear,0.74,0.6818,0.55,0.194,32,392,424,424,524,424,2,4,4,244,2,727,261001,2,424
2011-07-26,fall,2011,July,9,Tuesday,Workingday,Clear,0.76,0.6818,0.4,0.2239,25,162,187,187,524,187,2,3,4,234,2,727,159438,2,187
2011-07-26,fall,2011,July,10,Tuesday,Workingday,Clear,0.8,0.697,0.31,0.2239,42,96,138,138,524,138,2,2,4,224,2,727,126257,2,138
2011-07-26,fall,2011,July,11,Tuesday,Workingday,Clear,0.82,0.7121,0.3,0.0,49,102,151,151,524,151,2,3,4,234,2,727,151320,2,151
2011-07-26,fall,2011,July,12,Tuesday,Workingday,Clear,0.84,0.7273,0.28,0.0,25,122,147,147,524,147,2,3,4,234,2,728,184414,2,147
2011-07-26,fall,2011,July,13,Tuesday,Workingday,Clear,0.84,0.7273,0.32,0.2985,43,139,182,182,524,182,2,3,4,234,2,729,184919,2,182
2011-07-26,fall,2011,July,14,Tuesday,Workingday,Clear,0.86,0.7424,0.3,0.2836,46,101,147,147,524,147,2,3,4,234,2,729,175652,2,147
2011-07-26,fall,2011,July,15,Tuesday,Workingday,Clear,0.88,0.7576,0.28,0.3284,49,114,163,163,524,163,2,3,4,234,2,729,183149,2,163
2011-07-26,fall,2011,July,16,Tuesday,Workingday,Clear,0.86,0.7576,0.36,0.2836,41,213,254,254,524,254,2,3,4,234,2,730,227748,2,254
2011-07-26,fall,2011,July,17,Tuesday,Workingday,Clear,0.86,0.7576,0.36,0.3582,72,465,537,537,524,537,2,4,4,244,2,730,336860,2,537
2011-07-26,fall,2011,July,18,Tuesday,Workingday,Clear,0.84,0.7424,0.39,0.3881,68,478,546,546,524,546,2,4,4,244,2,728,309772,2,546
2011-07-26,fall,2011,July,19,Tuesday,Workingday,Clear,0.82,0.7424,0.43,0.2985,69,329,398,398,524,398,2,4,4,244,2,728,226789,2,398
2011-07-26,fall,2011,July,20,Tuesday,Workingday,Clear,0.8,0.7273,0.46,0.2537,47,243,290,290,524,290,2,4,4,244,2,728,164550,2,290
2011-07-26,fall,2011,July,21,Tuesday,Workingday,Clear,0.78,0.7121,0.49,0.2239,45,222,267,267,524,267,2,3,4,234,2,728,125445,2,267
2011-07-26,fall,2011,July,22,Tuesday,Workingday,Clear,0.76,0.697,0.55,0.1343,27,131,158,158,524,158,2,3,4,234,0,728,95612,2,158
2011-07-26,fall,2011,July,23,Tuesday,Workingday,Clear,0.76,0.7121,0.58,0.1045,18,71,89,89,524,89,2,2,4,224,0,728,63941,2,89
2011-07-27,fall,2011,July,0,Wednesday,Workingday,Mist,0.78,0.7121,0.52,0.1642,19,26,45,45,523,45,2,2,4,224,0,726,39130,2,45
2011-07-27,fall,2011,July,1,Wednesday,Workingday,Clear,0.78,0.7121,0.49,0.194,1,9,10,10,523,10,2,1,4,214,0,724,24164,2,10
2011-07-27,fall,2011,July,2,Wednesday,Workingday,Clear,0.76,0.697,0.52,0.2985,1,5,6,6,523,6,2,1,4,214,0,715,16352,2,6
2011-07-27,fall,2011,July,3,Wednesday,Workingday,Clear,0.72,0.6667,0.58,0.1642,0,4,4,4,523,4,2,1,4,214,0,697,8174,2,4
2011-07-27,fall,2011,July,4,Wednesday,Workingday,Clear,0.72,0.6667,0.51,0.194,1,3,4,4,523,4,2,1,4,214,0,697,4428,2,4
2011-07-27,fall,2011,July,5,Wednesday,Workingday,Clear,0.7,0.6515,0.54,0.2836,0,18,18,18,523,18,2,1,4,214,0,717,14261,2,18
2011-07-27,fall,2011,July,6,Wednesday,Workingday,Clear,0.7,0.6515,0.54,0.2239,4,119,123,123,523,123,2,2,4,224,0,725,55132,2,123
2011-07-27,fall,2011,July,7,Wednesday,Workingday,Clear,0.72,0.6667,0.48,0.2537,34,313,347,347,523,347,2,4,4,244,2,727,154171,2,347
2011-07-27,fall,2011,July,8,Wednesday,Workingday,Clear,0.74,0.6667,0.42,0.2537,28,405,433,433,523,433,2,4,4,244,2,727,261001,2,433
2011-07-27,fall,2011,July,9,Wednesday,Workingday,Clear,0.76,0.6667,0.35,0.2537,27,189,216,216,523,216,2,3,4,234,2,727,159438,2,216
2011-07-27,fall,2011,July,10,Wednesday,Workingday,Clear,0.78,0.6818,0.33,0.0,32,82,114,114,523,114,2,2,4,224,2,727,126257,2,114
2011-07-27,fall,2011,July,11,Wednesday,Workingday,Clear,0.8,0.697,0.31,0.0,42,94,136,136,523,136,2,2,4,224,2,727,151320,2,136
2011-07-27,fall,2011,July,12,Wednesday,Workingday,Clear,0.82,0.7121,0.3,0.2836,37,132,169,169,523,169,2,3,4,234,2,728,184414,2,169
2011-07-27,fall,2011,July,13,Wednesday,Workingday,Clear,0.84,0.7273,0.3,0.3582,29,151,180,180,523,180,2,3,4,234,2,729,184919,2,180
2011-07-27,fall,2011,July,14,Wednesday,Workingday,Clear,0.84,0.7273,0.28,0.2239,20,107,127,127,523,127,2,2,4,224,2,729,175652,2,127
2011-07-27,fall,2011,July,15,Wednesday,Workingday,Clear,0.86,0.7424,0.26,0.2537,37,103,140,140,523,140,2,2,4,224,2,729,183149,2,140
2011-07-27,fall,2011,July,16,Wednesday,Workingday,Clear,0.86,0.7273,0.25,0.1642,40,228,268,268,523,268,2,3,4,234,2,730,227748,2,268
2011-07-27,fall,2011,July,17,Wednesday,Workingday,Clear,0.84,0.7121,0.26,0.2239,81,491,572,572,523,572,2,4,4,244,2,730,336860,2,572
2011-07-27,fall,2011,July,18,Wednesday,Workingday,Clear,0.82,0.7121,0.28,0.1045,78,463,541,541,523,541,2,4,4,244,2,728,309772,2,541
2011-07-27,fall,2011,July,19,Wednesday,Workingday,Clear,0.8,0.697,0.29,0.0896,87,288,375,375,523,375,2,4,4,244,2,728,226789,2,375
2011-07-27,fall,2011,July,20,Wednesday,Workingday,Clear,0.76,0.6818,0.45,0.2239,55,239,294,294,523,294,2,4,4,244,2,728,164550,2,294
2011-07-27,fall,2011,July,21,Wednesday,Workingday,Clear,0.74,0.6667,0.48,0.1045,49,196,245,245,523,245,2,3,4,234,2,728,125445,2,245
2011-07-27,fall,2011,July,22,Wednesday,Workingday,Clear,0.72,0.6667,0.48,0.0,37,143,180,180,523,180,2,3,4,234,0,728,95612,2,180
2011-07-27,fall,2011,July,23,Wednesday,Workingday,Clear,0.74,0.6667,0.45,0.0896,16,93,109,109,523,109,2,2,4,224,0,728,63941,2,109
2011-07-28,fall,2011,July,0,Thursday,Workingday,Clear,0.7,0.6515,0.51,0.1343,14,31,45,45,522,45,2,2,4,224,0,726,39130,2,45
2011-07-28,fall,2011,July,1,Thursday,Workingday,Clear,0.72,0.6667,0.51,0.0,3,26,29,29,522,29,2,1,4,214,0,724,24164,2,29
2011-07-28,fall,2011,July,2,Thursday,Workingday,Clear,0.72,0.6667,0.54,0.1045,2,5,7,7,522,7,2,1,4,214,0,715,16352,2,7
2011-07-28,fall,2011,July,3,Thursday,Workingday,Clear,0.72,0.6667,0.54,0.0,0,5,5,5,522,5,2,1,4,214,0,697,8174,2,5
2011-07-28,fall,2011,July,4,Thursday,Workingday,Clear,0.7,0.6515,0.61,0.1045,0,6,6,6,522,6,2,1,4,214,0,697,4428,2,6
2011-07-28,fall,2011,July,5,Thursday,Workingday,Clear,0.7,0.6515,0.65,0.1045,1,26,27,27,522,27,2,1,4,214,0,717,14261,2,27
2011-07-28,fall,2011,July,6,Thursday,Workingday,Clear,0.7,0.6515,0.7,0.0896,6,110,116,116,522,116,2,2,4,224,0,725,55132,2,116
2011-07-28,fall,2011,July,7,Thursday,Workingday,Clear,0.72,0.6818,0.7,0.1642,27,278,305,305,522,305,2,4,4,244,0,727,154171,2,305
2011-07-28,fall,2011,July,8,Thursday,Workingday,Clear,0.74,0.697,0.66,0.1642,47,409,456,456,522,456,2,4,4,244,2,727,261001,2,456
2011-07-28,fall,2011,July,9,Thursday,Workingday,Clear,0.78,0.7424,0.59,0.194,21,189,210,210,522,210,2,3,4,234,2,727,159438,2,210
2011-07-28,fall,2011,July,10,Thursday,Workingday,Clear,0.8,0.7576,0.55,0.2836,30,86,116,116,522,116,2,2,4,224,2,727,126257,2,116
2011-07-28,fall,2011,July,11,Thursday,Workingday,Clear,0.84,0.8182,0.56,0.2836,41,113,154,154,522,154,2,3,4,234,2,727,151320,2,154
2011-07-28,fall,2011,July,12,Thursday,Workingday,Clear,0.84,0.803,0.53,0.2537,35,151,186,186,522,186,2,3,4,234,2,728,184414,2,186
2011-07-28,fall,2011,July,13,Thursday,Workingday,Clear,0.86,0.803,0.47,0.2537,26,126,152,152,522,152,2,3,4,234,2,729,184919,2,152
2011-07-28,fall,2011,July,14,Thursday,Workingday,Mist,0.84,0.7879,0.49,0.2537,27,111,138,138,522,138,2,2,4,224,2,729,175652,2,138
2011-07-28,fall,2011,July,15,Thursday,Workingday,Clear,0.86,0.8182,0.5,0.194,22,124,146,146,522,146,2,3,4,234,2,729,183149,2,146
2011-07-28,fall,2011,July,16,Thursday,Workingday,Clear,0.86,0.803,0.47,0.1642,42,214,256,256,522,256,2,3,4,234,2,730,227748,2,256
2011-07-28,fall,2011,July,17,Thursday,Workingday,Clear,0.84,0.803,0.53,0.194,45,423,468,468,522,468,2,4,4,244,2,730,336860,2,468
2011-07-28,fall,2011,July,18,Thursday,Workingday,Clear,0.84,0.8182,0.56,0.2239,55,428,483,483,522,483,2,4,4,244,2,728,309772,2,483
2011-07-28,fall,2011,July,19,Thursday,Workingday,Clear,0.82,0.803,0.59,0.194,37,285,322,322,522,322,2,4,4,244,2,728,226789,2,322
2011-07-28,fall,2011,July,20,Thursday,Workingday,Clear,0.8,0.7879,0.63,0.194,41,229,270,270,522,270,2,3,4,234,2,728,164550,2,270
2011-07-28,fall,2011,July,21,Thursday,Workingday,Clear,0.78,0.7576,0.66,0.2836,31,165,196,196,522,196,2,3,4,234,2,728,125445,2,196
2011-07-28,fall,2011,July,22,Thursday,Workingday,Clear,0.76,0.7273,0.7,0.2537,25,149,174,174,522,174,2,3,4,234,0,728,95612,2,174
2011-07-28,fall,2011,July,23,Thursday,Workingday,Clear,0.76,0.7424,0.75,0.194,28,95,123,123,522,123,2,2,4,224,0,728,63941,2,123
2011-07-29,fall,2011,July,0,Friday,Workingday,Clear,0.74,0.7121,0.79,0.1642,12,45,57,57,521,57,2,2,4,224,0,726,39130,2,57
2011-07-29,fall,2011,July,1,Friday,Workingday,Clear,0.74,0.7121,0.79,0.1343,12,22,34,34,521,34,2,1,4,214,0,724,24164,2,34
2011-07-29,fall,2011,July,2,Friday,Workingday,Clear,0.74,0.7121,0.79,0.0,3,10,13,13,521,13,2,1,4,214,0,715,16352,2,13
2011-07-29,fall,2011,July,3,Friday,Workingday,Clear,0.74,0.7121,0.79,0.0,2,9,11,11,521,11,2,1,4,214,0,697,8174,2,11
2011-07-29,fall,2011,July,4,Friday,Workingday,Clear,0.72,0.7121,0.84,0.1343,2,4,6,6,521,6,2,1,4,214,0,697,4428,2,6
2011-07-29,fall,2011,July,5,Friday,Workingday,Clear,0.72,0.7121,0.84,0.0,4,23,27,27,521,27,2,1,4,214,0,717,14261,2,27
2011-07-29,fall,2011,July,6,Friday,Workingday,Mist,0.72,0.7121,0.84,0.0,7,83,90,90,521,90,2,2,4,224,0,725,55132,2,90
2011-07-29,fall,2011,July,7,Friday,Workingday,Mist,0.74,0.7121,0.79,0.0896,26,228,254,254,521,254,2,3,4,234,0,727,154171,2,254
2011-07-29,fall,2011,July,8,Friday,Workingday,Mist,0.76,0.7727,0.77,0.0,30,354,384,384,521,384,2,4,4,244,0,727,261001,2,384
2011-07-29,fall,2011,July,9,Friday,Workingday,Clear,0.86,0.803,0.47,0.2537,28,151,179,179,521,179,2,3,4,234,2,727,159438,2,179
2011-07-29,fall,2011,July,10,Friday,Workingday,Clear,0.9,0.8485,0.42,0.2836,37,69,106,106,521,106,2,2,4,224,2,727,126257,2,106
2011-07-29,fall,2011,July,11,Friday,Workingday,Clear,0.92,0.8788,0.4,0.2985,43,118,161,161,521,161,2,3,4,234,2,727,151320,2,161
2011-07-29,fall,2011,July,12,Friday,Workingday,Clear,0.96,0.8636,0.31,0.2836,40,95,135,135,521,135,2,2,4,224,2,728,184414,2,135
2011-07-29,fall,2011,July,13,Friday,Workingday,Clear,0.94,0.8333,0.31,0.0,42,114,156,156,521,156,2,3,4,234,2,729,184919,2,156
2011-07-29,fall,2011,July,14,Friday,Workingday,Clear,0.96,0.8636,0.3,0.2239,34,114,148,148,521,148,2,3,4,234,2,729,175652,2,148
2011-07-29,fall,2011,July,15,Friday,Workingday,Clear,0.96,0.8636,0.3,0.2537,40,129,169,169,521,169,2,3,4,234,2,729,183149,2,169
2011-07-29,fall,2011,July,16,Friday,Workingday,Clear,0.96,0.8636,0.3,0.3881,35,198,233,233,521,233,2,3,4,234,2,730,227748,2,233
2011-07-29,fall,2011,July,17,Friday,Workingday,Clear,0.96,0.8636,0.3,0.2985,47,374,421,421,521,421,2,4,4,244,2,730,336860,2,421
2011-07-29,fall,2011,July,18,Friday,Workingday,Clear,0.92,0.8636,0.37,0.3284,49,313,362,362,521,362,2,4,4,244,2,728,309772,2,362
2011-07-29,fall,2011,July,19,Friday,Workingday,Clear,0.9,0.8485,0.42,0.2239,22,219,241,241,521,241,2,3,4,234,2,728,226789,2,241
2011-07-29,fall,2011,July,20,Friday,Workingday,Clear,0.86,0.7879,0.41,0.3284,53,153,206,206,521,206,2,3,4,234,2,728,164550,2,206
2011-07-29,fall,2011,July,21,Friday,Workingday,Clear,0.82,0.7576,0.46,0.1642,29,134,163,163,521,163,2,3,4,234,2,728,125445,2,163
2011-07-29,fall,2011,July,22,Friday,Workingday,Clear,0.8,0.7424,0.49,0.2239,47,127,174,174,521,174,2,3,4,234,2,728,95612,2,174
2011-07-29,fall,2011,July,23,Friday,Workingday,Clear,0.78,0.7121,0.52,0.1045,26,90,116,116,521,116,2,2,4,224,0,728,63941,2,116
2011-07-30,fall,2011,July,0,Saturday,Holiday,Clear,0.76,0.697,0.55,0.194,60,73,133,133,520,133,2,2,4,224,2,726,39130,2,133
2011-07-30,fall,2011,July,1,Saturday,Holiday,Clear,0.76,0.697,0.55,0.0896,15,75,90,90,520,90,2,2,4,224,0,724,24164,2,90
2011-07-30,fall,2011,July,2,Saturday,Holiday,Clear,0.76,0.697,0.55,0.1045,11,31,42,42,520,42,2,2,4,224,0,715,16352,2,42
2011-07-30,fall,2011,July,3,Saturday,Holiday,Clear,0.74,0.6818,0.62,0.1642,18,25,43,43,520,43,2,2,4,224,0,697,8174,2,43
2011-07-30,fall,2011,July,4,Saturday,Holiday,Clear,0.72,0.6818,0.66,0.1642,4,6,10,10,520,10,2,1,4,214,0,697,4428,2,10
2011-07-30,fall,2011,July,5,Saturday,Holiday,Clear,0.72,0.6818,0.7,0.2836,4,9,13,13,520,13,2,1,4,214,0,717,14261,2,13
2011-07-30,fall,2011,July,6,Saturday,Holiday,Clear,0.72,0.6818,0.7,0.2985,6,18,24,24,520,24,2,1,4,214,0,725,55132,2,24
2011-07-30,fall,2011,July,7,Saturday,Holiday,Clear,0.76,0.7273,0.66,0.194,3,39,42,42,520,42,2,2,4,224,0,727,154171,2,42
2011-07-30,fall,2011,July,8,Saturday,Holiday,Clear,0.78,0.7424,0.59,0.2239,27,87,114,114,520,114,2,2,4,224,0,727,261001,2,114
2011-07-30,fall,2011,July,9,Saturday,Holiday,Clear,0.82,0.7576,0.46,0.2985,49,125,174,174,520,174,2,3,4,234,2,727,159438,2,174
2011-07-30,fall,2011,July,10,Saturday,Holiday,Clear,0.82,0.7424,0.41,0.2985,79,182,261,261,520,261,2,3,4,234,2,727,126257,2,261
2011-07-30,fall,2011,July,11,Saturday,Holiday,Clear,0.84,0.7424,0.36,0.194,111,206,317,317,520,317,2,4,4,244,2,727,151320,2,317
2011-07-30,fall,2011,July,12,Saturday,Holiday,Clear,0.84,0.7273,0.32,0.1642,111,230,341,341,520,341,2,4,4,244,2,728,184414,2,341
2011-07-30,fall,2011,July,13,Saturday,Holiday,Clear,0.88,0.7576,0.29,0.0,125,183,308,308,520,308,2,4,4,244,2,729,184919,2,308
2011-07-30,fall,2011,July,14,Saturday,Holiday,Clear,0.9,0.7879,0.29,0.0,112,193,305,305,520,305,2,4,4,244,2,729,175652,2,305
2011-07-30,fall,2011,July,15,Saturday,Holiday,Clear,0.9,0.803,0.31,0.1343,113,189,302,302,520,302,2,4,4,244,2,729,183149,2,302
2011-07-30,fall,2011,July,16,Saturday,Holiday,Clear,0.9,0.7879,0.27,0.2239,126,176,302,302,520,302,2,4,4,244,2,730,227748,2,302
2011-07-30,fall,2011,July,17,Saturday,Holiday,Clear,0.9,0.7879,0.29,0.1045,93,209,302,302,520,302,2,4,4,244,2,730,336860,2,302
2011-07-30,fall,2011,July,18,Saturday,Holiday,Clear,0.88,0.7576,0.28,0.194,92,207,299,299,520,299,2,4,4,244,2,728,309772,2,299
2011-07-30,fall,2011,July,19,Saturday,Holiday,Clear,0.74,0.6515,0.33,0.2239,101,155,256,256,520,256,2,3,4,234,2,728,226789,2,256
2011-07-30,fall,2011,July,20,Saturday,Holiday,Clear,0.82,0.7424,0.43,0.1343,74,132,206,206,520,206,2,3,4,234,2,728,164550,2,206
2011-07-30,fall,2011,July,21,Saturday,Holiday,Clear,0.8,0.7424,0.49,0.1642,82,123,205,205,520,205,2,3,4,234,2,728,125445,2,205
2011-07-30,fall,2011,July,22,Saturday,Holiday,Clear,0.78,0.7121,0.52,0.1045,80,129,209,209,520,209,2,3,4,234,2,728,95612,2,209
2011-07-30,fall,2011,July,23,Saturday,Holiday,Clear,0.76,0.697,0.55,0.0896,63,114,177,177,520,177,2,3,4,234,2,728,63941,2,177
2011-07-31,fall,2011,July,0,Sunday,Holiday,Clear,0.76,0.697,0.55,0.0896,33,80,113,113,519,113,2,2,4,224,0,726,39130,2,113
2011-07-31,fall,2011,July,1,Sunday,Holiday,Clear,0.74,0.6818,0.62,0.0896,8,71,79,79,519,79,2,2,4,224,0,724,24164,2,79
2011-07-31,fall,2011,July,2,Sunday,Holiday,Clear,0.74,0.697,0.66,0.0896,19,48,67,67,519,67,2,2,4,224,0,715,16352,2,67
2011-07-31,fall,2011,July,3,Sunday,Holiday,Clear,0.74,0.697,0.66,0.0,24,26,50,50,519,50,2,2,4,224,0,697,8174,2,50
2011-07-31,fall,2011,July,4,Sunday,Holiday,Clear,0.72,0.6818,0.7,0.0,6,7,13,13,519,13,2,1,4,214,0,697,4428,2,13
2011-07-31,fall,2011,July,5,Sunday,Holiday,Clear,0.72,0.6818,0.69,0.0,4,4,8,8,519,8,2,1,4,214,0,717,14261,2,8
2011-07-31,fall,2011,July,6,Sunday,Holiday,Clear,0.74,0.697,0.7,0.0,5,8,13,13,519,13,2,1,4,214,0,725,55132,2,13
2011-07-31,fall,2011,July,7,Sunday,Holiday,Clear,0.74,0.6818,0.58,0.1343,19,26,45,45,519,45,2,2,4,224,0,727,154171,2,45
2011-07-31,fall,2011,July,8,Sunday,Holiday,Clear,0.76,0.697,0.55,0.2239,54,88,142,142,519,142,2,2,4,224,2,727,261001,2,142
2011-07-31,fall,2011,July,9,Sunday,Holiday,Clear,0.8,0.7424,0.49,0.0,55,128,183,183,519,183,2,3,4,234,2,727,159438,2,183
2011-07-31,fall,2011,July,10,Sunday,Holiday,Clear,0.84,0.7424,0.36,0.1642,91,163,254,254,519,254,2,3,4,234,2,727,126257,2,254
2011-07-31,fall,2011,July,11,Sunday,Holiday,Clear,0.86,0.7424,0.28,0.1642,112,163,275,275,519,275,2,3,4,234,2,727,151320,2,275
2011-07-31,fall,2011,July,12,Sunday,Holiday,Clear,0.9,0.7727,0.25,0.194,146,192,338,338,519,338,2,4,4,244,2,728,184414,2,338
2011-07-31,fall,2011,July,13,Sunday,Holiday,Clear,0.9,0.7727,0.24,0.1343,142,152,294,294,519,294,2,4,4,244,2,729,184919,2,294
2011-07-31,fall,2011,July,14,Sunday,Holiday,Clear,0.9,0.7727,0.24,0.1642,130,196,326,326,519,326,2,4,4,244,2,729,175652,2,326
2011-07-31,fall,2011,July,15,Sunday,Holiday,Clear,0.92,0.7727,0.18,0.2985,109,184,293,293,519,293,2,4,4,244,2,729,183149,2,293
2011-07-31,fall,2011,July,16,Sunday,Holiday,Clear,0.92,0.7727,0.17,0.2836,98,208,306,306,519,306,2,4,4,244,2,730,227748,2,306
2011-07-31,fall,2011,July,17,Sunday,Holiday,Clear,0.92,0.7727,0.16,0.1642,114,206,320,320,519,320,2,4,4,244,2,730,336860,2,320
2011-07-31,fall,2011,July,18,Sunday,Holiday,Clear,0.86,0.7879,0.41,0.2836,91,213,304,304,519,304,2,4,4,244,2,728,309772,2,304
2011-07-31,fall,2011,July,19,Sunday,Holiday,Clear,0.8,0.7576,0.55,0.3284,87,187,274,274,519,274,2,3,4,234,2,728,226789,2,274
2011-07-31,fall,2011,July,20,Sunday,Holiday,Clear,0.8,0.7576,0.55,0.3284,70,205,275,275,519,275,2,3,4,234,2,728,164550,2,275
2011-07-31,fall,2011,July,21,Sunday,Holiday,Clear,0.78,0.7424,0.59,0.2985,68,96,164,164,519,164,2,3,4,234,2,728,125445,2,164
2011-07-31,fall,2011,July,22,Sunday,Holiday,Clear,0.74,0.697,0.7,0.2985,25,71,96,96,519,96,2,2,4,224,0,728,95612,2,96
2011-07-31,fall,2011,July,23,Sunday,Holiday,Clear,0.74,0.697,0.66,0.2239,14,56,70,70,519,70,2,2,4,224,0,728,63941,2,70
2011-08-01,fall,2011,August,0,Monday,Workingday,Clear,0.72,0.6818,0.7,0.2239,7,22,29,29,518,29,2,1,4,214,0,726,39130,2,29
2011-08-01,fall,2011,August,1,Monday,Workingday,Clear,0.72,0.697,0.74,0.194,5,12,17,17,518,17,2,1,4,214,0,724,24164,2,17
2011-08-01,fall,2011,August,2,Monday,Workingday,Clear,0.7,0.6667,0.74,0.1045,4,7,11,11,518,11,2,1,4,214,0,715,16352,2,11
2011-08-01,fall,2011,August,3,Monday,Workingday,Clear,0.7,0.6667,0.79,0.1642,0,4,4,4,518,4,2,1,4,214,0,697,8174,2,4
2011-08-01,fall,2011,August,4,Monday,Workingday,Clear,0.66,0.6061,0.83,0.1343,2,2,4,4,518,4,2,1,3,213,0,697,4428,2,4
2011-08-01,fall,2011,August,5,Monday,Workingday,Clear,0.66,0.6061,0.83,0.1045,2,24,26,26,518,26,2,1,3,213,0,717,14261,2,26
2011-08-01,fall,2011,August,6,Monday,Workingday,Clear,0.66,0.6061,0.83,0.0896,3,97,100,100,518,100,2,2,3,223,0,725,55132,2,100
2011-08-01,fall,2011,August,7,Monday,Workingday,Clear,0.74,0.6818,0.62,0.0,24,258,282,282,518,282,2,4,4,244,0,727,154171,2,282
2011-08-01,fall,2011,August,8,Monday,Workingday,Clear,0.8,0.7273,0.43,0.194,35,347,382,382,518,382,2,4,4,244,2,727,261001,2,382
2011-08-01,fall,2011,August,9,Monday,Workingday,Clear,0.82,0.7424,0.41,0.0,27,139,166,166,518,166,2,3,4,234,2,727,159438,2,166
2011-08-01,fall,2011,August,10,Monday,Workingday,Clear,0.86,0.7576,0.36,0.1642,27,70,97,97,518,97,2,2,4,224,2,727,126257,2,97
2011-08-01,fall,2011,August,11,Monday,Workingday,Clear,0.88,0.7727,0.32,0.1642,53,66,119,119,518,119,2,2,4,224,2,727,151320,2,119
2011-08-01,fall,2011,August,12,Monday,Workingday,Clear,0.9,0.803,0.33,0.2537,53,115,168,168,518,168,2,3,4,234,2,728,184414,2,168
2011-08-01,fall,2011,August,13,Monday,Workingday,Clear,0.9,0.803,0.31,0.2985,38,112,150,150,518,150,2,3,4,234,2,729,184919,2,150
2011-08-01,fall,2011,August,14,Monday,Workingday,Clear,0.92,0.8182,0.29,0.194,37,86,123,123,518,123,2,2,4,224,2,729,175652,2,123
2011-08-01,fall,2011,August,15,Monday,Workingday,Clear,0.9,0.7879,0.27,0.0,52,77,129,129,518,129,2,2,4,224,2,729,183149,2,129
2011-08-01,fall,2011,August,16,Monday,Workingday,Clear,0.9,0.7879,0.27,0.0,34,197,231,231,518,231,2,3,4,234,2,730,227748,2,231
2011-08-01,fall,2011,August,17,Monday,Workingday,Clear,0.76,0.6818,0.45,0.2985,69,445,514,514,518,514,2,4,4,244,2,730,336860,2,514
2011-08-01,fall,2011,August,18,Monday,Workingday,Clear,0.78,0.697,0.43,0.194,68,475,543,543,518,543,2,4,4,244,2,728,309772,2,543
2011-08-01,fall,2011,August,19,Monday,Workingday,Clear,0.74,0.6667,0.51,0.2239,63,350,413,413,518,413,2,4,4,244,2,728,226789,2,413
2011-08-01,fall,2011,August,20,Monday,Workingday,Clear,0.72,0.6818,0.62,0.2239,49,256,305,305,518,305,2,4,4,244,2,728,164550,2,305
2011-08-01,fall,2011,August,21,Monday,Workingday,Clear,0.7,0.6515,0.7,0.2537,42,178,220,220,518,220,2,3,4,234,0,728,125445,2,220
2011-08-01,fall,2011,August,22,Monday,Workingday,Clear,0.7,0.6515,0.7,0.0896,21,116,137,137,518,137,2,2,4,224,0,728,95612,2,137
2011-08-01,fall,2011,August,23,Monday,Workingday,Clear,0.68,0.6364,0.74,0.194,14,82,96,96,518,96,2,2,4,224,0,728,63941,2,96
2011-08-02,fall,2011,August,0,Tuesday,Workingday,Clear,0.66,0.6212,0.74,0.0,11,18,29,29,517,29,2,1,3,213,0,726,39130,2,29
2011-08-02,fall,2011,August,1,Tuesday,Workingday,Clear,0.66,0.6212,0.74,0.1045,4,8,12,12,517,12,2,1,3,213,0,724,24164,2,12
2011-08-02,fall,2011,August,2,Tuesday,Workingday,Clear,0.68,0.6364,0.69,0.0,2,6,8,8,517,8,2,1,4,214,0,715,16352,2,8
2011-08-02,fall,2011,August,3,Tuesday,Workingday,Clear,0.66,0.6212,0.74,0.194,0,5,5,5,517,5,2,1,3,213,0,697,8174,2,5
2011-08-02,fall,2011,August,4,Tuesday,Workingday,Clear,0.66,0.6212,0.74,0.1045,0,10,10,10,517,10,2,1,3,213,0,697,4428,2,10
2011-08-02,fall,2011,August,5,Tuesday,Workingday,Clear,0.66,0.6212,0.74,0.1343,4,17,21,21,517,21,2,1,3,213,0,717,14261,2,21
2011-08-02,fall,2011,August,6,Tuesday,Workingday,Clear,0.68,0.6364,0.69,0.1045,12,105,117,117,517,117,2,2,4,224,0,725,55132,2,117
2011-08-02,fall,2011,August,7,Tuesday,Workingday,Clear,0.72,0.6667,0.61,0.2836,15,320,335,335,517,335,2,4,4,244,2,727,154171,2,335
2011-08-02,fall,2011,August,8,Tuesday,Workingday,Clear,0.74,0.6818,0.58,0.2836,37,398,435,435,517,435,2,4,4,244,2,727,261001,2,435
2011-08-02,fall,2011,August,9,Tuesday,Workingday,Clear,0.78,0.697,0.46,0.2985,31,182,213,213,517,213,2,3,4,234,2,727,159438,2,213
2011-08-02,fall,2011,August,10,Tuesday,Workingday,Clear,0.82,0.7273,0.36,0.2985,50,90,140,140,517,140,2,2,4,224,2,727,126257,2,140
2011-08-02,fall,2011,August,11,Tuesday,Workingday,Clear,0.84,0.7273,0.32,0.4179,32,96,128,128,517,128,2,2,4,224,2,727,151320,2,128
2011-08-02,fall,2011,August,12,Tuesday,Workingday,Clear,0.86,0.7424,0.3,0.2836,45,112,157,157,517,157,2,3,4,234,2,728,184414,2,157
2011-08-02,fall,2011,August,13,Tuesday,Workingday,Clear,0.86,0.7424,0.3,0.2239,50,153,203,203,517,203,2,3,4,234,2,729,184919,2,203
2011-08-02,fall,2011,August,14,Tuesday,Workingday,Clear,0.9,0.7727,0.25,0.2836,45,114,159,159,517,159,2,3,4,234,2,729,175652,2,159
2011-08-02,fall,2011,August,15,Tuesday,Workingday,Clear,0.9,0.7727,0.25,0.2836,48,120,168,168,517,168,2,3,4,234,2,729,183149,2,168
2011-08-02,fall,2011,August,16,Tuesday,Workingday,Clear,0.9,0.7727,0.25,0.2836,58,216,274,274,517,274,2,3,4,234,2,730,227748,2,274
2011-08-02,fall,2011,August,17,Tuesday,Workingday,Mist,0.9,0.7879,0.27,0.1343,63,493,556,556,517,556,2,4,4,244,2,730,336860,2,556
2011-08-02,fall,2011,August,18,Tuesday,Workingday,Mist,0.86,0.7576,0.34,0.194,65,491,556,556,517,556,2,4,4,244,2,728,309772,2,556
2011-08-02,fall,2011,August,19,Tuesday,Workingday,Mist,0.86,0.7576,0.36,0.2239,85,369,454,454,517,454,2,4,4,244,2,728,226789,2,454
2011-08-02,fall,2011,August,20,Tuesday,Workingday,Mist,0.82,0.7576,0.46,0.2537,40,248,288,288,517,288,2,4,4,244,2,728,164550,2,288
2011-08-02,fall,2011,August,21,Tuesday,Workingday,Clear,0.8,0.7424,0.52,0.2239,53,201,254,254,517,254,2,3,4,234,2,728,125445,2,254
2011-08-02,fall,2011,August,22,Tuesday,Workingday,Mist,0.78,0.7424,0.59,0.1642,22,169,191,191,517,191,2,3,4,234,2,728,95612,2,191
2011-08-02,fall,2011,August,23,Tuesday,Workingday,Mist,0.8,0.7424,0.49,0.1642,29,103,132,132,517,132,2,2,4,224,2,728,63941,2,132
2011-08-03,fall,2011,August,0,Wednesday,Workingday,Mist,0.8,0.7424,0.49,0.1642,11,32,43,43,516,43,2,2,4,224,0,726,39130,2,43
2011-08-03,fall,2011,August,1,Wednesday,Workingday,Mist,0.78,0.7121,0.52,0.1642,7,9,16,16,516,16,2,1,4,214,0,724,24164,2,16
2011-08-03,fall,2011,August,2,Wednesday,Workingday,Mist,0.78,0.7121,0.49,0.1642,2,9,11,11,516,11,2,1,4,214,0,715,16352,2,11
2011-08-03,fall,2011,August,3,Wednesday,Workingday,Mist,0.76,0.697,0.55,0.0896,0,4,4,4,516,4,2,1,4,214,0,697,8174,2,4
2011-08-03,fall,2011,August,4,Wednesday,Workingday,Mist,0.76,0.697,0.52,0.1642,0,7,7,7,516,7,2,1,4,214,0,697,4428,2,7
2011-08-03,fall,2011,August,5,Wednesday,Workingday,Mist,0.76,0.697,0.55,0.0896,2,22,24,24,516,24,2,1,4,214,0,717,14261,2,24
2011-08-03,fall,2011,August,6,Wednesday,Workingday,Light Snow,0.72,0.6818,0.66,0.4925,9,101,110,110,516,110,2,2,4,224,0,725,55132,2,110
2011-08-03,fall,2011,August,7,Wednesday,Workingday,Mist,0.74,0.6667,0.51,0.2239,19,252,271,271,516,271,2,3,4,234,2,727,154171,2,271
2011-08-03,fall,2011,August,8,Wednesday,Workingday,Mist,0.74,0.6667,0.51,0.1642,29,408,437,437,516,437,2,4,4,244,2,727,261001,2,437
2011-08-03,fall,2011,August,9,Wednesday,Workingday,Mist,0.74,0.6818,0.55,0.194,23,172,195,195,516,195,2,3,4,234,2,727,159438,2,195
2011-08-03,fall,2011,August,10,Wednesday,Workingday,Light Snow,0.74,0.6818,0.58,0.0896,9,59,68,68,516,68,2,2,4,224,0,727,126257,2,68
2011-08-03,fall,2011,August,11,Wednesday,Workingday,Mist,0.74,0.6818,0.58,0.1045,29,93,122,122,516,122,2,2,4,224,0,727,151320,2,122
2011-08-03,fall,2011,August,12,Wednesday,Workingday,Light Snow,0.76,0.697,0.55,0.1343,19,142,161,161,516,161,2,3,4,234,0,728,184414,2,161
2011-08-03,fall,2011,August,13,Wednesday,Workingday,Mist,0.76,0.7121,0.58,0.2239,37,107,144,144,516,144,2,3,4,234,2,729,184919,2,144
2011-08-03,fall,2011,August,14,Wednesday,Workingday,Mist,0.76,0.7121,0.58,0.2239,43,104,147,147,516,147,2,3,4,234,2,729,175652,2,147
2011-08-03,fall,2011,August,15,Wednesday,Workingday,Mist,0.7,0.6667,0.79,0.1343,31,87,118,118,516,118,2,2,4,224,0,729,183149,2,118
2011-08-03,fall,2011,August,16,Wednesday,Workingday,Light Snow,0.68,0.6364,0.79,0.0,21,129,150,150,516,150,2,3,4,234,0,730,227748,2,150
2011-08-03,fall,2011,August,17,Wednesday,Workingday,Mist,0.7,0.6667,0.79,0.0,47,378,425,425,516,425,2,4,4,244,0,730,336860,2,425
2011-08-03,fall,2011,August,18,Wednesday,Workingday,Light Snow,0.7,0.6667,0.84,0.0,49,443,492,492,516,492,2,4,4,244,0,728,309772,2,492
2011-08-03,fall,2011,August,19,Wednesday,Workingday,Light Snow,0.7,0.6667,0.84,0.0,51,270,321,321,516,321,2,4,4,244,0,728,226789,2,321
2011-08-03,fall,2011,August,20,Wednesday,Workingday,Light Snow,0.7,0.6667,0.84,0.1045,7,80,87,87,516,87,2,2,4,224,0,728,164550,2,87
2011-08-03,fall,2011,August,21,Wednesday,Workingday,Mist,0.68,0.6364,0.89,0.1343,7,81,88,88,516,88,2,2,4,224,0,728,125445,2,88
2011-08-03,fall,2011,August,22,Wednesday,Workingday,Light Snow,0.68,0.6364,0.89,0.1045,11,66,77,77,516,77,2,2,4,224,0,728,95612,2,77
2011-08-03,fall,2011,August,23,Wednesday,Workingday,Mist,0.68,0.6364,0.89,0.0896,4,52,56,56,516,56,2,2,4,224,0,728,63941,2,56
2011-08-04,fall,2011,August,0,Thursday,Workingday,Mist,0.68,0.6364,0.89,0.0896,2,15,17,17,515,17,2,1,4,214,0,726,39130,2,17
2011-08-04,fall,2011,August,1,Thursday,Workingday,Mist,0.66,0.5909,0.94,0.0896,3,14,17,17,515,17,2,1,3,213,0,724,24164,2,17
2011-08-04,fall,2011,August,2,Thursday,Workingday,Mist,0.66,0.5909,0.94,0.0896,2,5,7,7,515,7,2,1,3,213,0,715,16352,2,7
2011-08-04,fall,2011,August,3,Thursday,Workingday,Light Snow,0.66,0.5909,0.94,0.0896,0,3,3,3,515,3,2,1,3,213,0,697,8174,2,3
2011-08-04,fall,2011,August,4,Thursday,Workingday,Mist,0.68,0.6364,0.89,0.0,0,7,7,7,515,7,2,1,4,214,0,697,4428,2,7
2011-08-04,fall,2011,August,5,Thursday,Workingday,Mist,0.68,0.6364,0.89,0.0,3,17,20,20,515,20,2,1,4,214,0,717,14261,2,20
2011-08-04,fall,2011,August,6,Thursday,Workingday,Mist,0.68,0.6364,0.89,0.2985,7,90,97,97,515,97,2,2,4,224,0,725,55132,2,97
2011-08-04,fall,2011,August,7,Thursday,Workingday,Mist,0.68,0.6364,0.89,0.2985,11,271,282,282,515,282,2,4,4,244,0,727,154171,2,282
2011-08-04,fall,2011,August,8,Thursday,Workingday,Mist,0.7,0.6515,0.82,0.3582,29,369,398,398,515,398,2,4,4,244,2,727,261001,2,398
2011-08-04,fall,2011,August,9,Thursday,Workingday,Clear,0.72,0.697,0.74,0.3284,25,162,187,187,515,187,2,3,4,234,0,727,159438,2,187
2011-08-04,fall,2011,August,10,Thursday,Workingday,Clear,0.72,0.6667,0.71,0.2985,24,89,113,113,515,113,2,2,4,224,0,727,126257,2,113
2011-08-04,fall,2011,August,11,Thursday,Workingday,Mist,0.74,0.697,0.66,0.2239,37,112,149,149,515,149,2,3,4,234,0,727,151320,2,149
2011-08-04,fall,2011,August,12,Thursday,Workingday,Mist,0.76,0.7121,0.62,0.2239,53,152,205,205,515,205,2,3,4,234,2,728,184414,2,205
2011-08-04,fall,2011,August,13,Thursday,Workingday,Clear,0.76,0.7121,0.58,0.0,63,142,205,205,515,205,2,3,4,234,2,729,184919,2,205
2011-08-04,fall,2011,August,14,Thursday,Workingday,Clear,0.8,0.7576,0.55,0.1642,53,114,167,167,515,167,2,3,4,234,2,729,175652,2,167
2011-08-04,fall,2011,August,15,Thursday,Workingday,Clear,0.8,0.7576,0.55,0.2537,50,115,165,165,515,165,2,3,4,234,2,729,183149,2,165
2011-08-04,fall,2011,August,16,Thursday,Workingday,Clear,0.76,0.7121,0.62,0.3284,70,220,290,290,515,290,2,4,4,244,2,730,227748,2,290
2011-08-04,fall,2011,August,17,Thursday,Workingday,Clear,0.76,0.7121,0.62,0.3284,91,464,555,555,515,555,2,4,4,244,2,730,336860,2,555
2011-08-04,fall,2011,August,18,Thursday,Workingday,Clear,0.7,0.6667,0.74,0.2985,88,435,523,523,515,523,2,4,4,244,2,728,309772,2,523
2011-08-04,fall,2011,August,19,Thursday,Workingday,Clear,0.7,0.6667,0.74,0.2836,65,301,366,366,515,366,2,4,4,244,2,728,226789,2,366
2011-08-04,fall,2011,August,20,Thursday,Workingday,Mist,0.7,0.6667,0.74,0.194,41,245,286,286,515,286,2,4,4,244,0,728,164550,2,286
2011-08-04,fall,2011,August,21,Thursday,Workingday,Mist,0.7,0.6667,0.74,0.194,25,186,211,211,515,211,2,3,4,234,0,728,125445,2,211
2011-08-04,fall,2011,August,22,Thursday,Workingday,Clear,0.68,0.6364,0.74,0.194,33,141,174,174,515,174,2,3,4,234,0,728,95612,2,174
2011-08-04,fall,2011,August,23,Thursday,Workingday,Clear,0.66,0.6212,0.74,0.1045,24,108,132,132,515,132,2,2,3,223,0,728,63941,2,132
2011-08-05,fall,2011,August,0,Friday,Workingday,Clear,0.66,0.6212,0.74,0.1045,13,41,54,54,514,54,2,2,3,223,0,726,39130,2,54
2011-08-05,fall,2011,August,1,Friday,Workingday,Clear,0.64,0.5909,0.78,0.0896,3,16,19,19,514,19,2,1,3,213,0,724,24164,2,19
2011-08-05,fall,2011,August,2,Friday,Workingday,Clear,0.66,0.6212,0.69,0.0,5,14,19,19,514,19,2,1,3,213,0,715,16352,2,19
2011-08-05,fall,2011,August,3,Friday,Workingday,Clear,0.64,0.5909,0.78,0.0896,0,6,6,6,514,6,2,1,3,213,0,697,8174,2,6
2011-08-05,fall,2011,August,4,Friday,Workingday,Clear,0.64,0.5909,0.78,0.1343,1,6,7,7,514,7,2,1,3,213,0,697,4428,2,7
2011-08-05,fall,2011,August,5,Friday,Workingday,Clear,0.64,0.5909,0.78,0.0896,0,16,16,16,514,16,2,1,3,213,0,717,14261,2,16
2011-08-05,fall,2011,August,6,Friday,Workingday,Clear,0.64,0.5909,0.78,0.1343,7,94,101,101,514,101,2,2,3,223,0,725,55132,2,101
2011-08-05,fall,2011,August,7,Friday,Workingday,Clear,0.66,0.6061,0.78,0.1343,23,247,270,270,514,270,2,3,3,233,0,727,154171,2,270
2011-08-05,fall,2011,August,8,Friday,Workingday,Clear,0.7,0.6515,0.65,0.2239,39,415,454,454,514,454,2,4,4,244,2,727,261001,2,454
2011-08-05,fall,2011,August,9,Friday,Workingday,Clear,0.72,0.6667,0.58,0.1045,43,183,226,226,514,226,2,3,4,234,2,727,159438,2,226
2011-08-05,fall,2011,August,10,Friday,Workingday,Clear,0.74,0.6818,0.55,0.1343,50,113,163,163,514,163,2,3,4,234,2,727,126257,2,163
2011-08-05,fall,2011,August,11,Friday,Workingday,Mist,0.76,0.697,0.52,0.2537,44,103,147,147,514,147,2,3,4,234,2,727,151320,2,147
2011-08-05,fall,2011,August,12,Friday,Workingday,Clear,0.76,0.697,0.52,0.2537,57,159,216,216,514,216,2,3,4,234,2,728,184414,2,216
2011-08-05,fall,2011,August,13,Friday,Workingday,Clear,0.78,0.7121,0.52,0.2537,40,164,204,204,514,204,2,3,4,234,2,729,184919,2,204
2011-08-05,fall,2011,August,14,Friday,Workingday,Mist,0.78,0.7121,0.52,0.2537,81,164,245,245,514,245,2,3,4,234,2,729,175652,2,245
2011-08-05,fall,2011,August,15,Friday,Workingday,Clear,0.76,0.697,0.55,0.2537,50,160,210,210,514,210,2,3,4,234,2,729,183149,2,210
2011-08-05,fall,2011,August,16,Friday,Workingday,Clear,0.8,0.7424,0.49,0.2537,76,254,330,330,514,330,2,4,4,244,2,730,227748,2,330
2011-08-05,fall,2011,August,17,Friday,Workingday,Clear,0.78,0.7121,0.49,0.2985,84,466,550,550,514,550,2,4,4,244,2,730,336860,2,550
2011-08-05,fall,2011,August,18,Friday,Workingday,Clear,0.76,0.697,0.52,0.2537,105,361,466,466,514,466,2,4,4,244,2,728,309772,2,466
2011-08-05,fall,2011,August,19,Friday,Workingday,Clear,0.74,0.6818,0.55,0.2537,90,282,372,372,514,372,2,4,4,244,2,728,226789,2,372
2011-08-05,fall,2011,August,20,Friday,Workingday,Clear,0.72,0.6667,0.58,0.2239,70,221,291,291,514,291,2,4,4,244,2,728,164550,2,291
2011-08-05,fall,2011,August,21,Friday,Workingday,Clear,0.7,0.6515,0.65,0.194,54,119,173,173,514,173,2,3,4,234,0,728,125445,2,173
2011-08-05,fall,2011,August,22,Friday,Workingday,Clear,0.7,0.6515,0.65,0.2239,51,137,188,188,514,188,2,3,4,234,0,728,95612,2,188
2011-08-05,fall,2011,August,23,Friday,Workingday,Clear,0.68,0.6364,0.69,0.2239,37,102,139,139,514,139,2,2,4,224,0,728,63941,2,139
2011-08-06,fall,2011,August,0,Saturday,Holiday,Clear,0.66,0.6061,0.78,0.194,29,104,133,133,513,133,2,2,3,223,0,726,39130,2,133
2011-08-06,fall,2011,August,1,Saturday,Holiday,Clear,0.66,0.6061,0.78,0.1642,17,50,67,67,513,67,2,2,3,223,0,724,24164,2,67
2011-08-06,fall,2011,August,2,Saturday,Holiday,Clear,0.66,0.6061,0.78,0.2239,14,39,53,53,513,53,2,2,3,223,0,715,16352,2,53
2011-08-06,fall,2011,August,3,Saturday,Holiday,Mist,0.66,0.6061,0.78,0.1642,14,28,42,42,513,42,2,2,3,223,0,697,8174,2,42
2011-08-06,fall,2011,August,4,Saturday,Holiday,Mist,0.66,0.6061,0.83,0.1642,5,5,10,10,513,10,2,1,3,213,0,697,4428,2,10
2011-08-06,fall,2011,August,5,Saturday,Holiday,Clear,0.64,0.5758,0.89,0.0896,2,4,6,6,513,6,2,1,3,213,0,717,14261,2,6
2011-08-06,fall,2011,August,6,Saturday,Holiday,Clear,0.64,0.5758,0.89,0.1045,5,22,27,27,513,27,2,1,3,213,0,725,55132,2,27
2011-08-06,fall,2011,August,7,Saturday,Holiday,Clear,0.68,0.6364,0.83,0.1642,14,49,63,63,513,63,2,2,4,224,0,727,154171,2,63
2011-08-06,fall,2011,August,8,Saturday,Holiday,Clear,0.68,0.6364,0.83,0.1642,27,94,121,121,513,121,2,2,4,224,0,727,261001,2,121
2011-08-06,fall,2011,August,9,Saturday,Holiday,Clear,0.74,0.697,0.7,0.2239,60,155,215,215,513,215,2,3,4,234,2,727,159438,2,215
2011-08-06,fall,2011,August,10,Saturday,Holiday,Mist,0.74,0.697,0.7,0.2836,91,199,290,290,513,290,2,4,4,244,2,727,126257,2,290
2011-08-06,fall,2011,August,11,Saturday,Holiday,Clear,0.78,0.7424,0.62,0.2239,138,211,349,349,513,349,2,4,4,244,2,727,151320,2,349
2011-08-06,fall,2011,August,12,Saturday,Holiday,Clear,0.8,0.7576,0.55,0.2239,130,252,382,382,513,382,2,4,4,244,2,728,184414,2,382
2011-08-06,fall,2011,August,13,Saturday,Holiday,Mist,0.8,0.7727,0.59,0.3284,176,265,441,441,513,441,2,4,4,244,2,729,184919,2,441
2011-08-06,fall,2011,August,14,Saturday,Holiday,Clear,0.82,0.7727,0.52,0.2537,176,204,380,380,513,380,2,4,4,244,2,729,175652,2,380
2011-08-06,fall,2011,August,15,Saturday,Holiday,Mist,0.84,0.803,0.53,0.2537,130,232,362,362,513,362,2,4,4,244,2,729,183149,2,362
2011-08-06,fall,2011,August,16,Saturday,Holiday,Light Snow,0.74,0.7121,0.79,0.1642,155,188,343,343,513,343,2,4,4,244,2,730,227748,2,343
2011-08-06,fall,2011,August,17,Saturday,Holiday,Light Snow,0.74,0.7121,0.79,0.1642,61,88,149,149,513,149,2,3,4,234,0,730,336860,2,149
2011-08-06,fall,2011,August,18,Saturday,Holiday,Mist,0.72,0.697,0.79,0.4478,81,130,211,211,513,211,2,3,4,234,2,728,309772,2,211
2011-08-06,fall,2011,August,19,Saturday,Holiday,Light Snow,0.72,0.7121,0.84,0.2537,57,114,171,171,513,171,2,3,4,234,0,728,226789,2,171
2011-08-06,fall,2011,August,20,Saturday,Holiday,Light Snow,0.72,0.697,0.79,0.2836,58,79,137,137,513,137,2,2,4,224,0,728,164550,2,137
2011-08-06,fall,2011,August,21,Saturday,Holiday,Mist,0.7,0.6667,0.84,0.3284,28,86,114,114,513,114,2,2,4,224,0,728,125445,2,114
2011-08-06,fall,2011,August,22,Saturday,Holiday,Mist,0.7,0.6667,0.84,0.3284,24,96,120,120,513,120,2,2,4,224,0,728,95612,2,120
2011-08-06,fall,2011,August,23,Saturday,Holiday,Light Snow,0.7,0.6667,0.84,0.2836,29,79,108,108,513,108,2,2,4,224,0,728,63941,2,108
2011-08-07,fall,2011,August,0,Sunday,Holiday,Mist,0.7,0.6667,0.84,0.2836,14,66,80,80,512,80,2,2,4,224,0,726,39130,2,80
2011-08-07,fall,2011,August,1,Sunday,Holiday,Mist,0.7,0.6667,0.84,0.2537,10,63,73,73,512,73,2,2,4,224,0,724,24164,2,73
2011-08-07,fall,2011,August,2,Sunday,Holiday,Mist,0.7,0.6667,0.84,0.2239,18,48,66,66,512,66,2,2,4,224,0,715,16352,2,66
2011-08-07,fall,2011,August,3,Sunday,Holiday,Mist,0.7,0.6667,0.84,0.1343,9,23,32,32,512,32,2,1,4,214,0,697,8174,2,32
2011-08-07,fall,2011,August,4,Sunday,Holiday,Clear,0.7,0.6667,0.84,0.1343,1,5,6,6,512,6,2,1,4,214,0,697,4428,2,6
2011-08-07,fall,2011,August,5,Sunday,Holiday,Clear,0.7,0.6667,0.89,0.194,1,4,5,5,512,5,2,1,4,214,0,717,14261,2,5
2011-08-07,fall,2011,August,6,Sunday,Holiday,Clear,0.7,0.6667,0.89,0.1642,3,10,13,13,512,13,2,1,4,214,0,725,55132,2,13
2011-08-07,fall,2011,August,7,Sunday,Holiday,Clear,0.7,0.6667,0.84,0.194,11,28,39,39,512,39,2,1,4,214,0,727,154171,2,39
2011-08-07,fall,2011,August,8,Sunday,Holiday,Clear,0.72,0.697,0.79,0.194,23,66,89,89,512,89,2,2,4,224,0,727,261001,2,89
2011-08-07,fall,2011,August,9,Sunday,Holiday,Clear,0.76,0.7424,0.75,0.1045,82,102,184,184,512,184,2,3,4,234,0,727,159438,2,184
2011-08-07,fall,2011,August,10,Sunday,Holiday,Clear,0.8,0.803,0.66,0.1343,88,178,266,266,512,266,2,3,4,234,2,727,126257,2,266
2011-08-07,fall,2011,August,11,Sunday,Holiday,Clear,0.82,0.8333,0.63,0.0,113,156,269,269,512,269,2,3,4,234,2,727,151320,2,269
2011-08-07,fall,2011,August,12,Sunday,Holiday,Clear,0.9,0.8485,0.42,0.2985,161,209,370,370,512,370,2,4,4,244,2,728,184414,2,370
2011-08-07,fall,2011,August,13,Sunday,Holiday,Clear,0.9,0.8485,0.42,0.2985,118,206,324,324,512,324,2,4,4,244,2,729,184919,2,324
2011-08-07,fall,2011,August,14,Sunday,Holiday,Clear,0.86,0.803,0.47,0.194,130,192,322,322,512,322,2,4,4,244,2,729,175652,2,322
2011-08-07,fall,2011,August,15,Sunday,Holiday,Light Snow,0.72,0.697,0.74,0.2985,118,208,326,326,512,326,2,4,4,244,2,729,183149,2,326
2011-08-07,fall,2011,August,16,Sunday,Holiday,Light Snow,0.72,0.697,0.74,0.2985,74,119,193,193,512,193,2,3,4,234,2,730,227748,2,193
2011-08-07,fall,2011,August,17,Sunday,Holiday,Light Snow,0.74,0.7121,0.74,0.6418,63,131,194,194,512,194,2,3,4,234,2,730,336860,2,194
2011-08-07,fall,2011,August,18,Sunday,Holiday,Clear,0.72,0.697,0.74,0.0896,74,155,229,229,512,229,2,3,4,234,0,728,309772,2,229
2011-08-07,fall,2011,August,19,Sunday,Holiday,Clear,0.72,0.697,0.79,0.1642,68,160,228,228,512,228,2,3,4,234,0,728,226789,2,228
2011-08-07,fall,2011,August,20,Sunday,Holiday,Clear,0.72,0.7121,0.84,0.1343,50,133,183,183,512,183,2,3,4,234,0,728,164550,2,183
2011-08-07,fall,2011,August,21,Sunday,Holiday,Clear,0.72,0.7121,0.84,0.1045,36,100,136,136,512,136,2,2,4,224,0,728,125445,2,136
2011-08-07,fall,2011,August,22,Sunday,Holiday,Clear,0.7,0.6667,0.89,0.194,21,82,103,103,512,103,2,2,4,224,0,728,95612,2,103
2011-08-07,fall,2011,August,23,Sunday,Holiday,Clear,0.7,0.6667,0.79,0.1045,12,43,55,55,512,55,2,2,4,224,0,728,63941,2,55
2011-08-08,fall,2011,August,0,Monday,Workingday,Clear,0.7,0.6667,0.79,0.1045,13,17,30,30,511,30,2,1,4,214,0,726,39130,2,30
2011-08-08,fall,2011,August,1,Monday,Workingday,Clear,0.68,0.6364,0.83,0.1343,4,8,12,12,511,12,2,1,4,214,0,724,24164,2,12
2011-08-08,fall,2011,August,2,Monday,Workingday,Clear,0.66,0.5909,0.89,0.0,4,3,7,7,511,7,2,1,3,213,0,715,16352,2,7
2011-08-08,fall,2011,August,3,Monday,Workingday,Clear,0.66,0.5909,0.89,0.0,1,0,1,1,511,1,2,1,3,213,0,697,8174,2,1
2011-08-08,fall,2011,August,4,Monday,Workingday,Clear,0.66,0.5909,0.89,0.1045,2,8,10,10,511,10,2,1,3,213,0,697,4428,2,10
2011-08-08,fall,2011,August,5,Monday,Workingday,Clear,0.7,0.6667,0.79,0.0896,1,14,15,15,511,15,2,1,4,214,0,717,14261,2,15
2011-08-08,fall,2011,August,6,Monday,Workingday,Clear,0.7,0.6515,0.65,0.2836,8,87,95,95,511,95,2,2,4,224,0,725,55132,2,95
2011-08-08,fall,2011,August,7,Monday,Workingday,Clear,0.72,0.6818,0.62,0.2985,18,249,267,267,511,267,2,3,4,234,2,727,154171,2,267
2011-08-08,fall,2011,August,8,Monday,Workingday,Clear,0.74,0.6818,0.58,0.3284,29,320,349,349,511,349,2,4,4,244,2,727,261001,2,349
2011-08-08,fall,2011,August,9,Monday,Workingday,Clear,0.76,0.697,0.55,0.3881,37,146,183,183,511,183,2,3,4,234,2,727,159438,2,183
2011-08-08,fall,2011,August,10,Monday,Workingday,Clear,0.8,0.7424,0.52,0.3881,62,62,124,124,511,124,2,2,4,224,2,727,126257,2,124
2011-08-08,fall,2011,August,11,Monday,Workingday,Clear,0.82,0.7424,0.48,0.3582,90,89,179,179,511,179,2,3,4,234,2,727,151320,2,179
2011-08-08,fall,2011,August,12,Monday,Workingday,Clear,0.82,0.7576,0.46,0.2537,48,134,182,182,511,182,2,3,4,234,2,728,184414,2,182
2011-08-08,fall,2011,August,13,Monday,Workingday,Clear,0.84,0.7576,0.44,0.2985,43,108,151,151,511,151,2,3,4,234,2,729,184919,2,151
2011-08-08,fall,2011,August,14,Monday,Workingday,Clear,0.82,0.7424,0.43,0.2985,41,109,150,150,511,150,2,3,4,234,2,729,175652,2,150
2011-08-08,fall,2011,August,15,Monday,Workingday,Clear,0.84,0.7576,0.41,0.2985,40,86,126,126,511,126,2,2,4,224,2,729,183149,2,126
2011-08-08,fall,2011,August,16,Monday,Workingday,Clear,0.86,0.7727,0.39,0.2836,64,218,282,282,511,282,2,4,4,244,2,730,227748,2,282
2011-08-08,fall,2011,August,17,Monday,Workingday,Clear,0.86,0.7727,0.39,0.1642,67,460,527,527,511,527,2,4,4,244,2,730,336860,2,527
2011-08-08,fall,2011,August,18,Monday,Workingday,Clear,0.84,0.7576,0.41,0.1343,64,465,529,529,511,529,2,4,4,244,2,728,309772,2,529
2011-08-08,fall,2011,August,19,Monday,Workingday,Clear,0.82,0.7424,0.43,0.1045,64,352,416,416,511,416,2,4,4,244,2,728,226789,2,416
2011-08-08,fall,2011,August,20,Monday,Workingday,Clear,0.8,0.7576,0.55,0.0,71,215,286,286,511,286,2,4,4,244,2,728,164550,2,286
2011-08-08,fall,2011,August,21,Monday,Workingday,Clear,0.76,0.7121,0.58,0.0896,30,156,186,186,511,186,2,3,4,234,0,728,125445,2,186
2011-08-08,fall,2011,August,22,Monday,Workingday,Clear,0.76,0.7121,0.58,0.1045,26,121,147,147,511,147,2,3,4,234,0,728,95612,2,147
2011-08-08,fall,2011,August,23,Monday,Workingday,Clear,0.74,0.697,0.66,0.1045,19,53,72,72,511,72,2,2,4,224,0,728,63941,2,72
2011-08-09,fall,2011,August,0,Tuesday,Workingday,Clear,0.72,0.697,0.79,0.1343,10,25,35,35,510,35,2,1,4,214,0,726,39130,2,35
2011-08-09,fall,2011,August,1,Tuesday,Workingday,Clear,0.72,0.6818,0.66,0.0,5,9,14,14,510,14,2,1,4,214,0,724,24164,2,14
2011-08-09,fall,2011,August,2,Tuesday,Workingday,Clear,0.72,0.6818,0.7,0.0,9,3,12,12,510,12,2,1,4,214,0,715,16352,2,12
2011-08-09,fall,2011,August,3,Tuesday,Workingday,Clear,0.72,0.6818,0.62,0.0,0,3,3,3,510,3,2,1,4,214,0,697,8174,2,3
2011-08-09,fall,2011,August,4,Tuesday,Workingday,Clear,0.7,0.6667,0.74,0.0,1,6,7,7,510,7,2,1,4,214,0,697,4428,2,7
2011-08-09,fall,2011,August,5,Tuesday,Workingday,Clear,0.7,0.6515,0.65,0.0896,5,25,30,30,510,30,2,1,4,214,0,717,14261,2,30
2011-08-09,fall,2011,August,6,Tuesday,Workingday,Clear,0.72,0.6667,0.64,0.0,6,95,101,101,510,101,2,2,4,224,0,725,55132,2,101
2011-08-09,fall,2011,August,7,Tuesday,Workingday,Clear,0.72,0.697,0.74,0.1045,30,313,343,343,510,343,2,4,4,244,0,727,154171,2,343
2011-08-09,fall,2011,August,8,Tuesday,Workingday,Clear,0.74,0.697,0.66,0.0,40,352,392,392,510,392,2,4,4,244,2,727,261001,2,392
2011-08-09,fall,2011,August,9,Tuesday,Workingday,Mist,0.78,0.7424,0.62,0.1343,34,141,175,175,510,175,2,3,4,234,0,727,159438,2,175
2011-08-09,fall,2011,August,10,Tuesday,Workingday,Mist,0.8,0.7727,0.59,0.2239,55,89,144,144,510,144,2,3,4,234,2,727,126257,2,144
2011-08-09,fall,2011,August,11,Tuesday,Workingday,Clear,0.8,0.7727,0.59,0.2239,61,88,149,149,510,149,2,3,4,234,2,727,151320,2,149
2011-08-09,fall,2011,August,12,Tuesday,Workingday,Clear,0.82,0.7879,0.56,0.194,60,125,185,185,510,185,2,3,4,234,2,728,184414,2,185
2011-08-09,fall,2011,August,13,Tuesday,Workingday,Clear,0.84,0.7879,0.49,0.1642,48,127,175,175,510,175,2,3,4,234,2,729,184919,2,175
2011-08-09,fall,2011,August,14,Tuesday,Workingday,Clear,0.86,0.7879,0.44,0.2836,53,95,148,148,510,148,2,3,4,234,2,729,175652,2,148
2011-08-09,fall,2011,August,15,Tuesday,Workingday,Clear,0.86,0.7727,0.39,0.2836,58,106,164,164,510,164,2,3,4,234,2,729,183149,2,164
2011-08-09,fall,2011,August,16,Tuesday,Workingday,Clear,0.86,0.7727,0.39,0.2985,57,228,285,285,510,285,2,4,4,244,2,730,227748,2,285
2011-08-09,fall,2011,August,17,Tuesday,Workingday,Clear,0.8,0.7576,0.55,0.1642,79,453,532,532,510,532,2,4,4,244,2,730,336860,2,532
2011-08-09,fall,2011,August,18,Tuesday,Workingday,Clear,0.8,0.7576,0.55,0.194,97,488,585,585,510,585,2,4,4,244,2,728,309772,2,585
2011-08-09,fall,2011,August,19,Tuesday,Workingday,Clear,0.8,0.7424,0.49,0.1045,69,302,371,371,510,371,2,4,4,244,2,728,226789,2,371
2011-08-09,fall,2011,August,20,Tuesday,Workingday,Clear,0.8,0.7273,0.43,0.194,34,258,292,292,510,292,2,4,4,244,2,728,164550,2,292
2011-08-09,fall,2011,August,21,Tuesday,Workingday,Clear,0.78,0.697,0.46,0.2537,46,184,230,230,510,230,2,3,4,234,2,728,125445,2,230
2011-08-09,fall,2011,August,22,Tuesday,Workingday,Clear,0.78,0.697,0.46,0.2985,28,127,155,155,510,155,2,3,4,234,2,728,95612,2,155
2011-08-09,fall,2011,August,23,Tuesday,Workingday,Clear,0.76,0.6818,0.48,0.2836,22,53,75,75,510,75,2,2,4,224,2,728,63941,2,75
2011-08-10,fall,2011,August,0,Wednesday,Workingday,Clear,0.74,0.6667,0.51,0.2239,19,18,37,37,509,37,2,1,4,214,0,726,39130,2,37
2011-08-10,fall,2011,August,1,Wednesday,Workingday,Clear,0.72,0.6667,0.54,0.194,7,10,17,17,509,17,2,1,4,214,0,724,24164,2,17
2011-08-10,fall,2011,August,2,Wednesday,Workingday,Clear,0.72,0.6667,0.54,0.1642,1,10,11,11,509,11,2,1,4,214,0,715,16352,2,11
2011-08-10,fall,2011,August,3,Wednesday,Workingday,Clear,0.7,0.6515,0.58,0.1642,1,3,4,4,509,4,2,1,4,214,0,697,8174,2,4
2011-08-10,fall,2011,August,4,Wednesday,Workingday,Clear,0.7,0.6515,0.54,0.1343,1,4,5,5,509,5,2,1,4,214,0,697,4428,2,5
2011-08-10,fall,2011,August,5,Wednesday,Workingday,Clear,0.68,0.6364,0.61,0.0896,2,30,32,32,509,32,2,1,4,214,0,717,14261,2,32
2011-08-10,fall,2011,August,6,Wednesday,Workingday,Clear,0.68,0.6364,0.61,0.0,9,110,119,119,509,119,2,2,4,224,0,725,55132,2,119
2011-08-10,fall,2011,August,7,Wednesday,Workingday,Clear,0.7,0.6515,0.58,0.0896,16,289,305,305,509,305,2,4,4,244,2,727,154171,2,305
2011-08-10,fall,2011,August,8,Wednesday,Workingday,Clear,0.74,0.6667,0.51,0.194,38,361,399,399,509,399,2,4,4,244,2,727,261001,2,399
2011-08-10,fall,2011,August,9,Wednesday,Workingday,Clear,0.76,0.6818,0.48,0.2239,32,148,180,180,509,180,2,3,4,234,2,727,159438,2,180
2011-08-10,fall,2011,August,10,Wednesday,Workingday,Clear,0.8,0.7273,0.43,0.2239,41,72,113,113,509,113,2,2,4,224,2,727,126257,2,113
2011-08-10,fall,2011,August,11,Wednesday,Workingday,Clear,0.8,0.7121,0.41,0.3881,54,95,149,149,509,149,2,3,4,234,2,727,151320,2,149
2011-08-10,fall,2011,August,12,Wednesday,Workingday,Clear,0.82,0.7273,0.38,0.2985,74,166,240,240,509,240,2,3,4,234,2,728,184414,2,240
2011-08-10,fall,2011,August,13,Wednesday,Workingday,Clear,0.82,0.7273,0.38,0.2836,41,150,191,191,509,191,2,3,4,234,2,729,184919,2,191
2011-08-10,fall,2011,August,14,Wednesday,Workingday,Clear,0.84,0.7273,0.34,0.3284,62,116,178,178,509,178,2,3,4,234,2,729,175652,2,178
2011-08-10,fall,2011,August,15,Wednesday,Workingday,Clear,0.86,0.7424,0.3,0.3284,53,141,194,194,509,194,2,3,4,234,2,729,183149,2,194
2011-08-10,fall,2011,August,16,Wednesday,Workingday,Clear,0.86,0.7424,0.26,0.2985,76,206,282,282,509,282,2,4,4,244,2,730,227748,2,282
2011-08-10,fall,2011,August,17,Wednesday,Workingday,Clear,0.84,0.7121,0.26,0.2985,71,513,584,584,509,584,2,4,4,244,2,730,336860,2,584
2011-08-10,fall,2011,August,18,Wednesday,Workingday,Clear,0.82,0.7121,0.28,0.2985,70,489,559,559,509,559,2,4,4,244,2,728,309772,2,559
2011-08-10,fall,2011,August,19,Wednesday,Workingday,Clear,0.8,0.697,0.26,0.2537,79,334,413,413,509,413,2,4,4,244,2,728,226789,2,413
2011-08-10,fall,2011,August,20,Wednesday,Workingday,Clear,0.76,0.6667,0.31,0.1343,59,253,312,312,509,312,2,4,4,244,2,728,164550,2,312
2011-08-10,fall,2011,August,21,Wednesday,Workingday,Clear,0.76,0.6667,0.33,0.1045,47,162,209,209,509,209,2,3,4,234,2,728,125445,2,209
2011-08-10,fall,2011,August,22,Wednesday,Workingday,Clear,0.74,0.6515,0.37,0.0,17,122,139,139,509,139,2,2,4,224,0,728,95612,2,139
2011-08-10,fall,2011,August,23,Wednesday,Workingday,Clear,0.74,0.6515,0.37,0.0896,14,94,108,108,509,108,2,2,4,224,0,728,63941,2,108
2011-08-11,fall,2011,August,0,Thursday,Workingday,Clear,0.7,0.6364,0.45,0.1045,6,40,46,46,508,46,2,2,4,224,0,726,39130,2,46
2011-08-11,fall,2011,August,1,Thursday,Workingday,Clear,0.7,0.6364,0.45,0.1343,9,17,26,26,508,26,2,1,4,214,0,724,24164,2,26
2011-08-11,fall,2011,August,2,Thursday,Workingday,Clear,0.66,0.6212,0.54,0.1343,3,8,11,11,508,11,2,1,3,213,0,715,16352,2,11
2011-08-11,fall,2011,August,3,Thursday,Workingday,Clear,0.64,0.6212,0.57,0.1343,2,7,9,9,508,9,2,1,3,213,0,697,8174,2,9
2011-08-11,fall,2011,August,4,Thursday,Workingday,Clear,0.64,0.6212,0.57,0.1642,1,4,5,5,508,5,2,1,3,213,0,697,4428,2,5
2011-08-11,fall,2011,August,5,Thursday,Workingday,Clear,0.64,0.6212,0.61,0.194,2,23,25,25,508,25,2,1,3,213,0,717,14261,2,25
2011-08-11,fall,2011,August,6,Thursday,Workingday,Clear,0.62,0.6061,0.65,0.1642,5,101,106,106,508,106,2,2,3,223,0,725,55132,2,106
2011-08-11,fall,2011,August,7,Thursday,Workingday,Clear,0.66,0.6212,0.54,0.1343,15,292,307,307,508,307,2,4,3,243,2,727,154171,2,307
2011-08-11,fall,2011,August,8,Thursday,Workingday,Clear,0.7,0.6364,0.45,0.1642,29,361,390,390,508,390,2,4,4,244,2,727,261001,2,390
2011-08-11,fall,2011,August,9,Thursday,Workingday,Clear,0.72,0.6515,0.39,0.2239,31,166,197,197,508,197,2,3,4,234,2,727,159438,2,197
2011-08-11,fall,2011,August,10,Thursday,Workingday,Clear,0.74,0.6515,0.37,0.2537,36,96,132,132,508,132,2,2,4,224,2,727,126257,2,132
2011-08-11,fall,2011,August,11,Thursday,Workingday,Clear,0.76,0.6667,0.35,0.2537,59,128,187,187,508,187,2,3,4,234,2,727,151320,2,187
2011-08-11,fall,2011,August,12,Thursday,Workingday,Clear,0.78,0.6818,0.31,0.2537,50,164,214,214,508,214,2,3,4,234,2,728,184414,2,214
2011-08-11,fall,2011,August,13,Thursday,Workingday,Clear,0.76,0.6667,0.31,0.2239,51,166,217,217,508,217,2,3,4,234,2,729,184919,2,217
2011-08-11,fall,2011,August,14,Thursday,Workingday,Clear,0.8,0.697,0.29,0.0,39,103,142,142,508,142,2,2,4,224,2,729,175652,2,142
2011-08-11,fall,2011,August,15,Thursday,Workingday,Clear,0.8,0.697,0.29,0.2985,52,126,178,178,508,178,2,3,4,234,2,729,183149,2,178
2011-08-11,fall,2011,August,16,Thursday,Workingday,Clear,0.8,0.697,0.27,0.194,57,241,298,298,508,298,2,4,4,244,2,730,227748,2,298
2011-08-11,fall,2011,August,17,Thursday,Workingday,Clear,0.8,0.697,0.29,0.2537,96,486,582,582,508,582,2,4,4,244,2,730,336860,2,582
2011-08-11,fall,2011,August,18,Thursday,Workingday,Clear,0.78,0.6818,0.29,0.0896,74,497,571,571,508,571,2,4,4,244,2,728,309772,2,571
2011-08-11,fall,2011,August,19,Thursday,Workingday,Clear,0.74,0.6515,0.35,0.194,48,323,371,371,508,371,2,4,4,244,2,728,226789,2,371
2011-08-11,fall,2011,August,20,Thursday,Workingday,Clear,0.72,0.6515,0.37,0.1343,56,232,288,288,508,288,2,4,4,244,2,728,164550,2,288
2011-08-11,fall,2011,August,21,Thursday,Workingday,Clear,0.7,0.6515,0.48,0.0896,35,171,206,206,508,206,2,3,4,234,2,728,125445,2,206
2011-08-11,fall,2011,August,22,Thursday,Workingday,Clear,0.7,0.6515,0.48,0.0,34,123,157,157,508,157,2,3,4,234,0,728,95612,2,157
2011-08-11,fall,2011,August,23,Thursday,Workingday,Clear,0.66,0.6212,0.5,0.1642,22,105,127,127,508,127,2,2,3,223,0,728,63941,2,127
2011-08-12,fall,2011,August,0,Friday,Workingday,Clear,0.64,0.6212,0.53,0.1642,12,53,65,65,507,65,2,2,3,223,0,726,39130,2,65
2011-08-12,fall,2011,August,1,Friday,Workingday,Clear,0.64,0.6212,0.53,0.1343,4,19,23,23,507,23,2,1,3,213,0,724,24164,2,23
2011-08-12,fall,2011,August,2,Friday,Workingday,Clear,0.62,0.6212,0.57,0.194,0,15,15,15,507,15,2,1,3,213,0,715,16352,2,15
2011-08-12,fall,2011,August,3,Friday,Workingday,Clear,0.62,0.6212,0.53,0.1642,0,9,9,9,507,9,2,1,3,213,0,697,8174,2,9
2011-08-12,fall,2011,August,4,Friday,Workingday,Clear,0.62,0.6212,0.53,0.1343,0,5,5,5,507,5,2,1,3,213,0,697,4428,2,5
2011-08-12,fall,2011,August,5,Friday,Workingday,Clear,0.6,0.6212,0.56,0.1343,2,24,26,26,507,26,2,1,3,213,0,717,14261,2,26
2011-08-12,fall,2011,August,6,Friday,Workingday,Clear,0.62,0.6212,0.5,0.1343,3,73,76,76,507,76,2,2,3,223,0,725,55132,2,76
2011-08-12,fall,2011,August,7,Friday,Workingday,Clear,0.64,0.6212,0.44,0.1642,17,247,264,264,507,264,2,3,3,233,2,727,154171,2,264
2011-08-12,fall,2011,August,8,Friday,Workingday,Clear,0.68,0.6364,0.39,0.2239,29,397,426,426,507,426,2,4,4,244,2,727,261001,2,426
2011-08-12,fall,2011,August,9,Friday,Workingday,Clear,0.72,0.6515,0.34,0.1343,27,178,205,205,507,205,2,3,4,234,2,727,159438,2,205
2011-08-12,fall,2011,August,10,Friday,Workingday,Clear,0.74,0.6515,0.33,0.1045,44,86,130,130,507,130,2,2,4,224,2,727,126257,2,130
2011-08-12,fall,2011,August,11,Friday,Workingday,Clear,0.76,0.6667,0.29,0.0,48,108,156,156,507,156,2,3,4,234,2,727,151320,2,156
2011-08-12,fall,2011,August,12,Friday,Workingday,Clear,0.8,0.697,0.27,0.0,55,167,222,222,507,222,2,3,4,234,2,728,184414,2,222
2011-08-12,fall,2011,August,13,Friday,Workingday,Clear,0.78,0.6818,0.29,0.0896,74,179,253,253,507,253,2,3,4,234,2,729,184919,2,253
2011-08-12,fall,2011,August,14,Friday,Workingday,Clear,0.8,0.697,0.29,0.194,51,135,186,186,507,186,2,3,4,234,2,729,175652,2,186
2011-08-12,fall,2011,August,15,Friday,Workingday,Clear,0.8,0.697,0.29,0.1642,59,190,249,249,507,249,2,3,4,234,2,729,183149,2,249
2011-08-12,fall,2011,August,16,Friday,Workingday,Clear,0.82,0.7121,0.28,0.0,68,266,334,334,507,334,2,4,4,244,2,730,227748,2,334
2011-08-12,fall,2011,August,17,Friday,Workingday,Clear,0.82,0.7121,0.26,0.0,93,423,516,516,507,516,2,4,4,244,2,730,336860,2,516
2011-08-12,fall,2011,August,18,Friday,Workingday,Clear,0.76,0.6818,0.4,0.2985,89,376,465,465,507,465,2,4,4,244,2,728,309772,2,465
2011-08-12,fall,2011,August,19,Friday,Workingday,Clear,0.74,0.6667,0.42,0.2239,101,284,385,385,507,385,2,4,4,244,2,728,226789,2,385
2011-08-12,fall,2011,August,20,Friday,Workingday,Clear,0.72,0.6515,0.42,0.2239,77,210,287,287,507,287,2,4,4,244,2,728,164550,2,287
2011-08-12,fall,2011,August,21,Friday,Workingday,Clear,0.7,0.6515,0.48,0.1343,73,153,226,226,507,226,2,3,4,234,2,728,125445,2,226
2011-08-12,fall,2011,August,22,Friday,Workingday,Clear,0.68,0.6364,0.51,0.0,74,157,231,231,507,231,2,3,4,234,2,728,95612,2,231
2011-08-12,fall,2011,August,23,Friday,Workingday,Clear,0.68,0.6364,0.51,0.0,51,100,151,151,507,151,2,3,4,234,0,728,63941,2,151
2011-08-13,fall,2011,August,0,Saturday,Holiday,Clear,0.68,0.6364,0.51,0.1045,15,69,84,84,506,84,2,2,4,224,0,726,39130,2,84
2011-08-13,fall,2011,August,1,Saturday,Holiday,Mist,0.68,0.6364,0.57,0.0896,13,64,77,77,506,77,2,2,4,224,0,724,24164,2,77
2011-08-13,fall,2011,August,2,Saturday,Holiday,Clear,0.68,0.6364,0.57,0.0,16,58,74,74,506,74,2,2,4,224,0,715,16352,2,74
2011-08-13,fall,2011,August,3,Saturday,Holiday,Clear,0.66,0.6212,0.65,0.1343,9,18,27,27,506,27,2,1,3,213,0,697,8174,2,27
2011-08-13,fall,2011,August,4,Saturday,Holiday,Mist,0.64,0.6061,0.73,0.1343,5,5,10,10,506,10,2,1,3,213,0,697,4428,2,10
2011-08-13,fall,2011,August,5,Saturday,Holiday,Clear,0.64,0.6061,0.73,0.1045,3,15,18,18,506,18,2,1,3,213,0,717,14261,2,18
2011-08-13,fall,2011,August,6,Saturday,Holiday,Clear,0.64,0.6061,0.73,0.0896,3,19,22,22,506,22,2,1,3,213,0,725,55132,2,22
2011-08-13,fall,2011,August,7,Saturday,Holiday,Mist,0.66,0.6212,0.74,0.194,10,34,44,44,506,44,2,2,3,223,0,727,154171,2,44
2011-08-13,fall,2011,August,8,Saturday,Holiday,Mist,0.7,0.6515,0.65,0.1642,28,90,118,118,506,118,2,2,4,224,0,727,261001,2,118
2011-08-13,fall,2011,August,9,Saturday,Holiday,Mist,0.7,0.6667,0.74,0.1642,70,138,208,208,506,208,2,3,4,234,0,727,159438,2,208
2011-08-13,fall,2011,August,10,Saturday,Holiday,Mist,0.72,0.697,0.74,0.2239,97,163,260,260,506,260,2,3,4,234,2,727,126257,2,260
2011-08-13,fall,2011,August,11,Saturday,Holiday,Mist,0.74,0.697,0.7,0.194,122,192,314,314,506,314,2,4,4,244,2,727,151320,2,314
2011-08-13,fall,2011,August,12,Saturday,Holiday,Mist,0.66,0.5909,0.89,0.1642,175,246,421,421,506,421,2,4,3,243,2,728,184414,2,421
2011-08-13,fall,2011,August,13,Saturday,Holiday,Mist,0.74,0.7121,0.74,0.3284,61,92,153,153,506,153,2,3,4,234,2,729,184919,2,153
2011-08-13,fall,2011,August,14,Saturday,Holiday,Clear,0.74,0.697,0.7,0.2537,113,146,259,259,506,259,2,3,4,234,2,729,175652,2,259
2011-08-13,fall,2011,August,15,Saturday,Holiday,Light Snow,0.68,0.6364,0.79,0.3582,150,208,358,358,506,358,2,4,4,244,2,729,183149,2,358
2011-08-13,fall,2011,August,16,Saturday,Holiday,Mist,0.7,0.6667,0.74,0.2836,148,133,281,281,506,281,2,3,4,234,2,730,227748,2,281
2011-08-13,fall,2011,August,17,Saturday,Holiday,Mist,0.72,0.697,0.74,0.2537,97,172,269,269,506,269,2,3,4,234,2,730,336860,2,269
2011-08-13,fall,2011,August,18,Saturday,Holiday,Clear,0.7,0.6667,0.74,0.2239,123,169,292,292,506,292,2,4,4,244,2,728,309772,2,292
2011-08-13,fall,2011,August,19,Saturday,Holiday,Mist,0.68,0.6364,0.79,0.2836,67,170,237,237,506,237,2,3,4,234,0,728,226789,2,237
2011-08-13,fall,2011,August,20,Saturday,Holiday,Mist,0.68,0.6364,0.83,0.2239,78,105,183,183,506,183,2,3,4,234,0,728,164550,2,183
2011-08-13,fall,2011,August,21,Saturday,Holiday,Mist,0.68,0.6364,0.83,0.3881,40,127,167,167,506,167,2,3,4,234,0,728,125445,2,167
2011-08-13,fall,2011,August,22,Saturday,Holiday,Mist,0.68,0.6364,0.83,0.3881,36,118,154,154,506,154,2,3,4,234,0,728,95612,2,154
2011-08-13,fall,2011,August,23,Saturday,Holiday,Mist,0.66,0.6061,0.83,0.3284,25,95,120,120,506,120,2,2,3,223,0,728,63941,2,120
2011-08-14,fall,2011,August,0,Sunday,Holiday,Light Snow,0.66,0.6061,0.83,0.2985,19,71,90,90,505,90,2,2,3,223,0,726,39130,2,90
2011-08-14,fall,2011,August,1,Sunday,Holiday,Light Snow,0.64,0.5758,0.89,0.2239,16,57,73,73,505,73,2,2,3,223,0,724,24164,2,73
2011-08-14,fall,2011,August,2,Sunday,Holiday,Light Snow,0.64,0.5758,0.89,0.2239,13,49,62,62,505,62,2,2,3,223,0,715,16352,2,62
2011-08-14,fall,2011,August,3,Sunday,Holiday,Mist,0.64,0.5606,0.94,0.2537,5,22,27,27,505,27,2,1,3,213,0,697,8174,2,27
2011-08-14,fall,2011,August,4,Sunday,Holiday,Light Snow,0.64,0.5606,0.94,0.194,1,2,3,3,505,3,2,1,3,213,0,697,4428,2,3
2011-08-14,fall,2011,August,5,Sunday,Holiday,Mist,0.64,0.5606,0.94,0.1642,1,9,10,10,505,10,2,1,3,213,0,717,14261,2,10
2011-08-14,fall,2011,August,6,Sunday,Holiday,Mist,0.64,0.5606,0.94,0.1045,2,4,6,6,505,6,2,1,3,213,0,725,55132,2,6
2011-08-14,fall,2011,August,7,Sunday,Holiday,Mist,0.66,0.5909,0.89,0.194,4,20,24,24,505,24,2,1,3,213,0,727,154171,2,24
2011-08-14,fall,2011,August,8,Sunday,Holiday,Mist,0.66,0.5909,0.89,0.2836,20,21,41,41,505,41,2,2,3,223,0,727,261001,2,41
2011-08-14,fall,2011,August,9,Sunday,Holiday,Light Snow,0.66,0.5909,0.89,0.2836,27,76,103,103,505,103,2,2,3,223,0,727,159438,2,103
2011-08-14,fall,2011,August,10,Sunday,Holiday,Clear,0.7,0.6667,0.79,0.2239,67,116,183,183,505,183,2,3,4,234,0,727,126257,2,183
2011-08-14,fall,2011,August,11,Sunday,Holiday,Clear,0.7,0.6667,0.79,0.194,81,117,198,198,505,198,2,3,4,234,0,727,151320,2,198
2011-08-14,fall,2011,August,12,Sunday,Holiday,Mist,0.7,0.6667,0.79,0.2239,98,183,281,281,505,281,2,3,4,234,2,728,184414,2,281
2011-08-14,fall,2011,August,13,Sunday,Holiday,Clear,0.72,0.697,0.74,0.2537,144,233,377,377,505,377,2,4,4,244,2,729,184919,2,377
2011-08-14,fall,2011,August,14,Sunday,Holiday,Clear,0.74,0.697,0.7,0.194,126,244,370,370,505,370,2,4,4,244,2,729,175652,2,370
2011-08-14,fall,2011,August,15,Sunday,Holiday,Clear,0.74,0.697,0.66,0.194,128,203,331,331,505,331,2,4,4,244,2,729,183149,2,331
2011-08-14,fall,2011,August,16,Sunday,Holiday,Clear,0.74,0.697,0.66,0.1642,116,176,292,292,505,292,2,4,4,244,2,730,227748,2,292
2011-08-14,fall,2011,August,17,Sunday,Holiday,Clear,0.76,0.7121,0.62,0.1343,133,196,329,329,505,329,2,4,4,244,2,730,336860,2,329
2011-08-14,fall,2011,August,18,Sunday,Holiday,Clear,0.74,0.697,0.66,0.1642,125,222,347,347,505,347,2,4,4,244,2,728,309772,2,347
2011-08-14,fall,2011,August,19,Sunday,Holiday,Clear,0.72,0.697,0.74,0.2239,75,184,259,259,505,259,2,3,4,234,2,728,226789,2,259
2011-08-14,fall,2011,August,20,Sunday,Holiday,Clear,0.7,0.6667,0.84,0.1642,67,126,193,193,505,193,2,3,4,234,0,728,164550,2,193
2011-08-14,fall,2011,August,21,Sunday,Holiday,Light Snow,0.6,0.5455,0.88,0.4925,51,104,155,155,505,155,2,3,3,233,0,728,125445,2,155
2011-08-14,fall,2011,August,22,Sunday,Holiday,Light Snow,0.6,0.5455,0.88,0.4925,14,25,39,39,505,39,2,1,3,213,0,728,95612,2,39
2011-08-14,fall,2011,August,23,Sunday,Holiday,Light Snow,0.6,0.5606,0.83,0.0,5,22,27,27,505,27,2,1,3,213,0,728,63941,2,27
2011-08-15,fall,2011,August,0,Monday,Workingday,Light Snow,0.6,0.5455,0.88,0.0896,7,18,25,25,504,25,2,1,3,213,0,726,39130,2,25
2011-08-15,fall,2011,August,1,Monday,Workingday,Mist,0.6,0.5455,0.88,0.1343,1,9,10,10,504,10,2,1,3,213,0,724,24164,2,10
2011-08-15,fall,2011,August,2,Monday,Workingday,Mist,0.6,0.5606,0.83,0.0,0,3,3,3,504,3,2,1,3,213,0,715,16352,2,3
2011-08-15,fall,2011,August,3,Monday,Workingday,Clear,0.6,0.5606,0.83,0.194,1,6,7,7,504,7,2,1,3,213,0,697,8174,2,7
2011-08-15,fall,2011,August,4,Monday,Workingday,Clear,0.6,0.5606,0.83,0.1343,1,4,5,5,504,5,2,1,3,213,0,697,4428,2,5
2011-08-15,fall,2011,August,5,Monday,Workingday,Mist,0.6,0.5455,0.88,0.194,3,14,17,17,504,17,2,1,3,213,0,717,14261,2,17
2011-08-15,fall,2011,August,6,Monday,Workingday,Clear,0.6,0.5455,0.88,0.2537,3,87,90,90,504,90,2,2,3,223,0,725,55132,2,90
2011-08-15,fall,2011,August,7,Monday,Workingday,Clear,0.6,0.5455,0.88,0.2537,10,248,258,258,504,258,2,3,3,233,0,727,154171,2,258
2011-08-15,fall,2011,August,8,Monday,Workingday,Clear,0.64,0.5909,0.78,0.3284,29,326,355,355,504,355,2,4,3,243,2,727,261001,2,355
2011-08-15,fall,2011,August,9,Monday,Workingday,Clear,0.64,0.5909,0.78,0.3284,52,170,222,222,504,222,2,3,3,233,0,727,159438,2,222
2011-08-15,fall,2011,August,10,Monday,Workingday,Clear,0.68,0.6364,0.69,0.2836,54,87,141,141,504,141,2,2,4,224,0,727,126257,2,141
2011-08-15,fall,2011,August,11,Monday,Workingday,Mist,0.72,0.6818,0.62,0.2537,41,112,153,153,504,153,2,3,4,234,0,727,151320,2,153
2011-08-15,fall,2011,August,12,Monday,Workingday,Clear,0.74,0.6818,0.58,0.2836,62,116,178,178,504,178,2,3,4,234,2,728,184414,2,178
2011-08-15,fall,2011,August,13,Monday,Workingday,Clear,0.78,0.7121,0.52,0.2836,53,140,193,193,504,193,2,3,4,234,2,729,184919,2,193
2011-08-15,fall,2011,August,14,Monday,Workingday,Clear,0.74,0.6818,0.55,0.0896,56,95,151,151,504,151,2,3,4,234,0,729,175652,2,151
2011-08-15,fall,2011,August,15,Monday,Workingday,Light Snow,0.74,0.6818,0.55,0.2985,49,133,182,182,504,182,2,3,4,234,2,729,183149,2,182
2011-08-15,fall,2011,August,16,Monday,Workingday,Clear,0.74,0.6818,0.55,0.3284,58,225,283,283,504,283,2,4,4,244,2,730,227748,2,283
2011-08-15,fall,2011,August,17,Monday,Workingday,Clear,0.74,0.6667,0.51,0.2836,59,471,530,530,504,530,2,4,4,244,2,730,336860,2,530
2011-08-15,fall,2011,August,18,Monday,Workingday,Clear,0.7,0.6515,0.65,0.194,70,413,483,483,504,483,2,4,4,244,2,728,309772,2,483
2011-08-15,fall,2011,August,19,Monday,Workingday,Clear,0.7,0.6515,0.65,0.0,54,343,397,397,504,397,2,4,4,244,2,728,226789,2,397
2011-08-15,fall,2011,August,20,Monday,Workingday,Clear,0.66,0.6212,0.74,0.1343,45,240,285,285,504,285,2,4,3,243,0,728,164550,2,285
2011-08-15,fall,2011,August,21,Monday,Workingday,Clear,0.66,0.6212,0.65,0.194,34,150,184,184,504,184,2,3,3,233,0,728,125445,2,184
2011-08-15,fall,2011,August,22,Monday,Workingday,Clear,0.66,0.6212,0.69,0.2537,22,76,98,98,504,98,2,2,3,223,0,728,95612,2,98
2011-08-15,fall,2011,August,23,Monday,Workingday,Clear,0.64,0.6061,0.69,0.2239,11,77,88,88,504,88,2,2,3,223,0,728,63941,2,88
2011-08-16,fall,2011,August,0,Tuesday,Workingday,Clear,0.64,0.6061,0.69,0.1045,8,23,31,31,503,31,2,1,3,213,0,726,39130,2,31
2011-08-16,fall,2011,August,1,Tuesday,Workingday,Clear,0.64,0.6061,0.69,0.1642,4,12,16,16,503,16,2,1,3,213,0,724,24164,2,16
2011-08-16,fall,2011,August,2,Tuesday,Workingday,Clear,0.62,0.5909,0.73,0.2239,1,3,4,4,503,4,2,1,3,213,0,715,16352,2,4
2011-08-16,fall,2011,August,3,Tuesday,Workingday,Clear,0.62,0.5909,0.73,0.2239,1,5,6,6,503,6,2,1,3,213,0,697,8174,2,6
2011-08-16,fall,2011,August,4,Tuesday,Workingday,Clear,0.64,0.6061,0.69,0.2985,0,5,5,5,503,5,2,1,3,213,0,697,4428,2,5
2011-08-16,fall,2011,August,5,Tuesday,Workingday,Clear,0.62,0.5909,0.73,0.2836,1,29,30,30,503,30,2,1,3,213,0,717,14261,2,30
2011-08-16,fall,2011,August,6,Tuesday,Workingday,Clear,0.62,0.5909,0.73,0.3284,4,115,119,119,503,119,2,2,3,223,0,725,55132,2,119
2011-08-16,fall,2011,August,7,Tuesday,Workingday,Clear,0.64,0.6061,0.69,0.2537,18,328,346,346,503,346,2,4,3,243,2,727,154171,2,346
2011-08-16,fall,2011,August,8,Tuesday,Workingday,Clear,0.7,0.6515,0.58,0.4478,24,417,441,441,503,441,2,4,4,244,2,727,261001,2,441
2011-08-16,fall,2011,August,9,Tuesday,Workingday,Clear,0.68,0.6364,0.61,0.2836,27,171,198,198,503,198,2,3,4,234,2,727,159438,2,198
2011-08-16,fall,2011,August,10,Tuesday,Workingday,Clear,0.7,0.6515,0.58,0.3881,28,83,111,111,503,111,2,2,4,224,2,727,126257,2,111
2011-08-16,fall,2011,August,11,Tuesday,Workingday,Clear,0.74,0.6667,0.51,0.2239,40,110,150,150,503,150,2,3,4,234,2,727,151320,2,150
2011-08-16,fall,2011,August,12,Tuesday,Workingday,Clear,0.76,0.6818,0.48,0.3284,42,120,162,162,503,162,2,3,4,234,2,728,184414,2,162
2011-08-16,fall,2011,August,13,Tuesday,Workingday,Clear,0.76,0.6818,0.48,0.2985,45,147,192,192,503,192,2,3,4,234,2,729,184919,2,192
2011-08-16,fall,2011,August,14,Tuesday,Workingday,Clear,0.76,0.6818,0.45,0.4179,65,117,182,182,503,182,2,3,4,234,2,729,175652,2,182
2011-08-16,fall,2011,August,15,Tuesday,Workingday,Clear,0.8,0.7121,0.41,0.2985,36,123,159,159,503,159,2,3,4,234,2,729,183149,2,159
2011-08-16,fall,2011,August,16,Tuesday,Workingday,Clear,0.8,0.7121,0.41,0.2239,55,248,303,303,503,303,2,4,4,244,2,730,227748,2,303
2011-08-16,fall,2011,August,17,Tuesday,Workingday,Clear,0.76,0.6818,0.45,0.3284,75,525,600,600,503,600,2,4,4,244,2,730,336860,2,600
2011-08-16,fall,2011,August,18,Tuesday,Workingday,Clear,0.76,0.6818,0.45,0.2239,54,516,570,570,503,570,2,4,4,244,2,728,309772,2,570
2011-08-16,fall,2011,August,19,Tuesday,Workingday,Clear,0.74,0.6667,0.48,0.194,56,320,376,376,503,376,2,4,4,244,2,728,226789,2,376
2011-08-16,fall,2011,August,20,Tuesday,Workingday,Clear,0.74,0.6667,0.51,0.0,48,232,280,280,503,280,2,3,4,234,2,728,164550,2,280
2011-08-16,fall,2011,August,21,Tuesday,Workingday,Clear,0.72,0.6667,0.54,0.0,38,177,215,215,503,215,2,3,4,234,0,728,125445,2,215
2011-08-16,fall,2011,August,22,Tuesday,Workingday,Clear,0.7,0.6515,0.61,0.0,31,121,152,152,503,152,2,3,4,234,0,728,95612,2,152
2011-08-16,fall,2011,August,23,Tuesday,Workingday,Clear,0.66,0.6212,0.65,0.1343,20,57,77,77,503,77,2,2,3,223,0,728,63941,2,77
2011-08-17,fall,2011,August,0,Wednesday,Workingday,Clear,0.66,0.6212,0.69,0.0896,8,16,24,24,502,24,2,1,3,213,0,726,39130,2,24
2011-08-17,fall,2011,August,1,Wednesday,Workingday,Clear,0.64,0.6061,0.73,0.1642,2,12,14,14,502,14,2,1,3,213,0,724,24164,2,14
2011-08-17,fall,2011,August,2,Wednesday,Workingday,Clear,0.66,0.6212,0.69,0.0,0,6,6,6,502,6,2,1,3,213,0,715,16352,2,6
2011-08-17,fall,2011,August,3,Wednesday,Workingday,Clear,0.64,0.5909,0.78,0.0,1,4,5,5,502,5,2,1,3,213,0,697,8174,2,5
2011-08-17,fall,2011,August,4,Wednesday,Workingday,Clear,0.64,0.6061,0.73,0.0,0,5,5,5,502,5,2,1,3,213,0,697,4428,2,5
2011-08-17,fall,2011,August,5,Wednesday,Workingday,Clear,0.64,0.6061,0.73,0.0,0,28,28,28,502,28,2,1,3,213,0,717,14261,2,28
2011-08-17,fall,2011,August,6,Wednesday,Workingday,Clear,0.62,0.5909,0.78,0.0,4,101,105,105,502,105,2,2,3,223,0,725,55132,2,105
2011-08-17,fall,2011,August,7,Wednesday,Workingday,Clear,0.66,0.6212,0.65,0.0896,12,296,308,308,502,308,2,4,3,243,0,727,154171,2,308
2011-08-17,fall,2011,August,8,Wednesday,Workingday,Clear,0.7,0.6515,0.54,0.1642,35,452,487,487,502,487,2,4,4,244,2,727,261001,2,487
2011-08-17,fall,2011,August,9,Wednesday,Workingday,Clear,0.74,0.6667,0.48,0.0896,31,178,209,209,502,209,2,3,4,234,2,727,159438,2,209
2011-08-17,fall,2011,August,10,Wednesday,Workingday,Clear,0.76,0.6818,0.43,0.0896,27,91,118,118,502,118,2,2,4,224,2,727,126257,2,118
2011-08-17,fall,2011,August,11,Wednesday,Workingday,Clear,0.78,0.697,0.43,0.1045,20,108,128,128,502,128,2,2,4,224,2,727,151320,2,128
2011-08-17,fall,2011,August,12,Wednesday,Workingday,Clear,0.8,0.7273,0.43,0.2836,26,163,189,189,502,189,2,3,4,234,2,728,184414,2,189
2011-08-17,fall,2011,August,13,Wednesday,Workingday,Clear,0.8,0.7121,0.41,0.194,38,138,176,176,502,176,2,3,4,234,2,729,184919,2,176
2011-08-17,fall,2011,August,14,Wednesday,Workingday,Clear,0.82,0.7273,0.36,0.1642,54,138,192,192,502,192,2,3,4,234,2,729,175652,2,192
2011-08-17,fall,2011,August,15,Wednesday,Workingday,Clear,0.8,0.7273,0.43,0.1343,42,117,159,159,502,159,2,3,4,234,2,729,183149,2,159
2011-08-17,fall,2011,August,16,Wednesday,Workingday,Clear,0.82,0.7424,0.43,0.2239,62,238,300,300,502,300,2,4,4,244,2,730,227748,2,300
2011-08-17,fall,2011,August,17,Wednesday,Workingday,Clear,0.8,0.7424,0.49,0.2239,46,506,552,552,502,552,2,4,4,244,2,730,336860,2,552
2011-08-17,fall,2011,August,18,Wednesday,Workingday,Clear,0.76,0.697,0.55,0.2537,86,470,556,556,502,556,2,4,4,244,2,728,309772,2,556
2011-08-17,fall,2011,August,19,Wednesday,Workingday,Clear,0.76,0.697,0.55,0.2239,50,297,347,347,502,347,2,4,4,244,2,728,226789,2,347
2011-08-17,fall,2011,August,20,Wednesday,Workingday,Clear,0.74,0.6818,0.58,0.2537,37,243,280,280,502,280,2,3,4,234,2,728,164550,2,280
2011-08-17,fall,2011,August,21,Wednesday,Workingday,Clear,0.72,0.6818,0.62,0.2239,38,192,230,230,502,230,2,3,4,234,2,728,125445,2,230
2011-08-17,fall,2011,August,22,Wednesday,Workingday,Clear,0.7,0.6515,0.65,0.194,29,142,171,171,502,171,2,3,4,234,0,728,95612,2,171
2011-08-17,fall,2011,August,23,Wednesday,Workingday,Clear,0.7,0.6515,0.65,0.2836,20,85,105,105,502,105,2,2,4,224,0,728,63941,2,105
2011-08-18,fall,2011,August,0,Thursday,Workingday,Clear,0.68,0.6364,0.65,0.1343,18,38,56,56,501,56,2,2,4,224,0,726,39130,2,56
2011-08-18,fall,2011,August,1,Thursday,Workingday,Mist,0.66,0.6212,0.65,0.1642,13,11,24,24,501,24,2,1,3,213,0,724,24164,2,24
2011-08-18,fall,2011,August,2,Thursday,Workingday,Clear,0.66,0.6212,0.65,0.2239,2,4,6,6,501,6,2,1,3,213,0,715,16352,2,6
2011-08-18,fall,2011,August,3,Thursday,Workingday,Clear,0.66,0.6212,0.69,0.2836,0,6,6,6,501,6,2,1,3,213,0,697,8174,2,6
2011-08-18,fall,2011,August,4,Thursday,Workingday,Clear,0.64,0.6061,0.73,0.2239,0,9,9,9,501,9,2,1,3,213,0,697,4428,2,9
2011-08-18,fall,2011,August,5,Thursday,Workingday,Clear,0.64,0.5909,0.78,0.2836,0,27,27,27,501,27,2,1,3,213,0,717,14261,2,27
2011-08-18,fall,2011,August,6,Thursday,Workingday,Mist,0.64,0.5909,0.78,0.2537,6,97,103,103,501,103,2,2,3,223,0,725,55132,2,103
2011-08-18,fall,2011,August,7,Thursday,Workingday,Clear,0.64,0.5909,0.78,0.2985,19,289,308,308,501,308,2,4,3,243,0,727,154171,2,308
2011-08-18,fall,2011,August,8,Thursday,Workingday,Clear,0.66,0.6212,0.74,0.2836,27,393,420,420,501,420,2,4,3,243,2,727,261001,2,420
2011-08-18,fall,2011,August,9,Thursday,Workingday,Clear,0.72,0.6818,0.66,0.2537,42,186,228,228,501,228,2,3,4,234,2,727,159438,2,228
2011-08-18,fall,2011,August,10,Thursday,Workingday,Clear,0.74,0.697,0.66,0.2537,37,92,129,129,501,129,2,2,4,224,0,727,126257,2,129
2011-08-18,fall,2011,August,11,Thursday,Workingday,Clear,0.76,0.7121,0.58,0.2537,44,97,141,141,501,141,2,2,4,224,2,727,151320,2,141
2011-08-18,fall,2011,August,12,Thursday,Workingday,Clear,0.8,0.7424,0.52,0.2836,34,139,173,173,501,173,2,3,4,234,2,728,184414,2,173
2011-08-18,fall,2011,August,13,Thursday,Workingday,Clear,0.8,0.7424,0.52,0.3582,33,154,187,187,501,187,2,3,4,234,2,729,184919,2,187
2011-08-18,fall,2011,August,14,Thursday,Workingday,Clear,0.82,0.7576,0.46,0.3284,67,115,182,182,501,182,2,3,4,234,2,729,175652,2,182
2011-08-18,fall,2011,August,15,Thursday,Workingday,Clear,0.8,0.7273,0.46,0.3582,56,118,174,174,501,174,2,3,4,234,2,729,183149,2,174
2011-08-18,fall,2011,August,16,Thursday,Workingday,Clear,0.8,0.7273,0.46,0.3582,49,196,245,245,501,245,2,3,4,234,2,730,227748,2,245
2011-08-18,fall,2011,August,17,Thursday,Workingday,Light Snow,0.8,0.7273,0.46,0.2985,44,365,409,409,501,409,2,4,4,244,2,730,336860,2,409
2011-08-18,fall,2011,August,18,Thursday,Workingday,Light Snow,0.76,0.697,0.55,0.2537,48,226,274,274,501,274,2,3,4,234,2,728,309772,2,274
2011-08-18,fall,2011,August,19,Thursday,Workingday,Clear,0.66,0.6061,0.83,0.1045,26,115,141,141,501,141,2,2,3,223,0,728,226789,2,141
2011-08-18,fall,2011,August,20,Thursday,Workingday,Clear,0.66,0.6061,0.83,0.1045,24,141,165,165,501,165,2,3,3,233,0,728,164550,2,165
2011-08-18,fall,2011,August,21,Thursday,Workingday,Mist,0.68,0.6364,0.79,0.0,12,137,149,149,501,149,2,3,4,234,0,728,125445,2,149
2011-08-18,fall,2011,August,22,Thursday,Workingday,Mist,0.7,0.6667,0.74,0.1045,18,117,135,135,501,135,2,2,4,224,0,728,95612,2,135
2011-08-18,fall,2011,August,23,Thursday,Workingday,Mist,0.7,0.6667,0.74,0.1343,20,94,114,114,501,114,2,2,4,224,0,728,63941,2,114
2011-08-19,fall,2011,August,0,Friday,Workingday,Light Snow,0.68,0.6364,0.69,0.194,9,53,62,62,500,62,2,2,4,224,0,726,39130,2,62
2011-08-19,fall,2011,August,1,Friday,Workingday,Light Snow,0.64,0.5758,0.89,0.0,1,19,20,20,500,20,2,1,3,213,0,724,24164,2,20
2011-08-19,fall,2011,August,2,Friday,Workingday,Light Snow,0.64,0.5758,0.83,0.0,0,8,8,8,500,8,2,1,3,213,0,715,16352,2,8
2011-08-19,fall,2011,August,3,Friday,Workingday,Clear,0.64,0.5909,0.78,0.0,2,1,3,3,500,3,2,1,3,213,0,697,8174,2,3
2011-08-19,fall,2011,August,4,Friday,Workingday,Clear,0.64,0.5758,0.83,0.0,1,7,8,8,500,8,2,1,3,213,0,697,4428,2,8
2011-08-19,fall,2011,August,5,Friday,Workingday,Clear,0.64,0.5758,0.83,0.0,1,16,17,17,500,17,2,1,3,213,0,717,14261,2,17
2011-08-19,fall,2011,August,6,Friday,Workingday,Clear,0.64,0.5758,0.83,0.0,2,91,93,93,500,93,2,2,3,223,0,725,55132,2,93
2011-08-19,fall,2011,August,7,Friday,Workingday,Mist,0.66,0.6061,0.83,0.0896,12,251,263,263,500,263,2,3,3,233,0,727,154171,2,263
2011-08-19,fall,2011,August,8,Friday,Workingday,Mist,0.66,0.6061,0.83,0.0,30,368,398,398,500,398,2,4,3,243,0,727,261001,2,398
2011-08-19,fall,2011,August,9,Friday,Workingday,Clear,0.7,0.6515,0.65,0.1343,31,187,218,218,500,218,2,3,4,234,0,727,159438,2,218
2011-08-19,fall,2011,August,10,Friday,Workingday,Clear,0.72,0.6818,0.62,0.0896,57,108,165,165,500,165,2,3,4,234,0,727,126257,2,165
2011-08-19,fall,2011,August,11,Friday,Workingday,Mist,0.72,0.6818,0.66,0.0896,45,120,165,165,500,165,2,3,4,234,0,727,151320,2,165
2011-08-19,fall,2011,August,12,Friday,Workingday,Mist,0.74,0.6818,0.62,0.0896,54,168,222,222,500,222,2,3,4,234,2,728,184414,2,222
2011-08-19,fall,2011,August,13,Friday,Workingday,Mist,0.76,0.7121,0.62,0.194,63,169,232,232,500,232,2,3,4,234,2,729,184919,2,232
2011-08-19,fall,2011,August,14,Friday,Workingday,Clear,0.78,0.7273,0.55,0.194,78,142,220,220,500,220,2,3,4,234,2,729,175652,2,220
2011-08-19,fall,2011,August,15,Friday,Workingday,Clear,0.8,0.7424,0.49,0.1045,66,156,222,222,500,222,2,3,4,234,2,729,183149,2,222
2011-08-19,fall,2011,August,16,Friday,Workingday,Clear,0.8,0.7424,0.49,0.0,66,261,327,327,500,327,2,4,4,244,2,730,227748,2,327
2011-08-19,fall,2011,August,17,Friday,Workingday,Clear,0.76,0.7121,0.58,0.5224,85,442,527,527,500,527,2,4,4,244,2,730,336860,2,527
2011-08-19,fall,2011,August,18,Friday,Workingday,Clear,0.76,0.7121,0.58,0.5224,88,337,425,425,500,425,2,4,4,244,2,728,309772,2,425
2011-08-19,fall,2011,August,19,Friday,Workingday,Light Snow,0.62,0.5909,0.73,0.4627,33,132,165,165,500,165,2,3,3,233,0,728,226789,2,165
2011-08-19,fall,2011,August,20,Friday,Workingday,Light Snow,0.62,0.5758,0.83,0.2985,12,46,58,58,500,58,2,2,3,223,0,728,164550,2,58
2011-08-19,fall,2011,August,21,Friday,Workingday,Clear,0.62,0.5758,0.83,0.1343,18,89,107,107,500,107,2,2,3,223,0,728,125445,2,107
2011-08-19,fall,2011,August,22,Friday,Workingday,Clear,0.6,0.5455,0.88,0.1343,25,97,122,122,500,122,2,2,3,223,0,728,95612,2,122
2011-08-19,fall,2011,August,23,Friday,Workingday,Mist,0.6,0.5455,0.88,0.0896,18,88,106,106,500,106,2,2,3,223,0,728,63941,2,106
2011-08-20,fall,2011,August,0,Saturday,Holiday,Clear,0.6,0.5455,0.88,0.0,21,107,128,128,499,128,2,2,3,223,0,726,39130,2,128
2011-08-20,fall,2011,August,1,Saturday,Holiday,Clear,0.62,0.5758,0.83,0.0,12,35,47,47,499,47,2,2,3,223,0,724,24164,2,47
2011-08-20,fall,2011,August,2,Saturday,Holiday,Clear,0.62,0.5909,0.78,0.0,10,59,69,69,499,69,2,2,3,223,0,715,16352,2,69
2011-08-20,fall,2011,August,3,Saturday,Holiday,Clear,0.62,0.5909,0.78,0.0,9,42,51,51,499,51,2,2,3,223,0,697,8174,2,51
2011-08-20,fall,2011,August,4,Saturday,Holiday,Mist,0.6,0.5455,0.88,0.0,1,6,7,7,499,7,2,1,3,213,0,697,4428,2,7
2011-08-20,fall,2011,August,5,Saturday,Holiday,Clear,0.6,0.5606,0.83,0.0,0,8,8,8,499,8,2,1,3,213,0,717,14261,2,8
2011-08-20,fall,2011,August,6,Saturday,Holiday,Mist,0.6,0.5606,0.83,0.1343,6,18,24,24,499,24,2,1,3,213,0,725,55132,2,24
2011-08-20,fall,2011,August,7,Saturday,Holiday,Clear,0.62,0.5758,0.83,0.0,8,36,44,44,499,44,2,2,3,223,0,727,154171,2,44
2011-08-20,fall,2011,August,8,Saturday,Holiday,Clear,0.66,0.6212,0.69,0.0,27,106,133,133,499,133,2,2,3,223,0,727,261001,2,133
2011-08-20,fall,2011,August,9,Saturday,Holiday,Clear,0.7,0.6515,0.65,0.0,51,139,190,190,499,190,2,3,4,234,0,727,159438,2,190
2011-08-20,fall,2011,August,10,Saturday,Holiday,Clear,0.72,0.6818,0.62,0.1045,114,192,306,306,499,306,2,4,4,244,2,727,126257,2,306
2011-08-20,fall,2011,August,11,Saturday,Holiday,Clear,0.72,0.6667,0.58,0.0,115,223,338,338,499,338,2,4,4,244,2,727,151320,2,338
2011-08-20,fall,2011,August,12,Saturday,Holiday,Clear,0.74,0.6818,0.58,0.1343,156,253,409,409,499,409,2,4,4,244,2,728,184414,2,409
2011-08-20,fall,2011,August,13,Saturday,Holiday,Clear,0.76,0.697,0.55,0.1343,158,220,378,378,499,378,2,4,4,244,2,729,184919,2,378
2011-08-20,fall,2011,August,14,Saturday,Holiday,Clear,0.8,0.7424,0.49,0.194,147,228,375,375,499,375,2,4,4,244,2,729,175652,2,375
2011-08-20,fall,2011,August,15,Saturday,Holiday,Clear,0.8,0.7273,0.43,0.194,175,215,390,390,499,390,2,4,4,244,2,729,183149,2,390
2011-08-20,fall,2011,August,16,Saturday,Holiday,Clear,0.8,0.7273,0.46,0.194,151,222,373,373,499,373,2,4,4,244,2,730,227748,2,373
2011-08-20,fall,2011,August,17,Saturday,Holiday,Clear,0.8,0.7424,0.49,0.194,180,203,383,383,499,383,2,4,4,244,2,730,336860,2,383
2011-08-20,fall,2011,August,18,Saturday,Holiday,Clear,0.76,0.7121,0.58,0.2537,169,225,394,394,499,394,2,4,4,244,2,728,309772,2,394
2011-08-20,fall,2011,August,19,Saturday,Holiday,Clear,0.74,0.6818,0.62,0.194,109,182,291,291,499,291,2,4,4,244,2,728,226789,2,291
2011-08-20,fall,2011,August,20,Saturday,Holiday,Clear,0.74,0.6818,0.62,0.2239,78,170,248,248,499,248,2,3,4,234,2,728,164550,2,248
2011-08-20,fall,2011,August,21,Saturday,Holiday,Clear,0.72,0.6818,0.7,0.2239,81,144,225,225,499,225,2,3,4,234,2,728,125445,2,225
2011-08-20,fall,2011,August,22,Saturday,Holiday,Mist,0.7,0.6667,0.74,0.194,77,146,223,223,499,223,2,3,4,234,0,728,95612,2,223
2011-08-20,fall,2011,August,23,Saturday,Holiday,Clear,0.7,0.6667,0.74,0.1343,59,98,157,157,499,157,2,3,4,234,0,728,63941,2,157
2011-08-21,fall,2011,August,0,Sunday,Holiday,Clear,0.7,0.6667,0.74,0.194,6,68,74,74,498,74,2,2,4,224,0,726,39130,2,74
2011-08-21,fall,2011,August,1,Sunday,Holiday,Clear,0.68,0.6364,0.79,0.2239,17,69,86,86,498,86,2,2,4,224,0,724,24164,2,86
2011-08-21,fall,2011,August,2,Sunday,Holiday,Clear,0.68,0.6364,0.79,0.194,13,51,64,64,498,64,2,2,4,224,0,715,16352,2,64
2011-08-21,fall,2011,August,3,Sunday,Holiday,Clear,0.66,0.6061,0.83,0.2239,25,26,51,51,498,51,2,2,3,223,0,697,8174,2,51
2011-08-21,fall,2011,August,4,Sunday,Holiday,Clear,0.68,0.6364,0.83,0.2239,1,5,6,6,498,6,2,1,4,214,0,697,4428,2,6
2011-08-21,fall,2011,August,5,Sunday,Holiday,Clear,0.66,0.5909,0.89,0.2985,0,8,8,8,498,8,2,1,3,213,0,717,14261,2,8
2011-08-21,fall,2011,August,6,Sunday,Holiday,Clear,0.66,0.5909,0.89,0.2836,4,10,14,14,498,14,2,1,3,213,0,725,55132,2,14
2011-08-21,fall,2011,August,7,Sunday,Holiday,Clear,0.68,0.6364,0.83,0.2985,12,19,31,31,498,31,2,1,4,214,0,727,154171,2,31
2011-08-21,fall,2011,August,8,Sunday,Holiday,Clear,0.7,0.6667,0.79,0.2239,30,62,92,92,498,92,2,2,4,224,0,727,261001,2,92
2011-08-21,fall,2011,August,9,Sunday,Holiday,Clear,0.72,0.697,0.74,0.2239,80,151,231,231,498,231,2,3,4,234,2,727,159438,2,231
2011-08-21,fall,2011,August,10,Sunday,Holiday,Clear,0.74,0.7121,0.74,0.2537,97,177,274,274,498,274,2,3,4,234,2,727,126257,2,274
2011-08-21,fall,2011,August,11,Sunday,Holiday,Clear,0.8,0.7879,0.63,0.2836,132,181,313,313,498,313,2,4,4,244,2,727,151320,2,313
2011-08-21,fall,2011,August,12,Sunday,Holiday,Clear,0.82,0.803,0.59,0.2836,135,239,374,374,498,374,2,4,4,244,2,728,184414,2,374
2011-08-21,fall,2011,August,13,Sunday,Holiday,Clear,0.8,0.7727,0.59,0.4179,94,216,310,310,498,310,2,4,4,244,2,729,184919,2,310
2011-08-21,fall,2011,August,14,Sunday,Holiday,Light Snow,0.7,0.6667,0.79,0.3881,78,157,235,235,498,235,2,3,4,234,2,729,175652,2,235
2011-08-21,fall,2011,August,15,Sunday,Holiday,Clear,0.7,0.6667,0.84,0.2836,17,51,68,68,498,68,2,2,4,224,0,729,183149,2,68
2011-08-21,fall,2011,August,16,Sunday,Holiday,Clear,0.72,0.697,0.79,0.1642,97,161,258,258,498,258,2,3,4,234,2,730,227748,2,258
2011-08-21,fall,2011,August,17,Sunday,Holiday,Clear,0.72,0.697,0.79,0.1343,91,179,270,270,498,270,2,3,4,234,2,730,336860,2,270
2011-08-21,fall,2011,August,18,Sunday,Holiday,Clear,0.72,0.697,0.79,0.2537,96,215,311,311,498,311,2,4,4,244,2,728,309772,2,311
2011-08-21,fall,2011,August,19,Sunday,Holiday,Clear,0.72,0.6818,0.7,0.2537,81,201,282,282,498,282,2,4,4,244,2,728,226789,2,282
2011-08-21,fall,2011,August,20,Sunday,Holiday,Clear,0.7,0.6667,0.79,0.2537,41,140,181,181,498,181,2,3,4,234,0,728,164550,2,181
2011-08-21,fall,2011,August,21,Sunday,Holiday,Clear,0.7,0.6667,0.79,0.2537,45,93,138,138,498,138,2,2,4,224,0,728,125445,2,138
2011-08-21,fall,2011,August,22,Sunday,Holiday,Mist,0.7,0.6667,0.79,0.194,37,97,134,134,498,134,2,2,4,224,0,728,95612,2,134
2011-08-21,fall,2011,August,23,Sunday,Holiday,Clear,0.7,0.6667,0.74,0.1642,20,48,68,68,498,68,2,2,4,224,0,728,63941,2,68
2011-08-22,fall,2011,August,0,Monday,Workingday,Clear,0.68,0.6364,0.79,0.1642,18,22,40,40,497,40,2,1,4,214,0,726,39130,2,40
2011-08-22,fall,2011,August,1,Monday,Workingday,Clear,0.68,0.6364,0.79,0.0896,8,13,21,21,497,21,2,1,4,214,0,724,24164,2,21
2011-08-22,fall,2011,August,2,Monday,Workingday,Mist,0.7,0.6515,0.65,0.1045,2,6,8,8,497,8,2,1,4,214,0,715,16352,2,8
2011-08-22,fall,2011,August,3,Monday,Workingday,Light Snow,0.7,0.6515,0.65,0.1343,0,5,5,5,497,5,2,1,4,214,0,697,8174,2,5
2011-08-22,fall,2011,August,4,Monday,Workingday,Clear,0.68,0.6364,0.65,0.194,2,10,12,12,497,12,2,1,4,214,0,697,4428,2,12
2011-08-22,fall,2011,August,5,Monday,Workingday,Clear,0.66,0.6212,0.65,0.3582,1,23,24,24,497,24,2,1,3,213,0,717,14261,2,24
2011-08-22,fall,2011,August,6,Monday,Workingday,Clear,0.66,0.6212,0.61,0.2985,6,106,112,112,497,112,2,2,3,223,0,725,55132,2,112
2011-08-22,fall,2011,August,7,Monday,Workingday,Clear,0.66,0.6212,0.61,0.3284,11,270,281,281,497,281,2,3,3,233,2,727,154171,2,281
2011-08-22,fall,2011,August,8,Monday,Workingday,Clear,0.66,0.6212,0.61,0.3284,20,331,351,351,497,351,2,4,3,243,2,727,261001,2,351
2011-08-22,fall,2011,August,9,Monday,Workingday,Clear,0.68,0.6364,0.54,0.2537,36,151,187,187,497,187,2,3,4,234,2,727,159438,2,187
2011-08-22,fall,2011,August,10,Monday,Workingday,Clear,0.7,0.6515,0.48,0.2836,36,85,121,121,497,121,2,2,4,224,2,727,126257,2,121
2011-08-22,fall,2011,August,11,Monday,Workingday,Clear,0.72,0.6515,0.34,0.3284,46,85,131,131,497,131,2,2,4,224,2,727,151320,2,131
2011-08-22,fall,2011,August,12,Monday,Workingday,Clear,0.74,0.6515,0.35,0.3881,54,153,207,207,497,207,2,3,4,234,2,728,184414,2,207
2011-08-22,fall,2011,August,13,Monday,Workingday,Clear,0.74,0.6515,0.3,0.4627,47,158,205,205,497,205,2,3,4,234,2,729,184919,2,205
2011-08-22,fall,2011,August,14,Monday,Workingday,Clear,0.74,0.6515,0.3,0.3881,88,137,225,225,497,225,2,3,4,234,2,729,175652,2,225
2011-08-22,fall,2011,August,15,Monday,Workingday,Clear,0.74,0.6515,0.3,0.2985,72,127,199,199,497,199,2,3,4,234,2,729,183149,2,199
2011-08-22,fall,2011,August,16,Monday,Workingday,Clear,0.74,0.6515,0.3,0.3881,66,254,320,320,497,320,2,4,4,244,2,730,227748,2,320
2011-08-22,fall,2011,August,17,Monday,Workingday,Clear,0.74,0.6515,0.27,0.3284,82,509,591,591,497,591,2,4,4,244,2,730,336860,2,591
2011-08-22,fall,2011,August,18,Monday,Workingday,Clear,0.72,0.6515,0.28,0.2985,72,537,609,609,497,609,2,4,4,244,2,728,309772,2,609
2011-08-22,fall,2011,August,19,Monday,Workingday,Clear,0.7,0.6364,0.3,0.2836,66,350,416,416,497,416,2,4,4,244,2,728,226789,2,416
2011-08-22,fall,2011,August,20,Monday,Workingday,Clear,0.66,0.6212,0.34,0.194,21,247,268,268,497,268,2,3,3,233,2,728,164550,2,268
2011-08-22,fall,2011,August,21,Monday,Workingday,Clear,0.64,0.6212,0.38,0.194,28,180,208,208,497,208,2,3,3,233,2,728,125445,2,208
2011-08-22,fall,2011,August,22,Monday,Workingday,Clear,0.64,0.6212,0.38,0.2985,32,121,153,153,497,153,2,3,3,233,2,728,95612,2,153
2011-08-22,fall,2011,August,23,Monday,Workingday,Clear,0.62,0.6212,0.41,0.2537,19,45,64,64,497,64,2,2,3,223,0,728,63941,2,64
2011-08-23,fall,2011,August,0,Tuesday,Workingday,Clear,0.6,0.6212,0.43,0.194,13,22,35,35,496,35,2,1,3,213,0,726,39130,2,35
2011-08-23,fall,2011,August,1,Tuesday,Workingday,Clear,0.58,0.5455,0.49,0.194,6,13,19,19,496,19,2,1,3,213,0,724,24164,2,19
2011-08-23,fall,2011,August,2,Tuesday,Workingday,Clear,0.56,0.5303,0.52,0.194,2,4,6,6,496,6,2,1,3,213,0,715,16352,2,6
2011-08-23,fall,2011,August,3,Tuesday,Workingday,Clear,0.56,0.5303,0.52,0.2836,2,4,6,6,496,6,2,1,3,213,0,697,8174,2,6
2011-08-23,fall,2011,August,4,Tuesday,Workingday,Clear,0.54,0.5152,0.56,0.1642,0,5,5,5,496,5,2,1,3,213,0,697,4428,2,5
2011-08-23,fall,2011,August,5,Tuesday,Workingday,Clear,0.54,0.5152,0.56,0.194,1,35,36,36,496,36,2,1,3,213,0,717,14261,2,36
2011-08-23,fall,2011,August,6,Tuesday,Workingday,Clear,0.54,0.5152,0.6,0.194,3,111,114,114,496,114,2,2,3,223,0,725,55132,2,114
2011-08-23,fall,2011,August,7,Tuesday,Workingday,Clear,0.6,0.6212,0.49,0.194,11,333,344,344,496,344,2,4,3,243,2,727,154171,2,344
2011-08-23,fall,2011,August,8,Tuesday,Workingday,Mist,0.62,0.6212,0.5,0.0,43,461,504,504,496,504,2,4,3,243,2,727,261001,2,504
2011-08-23,fall,2011,August,9,Tuesday,Workingday,Mist,0.66,0.6212,0.44,0.0,34,191,225,225,496,225,2,3,3,233,2,727,159438,2,225
2011-08-23,fall,2011,August,10,Tuesday,Workingday,Clear,0.7,0.6364,0.37,0.0,56,92,148,148,496,148,2,3,4,234,2,727,126257,2,148
2011-08-23,fall,2011,August,11,Tuesday,Workingday,Clear,0.7,0.6364,0.34,0.1045,62,124,186,186,496,186,2,3,4,234,2,727,151320,2,186
2011-08-23,fall,2011,August,12,Tuesday,Workingday,Clear,0.7,0.6364,0.39,0.0896,60,177,237,237,496,237,2,3,4,234,2,728,184414,2,237
2011-08-23,fall,2011,August,13,Tuesday,Workingday,Clear,0.72,0.6515,0.3,0.1045,70,164,234,234,496,234,2,3,4,234,2,729,184919,2,234
2011-08-23,fall,2011,August,14,Tuesday,Workingday,Clear,0.72,0.6515,0.3,0.0896,149,502,651,651,496,651,2,4,4,244,2,729,175652,2,651
2011-08-23,fall,2011,August,15,Tuesday,Workingday,Clear,0.72,0.6515,0.34,0.2239,178,423,601,601,496,601,2,4,4,244,2,729,183149,2,601
2011-08-23,fall,2011,August,16,Tuesday,Workingday,Clear,0.72,0.6515,0.32,0.1343,133,311,444,444,496,444,2,4,4,244,2,730,227748,2,444
2011-08-23,fall,2011,August,17,Tuesday,Workingday,Clear,0.72,0.6515,0.34,0.2239,133,339,472,472,496,472,2,4,4,244,2,730,336860,2,472
2011-08-23,fall,2011,August,18,Tuesday,Workingday,Clear,0.72,0.6515,0.34,0.194,98,421,519,519,496,519,2,4,4,244,2,728,309772,2,519
2011-08-23,fall,2011,August,19,Tuesday,Workingday,Clear,0.66,0.6212,0.5,0.2239,70,297,367,367,496,367,2,4,3,243,2,728,226789,2,367
2011-08-23,fall,2011,August,20,Tuesday,Workingday,Clear,0.64,0.6212,0.53,0.2537,54,206,260,260,496,260,2,3,3,233,2,728,164550,2,260
2011-08-23,fall,2011,August,21,Tuesday,Workingday,Clear,0.62,0.6212,0.57,0.0,38,173,211,211,496,211,2,3,3,233,0,728,125445,2,211
2011-08-23,fall,2011,August,22,Tuesday,Workingday,Clear,0.62,0.6212,0.57,0.1343,46,145,191,191,496,191,2,3,3,233,0,728,95612,2,191
2011-08-23,fall,2011,August,23,Tuesday,Workingday,Clear,0.62,0.6061,0.61,0.1343,19,61,80,80,496,80,2,2,3,223,0,728,63941,2,80
2011-08-24,fall,2011,August,0,Wednesday,Workingday,Clear,0.62,0.6212,0.57,0.1343,9,29,38,38,495,38,2,1,3,213,0,726,39130,2,38
2011-08-24,fall,2011,August,1,Wednesday,Workingday,Clear,0.6,0.6061,0.6,0.1045,7,17,24,24,495,24,2,1,3,213,0,724,24164,2,24
2011-08-24,fall,2011,August,2,Wednesday,Workingday,Clear,0.58,0.5455,0.68,0.1343,2,4,6,6,495,6,2,1,3,213,0,715,16352,2,6
2011-08-24,fall,2011,August,3,Wednesday,Workingday,Clear,0.58,0.5455,0.68,0.1343,0,1,1,1,495,1,2,1,3,213,0,697,8174,2,1
2011-08-24,fall,2011,August,4,Wednesday,Workingday,Clear,0.56,0.5303,0.73,0.1045,0,7,7,7,495,7,2,1,3,213,0,697,4428,2,7
2011-08-24,fall,2011,August,5,Wednesday,Workingday,Clear,0.56,0.5303,0.73,0.1045,1,26,27,27,495,27,2,1,3,213,0,717,14261,2,27
2011-08-24,fall,2011,August,6,Wednesday,Workingday,Clear,0.56,0.5303,0.73,0.0,3,105,108,108,495,108,2,2,3,223,0,725,55132,2,108
2011-08-24,fall,2011,August,7,Wednesday,Workingday,Clear,0.6,0.6061,0.64,0.0896,11,297,308,308,495,308,2,4,3,243,0,727,154171,2,308
2011-08-24,fall,2011,August,8,Wednesday,Workingday,Clear,0.62,0.6061,0.69,0.1343,32,436,468,468,495,468,2,4,3,243,2,727,261001,2,468
2011-08-24,fall,2011,August,9,Wednesday,Workingday,Clear,0.64,0.6061,0.69,0.2537,44,169,213,213,495,213,2,3,3,233,0,727,159438,2,213
2011-08-24,fall,2011,August,10,Wednesday,Workingday,Clear,0.7,0.6515,0.58,0.2836,51,95,146,146,495,146,2,3,4,234,2,727,126257,2,146
2011-08-24,fall,2011,August,11,Wednesday,Workingday,Clear,0.72,0.6667,0.54,0.2985,57,128,185,185,495,185,2,3,4,234,2,727,151320,2,185
2011-08-24,fall,2011,August,12,Wednesday,Workingday,Clear,0.74,0.6818,0.55,0.3284,60,175,235,235,495,235,2,3,4,234,2,728,184414,2,235
2011-08-24,fall,2011,August,13,Wednesday,Workingday,Clear,0.76,0.6818,0.48,0.4179,56,180,236,236,495,236,2,3,4,234,2,729,184919,2,236
2011-08-24,fall,2011,August,14,Wednesday,Workingday,Clear,0.76,0.6818,0.48,0.4179,77,127,204,204,495,204,2,3,4,234,2,729,175652,2,204
2011-08-24,fall,2011,August,15,Wednesday,Workingday,Clear,0.76,0.6818,0.48,0.4478,63,141,204,204,495,204,2,3,4,234,2,729,183149,2,204
2011-08-24,fall,2011,August,16,Wednesday,Workingday,Clear,0.76,0.697,0.52,0.4179,49,222,271,271,495,271,2,3,4,234,2,730,227748,2,271
2011-08-24,fall,2011,August,17,Wednesday,Workingday,Clear,0.76,0.697,0.52,0.3582,83,484,567,567,495,567,2,4,4,244,2,730,336860,2,567
2011-08-24,fall,2011,August,18,Wednesday,Workingday,Clear,0.74,0.6818,0.55,0.2985,102,519,621,621,495,621,2,4,4,244,2,728,309772,2,621
2011-08-24,fall,2011,August,19,Wednesday,Workingday,Clear,0.74,0.6818,0.55,0.2985,93,347,440,440,495,440,2,4,4,244,2,728,226789,2,440
2011-08-24,fall,2011,August,20,Wednesday,Workingday,Clear,0.72,0.6667,0.58,0.2985,45,289,334,334,495,334,2,4,4,244,2,728,164550,2,334
2011-08-24,fall,2011,August,21,Wednesday,Workingday,Clear,0.7,0.6515,0.61,0.3582,47,189,236,236,495,236,2,3,4,234,2,728,125445,2,236
2011-08-24,fall,2011,August,22,Wednesday,Workingday,Clear,0.7,0.6515,0.65,0.3582,41,140,181,181,495,181,2,3,4,234,2,728,95612,2,181
2011-08-24,fall,2011,August,23,Wednesday,Workingday,Clear,0.68,0.6364,0.69,0.2985,16,54,70,70,495,70,2,2,4,224,0,728,63941,2,70
2011-08-25,fall,2011,August,0,Thursday,Workingday,Clear,0.68,0.6364,0.74,0.2985,11,41,52,52,494,52,2,2,4,224,0,726,39130,2,52
2011-08-25,fall,2011,August,1,Thursday,Workingday,Clear,0.68,0.6364,0.69,0.3881,4,11,15,15,494,15,2,1,4,214,0,724,24164,2,15
2011-08-25,fall,2011,August,2,Thursday,Workingday,Clear,0.68,0.6364,0.69,0.3881,3,2,5,5,494,5,2,1,4,214,0,715,16352,2,5
2011-08-25,fall,2011,August,3,Thursday,Workingday,Clear,0.66,0.6212,0.74,0.3284,2,2,4,4,494,4,2,1,3,213,0,697,8174,2,4
2011-08-25,fall,2011,August,4,Thursday,Workingday,Clear,0.66,0.6061,0.78,0.3881,1,6,7,7,494,7,2,1,3,213,0,697,4428,2,7
2011-08-25,fall,2011,August,5,Thursday,Workingday,Clear,0.66,0.6061,0.83,0.4179,1,25,26,26,494,26,2,1,3,213,0,717,14261,2,26
2011-08-25,fall,2011,August,6,Thursday,Workingday,Clear,0.66,0.6061,0.83,0.3284,1,101,102,102,494,102,2,2,3,223,0,725,55132,2,102
2011-08-25,fall,2011,August,7,Thursday,Workingday,Mist,0.68,0.6364,0.79,0.3284,17,296,313,313,494,313,2,4,4,244,0,727,154171,2,313
2011-08-25,fall,2011,August,8,Thursday,Workingday,Mist,0.7,0.6667,0.74,0.2985,23,461,484,484,494,484,2,4,4,244,2,727,261001,2,484
2011-08-25,fall,2011,August,9,Thursday,Workingday,Mist,0.72,0.6818,0.7,0.2985,21,141,162,162,494,162,2,3,4,234,0,727,159438,2,162
2011-08-25,fall,2011,August,10,Thursday,Workingday,Mist,0.74,0.697,0.66,0.2985,37,105,142,142,494,142,2,2,4,224,0,727,126257,2,142
2011-08-25,fall,2011,August,11,Thursday,Workingday,Light Snow,0.7,0.6667,0.79,0.0,39,112,151,151,494,151,2,3,4,234,0,727,151320,2,151
2011-08-25,fall,2011,August,12,Thursday,Workingday,Light Snow,0.7,0.6667,0.79,0.0,9,32,41,41,494,41,2,2,4,224,0,728,184414,2,41
2011-08-25,fall,2011,August,13,Thursday,Workingday,Clear,0.7,0.6667,0.79,0.1045,7,30,37,37,494,37,2,1,4,214,0,729,184919,2,37
2011-08-25,fall,2011,August,14,Thursday,Workingday,Mist,0.72,0.697,0.74,0.0,27,86,113,113,494,113,2,2,4,224,0,729,175652,2,113
2011-08-25,fall,2011,August,15,Thursday,Workingday,Mist,0.74,0.697,0.7,0.0,28,104,132,132,494,132,2,2,4,224,0,729,183149,2,132
2011-08-25,fall,2011,August,16,Thursday,Workingday,Clear,0.72,0.7121,0.84,0.0,16,105,121,121,494,121,2,2,4,224,0,730,227748,2,121
2011-08-25,fall,2011,August,17,Thursday,Workingday,Clear,0.72,0.7121,0.84,0.0,28,284,312,312,494,312,2,4,4,244,0,730,336860,2,312
2011-08-25,fall,2011,August,18,Thursday,Workingday,Mist,0.72,0.7121,0.84,0.1343,31,377,408,408,494,408,2,4,4,244,0,728,309772,2,408
2011-08-25,fall,2011,August,19,Thursday,Workingday,Mist,0.66,0.6061,0.78,0.3284,31,241,272,272,494,272,2,3,3,233,0,728,226789,2,272
2011-08-25,fall,2011,August,20,Thursday,Workingday,Clear,0.64,0.5909,0.78,0.3582,33,192,225,225,494,225,2,3,3,233,0,728,164550,2,225
2011-08-25,fall,2011,August,21,Thursday,Workingday,Clear,0.64,0.5909,0.78,0.2836,29,158,187,187,494,187,2,3,3,233,0,728,125445,2,187
2011-08-25,fall,2011,August,22,Thursday,Workingday,Clear,0.62,0.5758,0.83,0.0,21,126,147,147,494,147,2,3,3,233,0,728,95612,2,147
2011-08-25,fall,2011,August,23,Thursday,Workingday,Clear,0.62,0.5758,0.83,0.0896,15,69,84,84,494,84,2,2,3,223,0,728,63941,2,84
2011-08-26,fall,2011,August,0,Friday,Workingday,Clear,0.62,0.5758,0.83,0.1343,9,42,51,51,493,51,2,2,3,223,0,726,39130,2,51
2011-08-26,fall,2011,August,1,Friday,Workingday,Clear,0.62,0.5758,0.83,0.0,10,13,23,23,493,23,2,1,3,213,0,724,24164,2,23
2011-08-26,fall,2011,August,2,Friday,Workingday,Clear,0.62,0.5606,0.88,0.1343,4,16,20,20,493,20,2,1,3,213,0,715,16352,2,20
2011-08-26,fall,2011,August,3,Friday,Workingday,Clear,0.6,0.5455,0.88,0.1045,3,8,11,11,493,11,2,1,3,213,0,697,8174,2,11
2011-08-26,fall,2011,August,4,Friday,Workingday,Clear,0.62,0.5606,0.88,0.0,2,6,8,8,493,8,2,1,3,213,0,697,4428,2,8
2011-08-26,fall,2011,August,5,Friday,Workingday,Mist,0.62,0.5606,0.88,0.0,3,23,26,26,493,26,2,1,3,213,0,717,14261,2,26
2011-08-26,fall,2011,August,6,Friday,Workingday,Clear,0.62,0.5606,0.88,0.0,5,100,105,105,493,105,2,2,3,223,0,725,55132,2,105
2011-08-26,fall,2011,August,7,Friday,Workingday,Clear,0.64,0.5758,0.83,0.0,3,263,266,266,493,266,2,3,3,233,0,727,154171,2,266
2011-08-26,fall,2011,August,8,Friday,Workingday,Clear,0.66,0.6061,0.83,0.1045,17,387,404,404,493,404,2,4,3,243,0,727,261001,2,404
2011-08-26,fall,2011,August,9,Friday,Workingday,Clear,0.7,0.6667,0.74,0.0,39,191,230,230,493,230,2,3,4,234,0,727,159438,2,230
2011-08-26,fall,2011,August,10,Friday,Workingday,Clear,0.74,0.697,0.66,0.0896,34,89,123,123,493,123,2,2,4,224,0,727,126257,2,123
2011-08-26,fall,2011,August,11,Friday,Workingday,Mist,0.76,0.7121,0.62,0.0,63,151,214,214,493,214,2,3,4,234,0,727,151320,2,214
2011-08-26,fall,2011,August,12,Friday,Workingday,Mist,0.76,0.7273,0.66,0.1045,70,173,243,243,493,243,2,3,4,234,2,728,184414,2,243
2011-08-26,fall,2011,August,13,Friday,Workingday,Mist,0.78,0.7424,0.59,0.1045,72,165,237,237,493,237,2,3,4,234,2,729,184919,2,237
2011-08-26,fall,2011,August,14,Friday,Workingday,Clear,0.8,0.7727,0.59,0.0,55,164,219,219,493,219,2,3,4,234,2,729,175652,2,219
2011-08-26,fall,2011,August,15,Friday,Workingday,Mist,0.8,0.7727,0.59,0.194,53,196,249,249,493,249,2,3,4,234,2,729,183149,2,249
2011-08-26,fall,2011,August,16,Friday,Workingday,Clear,0.78,0.7424,0.62,0.1045,50,293,343,343,493,343,2,4,4,244,2,730,227748,2,343
2011-08-26,fall,2011,August,17,Friday,Workingday,Clear,0.74,0.7121,0.74,0.2537,56,433,489,489,493,489,2,4,4,244,2,730,336860,2,489
2011-08-26,fall,2011,August,18,Friday,Workingday,Mist,0.74,0.7121,0.74,0.1343,40,370,410,410,493,410,2,4,4,244,2,728,309772,2,410
2011-08-26,fall,2011,August,19,Friday,Workingday,Clear,0.72,0.697,0.79,0.1045,55,235,290,290,493,290,2,4,4,244,0,728,226789,2,290
2011-08-26,fall,2011,August,20,Friday,Workingday,Clear,0.72,0.697,0.79,0.0896,39,183,222,222,493,222,2,3,4,234,0,728,164550,2,222
2011-08-26,fall,2011,August,21,Friday,Workingday,Clear,0.72,0.697,0.79,0.1642,38,152,190,190,493,190,2,3,4,234,0,728,125445,2,190
2011-08-26,fall,2011,August,22,Friday,Workingday,Clear,0.72,0.697,0.79,0.1045,26,126,152,152,493,152,2,3,4,234,0,728,95612,2,152
2011-08-26,fall,2011,August,23,Friday,Workingday,Clear,0.7,0.6667,0.84,0.0896,22,114,136,136,493,136,2,2,4,224,0,728,63941,2,136
2011-08-27,fall,2011,August,0,Saturday,Holiday,Clear,0.7,0.6667,0.84,0.1045,33,112,145,145,492,145,2,3,4,234,0,726,39130,2,145
2011-08-27,fall,2011,August,1,Saturday,Holiday,Clear,0.7,0.6667,0.84,0.1642,13,51,64,64,492,64,2,2,4,224,0,724,24164,2,64
2011-08-27,fall,2011,August,2,Saturday,Holiday,Clear,0.7,0.6667,0.84,0.194,18,59,77,77,492,77,2,2,4,224,0,715,16352,2,77
2011-08-27,fall,2011,August,3,Saturday,Holiday,Mist,0.7,0.6667,0.84,0.2239,8,22,30,30,492,30,2,1,4,214,0,697,8174,2,30
2011-08-27,fall,2011,August,4,Saturday,Holiday,Mist,0.7,0.6667,0.84,0.2239,1,3,4,4,492,4,2,1,4,214,0,697,4428,2,4
2011-08-27,fall,2011,August,5,Saturday,Holiday,Mist,0.7,0.6667,0.84,0.2985,1,11,12,12,492,12,2,1,4,214,0,717,14261,2,12
2011-08-27,fall,2011,August,6,Saturday,Holiday,Mist,0.7,0.6667,0.84,0.2985,3,15,18,18,492,18,2,1,4,214,0,725,55132,2,18
2011-08-27,fall,2011,August,7,Saturday,Holiday,Mist,0.7,0.6667,0.84,0.3582,2,26,28,28,492,28,2,1,4,214,0,727,154171,2,28
2011-08-27,fall,2011,August,8,Saturday,Holiday,Mist,0.7,0.6667,0.84,0.2537,14,62,76,76,492,76,2,2,4,224,0,727,261001,2,76
2011-08-27,fall,2011,August,9,Saturday,Holiday,Mist,0.7,0.6667,0.84,0.4179,28,128,156,156,492,156,2,3,4,234,0,727,159438,2,156
2011-08-27,fall,2011,August,10,Saturday,Holiday,Mist,0.7,0.6667,0.79,0.4627,51,154,205,205,492,205,2,3,4,234,2,727,126257,2,205
2011-08-27,fall,2011,August,11,Saturday,Holiday,Light Snow,0.66,0.5909,0.89,0.4179,15,73,88,88,492,88,2,2,3,223,0,727,151320,2,88
2011-08-27,fall,2011,August,12,Saturday,Holiday,Light Snow,0.66,0.6061,0.83,0.4925,11,65,76,76,492,76,2,2,3,223,0,728,184414,2,76
2011-08-27,fall,2011,August,13,Saturday,Holiday,Light Snow,0.66,0.6061,0.83,0.3881,10,33,43,43,492,43,2,2,3,223,0,729,184919,2,43
2011-08-27,fall,2011,August,14,Saturday,Holiday,Light Snow,0.64,0.5758,0.89,0.5522,4,19,23,23,492,23,2,1,3,213,0,729,175652,2,23
2011-08-27,fall,2011,August,15,Saturday,Holiday,Light Snow,0.64,0.5758,0.89,0.5522,2,28,30,30,492,30,2,1,3,213,0,729,183149,2,30
2011-08-27,fall,2011,August,16,Saturday,Holiday,Light Snow,0.64,0.5758,0.89,0.5224,10,14,24,24,492,24,2,1,3,213,0,730,227748,2,24
2011-08-27,fall,2011,August,17,Saturday,Holiday,Light Snow,0.64,0.5758,0.89,0.8358,2,14,16,16,492,16,2,1,3,213,0,730,336860,2,16
2011-08-28,fall,2011,August,7,Sunday,Holiday,Light Snow,0.62,0.5758,0.83,0.3582,0,1,1,1,491,1,2,1,3,213,0,727,154171,2,1
2011-08-28,fall,2011,August,8,Sunday,Holiday,Light Snow,0.62,0.5758,0.83,0.4179,2,6,8,8,491,8,2,1,3,213,0,727,261001,2,8
2011-08-28,fall,2011,August,9,Sunday,Holiday,Clear,0.66,0.6212,0.74,0.4179,7,46,53,53,491,53,2,2,3,223,0,727,159438,2,53
2011-08-28,fall,2011,August,10,Sunday,Holiday,Clear,0.7,0.6515,0.61,0.6119,27,115,142,142,491,142,2,2,4,224,2,727,126257,2,142
2011-08-28,fall,2011,August,11,Sunday,Holiday,Clear,0.7,0.6515,0.58,0.3881,59,178,237,237,491,237,2,3,4,234,2,727,151320,2,237
2011-08-28,fall,2011,August,12,Sunday,Holiday,Clear,0.74,0.6667,0.51,0.3881,88,218,306,306,491,306,2,4,4,244,2,728,184414,2,306
2011-08-28,fall,2011,August,13,Sunday,Holiday,Clear,0.76,0.6818,0.45,0.3582,129,302,431,431,491,431,2,4,4,244,2,729,184919,2,431
2011-08-28,fall,2011,August,14,Sunday,Holiday,Clear,0.78,0.697,0.43,0.4179,157,290,447,447,491,447,2,4,4,244,2,729,175652,2,447
2011-08-28,fall,2011,August,15,Sunday,Holiday,Clear,0.78,0.697,0.43,0.3582,155,314,469,469,491,469,2,4,4,244,2,729,183149,2,469
2011-08-28,fall,2011,August,16,Sunday,Holiday,Clear,0.8,0.7121,0.36,0.3881,196,295,491,491,491,491,2,4,4,244,2,730,227748,2,491
2011-08-28,fall,2011,August,17,Sunday,Holiday,Clear,0.76,0.6818,0.4,0.2985,145,253,398,398,491,398,2,4,4,244,2,730,336860,2,398
2011-08-28,fall,2011,August,18,Sunday,Holiday,Clear,0.74,0.6667,0.42,0.2239,145,257,402,402,491,402,2,4,4,244,2,728,309772,2,402
2011-08-28,fall,2011,August,19,Sunday,Holiday,Clear,0.72,0.6667,0.48,0.1045,140,247,387,387,491,387,2,4,4,244,2,728,226789,2,387
2011-08-28,fall,2011,August,20,Sunday,Holiday,Clear,0.72,0.6515,0.45,0.1045,64,150,214,214,491,214,2,3,4,234,2,728,164550,2,214
2011-08-28,fall,2011,August,21,Sunday,Holiday,Clear,0.66,0.6212,0.61,0.1343,60,126,186,186,491,186,2,3,3,233,0,728,125445,2,186
2011-08-28,fall,2011,August,22,Sunday,Holiday,Clear,0.64,0.6061,0.69,0.1045,25,73,98,98,491,98,2,2,3,223,0,728,95612,2,98
2011-08-28,fall,2011,August,23,Sunday,Holiday,Clear,0.62,0.5909,0.73,0.1045,16,48,64,64,491,64,2,2,3,223,0,728,63941,2,64
2011-08-29,fall,2011,August,0,Monday,Workingday,Clear,0.62,0.5909,0.73,0.1045,13,21,34,34,490,34,2,1,3,213,0,726,39130,2,34
2011-08-29,fall,2011,August,1,Monday,Workingday,Clear,0.6,0.5909,0.69,0.1045,5,15,20,20,490,20,2,1,3,213,0,724,24164,2,20
2011-08-29,fall,2011,August,2,Monday,Workingday,Clear,0.6,0.5909,0.69,0.194,8,5,13,13,490,13,2,1,3,213,0,715,16352,2,13
2011-08-29,fall,2011,August,3,Monday,Workingday,Clear,0.6,0.5909,0.69,0.1045,1,5,6,6,490,6,2,1,3,213,0,697,8174,2,6
2011-08-29,fall,2011,August,4,Monday,Workingday,Clear,0.56,0.5303,0.68,0.1343,0,3,3,3,490,3,2,1,3,213,0,697,4428,2,3
2011-08-29,fall,2011,August,5,Monday,Workingday,Clear,0.56,0.5303,0.73,0.1343,0,17,17,17,490,17,2,1,3,213,0,717,14261,2,17
2011-08-29,fall,2011,August,6,Monday,Workingday,Clear,0.56,0.5303,0.73,0.1343,3,99,102,102,490,102,2,2,3,223,0,725,55132,2,102
2011-08-29,fall,2011,August,7,Monday,Workingday,Clear,0.6,0.6061,0.6,0.2239,11,273,284,284,490,284,2,4,3,243,0,727,154171,2,284
2011-08-29,fall,2011,August,8,Monday,Workingday,Clear,0.62,0.6212,0.57,0.2537,20,384,404,404,490,404,2,4,3,243,2,727,261001,2,404
2011-08-29,fall,2011,August,9,Monday,Workingday,Clear,0.62,0.6212,0.53,0.2537,22,166,188,188,490,188,2,3,3,233,2,727,159438,2,188
2011-08-29,fall,2011,August,10,Monday,Workingday,Clear,0.66,0.6212,0.47,0.2239,42,73,115,115,490,115,2,2,3,223,2,727,126257,2,115
2011-08-29,fall,2011,August,11,Monday,Workingday,Clear,0.66,0.6212,0.47,0.1642,38,100,138,138,490,138,2,2,3,223,2,727,151320,2,138
2011-08-29,fall,2011,August,12,Monday,Workingday,Mist,0.68,0.6364,0.44,0.1642,48,159,207,207,490,207,2,3,4,234,2,728,184414,2,207
2011-08-29,fall,2011,August,13,Monday,Workingday,Mist,0.7,0.6364,0.39,0.0,48,170,218,218,490,218,2,3,4,234,2,729,184919,2,218
2011-08-29,fall,2011,August,14,Monday,Workingday,Clear,0.7,0.6364,0.42,0.0,55,127,182,182,490,182,2,3,4,234,2,729,175652,2,182
2011-08-29,fall,2011,August,15,Monday,Workingday,Clear,0.7,0.6364,0.42,0.1642,56,164,220,220,490,220,2,3,4,234,2,729,183149,2,220
2011-08-29,fall,2011,August,16,Monday,Workingday,Clear,0.72,0.6515,0.42,0.1642,56,226,282,282,490,282,2,4,4,244,2,730,227748,2,282
2011-08-29,fall,2011,August,17,Monday,Workingday,Mist,0.7,0.6364,0.47,0.2239,67,524,591,591,490,591,2,4,4,244,2,730,336860,2,591
2011-08-29,fall,2011,August,18,Monday,Workingday,Clear,0.66,0.6212,0.47,0.2537,60,487,547,547,490,547,2,4,3,243,2,728,309772,2,547
2011-08-29,fall,2011,August,19,Monday,Workingday,Clear,0.66,0.6212,0.47,0.2537,50,317,367,367,490,367,2,4,3,243,2,728,226789,2,367
2011-08-29,fall,2011,August,20,Monday,Workingday,Clear,0.64,0.6212,0.53,0.1642,50,227,277,277,490,277,2,3,3,233,2,728,164550,2,277
2011-08-29,fall,2011,August,21,Monday,Workingday,Clear,0.64,0.6212,0.53,0.194,34,168,202,202,490,202,2,3,3,233,2,728,125445,2,202
2011-08-29,fall,2011,August,22,Monday,Workingday,Clear,0.62,0.6212,0.57,0.1343,23,119,142,142,490,142,2,2,3,223,0,728,95612,2,142
2011-08-29,fall,2011,August,23,Monday,Workingday,Clear,0.6,0.6061,0.6,0.0896,19,56,75,75,490,75,2,2,3,223,0,728,63941,2,75
2011-08-30,fall,2011,August,0,Tuesday,Workingday,Clear,0.56,0.5303,0.73,0.1343,10,17,27,27,489,27,2,1,3,213,0,726,39130,2,27
2011-08-30,fall,2011,August,1,Tuesday,Workingday,Clear,0.56,0.5303,0.68,0.1045,6,7,13,13,489,13,2,1,3,213,0,724,24164,2,13
2011-08-30,fall,2011,August,2,Tuesday,Workingday,Clear,0.54,0.5152,0.73,0.1045,2,8,10,10,489,10,2,1,3,213,0,715,16352,2,10
2011-08-30,fall,2011,August,3,Tuesday,Workingday,Clear,0.54,0.5152,0.73,0.194,2,2,4,4,489,4,2,1,3,213,0,697,8174,2,4
2011-08-30,fall,2011,August,4,Tuesday,Workingday,Clear,0.52,0.5,0.77,0.1642,0,6,6,6,489,6,2,1,3,213,0,697,4428,2,6
2011-08-30,fall,2011,August,5,Tuesday,Workingday,Clear,0.52,0.5,0.77,0.0896,1,27,28,28,489,28,2,1,3,213,0,717,14261,2,28
2011-08-30,fall,2011,August,6,Tuesday,Workingday,Clear,0.54,0.5152,0.73,0.1045,4,115,119,119,489,119,2,2,3,223,0,725,55132,2,119
2011-08-30,fall,2011,August,7,Tuesday,Workingday,Clear,0.56,0.5303,0.68,0.1343,19,338,357,357,489,357,2,4,3,243,0,727,154171,2,357
2011-08-30,fall,2011,August,8,Tuesday,Workingday,Clear,0.62,0.6212,0.57,0.1343,34,459,493,493,489,493,2,4,3,243,2,727,261001,2,493
2011-08-30,fall,2011,August,9,Tuesday,Workingday,Clear,0.66,0.6212,0.5,0.2239,38,180,218,218,489,218,2,3,3,233,2,727,159438,2,218
2011-08-30,fall,2011,August,10,Tuesday,Workingday,Clear,0.7,0.6364,0.39,0.2239,28,109,137,137,489,137,2,2,4,224,2,727,126257,2,137
2011-08-30,fall,2011,August,11,Tuesday,Workingday,Clear,0.72,0.6515,0.37,0.194,60,115,175,175,489,175,2,3,4,234,2,727,151320,2,175
2011-08-30,fall,2011,August,12,Tuesday,Workingday,Clear,0.72,0.6515,0.37,0.0,65,172,237,237,489,237,2,3,4,234,2,728,184414,2,237
2011-08-30,fall,2011,August,13,Tuesday,Workingday,Clear,0.74,0.6515,0.35,0.1045,59,170,229,229,489,229,2,3,4,234,2,729,184919,2,229
2011-08-30,fall,2011,August,14,Tuesday,Workingday,Clear,0.74,0.6515,0.33,0.1642,58,151,209,209,489,209,2,3,4,234,2,729,175652,2,209
2011-08-30,fall,2011,August,15,Tuesday,Workingday,Clear,0.74,0.6515,0.35,0.2239,34,162,196,196,489,196,2,3,4,234,2,729,183149,2,196
2011-08-30,fall,2011,August,16,Tuesday,Workingday,Clear,0.74,0.6515,0.37,0.1642,42,295,337,337,489,337,2,4,4,244,2,730,227748,2,337
2011-08-30,fall,2011,August,17,Tuesday,Workingday,Clear,0.72,0.6515,0.42,0.194,62,549,611,611,489,611,2,4,4,244,2,730,336860,2,611
2011-08-30,fall,2011,August,18,Tuesday,Workingday,Clear,0.7,0.6364,0.45,0.1642,60,516,576,576,489,576,2,4,4,244,2,728,309772,2,576
2011-08-30,fall,2011,August,19,Tuesday,Workingday,Clear,0.66,0.6212,0.5,0.0896,68,397,465,465,489,465,2,4,3,243,2,728,226789,2,465
2011-08-30,fall,2011,August,20,Tuesday,Workingday,Clear,0.66,0.6212,0.5,0.0,39,259,298,298,489,298,2,4,3,243,2,728,164550,2,298
2011-08-30,fall,2011,August,21,Tuesday,Workingday,Clear,0.64,0.6061,0.65,0.0896,43,180,223,223,489,223,2,3,3,233,0,728,125445,2,223
2011-08-30,fall,2011,August,22,Tuesday,Workingday,Clear,0.62,0.6061,0.61,0.0,22,121,143,143,489,143,2,3,3,233,0,728,95612,2,143
2011-08-30,fall,2011,August,23,Tuesday,Workingday,Clear,0.62,0.6061,0.61,0.0,19,74,93,93,489,93,2,2,3,223,0,728,63941,2,93
2011-08-31,fall,2011,August,0,Wednesday,Workingday,Clear,0.6,0.5909,0.69,0.0,8,24,32,32,488,32,2,1,3,213,0,726,39130,2,32
2011-08-31,fall,2011,August,1,Wednesday,Workingday,Clear,0.6,0.5909,0.69,0.0,2,13,15,15,488,15,2,1,3,213,0,724,24164,2,15
2011-08-31,fall,2011,August,2,Wednesday,Workingday,Clear,0.56,0.5303,0.73,0.0,1,5,6,6,488,6,2,1,3,213,0,715,16352,2,6
2011-08-31,fall,2011,August,3,Wednesday,Workingday,Clear,0.56,0.5303,0.78,0.0,2,4,6,6,488,6,2,1,3,213,0,697,8174,2,6
2011-08-31,fall,2011,August,4,Wednesday,Workingday,Clear,0.56,0.5303,0.73,0.0,0,5,5,5,488,5,2,1,3,213,0,697,4428,2,5
2011-08-31,fall,2011,August,5,Wednesday,Workingday,Clear,0.54,0.5152,0.83,0.0896,2,25,27,27,488,27,2,1,3,213,0,717,14261,2,27
2011-08-31,fall,2011,August,6,Wednesday,Workingday,Clear,0.54,0.5152,0.77,0.0,4,107,111,111,488,111,2,2,3,223,0,725,55132,2,111
2011-08-31,fall,2011,August,7,Wednesday,Workingday,Clear,0.6,0.5758,0.78,0.0,12,316,328,328,488,328,2,4,3,243,0,727,154171,2,328
2011-08-31,fall,2011,August,8,Wednesday,Workingday,Clear,0.62,0.6061,0.69,0.0,27,440,467,467,488,467,2,4,3,243,0,727,261001,2,467
2011-08-31,fall,2011,August,9,Wednesday,Workingday,Clear,0.64,0.6061,0.69,0.0896,27,217,244,244,488,244,2,3,3,233,0,727,159438,2,244
2011-08-31,fall,2011,August,10,Wednesday,Workingday,Clear,0.7,0.6364,0.45,0.1045,33,105,138,138,488,138,2,2,4,224,0,727,126257,2,138
2011-08-31,fall,2011,August,11,Wednesday,Workingday,Clear,0.72,0.6515,0.42,0.1343,28,143,171,171,488,171,2,3,4,234,2,727,151320,2,171
2011-08-31,fall,2011,August,12,Wednesday,Workingday,Clear,0.74,0.6667,0.43,0.1343,68,192,260,260,488,260,2,3,4,234,2,728,184414,2,260
2011-08-31,fall,2011,August,13,Wednesday,Workingday,Clear,0.74,0.6515,0.37,0.1045,39,182,221,221,488,221,2,3,4,234,2,729,184919,2,221
2011-08-31,fall,2011,August,14,Wednesday,Workingday,Clear,0.74,0.6515,0.4,0.1343,48,148,196,196,488,196,2,3,4,234,2,729,175652,2,196
2011-08-31,fall,2011,August,15,Wednesday,Workingday,Clear,0.74,0.6515,0.4,0.1343,34,138,172,172,488,172,2,3,4,234,2,729,183149,2,172
2011-08-31,fall,2011,August,16,Wednesday,Workingday,Clear,0.74,0.6667,0.42,0.1343,46,263,309,309,488,309,2,4,4,244,2,730,227748,2,309
2011-08-31,fall,2011,August,17,Wednesday,Workingday,Clear,0.72,0.6515,0.45,0.1343,83,525,608,608,488,608,2,4,4,244,2,730,336860,2,608
2011-08-31,fall,2011,August,18,Wednesday,Workingday,Clear,0.7,0.6515,0.51,0.2239,70,495,565,565,488,565,2,4,4,244,2,728,309772,2,565
2011-08-31,fall,2011,August,19,Wednesday,Workingday,Clear,0.84,0.7727,0.47,0.2537,53,393,446,446,488,446,2,4,4,244,2,728,226789,2,446
2011-08-31,fall,2011,August,20,Wednesday,Workingday,Clear,0.66,0.6212,0.57,0.1343,30,259,289,289,488,289,2,4,3,243,2,728,164550,2,289
2011-08-31,fall,2011,August,21,Wednesday,Workingday,Clear,0.66,0.6212,0.61,0.0896,27,174,201,201,488,201,2,3,3,233,0,728,125445,2,201
2011-08-31,fall,2011,August,22,Wednesday,Workingday,Clear,0.64,0.6061,0.69,0.0,20,137,157,157,488,157,2,3,3,233,0,728,95612,2,157
2011-08-31,fall,2011,August,23,Wednesday,Workingday,Clear,0.6,0.5758,0.78,0.1045,24,60,84,84,488,84,2,2,3,223,0,728,63941,2,84
2011-09-01,fall,2011,September,0,Thursday,Workingday,Clear,0.6,0.5758,0.78,0.1045,18,33,51,51,487,51,2,2,3,223,0,726,39130,2,51
2011-09-01,fall,2011,September,1,Thursday,Workingday,Clear,0.6,0.5909,0.73,0.0896,7,14,21,21,487,21,2,1,3,213,0,724,24164,2,21
2011-09-01,fall,2011,September,2,Thursday,Workingday,Clear,0.58,0.5455,0.78,0.0896,14,11,25,25,487,25,2,1,3,213,0,715,16352,2,25
2011-09-01,fall,2011,September,3,Thursday,Workingday,Clear,0.58,0.5455,0.78,0.0896,7,7,14,14,487,14,2,1,3,213,0,697,8174,2,14
2011-09-01,fall,2011,September,4,Thursday,Workingday,Clear,0.56,0.5303,0.83,0.0896,0,7,7,7,487,7,2,1,3,213,0,697,4428,2,7
2011-09-01,fall,2011,September,5,Thursday,Workingday,Clear,0.56,0.5303,0.73,0.0896,1,22,23,23,487,23,2,1,3,213,0,717,14261,2,23
2011-09-01,fall,2011,September,6,Thursday,Workingday,Clear,0.6,0.5758,0.78,0.0,2,103,105,105,487,105,2,2,3,223,0,725,55132,2,105
2011-09-01,fall,2011,September,7,Thursday,Workingday,Clear,0.6,0.5758,0.78,0.0,7,335,342,342,487,342,2,4,3,243,0,727,154171,2,342
2011-09-01,fall,2011,September,8,Thursday,Workingday,Clear,0.62,0.5909,0.73,0.1343,31,467,498,498,487,498,2,4,3,243,2,727,261001,2,498
2011-09-01,fall,2011,September,9,Thursday,Workingday,Clear,0.64,0.6061,0.69,0.1045,29,178,207,207,487,207,2,3,3,233,0,727,159438,2,207
2011-09-01,fall,2011,September,10,Thursday,Workingday,Clear,0.68,0.6364,0.61,0.1343,46,92,138,138,487,138,2,2,4,224,0,727,126257,2,138
2011-09-01,fall,2011,September,11,Thursday,Workingday,Clear,0.72,0.6667,0.51,0.1343,51,141,192,192,487,192,2,3,4,234,2,727,151320,2,192
2011-09-01,fall,2011,September,12,Thursday,Workingday,Mist,0.72,0.6667,0.51,0.1343,64,165,229,229,487,229,2,3,4,234,2,728,184414,2,229
2011-09-01,fall,2011,September,13,Thursday,Workingday,Mist,0.72,0.6667,0.48,0.0896,50,169,219,219,487,219,2,3,4,234,2,729,184919,2,219
2011-09-01,fall,2011,September,14,Thursday,Workingday,Light Snow,0.72,0.6667,0.54,0.2537,54,144,198,198,487,198,2,3,4,234,2,729,175652,2,198
2011-09-01,fall,2011,September,15,Thursday,Workingday,Clear,0.72,0.6667,0.51,0.1343,39,135,174,174,487,174,2,3,4,234,2,729,183149,2,174
2011-09-01,fall,2011,September,16,Thursday,Workingday,Clear,0.74,0.6667,0.51,0.194,55,253,308,308,487,308,2,4,4,244,2,730,227748,2,308
2011-09-01,fall,2011,September,17,Thursday,Workingday,Clear,0.72,0.6667,0.54,0.2537,61,567,628,628,487,628,2,4,4,244,2,730,336860,2,628
2011-09-01,fall,2011,September,18,Thursday,Workingday,Clear,0.72,0.6667,0.54,0.2239,69,462,531,531,487,531,2,4,4,244,2,728,309772,2,531
2011-09-01,fall,2011,September,19,Thursday,Workingday,Clear,0.7,0.6515,0.58,0.1642,79,364,443,443,487,443,2,4,4,244,2,728,226789,2,443
2011-09-01,fall,2011,September,20,Thursday,Workingday,Clear,0.66,0.6212,0.61,0.2239,33,247,280,280,487,280,2,3,3,233,2,728,164550,2,280
2011-09-01,fall,2011,September,21,Thursday,Workingday,Mist,0.66,0.6212,0.57,0.194,17,160,177,177,487,177,2,3,3,233,0,728,125445,2,177
2011-09-01,fall,2011,September,22,Thursday,Workingday,Mist,0.66,0.6212,0.57,0.2239,34,145,179,179,487,179,2,3,3,233,0,728,95612,2,179
2011-09-01,fall,2011,September,23,Thursday,Workingday,Clear,0.64,0.6061,0.65,0.2537,15,111,126,126,487,126,2,2,3,223,0,728,63941,2,126
2011-09-02,fall,2011,September,0,Friday,Workingday,Clear,0.64,0.6061,0.65,0.194,6,58,64,64,486,64,2,2,3,223,0,726,39130,2,64
2011-09-02,fall,2011,September,1,Friday,Workingday,Light Snow,0.62,0.5909,0.73,0.1045,4,28,32,32,486,32,2,1,3,213,0,724,24164,2,32
2011-09-02,fall,2011,September,2,Friday,Workingday,Light Snow,0.62,0.5909,0.73,0.1045,9,11,20,20,486,20,2,1,3,213,0,715,16352,2,20
2011-09-02,fall,2011,September,3,Friday,Workingday,Mist,0.6,0.5606,0.83,0.1642,4,4,8,8,486,8,2,1,3,213,0,697,8174,2,8
2011-09-02,fall,2011,September,4,Friday,Workingday,Clear,0.6,0.5606,0.83,0.0896,2,2,4,4,486,4,2,1,3,213,0,697,4428,2,4
2011-09-02,fall,2011,September,5,Friday,Workingday,Mist,0.6,0.5606,0.83,0.1343,0,20,20,20,486,20,2,1,3,213,0,717,14261,2,20
2011-09-02,fall,2011,September,6,Friday,Workingday,Clear,0.6,0.5606,0.83,0.1343,3,73,76,76,486,76,2,2,3,223,0,725,55132,2,76
2011-09-02,fall,2011,September,7,Friday,Workingday,Clear,0.6,0.5606,0.83,0.1045,6,253,259,259,486,259,2,3,3,233,0,727,154171,2,259
2011-09-02,fall,2011,September,8,Friday,Workingday,Clear,0.62,0.5909,0.78,0.194,22,434,456,456,486,456,2,4,3,243,2,727,261001,2,456
2011-09-02,fall,2011,September,9,Friday,Workingday,Mist,0.62,0.5758,0.83,0.1045,30,190,220,220,486,220,2,3,3,233,0,727,159438,2,220
2011-09-02,fall,2011,September,10,Friday,Workingday,Mist,0.64,0.6061,0.76,0.1642,34,106,140,140,486,140,2,2,3,223,0,727,126257,2,140
2011-09-02,fall,2011,September,11,Friday,Workingday,Mist,0.66,0.6212,0.74,0.1045,51,141,192,192,486,192,2,3,3,233,0,727,151320,2,192
2011-09-02,fall,2011,September,12,Friday,Workingday,Mist,0.66,0.6212,0.69,0.2239,82,178,260,260,486,260,2,3,3,233,2,728,184414,2,260
2011-09-02,fall,2011,September,13,Friday,Workingday,Mist,0.68,0.6364,0.65,0.1343,72,207,279,279,486,279,2,3,4,234,2,729,184919,2,279
2011-09-02,fall,2011,September,14,Friday,Workingday,Mist,0.7,0.6515,0.61,0.1045,75,208,283,283,486,283,2,4,4,244,2,729,175652,2,283
2011-09-02,fall,2011,September,15,Friday,Workingday,Mist,0.7,0.6515,0.61,0.2537,69,277,346,346,486,346,2,4,4,244,2,729,183149,2,346
2011-09-02,fall,2011,September,16,Friday,Workingday,Mist,0.7,0.6515,0.61,0.1343,82,299,381,381,486,381,2,4,4,244,2,730,227748,2,381
2011-09-02,fall,2011,September,17,Friday,Workingday,Mist,0.68,0.6364,0.65,0.1642,78,377,455,455,486,455,2,4,4,244,2,730,336860,2,455
2011-09-02,fall,2011,September,18,Friday,Workingday,Mist,0.68,0.6364,0.65,0.194,50,305,355,355,486,355,2,4,4,244,2,728,309772,2,355
2011-09-02,fall,2011,September,19,Friday,Workingday,Clear,0.66,0.6212,0.69,0.1343,67,220,287,287,486,287,2,4,3,243,2,728,226789,2,287
2011-09-02,fall,2011,September,20,Friday,Workingday,Clear,0.64,0.6061,0.73,0.0,38,158,196,196,486,196,2,3,3,233,0,728,164550,2,196
2011-09-02,fall,2011,September,21,Friday,Workingday,Mist,0.64,0.6061,0.73,0.0896,28,121,149,149,486,149,2,3,3,233,0,728,125445,2,149
2011-09-02,fall,2011,September,22,Friday,Workingday,Mist,0.64,0.6061,0.73,0.1642,33,114,147,147,486,147,2,3,3,233,0,728,95612,2,147
2011-09-02,fall,2011,September,23,Friday,Workingday,Mist,0.64,0.6061,0.73,0.1642,30,68,98,98,486,98,2,2,3,223,0,728,63941,2,98
2011-09-03,fall,2011,September,0,Saturday,Holiday,Mist,0.64,0.6061,0.73,0.1045,22,65,87,87,485,87,2,2,3,223,0,726,39130,2,87
2011-09-03,fall,2011,September,1,Saturday,Holiday,Mist,0.64,0.6061,0.69,0.2537,17,57,74,74,485,74,2,2,3,223,0,724,24164,2,74
2011-09-03,fall,2011,September,2,Saturday,Holiday,Mist,0.64,0.6061,0.69,0.2239,15,26,41,41,485,41,2,2,3,223,0,715,16352,2,41
2011-09-03,fall,2011,September,3,Saturday,Holiday,Clear,0.62,0.5909,0.73,0.1642,17,18,35,35,485,35,2,1,3,213,0,697,8174,2,35
2011-09-03,fall,2011,September,4,Saturday,Holiday,Clear,0.62,0.5909,0.73,0.1642,3,4,7,7,485,7,2,1,3,213,0,697,4428,2,7
2011-09-03,fall,2011,September,5,Saturday,Holiday,Clear,0.62,0.6061,0.69,0.194,3,9,12,12,485,12,2,1,3,213,0,717,14261,2,12
2011-09-03,fall,2011,September,6,Saturday,Holiday,Clear,0.62,0.5909,0.73,0.1642,4,19,23,23,485,23,2,1,3,213,0,725,55132,2,23
2011-09-03,fall,2011,September,7,Saturday,Holiday,Clear,0.62,0.5909,0.73,0.194,5,33,38,38,485,38,2,1,3,213,0,727,154171,2,38
2011-09-03,fall,2011,September,8,Saturday,Holiday,Clear,0.64,0.6061,0.69,0.1642,24,65,89,89,485,89,2,2,3,223,0,727,261001,2,89
2011-09-03,fall,2011,September,9,Saturday,Holiday,Mist,0.66,0.6212,0.69,0.2537,83,118,201,201,485,201,2,3,3,233,2,727,159438,2,201
2011-09-03,fall,2011,September,10,Saturday,Holiday,Light Snow,0.66,0.6212,0.65,0.2537,90,168,258,258,485,258,2,3,3,233,2,727,126257,2,258
2011-09-03,fall,2011,September,11,Saturday,Holiday,Light Snow,0.66,0.6212,0.69,0.2836,66,128,194,194,485,194,2,3,3,233,2,727,151320,2,194
2011-09-03,fall,2011,September,12,Saturday,Holiday,Clear,0.7,0.6515,0.61,0.2239,97,160,257,257,485,257,2,3,4,234,2,728,184414,2,257
2011-09-03,fall,2011,September,13,Saturday,Holiday,Clear,0.7,0.6515,0.65,0.2239,153,200,353,353,485,353,2,4,4,244,2,729,184919,2,353
2011-09-03,fall,2011,September,14,Saturday,Holiday,Mist,0.72,0.6818,0.66,0.1642,204,176,380,380,485,380,2,4,4,244,2,729,175652,2,380
2011-09-03,fall,2011,September,15,Saturday,Holiday,Clear,0.72,0.6818,0.7,0.1642,187,201,388,388,485,388,2,4,4,244,2,729,183149,2,388
2011-09-03,fall,2011,September,16,Saturday,Holiday,Clear,0.72,0.6818,0.7,0.194,186,188,374,374,485,374,2,4,4,244,2,730,227748,2,374
2011-09-03,fall,2011,September,17,Saturday,Holiday,Clear,0.72,0.6818,0.7,0.2239,170,201,371,371,485,371,2,4,4,244,2,730,336860,2,371
2011-09-03,fall,2011,September,18,Saturday,Holiday,Clear,0.72,0.6818,0.7,0.1642,160,179,339,339,485,339,2,4,4,244,2,728,309772,2,339
2011-09-03,fall,2011,September,19,Saturday,Holiday,Clear,0.7,0.6667,0.74,0.1343,147,148,295,295,485,295,2,4,4,244,2,728,226789,2,295
2011-09-03,fall,2011,September,20,Saturday,Holiday,Clear,0.7,0.6667,0.79,0.1642,99,120,219,219,485,219,2,3,4,234,0,728,164550,2,219
2011-09-03,fall,2011,September,21,Saturday,Holiday,Clear,0.68,0.6364,0.83,0.1343,71,93,164,164,485,164,2,3,4,234,0,728,125445,2,164
2011-09-03,fall,2011,September,22,Saturday,Holiday,Clear,0.68,0.6364,0.83,0.1045,66,96,162,162,485,162,2,3,4,234,0,728,95612,2,162
2011-09-03,fall,2011,September,23,Saturday,Holiday,Clear,0.66,0.6212,0.85,0.1343,46,77,123,123,485,123,2,2,3,223,0,728,63941,2,123
2011-09-04,fall,2011,September,0,Sunday,Holiday,Clear,0.66,0.5909,0.89,0.194,33,76,109,109,484,109,2,2,3,223,0,726,39130,2,109
2011-09-04,fall,2011,September,1,Sunday,Holiday,Clear,0.66,0.6061,0.83,0.1343,37,38,75,75,484,75,2,2,3,223,0,724,24164,2,75
2011-09-04,fall,2011,September,2,Sunday,Holiday,Clear,0.66,0.6061,0.83,0.194,17,43,60,60,484,60,2,2,3,223,0,715,16352,2,60
2011-09-04,fall,2011,September,3,Sunday,Holiday,Clear,0.64,0.5758,0.89,0.194,20,23,43,43,484,43,2,2,3,223,0,697,8174,2,43
2011-09-04,fall,2011,September,4,Sunday,Holiday,Clear,0.64,0.5758,0.83,0.1642,0,4,4,4,484,4,2,1,3,213,0,697,4428,2,4
2011-09-04,fall,2011,September,5,Sunday,Holiday,Clear,0.64,0.5758,0.83,0.1343,1,5,6,6,484,6,2,1,3,213,0,717,14261,2,6
2011-09-04,fall,2011,September,6,Sunday,Holiday,Clear,0.64,0.5758,0.84,0.2239,0,3,3,3,484,3,2,1,3,213,0,725,55132,2,3
2011-09-04,fall,2011,September,7,Sunday,Holiday,Clear,0.66,0.6061,0.78,0.194,10,20,30,30,484,30,2,1,3,213,0,727,154171,2,30
2011-09-04,fall,2011,September,8,Sunday,Holiday,Clear,0.66,0.6061,0.78,0.1642,21,49,70,70,484,70,2,2,3,223,0,727,261001,2,70
2011-09-04,fall,2011,September,9,Sunday,Holiday,Clear,0.66,0.6061,0.78,0.1642,87,102,189,189,484,189,2,3,3,233,0,727,159438,2,189
2011-09-04,fall,2011,September,10,Sunday,Holiday,Clear,0.7,0.6667,0.74,0.1343,150,147,297,297,484,297,2,4,4,244,2,727,126257,2,297
2011-09-04,fall,2011,September,11,Sunday,Holiday,Clear,0.74,0.697,0.7,0.1642,174,163,337,337,484,337,2,4,4,244,2,727,151320,2,337
2011-09-04,fall,2011,September,12,Sunday,Holiday,Clear,0.76,0.7273,0.66,0.1642,214,221,435,435,484,435,2,4,4,244,2,728,184414,2,435
2011-09-04,fall,2011,September,13,Sunday,Holiday,Mist,0.78,0.7424,0.62,0.2836,245,174,419,419,484,419,2,4,4,244,2,729,184919,2,419
2011-09-04,fall,2011,September,14,Sunday,Holiday,Clear,0.78,0.7576,0.66,0.3284,205,156,361,361,484,361,2,4,4,244,2,729,175652,2,361
2011-09-04,fall,2011,September,15,Sunday,Holiday,Clear,0.78,0.7576,0.66,0.2836,218,192,410,410,484,410,2,4,4,244,2,729,183149,2,410
2011-09-04,fall,2011,September,16,Sunday,Holiday,Clear,0.8,0.7727,0.59,0.2239,196,141,337,337,484,337,2,4,4,244,2,730,227748,2,337
2011-09-04,fall,2011,September,17,Sunday,Holiday,Clear,0.76,0.7273,0.66,0.2239,204,172,376,376,484,376,2,4,4,244,2,730,336860,2,376
2011-09-04,fall,2011,September,18,Sunday,Holiday,Clear,0.76,0.7273,0.66,0.194,187,169,356,356,484,356,2,4,4,244,2,728,309772,2,356
2011-09-04,fall,2011,September,19,Sunday,Holiday,Clear,0.74,0.697,0.7,0.194,178,150,328,328,484,328,2,4,4,244,2,728,226789,2,328
2011-09-04,fall,2011,September,20,Sunday,Holiday,Clear,0.74,0.697,0.7,0.2985,104,125,229,229,484,229,2,3,4,234,2,728,164550,2,229
2011-09-04,fall,2011,September,21,Sunday,Holiday,Clear,0.72,0.697,0.74,0.2537,104,103,207,207,484,207,2,3,4,234,2,728,125445,2,207
2011-09-04,fall,2011,September,22,Sunday,Holiday,Mist,0.72,0.697,0.74,0.2836,70,85,155,155,484,155,2,3,4,234,0,728,95612,2,155
2011-09-04,fall,2011,September,23,Sunday,Holiday,Mist,0.72,0.6818,0.7,0.1642,46,58,104,104,484,104,2,2,4,224,0,728,63941,2,104
2011-09-05,fall,2011,September,0,Monday,Holiday,Mist,0.7,0.6667,0.74,0.2239,31,66,97,97,483,97,2,2,4,224,0,726,39130,2,97
2011-09-05,fall,2011,September,1,Monday,Holiday,Mist,0.68,0.6364,0.79,0.1045,19,35,54,54,483,54,2,2,4,224,0,724,24164,2,54
2011-09-05,fall,2011,September,2,Monday,Holiday,Mist,0.68,0.6364,0.79,0.1642,17,22,39,39,483,39,2,1,4,214,0,715,16352,2,39
2011-09-05,fall,2011,September,3,Monday,Holiday,Mist,0.68,0.6364,0.74,0.2985,4,12,16,16,483,16,2,1,4,214,0,697,8174,2,16
2011-09-05,fall,2011,September,4,Monday,Holiday,Mist,0.68,0.6364,0.69,0.2836,3,5,8,8,483,8,2,1,4,214,0,697,4428,2,8
2011-09-05,fall,2011,September,5,Monday,Holiday,Mist,0.66,0.6212,0.74,0.1642,2,4,6,6,483,6,2,1,3,213,0,717,14261,2,6
2011-09-05,fall,2011,September,6,Monday,Holiday,Mist,0.66,0.6212,0.74,0.1343,6,5,11,11,483,11,2,1,3,213,0,725,55132,2,11
2011-09-05,fall,2011,September,7,Monday,Holiday,Clear,0.66,0.6212,0.74,0.1642,11,30,41,41,483,41,2,2,3,223,0,727,154171,2,41
2011-09-05,fall,2011,September,8,Monday,Holiday,Mist,0.66,0.6061,0.78,0.194,45,56,101,101,483,101,2,2,3,223,0,727,261001,2,101
2011-09-05,fall,2011,September,9,Monday,Holiday,Light Snow,0.68,0.6364,0.74,0.1642,63,89,152,152,483,152,2,3,4,234,0,727,159438,2,152
2011-09-05,fall,2011,September,10,Monday,Holiday,Mist,0.7,0.6515,0.7,0.1642,107,137,244,244,483,244,2,3,4,234,2,727,126257,2,244
2011-09-05,fall,2011,September,11,Monday,Holiday,Mist,0.7,0.6667,0.74,0.1642,101,207,308,308,483,308,2,4,4,244,2,727,151320,2,308
2011-09-05,fall,2011,September,12,Monday,Holiday,Mist,0.72,0.6818,0.7,0.194,141,212,353,353,483,353,2,4,4,244,2,728,184414,2,353
2011-09-05,fall,2011,September,13,Monday,Holiday,Mist,0.74,0.697,0.7,0.1343,154,235,389,389,483,389,2,4,4,244,2,729,184919,2,389
2011-09-05,fall,2011,September,14,Monday,Holiday,Clear,0.74,0.697,0.7,0.1642,145,212,357,357,483,357,2,4,4,244,2,729,175652,2,357
2011-09-05,fall,2011,September,15,Monday,Holiday,Mist,0.68,0.6364,0.79,0.2836,111,142,253,253,483,253,2,3,4,234,2,729,183149,2,253
2011-09-05,fall,2011,September,16,Monday,Holiday,Mist,0.68,0.6364,0.79,0.2836,92,192,284,284,483,284,2,4,4,244,2,730,227748,2,284
2011-09-05,fall,2011,September,17,Monday,Holiday,Mist,0.66,0.5909,0.89,0.1045,37,77,114,114,483,114,2,2,3,223,0,730,336860,2,114
2011-09-05,fall,2011,September,18,Monday,Holiday,Clear,0.66,0.5909,0.89,0.0896,31,92,123,123,483,123,2,2,3,223,0,728,309772,2,123
2011-09-05,fall,2011,September,19,Monday,Holiday,Light Snow,0.66,0.5909,0.94,0.1045,52,123,175,175,483,175,2,3,3,233,0,728,226789,2,175
2011-09-05,fall,2011,September,20,Monday,Holiday,Light Snow,0.66,0.5909,0.94,0.2537,26,56,82,82,483,82,2,2,3,223,0,728,164550,2,82
2011-09-05,fall,2011,September,21,Monday,Holiday,Mist,0.66,0.5909,0.94,0.2985,20,40,60,60,483,60,2,2,3,223,0,728,125445,2,60
2011-09-05,fall,2011,September,22,Monday,Holiday,Mist,0.6,0.5455,0.88,0.5821,15,49,64,64,483,64,2,2,3,223,0,728,95612,2,64
2011-09-05,fall,2011,September,23,Monday,Holiday,Light Snow,0.56,0.5303,0.88,0.3881,3,17,20,20,483,20,2,1,3,213,0,728,63941,2,20
2011-09-06,fall,2011,September,0,Tuesday,Workingday,Light Snow,0.54,0.5152,0.94,0.3582,1,7,8,8,482,8,2,1,3,213,0,726,39130,2,8
2011-09-06,fall,2011,September,2,Tuesday,Workingday,Light Snow,0.54,0.5152,0.94,0.2537,0,2,2,2,482,2,2,1,3,213,0,715,16352,2,2
2011-09-06,fall,2011,September,3,Tuesday,Workingday,Light Snow,0.54,0.5152,0.94,0.2985,1,0,1,1,482,1,2,1,3,213,0,697,8174,2,1
2011-09-06,fall,2011,September,4,Tuesday,Workingday,Mist,0.54,0.5152,0.94,0.2985,1,3,4,4,482,4,2,1,3,213,0,697,4428,2,4
2011-09-06,fall,2011,September,5,Tuesday,Workingday,Light Snow,0.54,0.5152,0.88,0.3582,1,20,21,21,482,21,2,1,3,213,0,717,14261,2,21
2011-09-06,fall,2011,September,6,Tuesday,Workingday,Mist,0.54,0.5152,0.88,0.3284,0,72,72,72,482,72,2,2,3,223,0,725,55132,2,72
2011-09-06,fall,2011,September,7,Tuesday,Workingday,Mist,0.54,0.5152,0.83,0.3582,6,166,172,172,482,172,2,3,3,233,0,727,154171,2,172
2011-09-06,fall,2011,September,8,Tuesday,Workingday,Light Snow,0.54,0.5152,0.83,0.3881,15,349,364,364,482,364,2,4,3,243,0,727,261001,2,364
2011-09-06,fall,2011,September,9,Tuesday,Workingday,Mist,0.54,0.5152,0.81,0.4179,18,167,185,185,482,185,2,3,3,233,0,727,159438,2,185
2011-09-06,fall,2011,September,10,Tuesday,Workingday,Light Snow,0.54,0.5152,0.83,0.3582,16,90,106,106,482,106,2,2,3,223,0,727,126257,2,106
2011-09-06,fall,2011,September,11,Tuesday,Workingday,Light Snow,0.54,0.5152,0.83,0.3881,11,78,89,89,482,89,2,2,3,223,0,727,151320,2,89
2011-09-06,fall,2011,September,12,Tuesday,Workingday,Light Snow,0.54,0.5152,0.83,0.3881,16,51,67,67,482,67,2,2,3,223,0,728,184414,2,67
2011-09-06,fall,2011,September,13,Tuesday,Workingday,Light Snow,0.54,0.5152,0.88,0.2985,5,24,29,29,482,29,2,1,3,213,0,729,184919,2,29
2011-09-06,fall,2011,September,14,Tuesday,Workingday,Light Snow,0.54,0.5152,0.88,0.2836,3,21,24,24,482,24,2,1,3,213,0,729,175652,2,24
2011-09-06,fall,2011,September,15,Tuesday,Workingday,Light Snow,0.54,0.5152,0.94,0.3881,18,71,89,89,482,89,2,2,3,223,0,729,183149,2,89
2011-09-06,fall,2011,September,16,Tuesday,Workingday,Light Snow,0.54,0.5152,0.94,0.3881,11,95,106,106,482,106,2,2,3,223,0,730,227748,2,106
2011-09-06,fall,2011,September,17,Tuesday,Workingday,Mist,0.54,0.5152,0.88,0.3881,15,276,291,291,482,291,2,4,3,243,0,730,336860,2,291
2011-09-06,fall,2011,September,18,Tuesday,Workingday,Mist,0.54,0.5152,0.88,0.3881,22,351,373,373,482,373,2,4,3,243,0,728,309772,2,373
2011-09-06,fall,2011,September,19,Tuesday,Workingday,Mist,0.54,0.5152,0.88,0.4179,12,269,281,281,482,281,2,3,3,233,0,728,226789,2,281
2011-09-06,fall,2011,September,20,Tuesday,Workingday,Light Snow,0.54,0.5152,0.88,0.2985,13,150,163,163,482,163,2,3,3,233,0,728,164550,2,163
2011-09-06,fall,2011,September,21,Tuesday,Workingday,Light Snow,0.54,0.5152,0.88,0.2836,12,109,121,121,482,121,2,2,3,223,0,728,125445,2,121
2011-09-06,fall,2011,September,22,Tuesday,Workingday,Mist,0.54,0.5152,0.94,0.3284,5,79,84,84,482,84,2,2,3,223,0,728,95612,2,84
2011-09-06,fall,2011,September,23,Tuesday,Workingday,Light Snow,0.54,0.5152,0.94,0.2537,2,56,58,58,482,58,2,2,3,223,0,728,63941,2,58
2011-09-07,fall,2011,September,0,Wednesday,Workingday,Mist,0.54,0.5152,0.94,0.2239,1,12,13,13,481,13,2,1,3,213,0,726,39130,2,13
2011-09-07,fall,2011,September,1,Wednesday,Workingday,Light Snow,0.54,0.5152,0.94,0.2537,2,3,5,5,481,5,2,1,3,213,0,724,24164,2,5
2011-09-07,fall,2011,September,2,Wednesday,Workingday,Mist,0.54,0.5152,0.94,0.2239,2,4,6,6,481,6,2,1,3,213,0,715,16352,2,6
2011-09-07,fall,2011,September,3,Wednesday,Workingday,Light Snow,0.56,0.5303,0.94,0.1343,1,1,2,2,481,2,2,1,3,213,0,697,8174,2,2
2011-09-07,fall,2011,September,4,Wednesday,Workingday,Light Snow,0.56,0.5303,0.94,0.1642,0,4,4,4,481,4,2,1,3,213,0,697,4428,2,4
2011-09-07,fall,2011,September,5,Wednesday,Workingday,Mist,0.56,0.5303,1.0,0.1343,1,15,16,16,481,16,2,1,3,213,0,717,14261,2,16
2011-09-07,fall,2011,September,6,Wednesday,Workingday,Light Snow,0.6,0.5455,0.88,0.1045,1,74,75,75,481,75,2,2,3,223,0,725,55132,2,75
2011-09-07,fall,2011,September,7,Wednesday,Workingday,Light Snow,0.6,0.5455,0.88,0.0896,3,83,86,86,481,86,2,2,3,223,0,727,154171,2,86
2011-09-07,fall,2011,September,8,Wednesday,Workingday,Light Snow,0.62,0.5455,0.94,0.0896,9,319,328,328,481,328,2,4,3,243,0,727,261001,2,328
2011-09-07,fall,2011,September,9,Wednesday,Workingday,Light Snow,0.6,0.5455,0.88,0.1343,14,176,190,190,481,190,2,3,3,233,0,727,159438,2,190
2011-09-07,fall,2011,September,10,Wednesday,Workingday,Light Snow,0.6,0.5455,0.88,0.1343,3,63,66,66,481,66,2,2,3,223,0,727,126257,2,66
2011-09-07,fall,2011,September,11,Wednesday,Workingday,Light Snow,0.6,0.5152,0.94,0.0,1,9,10,10,481,10,2,1,3,213,0,727,151320,2,10
2011-09-07,fall,2011,September,12,Wednesday,Workingday,Light Snow,0.56,0.5303,0.94,0.0,1,21,22,22,481,22,2,1,3,213,0,728,184414,2,22
2011-09-07,fall,2011,September,13,Wednesday,Workingday,Light Snow,0.6,0.5455,0.88,0.0,2,9,11,11,481,11,2,1,3,213,0,729,184919,2,11
2011-09-07,fall,2011,September,14,Wednesday,Workingday,Light Snow,0.6,0.5152,0.93,0.0,1,24,25,25,481,25,2,1,3,213,0,729,175652,2,25
2011-09-07,fall,2011,September,15,Wednesday,Workingday,Light Snow,0.62,0.5455,0.94,0.1045,3,55,58,58,481,58,2,2,3,223,0,729,183149,2,58
2011-09-07,fall,2011,September,16,Wednesday,Workingday,Clear,0.64,0.5758,0.89,0.0,7,137,144,144,481,144,2,3,3,233,0,730,227748,2,144
2011-09-07,fall,2011,September,17,Wednesday,Workingday,Light Snow,0.64,0.5758,0.89,0.0,21,264,285,285,481,285,2,4,3,243,0,730,336860,2,285
2011-09-07,fall,2011,September,18,Wednesday,Workingday,Light Snow,0.64,0.5758,0.89,0.0,18,219,237,237,481,237,2,3,3,233,0,728,309772,2,237
2011-09-07,fall,2011,September,19,Wednesday,Workingday,Mist,0.64,0.5758,0.89,0.0,14,212,226,226,481,226,2,3,3,233,0,728,226789,2,226
2011-09-07,fall,2011,September,20,Wednesday,Workingday,Light Snow,0.64,0.5758,0.89,0.0896,3,93,96,96,481,96,2,2,3,223,0,728,164550,2,96
2011-09-07,fall,2011,September,21,Wednesday,Workingday,Light Snow,0.64,0.5758,0.89,0.0896,4,34,38,38,481,38,2,1,3,213,0,728,125445,2,38
2011-09-07,fall,2011,September,22,Wednesday,Workingday,Light Snow,0.62,0.5455,0.94,0.1642,3,26,29,29,481,29,2,1,3,213,0,728,95612,2,29
2011-09-07,fall,2011,September,23,Wednesday,Workingday,Light Snow,0.62,0.5455,0.94,0.194,3,21,24,24,481,24,2,1,3,213,0,728,63941,2,24
2011-09-08,fall,2011,September,0,Thursday,Workingday,Light Snow,0.6,0.5,1.0,0.194,3,11,14,14,480,14,2,1,3,213,0,726,39130,2,14
2011-09-08,fall,2011,September,1,Thursday,Workingday,Light Snow,0.62,0.5455,0.94,0.1045,0,4,4,4,480,4,2,1,3,213,0,724,24164,2,4
2011-09-08,fall,2011,September,3,Thursday,Workingday,Light Snow,0.62,0.5455,0.94,0.0,0,2,2,2,480,2,2,1,3,213,0,697,8174,2,2
2011-09-08,fall,2011,September,4,Thursday,Workingday,Mist,0.62,0.5455,0.94,0.0896,0,3,3,3,480,3,2,1,3,213,0,697,4428,2,3
2011-09-08,fall,2011,September,5,Thursday,Workingday,Light Snow,0.62,0.5455,0.94,0.0896,1,13,14,14,480,14,2,1,3,213,0,717,14261,2,14
2011-09-08,fall,2011,September,6,Thursday,Workingday,Light Snow,0.62,0.5455,0.94,0.1642,1,55,56,56,480,56,2,2,3,223,0,725,55132,2,56
2011-09-08,fall,2011,September,7,Thursday,Workingday,Light Snow,0.62,0.5455,0.94,0.1045,7,172,179,179,480,179,2,3,3,233,0,727,154171,2,179
2011-09-08,fall,2011,September,8,Thursday,Workingday,Light Snow,0.62,0.5455,0.94,0.1343,7,188,195,195,480,195,2,3,3,233,0,727,261001,2,195
2011-09-08,fall,2011,September,9,Thursday,Workingday,Mist,0.62,0.5152,1.0,0.2537,4,65,69,69,480,69,2,2,3,223,0,727,159438,2,69
2011-09-08,fall,2011,September,10,Thursday,Workingday,Mist,0.64,0.5606,0.94,0.1045,8,57,65,65,480,65,2,2,3,223,0,727,126257,2,65
2011-09-08,fall,2011,September,11,Thursday,Workingday,Mist,0.64,0.5606,0.94,0.2239,16,82,98,98,480,98,2,2,3,223,0,727,151320,2,98
2011-09-08,fall,2011,September,12,Thursday,Workingday,Mist,0.66,0.5909,0.94,0.2239,17,85,102,102,480,102,2,2,3,223,0,728,184414,2,102
2011-09-08,fall,2011,September,13,Thursday,Workingday,Mist,0.68,0.6364,0.83,0.3881,14,112,126,126,480,126,2,2,4,224,0,729,184919,2,126
2011-09-08,fall,2011,September,14,Thursday,Workingday,Mist,0.7,0.6667,0.79,0.3582,15,105,120,120,480,120,2,2,4,224,0,729,175652,2,120
2011-09-08,fall,2011,September,15,Thursday,Workingday,Light Snow,0.66,0.5909,0.89,0.2985,24,115,139,139,480,139,2,2,3,223,0,729,183149,2,139
2011-09-08,fall,2011,September,16,Thursday,Workingday,Light Snow,0.64,0.5606,0.94,0.2836,5,151,156,156,480,156,2,3,3,233,0,730,227748,2,156
2011-09-08,fall,2011,September,17,Thursday,Workingday,Light Snow,0.64,0.5606,0.94,0.2836,11,102,113,113,480,113,2,2,3,223,0,730,336860,2,113
2011-09-08,fall,2011,September,18,Thursday,Workingday,Light Snow,0.64,0.5606,0.94,0.3582,2,66,68,68,480,68,2,2,3,223,0,728,309772,2,68
2011-09-08,fall,2011,September,19,Thursday,Workingday,Light Snow,0.62,0.5152,1.0,0.3284,1,51,52,52,480,52,2,2,3,223,0,728,226789,2,52
2011-09-08,fall,2011,September,20,Thursday,Workingday,Mist,0.62,0.5455,0.94,0.1642,6,83,89,89,480,89,2,2,3,223,0,728,164550,2,89
2011-09-08,fall,2011,September,21,Thursday,Workingday,Light Snow,0.64,0.5606,0.94,0.1045,6,76,82,82,480,82,2,2,3,223,0,728,125445,2,82
2011-09-08,fall,2011,September,22,Thursday,Workingday,Light Snow,0.62,0.5152,1.0,0.0896,5,65,70,70,480,70,2,2,3,223,0,728,95612,2,70
2011-09-08,fall,2011,September,23,Thursday,Workingday,Light Snow,0.62,0.5152,1.0,0.0896,0,26,26,26,480,26,2,1,3,213,0,728,63941,2,26
2011-09-09,fall,2011,September,0,Friday,Workingday,Light Snow,0.64,0.5606,0.94,0.194,1,15,16,16,479,16,2,1,3,213,0,726,39130,2,16
2011-09-09,fall,2011,September,1,Friday,Workingday,Mist,0.62,0.5152,1.0,0.1642,0,8,8,8,479,8,2,1,3,213,0,724,24164,2,8
2011-09-09,fall,2011,September,2,Friday,Workingday,Mist,0.62,0.5152,1.0,0.2537,1,7,8,8,479,8,2,1,3,213,0,715,16352,2,8
2011-09-09,fall,2011,September,3,Friday,Workingday,Mist,0.62,0.5455,0.94,0.2537,1,1,2,2,479,2,2,1,3,213,0,697,8174,2,2
2011-09-09,fall,2011,September,4,Friday,Workingday,Light Snow,0.62,0.5455,0.94,0.1642,0,3,3,3,479,3,2,1,3,213,0,697,4428,2,3
2011-09-09,fall,2011,September,5,Friday,Workingday,Mist,0.62,0.5455,0.94,0.1343,0,14,14,14,479,14,2,1,3,213,0,717,14261,2,14
2011-09-09,fall,2011,September,6,Friday,Workingday,Mist,0.62,0.5152,1.0,0.1343,3,54,57,57,479,57,2,2,3,223,0,725,55132,2,57
2011-09-09,fall,2011,September,7,Friday,Workingday,Light Snow,0.62,0.5152,1.0,0.2537,4,104,108,108,479,108,2,2,3,223,0,727,154171,2,108
2011-09-09,fall,2011,September,8,Friday,Workingday,Light Snow,0.62,0.5455,0.94,0.1642,12,276,288,288,479,288,2,4,3,243,0,727,261001,2,288
2011-09-09,fall,2011,September,9,Friday,Workingday,Light Snow,0.62,0.5455,0.94,0.1642,5,131,136,136,479,136,2,2,3,223,0,727,159438,2,136
2011-09-09,fall,2011,September,10,Friday,Workingday,Mist,0.62,0.5152,1.0,0.0,2,27,29,29,479,29,2,1,3,213,0,727,126257,2,29
2011-09-09,fall,2011,September,11,Friday,Workingday,Mist,0.62,0.5455,0.94,0.0,6,66,72,72,479,72,2,2,3,223,0,727,151320,2,72
2011-09-09,fall,2011,September,12,Friday,Workingday,Clear,0.64,0.5606,0.94,0.0,4,71,75,75,479,75,2,2,3,223,0,728,184414,2,75
2011-09-09,fall,2011,September,13,Friday,Workingday,Clear,0.7,0.6667,0.79,0.0896,14,108,122,122,479,122,2,2,4,224,0,729,184919,2,122
2011-09-09,fall,2011,September,14,Friday,Workingday,Clear,0.72,0.697,0.74,0.0896,29,119,148,148,479,148,2,3,4,234,0,729,175652,2,148
2011-09-09,fall,2011,September,15,Friday,Workingday,Clear,0.74,0.697,0.66,0.0,27,161,188,188,479,188,2,3,4,234,0,729,183149,2,188
2011-09-09,fall,2011,September,16,Friday,Workingday,Clear,0.74,0.697,0.66,0.1343,41,244,285,285,479,285,2,4,4,244,2,730,227748,2,285
2011-09-09,fall,2011,September,17,Friday,Workingday,Clear,0.7,0.6667,0.79,0.2537,54,451,505,505,479,505,2,4,4,244,2,730,336860,2,505
2011-09-09,fall,2011,September,18,Friday,Workingday,Clear,0.7,0.6667,0.79,0.194,33,377,410,410,479,410,2,4,4,244,2,728,309772,2,410
2011-09-09,fall,2011,September,19,Friday,Workingday,Clear,0.66,0.5909,0.89,0.1642,33,316,349,349,479,349,2,4,3,243,0,728,226789,2,349
2011-09-09,fall,2011,September,20,Friday,Workingday,Clear,0.64,0.5606,0.94,0.0896,30,180,210,210,479,210,2,3,3,233,0,728,164550,2,210
2011-09-09,fall,2011,September,21,Friday,Workingday,Clear,0.66,0.5909,0.89,0.0,49,154,203,203,479,203,2,3,3,233,0,728,125445,2,203
2011-09-09,fall,2011,September,22,Friday,Workingday,Clear,0.62,0.5455,0.94,0.0,33,127,160,160,479,160,2,3,3,233,0,728,95612,2,160
2011-09-09,fall,2011,September,23,Friday,Workingday,Clear,0.62,0.5455,0.94,0.0896,35,113,148,148,479,148,2,3,3,233,0,728,63941,2,148
2011-09-10,fall,2011,September,0,Saturday,Holiday,Clear,0.62,0.5455,0.94,0.0,32,84,116,116,478,116,2,2,3,223,0,726,39130,2,116
2011-09-10,fall,2011,September,1,Saturday,Holiday,Mist,0.62,0.5455,0.94,0.0,16,67,83,83,478,83,2,2,3,223,0,724,24164,2,83
2011-09-10,fall,2011,September,2,Saturday,Holiday,Mist,0.6,0.5,0.97,0.1045,18,46,64,64,478,64,2,2,3,223,0,715,16352,2,64
2011-09-10,fall,2011,September,3,Saturday,Holiday,Clear,0.58,0.5455,1.0,0.1343,8,29,37,37,478,37,2,1,3,213,0,697,8174,2,37
2011-09-10,fall,2011,September,4,Saturday,Holiday,Clear,0.58,0.5455,0.94,0.0896,3,4,7,7,478,7,2,1,3,213,0,697,4428,2,7
2011-09-10,fall,2011,September,5,Saturday,Holiday,Clear,0.58,0.5455,0.94,0.1343,2,6,8,8,478,8,2,1,3,213,0,717,14261,2,8
2011-09-10,fall,2011,September,6,Saturday,Holiday,Clear,0.58,0.5455,0.94,0.1642,0,6,6,6,478,6,2,1,3,213,0,725,55132,2,6
2011-09-10,fall,2011,September,7,Saturday,Holiday,Clear,0.6,0.5455,0.88,0.1343,9,43,52,52,478,52,2,2,3,223,0,727,154171,2,52
2011-09-10,fall,2011,September,8,Saturday,Holiday,Clear,0.62,0.5758,0.83,0.1642,16,103,119,119,478,119,2,2,3,223,0,727,261001,2,119
2011-09-10,fall,2011,September,9,Saturday,Holiday,Clear,0.64,0.5909,0.78,0.2985,39,168,207,207,478,207,2,3,3,233,0,727,159438,2,207
2011-09-10,fall,2011,September,10,Saturday,Holiday,Clear,0.7,0.6515,0.65,0.2537,85,233,318,318,478,318,2,4,4,244,2,727,126257,2,318
2011-09-10,fall,2011,September,11,Saturday,Holiday,Clear,0.72,0.6818,0.62,0.2537,108,252,360,360,478,360,2,4,4,244,2,727,151320,2,360
2011-09-10,fall,2011,September,12,Saturday,Holiday,Clear,0.72,0.6818,0.62,0.2239,144,260,404,404,478,404,2,4,4,244,2,728,184414,2,404
2011-09-10,fall,2011,September,13,Saturday,Holiday,Clear,0.74,0.6818,0.55,0.2836,131,239,370,370,478,370,2,4,4,244,2,729,184919,2,370
2011-09-10,fall,2011,September,14,Saturday,Holiday,Clear,0.74,0.6818,0.55,0.2836,129,230,359,359,478,359,2,4,4,244,2,729,175652,2,359
2011-09-10,fall,2011,September,15,Saturday,Holiday,Clear,0.74,0.6818,0.55,0.2239,217,263,480,480,478,480,2,4,4,244,2,729,183149,2,480
2011-09-10,fall,2011,September,16,Saturday,Holiday,Clear,0.74,0.6818,0.55,0.194,170,261,431,431,478,431,2,4,4,244,2,730,227748,2,431
2011-09-10,fall,2011,September,17,Saturday,Holiday,Clear,0.74,0.6818,0.55,0.2239,185,275,460,460,478,460,2,4,4,244,2,730,336860,2,460
2011-09-10,fall,2011,September,18,Saturday,Holiday,Clear,0.72,0.6667,0.58,0.194,119,241,360,360,478,360,2,4,4,244,2,728,309772,2,360
2011-09-10,fall,2011,September,19,Saturday,Holiday,Clear,0.7,0.6515,0.58,0.1343,101,214,315,315,478,315,2,4,4,244,2,728,226789,2,315
2011-09-10,fall,2011,September,20,Saturday,Holiday,Clear,0.66,0.6212,0.69,0.1045,78,167,245,245,478,245,2,3,3,233,0,728,164550,2,245
2011-09-10,fall,2011,September,21,Saturday,Holiday,Clear,0.64,0.5909,0.78,0.0896,59,171,230,230,478,230,2,3,3,233,0,728,125445,2,230
2011-09-10,fall,2011,September,22,Saturday,Holiday,Clear,0.64,0.5909,0.78,0.0,49,126,175,175,478,175,2,3,3,233,0,728,95612,2,175
2011-09-10,fall,2011,September,23,Saturday,Holiday,Mist,0.62,0.5606,0.88,0.0,32,107,139,139,478,139,2,2,3,223,0,728,63941,2,139
2011-09-11,fall,2011,September,0,Sunday,Holiday,Clear,0.62,0.5606,0.88,0.0,29,79,108,108,477,108,2,2,3,223,0,726,39130,2,108
2011-09-11,fall,2011,September,1,Sunday,Holiday,Mist,0.62,0.5606,0.88,0.0,22,66,88,88,477,88,2,2,3,223,0,724,24164,2,88
2011-09-11,fall,2011,September,2,Sunday,Holiday,Mist,0.62,0.5909,0.78,0.194,16,60,76,76,477,76,2,2,3,223,0,715,16352,2,76
2011-09-11,fall,2011,September,3,Sunday,Holiday,Mist,0.62,0.5909,0.78,0.0896,15,30,45,45,477,45,2,2,3,223,0,697,8174,2,45
2011-09-11,fall,2011,September,4,Sunday,Holiday,Clear,0.6,0.5606,0.83,0.1343,3,6,9,9,477,9,2,1,3,213,0,697,4428,2,9
2011-09-11,fall,2011,September,5,Sunday,Holiday,Clear,0.6,0.5606,0.83,0.1343,15,24,39,39,477,39,2,1,3,213,0,717,14261,2,39
2011-09-11,fall,2011,September,6,Sunday,Holiday,Clear,0.58,0.5455,0.88,0.1045,4,16,20,20,477,20,2,1,3,213,0,725,55132,2,20
2011-09-11,fall,2011,September,7,Sunday,Holiday,Clear,0.6,0.5455,0.88,0.0,9,28,37,37,477,37,2,1,3,213,0,727,154171,2,37
2011-09-11,fall,2011,September,8,Sunday,Holiday,Clear,0.64,0.5909,0.78,0.0,25,69,94,94,477,94,2,2,3,223,0,727,261001,2,94
2011-09-11,fall,2011,September,9,Sunday,Holiday,Clear,0.66,0.6212,0.74,0.0,59,168,227,227,477,227,2,3,3,233,0,727,159438,2,227
2011-09-11,fall,2011,September,10,Sunday,Holiday,Clear,0.7,0.6515,0.65,0.0,120,214,334,334,477,334,2,4,4,244,2,727,126257,2,334
2011-09-11,fall,2011,September,11,Sunday,Holiday,Clear,0.7,0.6515,0.65,0.0,144,258,402,402,477,402,2,4,4,244,2,727,151320,2,402
2011-09-11,fall,2011,September,12,Sunday,Holiday,Clear,0.7,0.6515,0.65,0.0,113,298,411,411,477,411,2,4,4,244,2,728,184414,2,411
2011-09-11,fall,2011,September,13,Sunday,Holiday,Clear,0.74,0.6818,0.58,0.1045,119,231,350,350,477,350,2,4,4,244,2,729,184919,2,350
2011-09-11,fall,2011,September,14,Sunday,Holiday,Clear,0.72,0.6667,0.58,0.2836,120,222,342,342,477,342,2,4,4,244,2,729,175652,2,342
2011-09-11,fall,2011,September,15,Sunday,Holiday,Clear,0.74,0.6667,0.51,0.2985,134,270,404,404,477,404,2,4,4,244,2,729,183149,2,404
2011-09-11,fall,2011,September,16,Sunday,Holiday,Clear,0.72,0.6667,0.51,0.2985,180,303,483,483,477,483,2,4,4,244,2,730,227748,2,483
2011-09-11,fall,2011,September,17,Sunday,Holiday,Clear,0.72,0.6667,0.51,0.1343,152,228,380,380,477,380,2,4,4,244,2,730,336860,2,380
2011-09-11,fall,2011,September,18,Sunday,Holiday,Clear,0.68,0.6364,0.65,0.2985,110,229,339,339,477,339,2,4,4,244,2,728,309772,2,339
2011-09-11,fall,2011,September,19,Sunday,Holiday,Clear,0.64,0.6061,0.69,0.1045,101,232,333,333,477,333,2,4,3,243,2,728,226789,2,333
2011-09-11,fall,2011,September,20,Sunday,Holiday,Clear,0.62,0.5909,0.73,0.1045,65,161,226,226,477,226,2,3,3,233,0,728,164550,2,226
2011-09-11,fall,2011,September,21,Sunday,Holiday,Clear,0.64,0.6061,0.69,0.0,45,114,159,159,477,159,2,3,3,233,0,728,125445,2,159
2011-09-11,fall,2011,September,22,Sunday,Holiday,Clear,0.62,0.6061,0.69,0.3881,21,74,95,95,477,95,2,2,3,223,0,728,95612,2,95
2011-09-11,fall,2011,September,23,Sunday,Holiday,Light Snow,0.58,0.5455,0.78,0.0896,12,33,45,45,477,45,2,2,3,223,0,728,63941,2,45
2011-09-12,fall,2011,September,0,Monday,Workingday,Clear,0.56,0.5303,0.88,0.0896,5,11,16,16,476,16,2,1,3,213,0,726,39130,2,16
2011-09-12,fall,2011,September,1,Monday,Workingday,Clear,0.56,0.5303,0.88,0.0,1,11,12,12,476,12,2,1,3,213,0,724,24164,2,12
2011-09-12,fall,2011,September,2,Monday,Workingday,Clear,0.56,0.5303,0.88,0.0,2,0,2,2,476,2,2,1,3,213,0,715,16352,2,2
2011-09-12,fall,2011,September,4,Monday,Workingday,Clear,0.54,0.5152,0.94,0.1045,0,4,4,4,476,4,2,1,3,213,0,697,4428,2,4
2011-09-12,fall,2011,September,5,Monday,Workingday,Clear,0.56,0.5303,0.83,0.0,1,23,24,24,476,24,2,1,3,213,0,717,14261,2,24
2011-09-12,fall,2011,September,6,Monday,Workingday,Clear,0.56,0.5303,0.83,0.0,1,108,109,109,476,109,2,2,3,223,0,725,55132,2,109
2011-09-12,fall,2011,September,7,Monday,Workingday,Clear,0.58,0.5455,0.83,0.0,12,300,312,312,476,312,2,4,3,243,0,727,154171,2,312
2011-09-12,fall,2011,September,8,Monday,Workingday,Clear,0.6,0.5758,0.78,0.0896,26,382,408,408,476,408,2,4,3,243,0,727,261001,2,408
2011-09-12,fall,2011,September,9,Monday,Workingday,Clear,0.64,0.6061,0.69,0.0,21,155,176,176,476,176,2,3,3,233,0,727,159438,2,176
2011-09-12,fall,2011,September,10,Monday,Workingday,Clear,0.68,0.6364,0.62,0.1642,40,89,129,129,476,129,2,2,4,224,0,727,126257,2,129
2011-09-12,fall,2011,September,11,Monday,Workingday,Clear,0.7,0.6515,0.58,0.194,34,131,165,165,476,165,2,3,4,234,0,727,151320,2,165
2011-09-12,fall,2011,September,12,Monday,Workingday,Clear,0.72,0.6667,0.51,0.194,37,147,184,184,476,184,2,3,4,234,2,728,184414,2,184
2011-09-12,fall,2011,September,13,Monday,Workingday,Clear,0.72,0.6667,0.54,0.1045,43,120,163,163,476,163,2,3,4,234,0,729,184919,2,163
2011-09-12,fall,2011,September,14,Monday,Workingday,Clear,0.74,0.6667,0.51,0.1642,60,129,189,189,476,189,2,3,4,234,2,729,175652,2,189
2011-09-12,fall,2011,September,15,Monday,Workingday,Clear,0.74,0.6667,0.48,0.0896,60,152,212,212,476,212,2,3,4,234,2,729,183149,2,212
2011-09-12,fall,2011,September,16,Monday,Workingday,Clear,0.72,0.6667,0.48,0.0,60,238,298,298,476,298,2,4,4,244,2,730,227748,2,298
2011-09-12,fall,2011,September,17,Monday,Workingday,Clear,0.72,0.6667,0.51,0.1642,75,515,590,590,476,590,2,4,4,244,2,730,336860,2,590
2011-09-12,fall,2011,September,18,Monday,Workingday,Clear,0.7,0.6515,0.54,0.194,56,515,571,571,476,571,2,4,4,244,2,728,309772,2,571
2011-09-12,fall,2011,September,19,Monday,Workingday,Clear,0.68,0.6364,0.57,0.1343,63,373,436,436,476,436,2,4,4,244,2,728,226789,2,436
2011-09-12,fall,2011,September,20,Monday,Workingday,Clear,0.66,0.6212,0.65,0.0,41,258,299,299,476,299,2,4,3,243,0,728,164550,2,299
2011-09-12,fall,2011,September,21,Monday,Workingday,Clear,0.64,0.6061,0.73,0.0896,29,166,195,195,476,195,2,3,3,233,0,728,125445,2,195
2011-09-12,fall,2011,September,22,Monday,Workingday,Clear,0.62,0.5758,0.83,0.1642,16,134,150,150,476,150,2,3,3,233,0,728,95612,2,150
2011-09-12,fall,2011,September,23,Monday,Workingday,Clear,0.62,0.5758,0.83,0.1045,7,62,69,69,476,69,2,2,3,223,0,728,63941,2,69
2011-09-13,fall,2011,September,0,Tuesday,Workingday,Clear,0.6,0.5455,0.88,0.1045,7,19,26,26,475,26,2,1,3,213,0,726,39130,2,26
2011-09-13,fall,2011,September,1,Tuesday,Workingday,Clear,0.58,0.5455,0.83,0.1045,4,6,10,10,475,10,2,1,3,213,0,724,24164,2,10
2011-09-13,fall,2011,September,2,Tuesday,Workingday,Clear,0.6,0.5758,0.78,0.0,2,0,2,2,475,2,2,1,3,213,0,715,16352,2,2
2011-09-13,fall,2011,September,3,Tuesday,Workingday,Clear,0.58,0.5455,0.83,0.0,2,2,4,4,475,4,2,1,3,213,0,697,8174,2,4
2011-09-13,fall,2011,September,4,Tuesday,Workingday,Clear,0.56,0.5303,0.88,0.0,2,6,8,8,475,8,2,1,3,213,0,697,4428,2,8
2011-09-13,fall,2011,September,5,Tuesday,Workingday,Clear,0.56,0.5303,0.88,0.0,1,19,20,20,475,20,2,1,3,213,0,717,14261,2,20
2011-09-13,fall,2011,September,6,Tuesday,Workingday,Clear,0.56,0.5303,0.88,0.1045,6,116,122,122,475,122,2,2,3,223,0,725,55132,2,122
2011-09-13,fall,2011,September,7,Tuesday,Workingday,Clear,0.58,0.5455,0.83,0.0896,14,348,362,362,475,362,2,4,3,243,0,727,154171,2,362
2011-09-13,fall,2011,September,8,Tuesday,Workingday,Clear,0.6,0.5606,0.81,0.1045,26,399,425,425,475,425,2,4,3,243,0,727,261001,2,425
2011-09-13,fall,2011,September,9,Tuesday,Workingday,Clear,0.64,0.6061,0.69,0.0896,35,179,214,214,475,214,2,3,3,233,0,727,159438,2,214
2011-09-13,fall,2011,September,10,Tuesday,Workingday,Clear,0.68,0.6364,0.69,0.1343,42,93,135,135,475,135,2,2,4,224,0,727,126257,2,135
2011-09-13,fall,2011,September,11,Tuesday,Workingday,Clear,0.7,0.6515,0.61,0.1642,33,120,153,153,475,153,2,3,4,234,0,727,151320,2,153
2011-09-13,fall,2011,September,12,Tuesday,Workingday,Clear,0.72,0.6667,0.58,0.2239,43,144,187,187,475,187,2,3,4,234,2,728,184414,2,187
2011-09-13,fall,2011,September,13,Tuesday,Workingday,Clear,0.74,0.6667,0.51,0.2836,48,136,184,184,475,184,2,3,4,234,2,729,184919,2,184
2011-09-13,fall,2011,September,14,Tuesday,Workingday,Clear,0.74,0.6667,0.51,0.3284,51,139,190,190,475,190,2,3,4,234,2,729,175652,2,190
2011-09-13,fall,2011,September,15,Tuesday,Workingday,Clear,0.74,0.6667,0.51,0.2985,35,145,180,180,475,180,2,3,4,234,2,729,183149,2,180
2011-09-13,fall,2011,September,16,Tuesday,Workingday,Clear,0.74,0.6667,0.51,0.2239,41,251,292,292,475,292,2,4,4,244,2,730,227748,2,292
2011-09-13,fall,2011,September,17,Tuesday,Workingday,Clear,0.74,0.6667,0.51,0.2239,72,507,579,579,475,579,2,4,4,244,2,730,336860,2,579
2011-09-13,fall,2011,September,18,Tuesday,Workingday,Clear,0.7,0.6515,0.61,0.1642,67,472,539,539,475,539,2,4,4,244,2,728,309772,2,539
2011-09-13,fall,2011,September,19,Tuesday,Workingday,Clear,0.68,0.6364,0.69,0.1642,55,341,396,396,475,396,2,4,4,244,2,728,226789,2,396
2011-09-13,fall,2011,September,20,Tuesday,Workingday,Clear,0.66,0.6212,0.74,0.194,31,241,272,272,475,272,2,3,3,233,0,728,164550,2,272
2011-09-13,fall,2011,September,21,Tuesday,Workingday,Clear,0.64,0.5909,0.78,0.1642,45,200,245,245,475,245,2,3,3,233,0,728,125445,2,245
2011-09-13,fall,2011,September,22,Tuesday,Workingday,Clear,0.64,0.5909,0.78,0.1343,24,120,144,144,475,144,2,3,3,233,0,728,95612,2,144
2011-09-13,fall,2011,September,23,Tuesday,Workingday,Clear,0.64,0.5909,0.78,0.1045,15,59,74,74,475,74,2,2,3,223,0,728,63941,2,74
2011-09-14,fall,2011,September,0,Wednesday,Workingday,Clear,0.62,0.5909,0.78,0.0896,5,28,33,33,474,33,2,1,3,213,0,726,39130,2,33
2011-09-14,fall,2011,September,1,Wednesday,Workingday,Clear,0.62,0.5909,0.78,0.0896,1,7,8,8,474,8,2,1,3,213,0,724,24164,2,8
2011-09-14,fall,2011,September,2,Wednesday,Workingday,Clear,0.6,0.5606,0.83,0.0,1,4,5,5,474,5,2,1,3,213,0,715,16352,2,5
2011-09-14,fall,2011,September,3,Wednesday,Workingday,Clear,0.6,0.5455,0.88,0.1343,1,7,8,8,474,8,2,1,3,213,0,697,8174,2,8
2011-09-14,fall,2011,September,4,Wednesday,Workingday,Clear,0.6,0.5606,0.83,0.0896,1,8,9,9,474,9,2,1,3,213,0,697,4428,2,9
2011-09-14,fall,2011,September,5,Wednesday,Workingday,Clear,0.58,0.5455,0.88,0.1045,1,30,31,31,474,31,2,1,3,213,0,717,14261,2,31
2011-09-14,fall,2011,September,6,Wednesday,Workingday,Clear,0.58,0.5455,0.88,0.1045,7,138,145,145,474,145,2,3,3,233,0,725,55132,2,145
2011-09-14,fall,2011,September,7,Wednesday,Workingday,Clear,0.6,0.5606,0.83,0.1045,20,350,370,370,474,370,2,4,3,243,0,727,154171,2,370
2011-09-14,fall,2011,September,8,Wednesday,Workingday,Clear,0.62,0.5758,0.83,0.1642,33,396,429,429,474,429,2,4,3,243,0,727,261001,2,429
2011-09-14,fall,2011,September,9,Wednesday,Workingday,Clear,0.64,0.5909,0.78,0.1642,19,183,202,202,474,202,2,3,3,233,0,727,159438,2,202
2011-09-14,fall,2011,September,10,Wednesday,Workingday,Clear,0.7,0.6515,0.7,0.1343,27,115,142,142,474,142,2,2,4,224,0,727,126257,2,142
2011-09-14,fall,2011,September,11,Wednesday,Workingday,Clear,0.72,0.6818,0.66,0.1642,43,121,164,164,474,164,2,3,4,234,0,727,151320,2,164
2011-09-14,fall,2011,September,12,Wednesday,Workingday,Clear,0.74,0.6818,0.58,0.2239,56,156,212,212,474,212,2,3,4,234,2,728,184414,2,212
2011-09-14,fall,2011,September,13,Wednesday,Workingday,Clear,0.76,0.697,0.55,0.2537,39,139,178,178,474,178,2,3,4,234,2,729,184919,2,178
2011-09-14,fall,2011,September,14,Wednesday,Workingday,Clear,0.78,0.7121,0.52,0.2239,19,105,124,124,474,124,2,2,4,224,2,729,175652,2,124
2011-09-14,fall,2011,September,15,Wednesday,Workingday,Clear,0.78,0.7121,0.49,0.2537,30,146,176,176,474,176,2,3,4,234,2,729,183149,2,176
2011-09-14,fall,2011,September,16,Wednesday,Workingday,Clear,0.76,0.697,0.52,0.2836,36,241,277,277,474,277,2,3,4,234,2,730,227748,2,277
2011-09-14,fall,2011,September,17,Wednesday,Workingday,Clear,0.76,0.697,0.52,0.2836,87,512,599,599,474,599,2,4,4,244,2,730,336860,2,599
2011-09-14,fall,2011,September,18,Wednesday,Workingday,Clear,0.72,0.6818,0.62,0.1642,83,503,586,586,474,586,2,4,4,244,2,728,309772,2,586
2011-09-14,fall,2011,September,19,Wednesday,Workingday,Mist,0.7,0.6515,0.7,0.1045,44,337,381,381,474,381,2,4,4,244,2,728,226789,2,381
2011-09-14,fall,2011,September,20,Wednesday,Workingday,Mist,0.72,0.6667,0.58,0.4179,40,221,261,261,474,261,2,3,4,234,2,728,164550,2,261
2011-09-14,fall,2011,September,21,Wednesday,Workingday,Mist,0.66,0.6212,0.65,0.2239,24,189,213,213,474,213,2,3,3,233,0,728,125445,2,213
2011-09-14,fall,2011,September,22,Wednesday,Workingday,Mist,0.66,0.6212,0.65,0.1343,20,140,160,160,474,160,2,3,3,233,0,728,95612,2,160
2011-09-14,fall,2011,September,23,Wednesday,Workingday,Mist,0.64,0.6061,0.69,0.1045,10,62,72,72,474,72,2,2,3,223,0,728,63941,2,72
2011-09-15,fall,2011,September,0,Thursday,Workingday,Clear,0.64,0.6061,0.69,0.1343,3,34,37,37,473,37,2,1,3,213,0,726,39130,2,37
2011-09-15,fall,2011,September,1,Thursday,Workingday,Clear,0.64,0.6061,0.69,0.1642,0,20,20,20,473,20,2,1,3,213,0,724,24164,2,20
2011-09-15,fall,2011,September,2,Thursday,Workingday,Clear,0.62,0.5909,0.73,0.1045,0,5,5,5,473,5,2,1,3,213,0,715,16352,2,5
2011-09-15,fall,2011,September,3,Thursday,Workingday,Clear,0.62,0.5909,0.73,0.0896,3,5,8,8,473,8,2,1,3,213,0,697,8174,2,8
2011-09-15,fall,2011,September,4,Thursday,Workingday,Clear,0.6,0.5758,0.78,0.1045,2,5,7,7,473,7,2,1,3,213,0,697,4428,2,7
2011-09-15,fall,2011,September,5,Thursday,Workingday,Clear,0.6,0.5758,0.78,0.0,1,30,31,31,473,31,2,1,3,213,0,717,14261,2,31
2011-09-15,fall,2011,September,6,Thursday,Workingday,Mist,0.6,0.5606,0.83,0.2537,5,119,124,124,473,124,2,2,3,223,0,725,55132,2,124
2011-09-15,fall,2011,September,7,Thursday,Workingday,Mist,0.62,0.5909,0.78,0.194,17,321,338,338,473,338,2,4,3,243,0,727,154171,2,338
2011-09-15,fall,2011,September,8,Thursday,Workingday,Clear,0.64,0.6061,0.73,0.1343,27,364,391,391,473,391,2,4,3,243,0,727,261001,2,391
2011-09-15,fall,2011,September,9,Thursday,Workingday,Mist,0.64,0.6061,0.73,0.3582,23,186,209,209,473,209,2,3,3,233,0,727,159438,2,209
2011-09-15,fall,2011,September,10,Thursday,Workingday,Mist,0.66,0.6212,0.69,0.2537,25,96,121,121,473,121,2,2,3,223,0,727,126257,2,121
2011-09-15,fall,2011,September,11,Thursday,Workingday,Mist,0.68,0.6364,0.65,0.1343,39,120,159,159,473,159,2,3,4,234,0,727,151320,2,159
2011-09-15,fall,2011,September,12,Thursday,Workingday,Mist,0.66,0.6212,0.69,0.2985,31,148,179,179,473,179,2,3,3,233,0,728,184414,2,179
2011-09-15,fall,2011,September,13,Thursday,Workingday,Mist,0.64,0.6061,0.65,0.2836,38,151,189,189,473,189,2,3,3,233,0,729,184919,2,189
2011-09-15,fall,2011,September,14,Thursday,Workingday,Mist,0.64,0.6061,0.65,0.4179,36,134,170,170,473,170,2,3,3,233,2,729,175652,2,170
2011-09-15,fall,2011,September,15,Thursday,Workingday,Mist,0.6,0.5909,0.69,0.4179,25,110,135,135,473,135,2,2,3,223,0,729,183149,2,135
2011-09-15,fall,2011,September,16,Thursday,Workingday,Mist,0.54,0.5152,0.77,0.4627,29,193,222,222,473,222,2,3,3,233,0,730,227748,2,222
2011-09-15,fall,2011,September,17,Thursday,Workingday,Light Snow,0.48,0.4697,0.82,0.4627,31,230,261,261,473,261,2,3,2,232,0,730,336860,2,261
2011-09-15,fall,2011,September,18,Thursday,Workingday,Light Snow,0.48,0.4697,0.67,0.6119,22,222,244,244,473,244,2,3,2,232,1,728,309772,2,244
2011-09-15,fall,2011,September,19,Thursday,Workingday,Clear,0.46,0.4545,0.67,0.4627,20,212,232,232,473,232,2,3,2,232,1,728,226789,2,232
2011-09-15,fall,2011,September,20,Thursday,Workingday,Clear,0.46,0.4545,0.63,0.3284,25,223,248,248,473,248,2,3,2,232,1,728,164550,2,248
2011-09-15,fall,2011,September,21,Thursday,Workingday,Clear,0.46,0.4545,0.63,0.3284,11,134,145,145,473,145,2,3,2,232,1,728,125445,2,145
2011-09-15,fall,2011,September,22,Thursday,Workingday,Clear,0.44,0.4394,0.67,0.2836,7,108,115,115,473,115,2,2,2,222,1,728,95612,2,115
2011-09-15,fall,2011,September,23,Thursday,Workingday,Clear,0.44,0.4394,0.67,0.2239,8,61,69,69,473,69,2,2,2,222,1,728,63941,2,69
2011-09-16,fall,2011,September,0,Friday,Workingday,Clear,0.42,0.4242,0.71,0.2239,5,43,48,48,472,48,2,2,2,222,1,726,39130,2,48
2011-09-16,fall,2011,September,1,Friday,Workingday,Clear,0.42,0.4242,0.67,0.194,7,19,26,26,472,26,2,1,2,212,1,724,24164,2,26
2011-09-16,fall,2011,September,2,Friday,Workingday,Clear,0.4,0.4091,0.71,0.2836,3,7,10,10,472,10,2,1,2,212,1,715,16352,2,10
2011-09-16,fall,2011,September,3,Friday,Workingday,Clear,0.4,0.4091,0.71,0.2537,2,4,6,6,472,6,2,1,2,212,1,697,8174,2,6
2011-09-16,fall,2011,September,4,Friday,Workingday,Clear,0.4,0.4091,0.71,0.2836,1,3,4,4,472,4,2,1,2,212,1,697,4428,2,4
2011-09-16,fall,2011,September,5,Friday,Workingday,Clear,0.38,0.3939,0.76,0.194,2,30,32,32,472,32,2,1,2,212,1,717,14261,2,32
2011-09-16,fall,2011,September,6,Friday,Workingday,Clear,0.38,0.3939,0.71,0.2239,6,87,93,93,472,93,2,2,2,222,1,725,55132,2,93
2011-09-16,fall,2011,September,7,Friday,Workingday,Clear,0.4,0.4091,0.71,0.2836,16,283,299,299,472,299,2,4,2,242,1,727,154171,2,299
2011-09-16,fall,2011,September,8,Friday,Workingday,Clear,0.42,0.4242,0.67,0.2239,23,386,409,409,472,409,2,4,2,242,1,727,261001,2,409
2011-09-16,fall,2011,September,9,Friday,Workingday,Clear,0.46,0.4545,0.55,0.2537,21,189,210,210,472,210,2,3,2,232,1,727,159438,2,210
2011-09-16,fall,2011,September,10,Friday,Workingday,Mist,0.5,0.4848,0.51,0.2836,36,104,140,140,472,140,2,2,2,222,1,727,126257,2,140
2011-09-16,fall,2011,September,11,Friday,Workingday,Mist,0.5,0.4848,0.51,0.1343,40,139,179,179,472,179,2,3,2,232,0,727,151320,2,179
2011-09-16,fall,2011,September,12,Friday,Workingday,Mist,0.52,0.5,0.45,0.0,39,212,251,251,472,251,2,3,3,233,0,728,184414,2,251
2011-09-16,fall,2011,September,13,Friday,Workingday,Mist,0.54,0.5152,0.42,0.0,55,168,223,223,472,223,2,3,3,233,0,729,184919,2,223
2011-09-16,fall,2011,September,14,Friday,Workingday,Mist,0.54,0.5152,0.45,0.1642,49,176,225,225,472,225,2,3,3,233,2,729,175652,2,225
2011-09-16,fall,2011,September,15,Friday,Workingday,Mist,0.54,0.5152,0.45,0.2239,38,165,203,203,472,203,2,3,3,233,2,729,183149,2,203
2011-09-16,fall,2011,September,16,Friday,Workingday,Mist,0.52,0.5,0.48,0.1642,67,291,358,358,472,358,2,4,3,243,2,730,227748,2,358
2011-09-16,fall,2011,September,17,Friday,Workingday,Mist,0.52,0.5,0.48,0.1343,86,480,566,566,472,566,2,4,3,243,2,730,336860,2,566
2011-09-16,fall,2011,September,18,Friday,Workingday,Mist,0.52,0.5,0.52,0.1642,55,427,482,482,472,482,2,4,3,243,2,728,309772,2,482
2011-09-16,fall,2011,September,19,Friday,Workingday,Mist,0.5,0.4848,0.55,0.1642,59,256,315,315,472,315,2,4,2,242,2,728,226789,2,315
2011-09-16,fall,2011,September,20,Friday,Workingday,Mist,0.5,0.4848,0.55,0.0,41,184,225,225,472,225,2,3,2,232,0,728,164550,2,225
2011-09-16,fall,2011,September,21,Friday,Workingday,Mist,0.5,0.4848,0.63,0.0,39,124,163,163,472,163,2,3,2,232,0,728,125445,2,163
2011-09-16,fall,2011,September,22,Friday,Workingday,Clear,0.48,0.4697,0.67,0.0896,32,135,167,167,472,167,2,3,2,232,0,728,95612,2,167
2011-09-16,fall,2011,September,23,Friday,Workingday,Clear,0.5,0.4848,0.59,0.0,20,106,126,126,472,126,2,2,2,222,0,728,63941,2,126
2011-09-17,fall,2011,September,0,Saturday,Holiday,Clear,0.46,0.4545,0.72,0.1642,28,80,108,108,471,108,2,2,2,222,0,726,39130,2,108
2011-09-17,fall,2011,September,1,Saturday,Holiday,Clear,0.46,0.4545,0.72,0.1045,28,52,80,80,471,80,2,2,2,222,0,724,24164,2,80
2011-09-17,fall,2011,September,2,Saturday,Holiday,Clear,0.46,0.4545,0.82,0.0896,18,61,79,79,471,79,2,2,2,222,0,715,16352,2,79
2011-09-17,fall,2011,September,3,Saturday,Holiday,Clear,0.46,0.4545,0.72,0.1343,7,21,28,28,471,28,2,1,2,212,0,697,8174,2,28
2011-09-17,fall,2011,September,4,Saturday,Holiday,Clear,0.46,0.4545,0.72,0.1343,1,4,5,5,471,5,2,1,2,212,0,697,4428,2,5
2011-09-17,fall,2011,September,5,Saturday,Holiday,Clear,0.46,0.4545,0.72,0.1642,2,3,5,5,471,5,2,1,2,212,0,717,14261,2,5
2011-09-17,fall,2011,September,6,Saturday,Holiday,Mist,0.46,0.4545,0.72,0.2239,5,17,22,22,471,22,2,1,2,212,0,725,55132,2,22
2011-09-17,fall,2011,September,7,Saturday,Holiday,Mist,0.46,0.4545,0.77,0.194,4,33,37,37,471,37,2,1,2,212,0,727,154171,2,37
2011-09-17,fall,2011,September,8,Saturday,Holiday,Mist,0.46,0.4545,0.77,0.2537,27,81,108,108,471,108,2,2,2,222,0,727,261001,2,108
2011-09-17,fall,2011,September,9,Saturday,Holiday,Mist,0.48,0.4697,0.67,0.2239,32,145,177,177,471,177,2,3,2,232,0,727,159438,2,177
2011-09-17,fall,2011,September,10,Saturday,Holiday,Mist,0.5,0.4848,0.68,0.2836,72,177,249,249,471,249,2,3,2,232,0,727,126257,2,249
2011-09-17,fall,2011,September,11,Saturday,Holiday,Mist,0.52,0.5,0.68,0.2239,119,248,367,367,471,367,2,4,3,243,2,727,151320,2,367
2011-09-17,fall,2011,September,12,Saturday,Holiday,Mist,0.52,0.5,0.67,0.2239,115,257,372,372,471,372,2,4,3,243,2,728,184414,2,372
2011-09-17,fall,2011,September,13,Saturday,Holiday,Mist,0.52,0.5,0.68,0.194,124,225,349,349,471,349,2,4,3,243,2,729,184919,2,349
2011-09-17,fall,2011,September,14,Saturday,Holiday,Mist,0.52,0.5,0.72,0.194,123,174,297,297,471,297,2,4,3,243,2,729,175652,2,297
2011-09-17,fall,2011,September,15,Saturday,Holiday,Mist,0.52,0.5,0.72,0.194,148,206,354,354,471,354,2,4,3,243,2,729,183149,2,354
2011-09-17,fall,2011,September,16,Saturday,Holiday,Clear,0.54,0.5152,0.68,0.2537,116,189,305,305,471,305,2,4,3,243,2,730,227748,2,305
2011-09-17,fall,2011,September,17,Saturday,Holiday,Clear,0.52,0.5,0.72,0.2239,141,218,359,359,471,359,2,4,3,243,2,730,336860,2,359
2011-09-17,fall,2011,September,18,Saturday,Holiday,Mist,0.52,0.5,0.72,0.2239,95,234,329,329,471,329,2,4,3,243,2,728,309772,2,329
2011-09-17,fall,2011,September,19,Saturday,Holiday,Clear,0.52,0.5,0.68,0.1343,70,186,256,256,471,256,2,3,3,233,0,728,226789,2,256
2011-09-17,fall,2011,September,20,Saturday,Holiday,Clear,0.52,0.5,0.68,0.1343,43,133,176,176,471,176,2,3,3,233,0,728,164550,2,176
2011-09-17,fall,2011,September,21,Saturday,Holiday,Mist,0.5,0.4848,0.72,0.194,49,121,170,170,471,170,2,3,2,232,0,728,125445,2,170
2011-09-17,fall,2011,September,22,Saturday,Holiday,Clear,0.5,0.4848,0.72,0.2239,31,112,143,143,471,143,2,3,2,232,0,728,95612,2,143
2011-09-17,fall,2011,September,23,Saturday,Holiday,Clear,0.46,0.4545,0.82,0.1642,36,100,136,136,471,136,2,2,2,222,0,728,63941,2,136
2011-09-18,fall,2011,September,0,Sunday,Holiday,Clear,0.46,0.4545,0.77,0.2239,24,88,112,112,470,112,2,2,2,222,0,726,39130,2,112
2011-09-18,fall,2011,September,1,Sunday,Holiday,Clear,0.46,0.4545,0.77,0.2239,13,66,79,79,470,79,2,2,2,222,0,724,24164,2,79
2011-09-18,fall,2011,September,2,Sunday,Holiday,Clear,0.44,0.4394,0.82,0.2537,21,68,89,89,470,89,2,2,2,222,0,715,16352,2,89
2011-09-18,fall,2011,September,3,Sunday,Holiday,Clear,0.44,0.4394,0.82,0.194,11,25,36,36,470,36,2,1,2,212,0,697,8174,2,36
2011-09-18,fall,2011,September,4,Sunday,Holiday,Clear,0.44,0.4394,0.77,0.2239,1,0,1,1,470,1,2,1,2,212,0,697,4428,2,1
2011-09-18,fall,2011,September,5,Sunday,Holiday,Clear,0.44,0.4394,0.77,0.2239,1,5,6,6,470,6,2,1,2,212,0,717,14261,2,6
2011-09-18,fall,2011,September,6,Sunday,Holiday,Clear,0.44,0.4394,0.77,0.2537,2,10,12,12,470,12,2,1,2,212,0,725,55132,2,12
2011-09-18,fall,2011,September,7,Sunday,Holiday,Clear,0.46,0.4545,0.72,0.2239,15,29,44,44,470,44,2,2,2,222,0,727,154171,2,44
2011-09-18,fall,2011,September,8,Sunday,Holiday,Clear,0.46,0.4545,0.72,0.2537,16,53,69,69,470,69,2,2,2,222,0,727,261001,2,69
2011-09-18,fall,2011,September,9,Sunday,Holiday,Clear,0.48,0.4697,0.67,0.2537,46,94,140,140,470,140,2,2,2,222,0,727,159438,2,140
2011-09-18,fall,2011,September,10,Sunday,Holiday,Clear,0.5,0.4848,0.72,0.1642,82,178,260,260,470,260,2,3,2,232,0,727,126257,2,260
2011-09-18,fall,2011,September,11,Sunday,Holiday,Clear,0.52,0.5,0.68,0.2239,116,201,317,317,470,317,2,4,3,243,2,727,151320,2,317
2011-09-18,fall,2011,September,12,Sunday,Holiday,Clear,0.54,0.5152,0.64,0.1343,135,229,364,364,470,364,2,4,3,243,2,728,184414,2,364
2011-09-18,fall,2011,September,13,Sunday,Holiday,Clear,0.56,0.5303,0.6,0.1343,162,214,376,376,470,376,2,4,3,243,2,729,184919,2,376
2011-09-18,fall,2011,September,14,Sunday,Holiday,Mist,0.58,0.5455,0.56,0.1343,127,184,311,311,470,311,2,4,3,243,2,729,175652,2,311
2011-09-18,fall,2011,September,15,Sunday,Holiday,Mist,0.58,0.5455,0.6,0.1343,132,233,365,365,470,365,2,4,3,243,2,729,183149,2,365
2011-09-18,fall,2011,September,16,Sunday,Holiday,Mist,0.56,0.5303,0.64,0.1642,134,235,369,369,470,369,2,4,3,243,2,730,227748,2,369
2011-09-18,fall,2011,September,17,Sunday,Holiday,Mist,0.56,0.5303,0.64,0.194,95,230,325,325,470,325,2,4,3,243,2,730,336860,2,325
2011-09-18,fall,2011,September,18,Sunday,Holiday,Mist,0.56,0.5303,0.6,0.1045,66,223,289,289,470,289,2,4,3,243,2,728,309772,2,289
2011-09-18,fall,2011,September,19,Sunday,Holiday,Mist,0.54,0.5152,0.68,0.1045,54,191,245,245,470,245,2,3,3,233,0,728,226789,2,245
2011-09-18,fall,2011,September,20,Sunday,Holiday,Mist,0.54,0.5152,0.68,0.0896,44,136,180,180,470,180,2,3,3,233,0,728,164550,2,180
2011-09-18,fall,2011,September,21,Sunday,Holiday,Mist,0.54,0.5152,0.68,0.0896,37,110,147,147,470,147,2,3,3,233,0,728,125445,2,147
2011-09-18,fall,2011,September,22,Sunday,Holiday,Mist,0.54,0.5152,0.68,0.0896,9,75,84,84,470,84,2,2,3,223,0,728,95612,2,84
2011-09-18,fall,2011,September,23,Sunday,Holiday,Clear,0.54,0.5152,0.68,0.194,10,44,54,54,470,54,2,2,3,223,0,728,63941,2,54
2011-09-19,fall,2011,September,0,Monday,Workingday,Mist,0.52,0.5,0.72,0.1642,14,23,37,37,469,37,2,1,3,213,0,726,39130,2,37
2011-09-19,fall,2011,September,1,Monday,Workingday,Mist,0.52,0.5,0.72,0.1045,3,7,10,10,469,10,2,1,3,213,0,724,24164,2,10
2011-09-19,fall,2011,September,2,Monday,Workingday,Mist,0.52,0.5,0.72,0.1343,6,7,13,13,469,13,2,1,3,213,0,715,16352,2,13
2011-09-19,fall,2011,September,3,Monday,Workingday,Mist,0.5,0.4848,0.77,0.1343,1,4,5,5,469,5,2,1,2,212,0,697,8174,2,5
2011-09-19,fall,2011,September,4,Monday,Workingday,Mist,0.5,0.4848,0.77,0.1642,2,6,8,8,469,8,2,1,2,212,0,697,4428,2,8
2011-09-19,fall,2011,September,5,Monday,Workingday,Mist,0.5,0.4848,0.77,0.194,2,26,28,28,469,28,2,1,2,212,0,717,14261,2,28
2011-09-19,fall,2011,September,6,Monday,Workingday,Clear,0.5,0.4848,0.77,0.2239,6,107,113,113,469,113,2,2,2,222,0,725,55132,2,113
2011-09-19,fall,2011,September,7,Monday,Workingday,Mist,0.5,0.4848,0.82,0.2239,20,312,332,332,469,332,2,4,2,242,0,727,154171,2,332
2011-09-19,fall,2011,September,8,Monday,Workingday,Mist,0.52,0.5,0.77,0.1343,29,391,420,420,469,420,2,4,3,243,0,727,261001,2,420
2011-09-19,fall,2011,September,9,Monday,Workingday,Mist,0.54,0.5152,0.68,0.1642,32,183,215,215,469,215,2,3,3,233,0,727,159438,2,215
2011-09-19,fall,2011,September,10,Monday,Workingday,Mist,0.56,0.5303,0.64,0.1343,21,84,105,105,469,105,2,2,3,223,0,727,126257,2,105
2011-09-19,fall,2011,September,11,Monday,Workingday,Mist,0.58,0.5455,0.64,0.1642,41,98,139,139,469,139,2,2,3,223,0,727,151320,2,139
2011-09-19,fall,2011,September,12,Monday,Workingday,Mist,0.58,0.5455,0.6,0.0896,51,138,189,189,469,189,2,3,3,233,0,728,184414,2,189
2011-09-19,fall,2011,September,13,Monday,Workingday,Mist,0.6,0.6061,0.6,0.0,53,124,177,177,469,177,2,3,3,233,0,729,184919,2,177
2011-09-19,fall,2011,September,14,Monday,Workingday,Mist,0.6,0.6061,0.6,0.194,45,143,188,188,469,188,2,3,3,233,0,729,175652,2,188
2011-09-19,fall,2011,September,15,Monday,Workingday,Mist,0.6,0.6061,0.6,0.2239,44,143,187,187,469,187,2,3,3,233,0,729,183149,2,187
2011-09-19,fall,2011,September,16,Monday,Workingday,Mist,0.6,0.6061,0.6,0.1642,55,208,263,263,469,263,2,3,3,233,2,730,227748,2,263
2011-09-19,fall,2011,September,17,Monday,Workingday,Mist,0.58,0.5455,0.64,0.1343,85,483,568,568,469,568,2,4,3,243,2,730,336860,2,568
2011-09-19,fall,2011,September,18,Monday,Workingday,Mist,0.56,0.5303,0.68,0.1343,56,484,540,540,469,540,2,4,3,243,2,728,309772,2,540
2011-09-19,fall,2011,September,19,Monday,Workingday,Mist,0.56,0.5303,0.68,0.1045,41,333,374,374,469,374,2,4,3,243,0,728,226789,2,374
2011-09-19,fall,2011,September,20,Monday,Workingday,Mist,0.56,0.5303,0.68,0.1343,27,204,231,231,469,231,2,3,3,233,0,728,164550,2,231
2011-09-19,fall,2011,September,21,Monday,Workingday,Mist,0.56,0.5303,0.68,0.1642,19,181,200,200,469,200,2,3,3,233,0,728,125445,2,200
2011-09-19,fall,2011,September,22,Monday,Workingday,Mist,0.56,0.5303,0.68,0.1642,25,104,129,129,469,129,2,2,3,223,0,728,95612,2,129
2011-09-19,fall,2011,September,23,Monday,Workingday,Mist,0.56,0.5303,0.73,0.194,13,55,68,68,469,68,2,2,3,223,0,728,63941,2,68
2011-09-20,fall,2011,September,0,Tuesday,Workingday,Mist,0.56,0.5303,0.73,0.1642,4,21,25,25,468,25,2,1,3,213,0,726,39130,2,25
2011-09-20,fall,2011,September,1,Tuesday,Workingday,Mist,0.54,0.5152,0.88,0.1642,3,11,14,14,468,14,2,1,3,213,0,724,24164,2,14
2011-09-20,fall,2011,September,2,Tuesday,Workingday,Mist,0.54,0.5152,0.88,0.1642,1,4,5,5,468,5,2,1,3,213,0,715,16352,2,5
2011-09-20,fall,2011,September,3,Tuesday,Workingday,Mist,0.54,0.5152,0.83,0.2239,0,3,3,3,468,3,2,1,3,213,0,697,8174,2,3
2011-09-20,fall,2011,September,4,Tuesday,Workingday,Clear,0.54,0.5152,0.88,0.194,2,4,6,6,468,6,2,1,3,213,0,697,4428,2,6
2011-09-20,fall,2011,September,5,Tuesday,Workingday,Mist,0.54,0.5152,0.88,0.194,1,21,22,22,468,22,2,1,3,213,0,717,14261,2,22
2011-09-20,fall,2011,September,6,Tuesday,Workingday,Mist,0.54,0.5152,0.88,0.194,3,111,114,114,468,114,2,2,3,223,0,725,55132,2,114
2011-09-20,fall,2011,September,7,Tuesday,Workingday,Mist,0.54,0.5152,0.88,0.1642,23,306,329,329,468,329,2,4,3,243,0,727,154171,2,329
2011-09-20,fall,2011,September,8,Tuesday,Workingday,Light Snow,0.54,0.5152,0.94,0.2537,13,196,209,209,468,209,2,3,3,233,0,727,261001,2,209
2011-09-20,fall,2011,September,9,Tuesday,Workingday,Light Snow,0.54,0.5152,0.94,0.2239,5,64,69,69,468,69,2,2,3,223,0,727,159438,2,69
2011-09-20,fall,2011,September,10,Tuesday,Workingday,Light Snow,0.56,0.5303,0.88,0.1642,4,26,30,30,468,30,2,1,3,213,0,727,126257,2,30
2011-09-20,fall,2011,September,11,Tuesday,Workingday,Light Snow,0.56,0.5303,0.88,0.1642,8,48,56,56,468,56,2,2,3,223,0,727,151320,2,56
2011-09-20,fall,2011,September,12,Tuesday,Workingday,Mist,0.56,0.5303,0.94,0.1642,13,47,60,60,468,60,2,2,3,223,0,728,184414,2,60
2011-09-20,fall,2011,September,13,Tuesday,Workingday,Mist,0.56,0.5303,0.94,0.1343,22,81,103,103,468,103,2,2,3,223,0,729,184919,2,103
2011-09-20,fall,2011,September,14,Tuesday,Workingday,Mist,0.58,0.5455,0.88,0.194,27,85,112,112,468,112,2,2,3,223,0,729,175652,2,112
2011-09-20,fall,2011,September,15,Tuesday,Workingday,Mist,0.62,0.5909,0.78,0.1045,34,158,192,192,468,192,2,3,3,233,0,729,183149,2,192
2011-09-20,fall,2011,September,16,Tuesday,Workingday,Mist,0.6,0.5606,0.83,0.1642,23,241,264,264,468,264,2,3,3,233,0,730,227748,2,264
2011-09-20,fall,2011,September,17,Tuesday,Workingday,Clear,0.6,0.5606,0.83,0.1045,66,445,511,511,468,511,2,4,3,243,2,730,336860,2,511
2011-09-20,fall,2011,September,18,Tuesday,Workingday,Clear,0.6,0.5606,0.83,0.1045,39,453,492,492,468,492,2,4,3,243,0,728,309772,2,492
2011-09-20,fall,2011,September,19,Tuesday,Workingday,Clear,0.58,0.5455,0.88,0.0,43,294,337,337,468,337,2,4,3,243,0,728,226789,2,337
2011-09-20,fall,2011,September,20,Tuesday,Workingday,Clear,0.56,0.5303,0.94,0.0,41,212,253,253,468,253,2,3,3,233,0,728,164550,2,253
2011-09-20,fall,2011,September,21,Tuesday,Workingday,Clear,0.56,0.5303,0.94,0.0,29,177,206,206,468,206,2,3,3,233,0,728,125445,2,206
2011-09-20,fall,2011,September,22,Tuesday,Workingday,Clear,0.56,0.5303,0.94,0.0,23,125,148,148,468,148,2,3,3,233,0,728,95612,2,148
2011-09-20,fall,2011,September,23,Tuesday,Workingday,Clear,0.56,0.5303,0.94,0.0,11,70,81,81,468,81,2,2,3,223,0,728,63941,2,81
2011-09-21,fall,2011,September,0,Wednesday,Workingday,Clear,0.54,0.5152,1.0,0.0,7,20,27,27,467,27,2,1,3,213,0,726,39130,2,27
2011-09-21,fall,2011,September,1,Wednesday,Workingday,Clear,0.54,0.5152,0.94,0.0,0,17,17,17,467,17,2,1,3,213,0,724,24164,2,17
2011-09-21,fall,2011,September,2,Wednesday,Workingday,Clear,0.54,0.5152,0.94,0.0,1,5,6,6,467,6,2,1,3,213,0,715,16352,2,6
2011-09-21,fall,2011,September,3,Wednesday,Workingday,Mist,0.54,0.5152,0.94,0.0896,0,6,6,6,467,6,2,1,3,213,0,697,8174,2,6
2011-09-21,fall,2011,September,4,Wednesday,Workingday,Mist,0.54,0.5152,1.0,0.1343,2,5,7,7,467,7,2,1,3,213,0,697,4428,2,7
2011-09-21,fall,2011,September,5,Wednesday,Workingday,Mist,0.54,0.5152,1.0,0.1642,1,30,31,31,467,31,2,1,3,213,0,717,14261,2,31
2011-09-21,fall,2011,September,6,Wednesday,Workingday,Mist,0.54,0.5152,1.0,0.194,5,112,117,117,467,117,2,2,3,223,0,725,55132,2,117
2011-09-21,fall,2011,September,7,Wednesday,Workingday,Mist,0.54,0.5152,1.0,0.194,18,312,330,330,467,330,2,4,3,243,0,727,154171,2,330
2011-09-21,fall,2011,September,8,Wednesday,Workingday,Mist,0.54,0.5152,1.0,0.1045,18,444,462,462,467,462,2,4,3,243,0,727,261001,2,462
2011-09-21,fall,2011,September,9,Wednesday,Workingday,Mist,0.56,0.5303,1.0,0.0896,21,187,208,208,467,208,2,3,3,233,0,727,159438,2,208
2011-09-21,fall,2011,September,10,Wednesday,Workingday,Mist,0.6,0.5455,0.88,0.0,30,103,133,133,467,133,2,2,3,223,0,727,126257,2,133
2011-09-21,fall,2011,September,11,Wednesday,Workingday,Mist,0.62,0.5758,0.83,0.1642,42,138,180,180,467,180,2,3,3,233,0,727,151320,2,180
2011-09-21,fall,2011,September,12,Wednesday,Workingday,Mist,0.64,0.5909,0.78,0.0896,42,151,193,193,467,193,2,3,3,233,0,728,184414,2,193
2011-09-21,fall,2011,September,13,Wednesday,Workingday,Mist,0.66,0.6212,0.74,0.1642,37,144,181,181,467,181,2,3,3,233,0,729,184919,2,181
2011-09-21,fall,2011,September,14,Wednesday,Workingday,Mist,0.66,0.6212,0.74,0.194,40,139,179,179,467,179,2,3,3,233,0,729,175652,2,179
2011-09-21,fall,2011,September,15,Wednesday,Workingday,Mist,0.66,0.6212,0.74,0.1045,43,142,185,185,467,185,2,3,3,233,0,729,183149,2,185
2011-09-21,fall,2011,September,16,Wednesday,Workingday,Mist,0.66,0.6212,0.74,0.1045,51,230,281,281,467,281,2,3,3,233,0,730,227748,2,281
2011-09-21,fall,2011,September,17,Wednesday,Workingday,Light Snow,0.66,0.6212,0.74,0.1642,61,475,536,536,467,536,2,4,3,243,2,730,336860,2,536
2011-09-21,fall,2011,September,18,Wednesday,Workingday,Light Snow,0.64,0.5758,0.83,0.1642,24,384,408,408,467,408,2,4,3,243,0,728,309772,2,408
2011-09-21,fall,2011,September,19,Wednesday,Workingday,Light Snow,0.62,0.5455,0.94,0.0,30,253,283,283,467,283,2,4,3,243,0,728,226789,2,283
2011-09-21,fall,2011,September,20,Wednesday,Workingday,Light Snow,0.62,0.5455,0.94,0.0,11,149,160,160,467,160,2,3,3,233,0,728,164550,2,160
2011-09-21,fall,2011,September,21,Wednesday,Workingday,Mist,0.6,0.5,1.0,0.0896,25,175,200,200,467,200,2,3,3,233,0,728,125445,2,200
2011-09-21,fall,2011,September,22,Wednesday,Workingday,Mist,0.62,0.5455,0.94,0.0,15,112,127,127,467,127,2,2,3,223,0,728,95612,2,127
2011-09-21,fall,2011,September,23,Wednesday,Workingday,Clear,0.6,0.5152,0.94,0.1045,15,80,95,95,467,95,2,2,3,223,0,728,63941,2,95
2011-09-22,fall,2011,September,0,Thursday,Workingday,Clear,0.6,0.5152,0.94,0.1045,11,30,41,41,466,41,2,2,3,223,0,726,39130,2,41
2011-09-22,fall,2011,September,1,Thursday,Workingday,Mist,0.6,0.5152,0.94,0.0896,5,6,11,11,466,11,2,1,3,213,0,724,24164,2,11
2011-09-22,fall,2011,September,2,Thursday,Workingday,Mist,0.6,0.5152,0.94,0.1045,2,8,10,10,466,10,2,1,3,213,0,715,16352,2,10
2011-09-22,fall,2011,September,3,Thursday,Workingday,Mist,0.6,0.5152,0.94,0.0896,5,7,12,12,466,12,2,1,3,213,0,697,8174,2,12
2011-09-22,fall,2011,September,4,Thursday,Workingday,Mist,0.6,0.5152,0.94,0.0896,0,2,2,2,466,2,2,1,3,213,0,697,4428,2,2
2011-09-22,fall,2011,September,5,Thursday,Workingday,Mist,0.6,0.5152,0.94,0.1045,2,28,30,30,466,30,2,1,3,213,0,717,14261,2,30
2011-09-22,fall,2011,September,6,Thursday,Workingday,Mist,0.6,0.5,1.0,0.1343,7,94,101,101,466,101,2,2,3,223,0,725,55132,2,101
2011-09-22,fall,2011,September,7,Thursday,Workingday,Mist,0.6,0.5,1.0,0.1045,16,295,311,311,466,311,2,4,3,243,0,727,154171,2,311
2011-09-22,fall,2011,September,8,Thursday,Workingday,Mist,0.6,0.5,1.0,0.1642,26,389,415,415,466,415,2,4,3,243,0,727,261001,2,415
2011-09-22,fall,2011,September,9,Thursday,Workingday,Mist,0.62,0.5455,0.94,0.194,35,168,203,203,466,203,2,3,3,233,0,727,159438,2,203
2011-09-22,fall,2011,September,10,Thursday,Workingday,Mist,0.64,0.5758,0.89,0.2239,19,101,120,120,466,120,2,2,3,223,0,727,126257,2,120
2011-09-22,fall,2011,September,11,Thursday,Workingday,Mist,0.64,0.5758,0.89,0.194,23,142,165,165,466,165,2,3,3,233,0,727,151320,2,165
2011-09-22,fall,2011,September,12,Thursday,Workingday,Mist,0.66,0.6061,0.83,0.1642,25,151,176,176,466,176,2,3,3,233,0,728,184414,2,176
2011-09-22,fall,2011,September,13,Thursday,Workingday,Mist,0.66,0.6061,0.83,0.194,38,155,193,193,466,193,2,3,3,233,0,729,184919,2,193
2011-09-22,fall,2011,September,14,Thursday,Workingday,Mist,0.66,0.6061,0.83,0.2239,41,142,183,183,466,183,2,3,3,233,0,729,175652,2,183
2011-09-22,fall,2011,September,15,Thursday,Workingday,Mist,0.68,0.6364,0.79,0.1642,32,149,181,181,466,181,2,3,4,234,0,729,183149,2,181
2011-09-22,fall,2011,September,16,Thursday,Workingday,Mist,0.68,0.6364,0.74,0.1343,39,262,301,301,466,301,2,4,4,244,0,730,227748,2,301
2011-09-22,fall,2011,September,17,Thursday,Workingday,Mist,0.66,0.6061,0.78,0.0896,50,513,563,563,466,563,2,4,3,243,2,730,336860,2,563
2011-09-22,fall,2011,September,18,Thursday,Workingday,Mist,0.64,0.5758,0.83,0.1045,50,501,551,551,466,551,2,4,3,243,2,728,309772,2,551
2011-09-22,fall,2011,September,19,Thursday,Workingday,Mist,0.64,0.5758,0.89,0.0896,32,388,420,420,466,420,2,4,3,243,0,728,226789,2,420
2011-09-22,fall,2011,September,20,Thursday,Workingday,Mist,0.62,0.5455,0.94,0.1343,35,250,285,285,466,285,2,4,3,243,0,728,164550,2,285
2011-09-22,fall,2011,September,21,Thursday,Workingday,Mist,0.64,0.5758,0.89,0.0896,27,194,221,221,466,221,2,3,3,233,0,728,125445,2,221
2011-09-22,fall,2011,September,22,Thursday,Workingday,Mist,0.62,0.5152,1.0,0.0896,21,166,187,187,466,187,2,3,3,233,0,728,95612,2,187
2011-09-22,fall,2011,September,23,Thursday,Workingday,Mist,0.62,0.5455,0.94,0.0,14,99,113,113,466,113,2,2,3,223,0,728,63941,2,113
2011-09-23,winter,2011,September,0,Friday,Workingday,Mist,0.62,0.5455,0.94,0.0896,11,41,52,52,465,52,2,2,3,223,0,726,39130,2,52
2011-09-23,winter,2011,September,1,Friday,Workingday,Mist,0.6,0.5,1.0,0.0,2,29,31,31,465,31,2,1,3,213,0,724,24164,2,31
2011-09-23,winter,2011,September,2,Friday,Workingday,Mist,0.6,0.5,1.0,0.1045,6,14,20,20,465,20,2,1,3,213,0,715,16352,2,20
2011-09-23,winter,2011,September,3,Friday,Workingday,Mist,0.6,0.5,1.0,0.0,3,5,8,8,465,8,2,1,3,213,0,697,8174,2,8
2011-09-23,winter,2011,September,4,Friday,Workingday,Light Snow,0.6,0.5,1.0,0.0,6,7,13,13,465,13,2,1,3,213,0,697,4428,2,13
2011-09-23,winter,2011,September,5,Friday,Workingday,Mist,0.62,0.5455,0.94,0.0,2,20,22,22,465,22,2,1,3,213,0,717,14261,2,22
2011-09-23,winter,2011,September,6,Friday,Workingday,Mist,0.62,0.5455,0.94,0.0896,5,99,104,104,465,104,2,2,3,223,0,725,55132,2,104
2011-09-23,winter,2011,September,7,Friday,Workingday,Light Snow,0.62,0.5455,0.94,0.1343,14,240,254,254,465,254,2,3,3,233,0,727,154171,2,254
2011-09-23,winter,2011,September,8,Friday,Workingday,Light Snow,0.62,0.5455,0.94,0.1343,20,297,317,317,465,317,2,4,3,243,0,727,261001,2,317
2011-09-23,winter,2011,September,9,Friday,Workingday,Light Snow,0.62,0.5152,1.0,0.1343,3,108,111,111,465,111,2,2,3,223,0,727,159438,2,111
2011-09-23,winter,2011,September,10,Friday,Workingday,Light Snow,0.62,0.5152,1.0,0.1045,7,28,35,35,465,35,2,1,3,213,0,727,126257,2,35
2011-09-23,winter,2011,September,11,Friday,Workingday,Light Snow,0.62,0.5152,1.0,0.1045,1,20,21,21,465,21,2,1,3,213,0,727,151320,2,21
2011-09-23,winter,2011,September,12,Friday,Workingday,Light Snow,0.62,0.5455,0.94,0.1045,1,28,29,29,465,29,2,1,3,213,0,728,184414,2,29
2011-09-23,winter,2011,September,13,Friday,Workingday,Light Snow,0.6,0.5,1.0,0.0896,7,27,34,34,465,34,2,1,3,213,0,729,184919,2,34
2011-09-23,winter,2011,September,14,Friday,Workingday,Light Snow,0.6,0.5,1.0,0.0896,3,21,24,24,465,24,2,1,3,213,0,729,175652,2,24
2011-09-23,winter,2011,September,15,Friday,Workingday,Light Snow,0.62,0.5455,0.94,0.1045,9,52,61,61,465,61,2,2,3,223,0,729,183149,2,61
2011-09-23,winter,2011,September,16,Friday,Workingday,Light Snow,0.62,0.5455,0.94,0.0,5,51,56,56,465,56,2,2,3,223,0,730,227748,2,56
2011-09-23,winter,2011,September,17,Friday,Workingday,Mist,0.6,0.5,1.0,0.0,13,86,99,99,465,99,2,2,3,223,0,730,336860,2,99
2011-09-23,winter,2011,September,18,Friday,Workingday,Clear,0.6,0.5,1.0,0.0,14,220,234,234,465,234,2,3,3,233,0,728,309772,2,234
2011-09-23,winter,2011,September,19,Friday,Workingday,Clear,0.62,0.5455,0.94,0.1343,16,232,248,248,465,248,2,3,3,233,0,728,226789,2,248
2011-09-23,winter,2011,September,20,Friday,Workingday,Clear,0.6,0.5152,0.94,0.0,21,158,179,179,465,179,2,3,3,233,0,728,164550,2,179
2011-09-23,winter,2011,September,21,Friday,Workingday,Clear,0.6,0.5,1.0,0.1642,17,121,138,138,465,138,2,2,3,223,0,728,125445,2,138
2011-09-23,winter,2011,September,22,Friday,Workingday,Clear,0.6,0.5152,0.94,0.1642,31,126,157,157,465,157,2,3,3,233,0,728,95612,2,157
2011-09-23,winter,2011,September,23,Friday,Workingday,Mist,0.58,0.5455,1.0,0.1343,41,107,148,148,465,148,2,3,3,233,0,728,63941,2,148
2011-09-24,winter,2011,September,0,Saturday,Holiday,Clear,0.58,0.5455,1.0,0.0896,7,86,93,93,464,93,2,2,3,223,0,726,39130,2,93
2011-09-24,winter,2011,September,1,Saturday,Holiday,Mist,0.58,0.5455,0.94,0.0896,18,61,79,79,464,79,2,2,3,223,0,724,24164,2,79
2011-09-24,winter,2011,September,2,Saturday,Holiday,Mist,0.58,0.5455,0.94,0.0896,14,54,68,68,464,68,2,2,3,223,0,715,16352,2,68
2011-09-24,winter,2011,September,3,Saturday,Holiday,Clear,0.58,0.5455,0.94,0.0,4,27,31,31,464,31,2,1,3,213,0,697,8174,2,31
2011-09-24,winter,2011,September,4,Saturday,Holiday,Clear,0.56,0.5303,0.94,0.1045,1,7,8,8,464,8,2,1,3,213,0,697,4428,2,8
2011-09-24,winter,2011,September,5,Saturday,Holiday,Mist,0.56,0.5303,0.94,0.1045,2,3,5,5,464,5,2,1,3,213,0,717,14261,2,5
2011-09-24,winter,2011,September,6,Saturday,Holiday,Mist,0.56,0.5303,0.94,0.1045,6,12,18,18,464,18,2,1,3,213,0,725,55132,2,18
2011-09-24,winter,2011,September,7,Saturday,Holiday,Mist,0.56,0.5303,0.88,0.1045,12,34,46,46,464,46,2,2,3,223,0,727,154171,2,46
2011-09-24,winter,2011,September,8,Saturday,Holiday,Mist,0.58,0.5455,0.9,0.0896,19,102,121,121,464,121,2,2,3,223,0,727,261001,2,121
2011-09-24,winter,2011,September,9,Saturday,Holiday,Mist,0.6,0.5455,0.88,0.0896,41,134,175,175,464,175,2,3,3,233,0,727,159438,2,175
2011-09-24,winter,2011,September,10,Saturday,Holiday,Mist,0.6,0.5455,0.88,0.0896,90,203,293,293,464,293,2,4,3,243,0,727,126257,2,293
2011-09-24,winter,2011,September,11,Saturday,Holiday,Mist,0.62,0.5758,0.83,0.0896,118,268,386,386,464,386,2,4,3,243,2,727,151320,2,386
2011-09-24,winter,2011,September,12,Saturday,Holiday,Mist,0.62,0.5758,0.83,0.0896,141,266,407,407,464,407,2,4,3,243,2,728,184414,2,407
2011-09-24,winter,2011,September,13,Saturday,Holiday,Clear,0.64,0.5909,0.78,0.0,170,290,460,460,464,460,2,4,3,243,2,729,184919,2,460
2011-09-24,winter,2011,September,14,Saturday,Holiday,Mist,0.66,0.6212,0.74,0.1343,164,226,390,390,464,390,2,4,3,243,2,729,175652,2,390
2011-09-24,winter,2011,September,15,Saturday,Holiday,Mist,0.66,0.6212,0.74,0.1343,168,284,452,452,464,452,2,4,3,243,2,729,183149,2,452
2011-09-24,winter,2011,September,16,Saturday,Holiday,Mist,0.64,0.5909,0.78,0.0896,167,282,449,449,464,449,2,4,3,243,2,730,227748,2,449
2011-09-24,winter,2011,September,17,Saturday,Holiday,Clear,0.66,0.6212,0.74,0.1045,180,246,426,426,464,426,2,4,3,243,2,730,336860,2,426
2011-09-24,winter,2011,September,18,Saturday,Holiday,Clear,0.64,0.5909,0.78,0.1045,157,243,400,400,464,400,2,4,3,243,2,728,309772,2,400
2011-09-24,winter,2011,September,19,Saturday,Holiday,Clear,0.62,0.5606,0.88,0.0,77,231,308,308,464,308,2,4,3,243,0,728,226789,2,308
2011-09-24,winter,2011,September,20,Saturday,Holiday,Clear,0.62,0.5758,0.83,0.0,77,166,243,243,464,243,2,3,3,233,0,728,164550,2,243
2011-09-24,winter,2011,September,21,Saturday,Holiday,Clear,0.62,0.5758,0.83,0.0896,66,156,222,222,464,222,2,3,3,233,0,728,125445,2,222
2011-09-24,winter,2011,September,22,Saturday,Holiday,Mist,0.62,0.5606,0.88,0.0,50,143,193,193,464,193,2,3,3,233,0,728,95612,2,193
2011-09-24,winter,2011,September,23,Saturday,Holiday,Mist,0.6,0.5455,0.88,0.0896,27,123,150,150,464,150,2,3,3,233,0,728,63941,2,150
2011-09-25,winter,2011,September,0,Sunday,Holiday,Mist,0.6,0.5455,0.88,0.0,37,136,173,173,463,173,2,3,3,233,0,726,39130,2,173
2011-09-25,winter,2011,September,1,Sunday,Holiday,Mist,0.6,0.5455,0.88,0.1045,31,93,124,124,463,124,2,2,3,223,0,724,24164,2,124
2011-09-25,winter,2011,September,2,Sunday,Holiday,Light Snow,0.6,0.5152,0.94,0.0,27,79,106,106,463,106,2,2,3,223,0,715,16352,2,106
2011-09-25,winter,2011,September,3,Sunday,Holiday,Light Snow,0.6,0.5152,0.94,0.0,20,39,59,59,463,59,2,2,3,223,0,697,8174,2,59
2011-09-25,winter,2011,September,4,Sunday,Holiday,Light Snow,0.6,0.5152,0.94,0.1343,3,5,8,8,463,8,2,1,3,213,0,697,4428,2,8
2011-09-25,winter,2011,September,5,Sunday,Holiday,Clear,0.6,0.5455,0.88,0.0896,1,2,3,3,463,3,2,1,3,213,0,717,14261,2,3
2011-09-25,winter,2011,September,6,Sunday,Holiday,Mist,0.6,0.5455,0.88,0.1045,4,13,17,17,463,17,2,1,3,213,0,725,55132,2,17
2011-09-25,winter,2011,September,7,Sunday,Holiday,Mist,0.6,0.5152,0.94,0.1343,15,23,38,38,463,38,2,1,3,213,0,727,154171,2,38
2011-09-25,winter,2011,September,8,Sunday,Holiday,Mist,0.62,0.5606,0.88,0.0,27,59,86,86,463,86,2,2,3,223,0,727,261001,2,86
2011-09-25,winter,2011,September,9,Sunday,Holiday,Mist,0.64,0.5758,0.83,0.0,55,100,155,155,463,155,2,3,3,233,0,727,159438,2,155
2011-09-25,winter,2011,September,10,Sunday,Holiday,Mist,0.64,0.5758,0.83,0.0,85,190,275,275,463,275,2,3,3,233,0,727,126257,2,275
2011-09-25,winter,2011,September,11,Sunday,Holiday,Mist,0.66,0.6061,0.78,0.1343,131,230,361,361,463,361,2,4,3,243,2,727,151320,2,361
2011-09-25,winter,2011,September,12,Sunday,Holiday,Mist,0.66,0.6061,0.78,0.0,143,270,413,413,463,413,2,4,3,243,2,728,184414,2,413
2011-09-25,winter,2011,September,13,Sunday,Holiday,Mist,0.68,0.6364,0.74,0.0,122,247,369,369,463,369,2,4,4,244,2,729,184919,2,369
2011-09-25,winter,2011,September,14,Sunday,Holiday,Mist,0.66,0.6061,0.78,0.0,116,231,347,347,463,347,2,4,3,243,2,729,175652,2,347
2011-09-25,winter,2011,September,15,Sunday,Holiday,Mist,0.66,0.6061,0.78,0.0,119,234,353,353,463,353,2,4,3,243,2,729,183149,2,353
2011-09-25,winter,2011,September,16,Sunday,Holiday,Clear,0.7,0.6515,0.7,0.0,144,320,464,464,463,464,2,4,4,244,2,730,227748,2,464
2011-09-25,winter,2011,September,17,Sunday,Holiday,Clear,0.68,0.6364,0.74,0.0,145,275,420,420,463,420,2,4,4,244,2,730,336860,2,420
2011-09-25,winter,2011,September,18,Sunday,Holiday,Clear,0.68,0.6364,0.74,0.0,125,279,404,404,463,404,2,4,4,244,2,728,309772,2,404
2011-09-25,winter,2011,September,19,Sunday,Holiday,Clear,0.64,0.5758,0.83,0.1343,87,242,329,329,463,329,2,4,3,243,0,728,226789,2,329
2011-09-25,winter,2011,September,20,Sunday,Holiday,Clear,0.64,0.5758,0.83,0.0896,51,135,186,186,463,186,2,3,3,233,0,728,164550,2,186
2011-09-25,winter,2011,September,21,Sunday,Holiday,Clear,0.62,0.5455,0.94,0.0896,24,113,137,137,463,137,2,2,3,223,0,728,125445,2,137
2011-09-25,winter,2011,September,22,Sunday,Holiday,Clear,0.62,0.5606,0.88,0.0896,20,84,104,104,463,104,2,2,3,223,0,728,95612,2,104
2011-09-25,winter,2011,September,23,Sunday,Holiday,Mist,0.62,0.5455,0.94,0.1045,12,67,79,79,463,79,2,2,3,223,0,728,63941,2,79
2011-09-26,winter,2011,September,0,Monday,Workingday,Mist,0.62,0.5455,0.94,0.0,6,23,29,29,462,29,2,1,3,213,0,726,39130,2,29
2011-09-26,winter,2011,September,1,Monday,Workingday,Mist,0.62,0.5606,0.88,0.1045,3,14,17,17,462,17,2,1,3,213,0,724,24164,2,17
2011-09-26,winter,2011,September,2,Monday,Workingday,Mist,0.62,0.5606,0.88,0.1045,4,4,8,8,462,8,2,1,3,213,0,715,16352,2,8
2011-09-26,winter,2011,September,3,Monday,Workingday,Mist,0.62,0.5455,0.94,0.0,0,5,5,5,462,5,2,1,3,213,0,697,8174,2,5
2011-09-26,winter,2011,September,4,Monday,Workingday,Mist,0.62,0.5455,0.94,0.0896,2,4,6,6,462,6,2,1,3,213,0,697,4428,2,6
2011-09-26,winter,2011,September,5,Monday,Workingday,Mist,0.62,0.5606,0.88,0.0,0,25,25,25,462,25,2,1,3,213,0,717,14261,2,25
2011-09-26,winter,2011,September,6,Monday,Workingday,Mist,0.62,0.5455,0.94,0.0896,6,107,113,113,462,113,2,2,3,223,0,725,55132,2,113
2011-09-26,winter,2011,September,7,Monday,Workingday,Mist,0.62,0.5455,0.94,0.0,17,315,332,332,462,332,2,4,3,243,0,727,154171,2,332
2011-09-26,winter,2011,September,8,Monday,Workingday,Mist,0.62,0.5455,0.94,0.0,29,326,355,355,462,355,2,4,3,243,0,727,261001,2,355
2011-09-26,winter,2011,September,9,Monday,Workingday,Mist,0.64,0.5758,0.89,0.194,44,161,205,205,462,205,2,3,3,233,0,727,159438,2,205
2011-09-26,winter,2011,September,10,Monday,Workingday,Mist,0.64,0.5758,0.89,0.194,37,117,154,154,462,154,2,3,3,233,0,727,126257,2,154
2011-09-26,winter,2011,September,11,Monday,Workingday,Clear,0.68,0.6364,0.79,0.2239,43,116,159,159,462,159,2,3,4,234,0,727,151320,2,159
2011-09-26,winter,2011,September,12,Monday,Workingday,Mist,0.68,0.6364,0.79,0.1642,48,161,209,209,462,209,2,3,4,234,0,728,184414,2,209
2011-09-26,winter,2011,September,13,Monday,Workingday,Mist,0.7,0.6667,0.74,0.1642,48,139,187,187,462,187,2,3,4,234,0,729,184919,2,187
2011-09-26,winter,2011,September,14,Monday,Workingday,Clear,0.7,0.6515,0.7,0.1642,44,110,154,154,462,154,2,3,4,234,0,729,175652,2,154
2011-09-26,winter,2011,September,15,Monday,Workingday,Clear,0.72,0.6818,0.62,0.1343,52,157,209,209,462,209,2,3,4,234,2,729,183149,2,209
2011-09-26,winter,2011,September,16,Monday,Workingday,Clear,0.7,0.6515,0.65,0.1642,74,239,313,313,462,313,2,4,4,244,2,730,227748,2,313
2011-09-26,winter,2011,September,17,Monday,Workingday,Clear,0.7,0.6515,0.7,0.1343,61,509,570,570,462,570,2,4,4,244,2,730,336860,2,570
2011-09-26,winter,2011,September,18,Monday,Workingday,Clear,0.66,0.6061,0.83,0.1045,63,490,553,553,462,553,2,4,3,243,2,728,309772,2,553
2011-09-26,winter,2011,September,19,Monday,Workingday,Clear,0.66,0.6061,0.82,0.0896,36,347,383,383,462,383,2,4,3,243,0,728,226789,2,383
2011-09-26,winter,2011,September,20,Monday,Workingday,Clear,0.64,0.5758,0.89,0.1343,24,227,251,251,462,251,2,3,3,233,0,728,164550,2,251
2011-09-26,winter,2011,September,21,Monday,Workingday,Clear,0.64,0.5758,0.89,0.1343,18,164,182,182,462,182,2,3,3,233,0,728,125445,2,182
2011-09-26,winter,2011,September,22,Monday,Workingday,Clear,0.62,0.5455,0.94,0.1343,14,122,136,136,462,136,2,2,3,223,0,728,95612,2,136
2011-09-26,winter,2011,September,23,Monday,Workingday,Clear,0.62,0.5455,0.94,0.1343,11,64,75,75,462,75,2,2,3,223,0,728,63941,2,75
2011-09-27,winter,2011,September,0,Tuesday,Workingday,Clear,0.62,0.5455,0.94,0.1343,9,28,37,37,461,37,2,1,3,213,0,726,39130,2,37
2011-09-27,winter,2011,September,1,Tuesday,Workingday,Clear,0.62,0.5455,0.94,0.1642,4,6,10,10,461,10,2,1,3,213,0,724,24164,2,10
2011-09-27,winter,2011,September,2,Tuesday,Workingday,Clear,0.62,0.5455,0.94,0.1045,7,4,11,11,461,11,2,1,3,213,0,715,16352,2,11
2011-09-27,winter,2011,September,3,Tuesday,Workingday,Mist,0.62,0.5455,0.94,0.0,5,5,10,10,461,10,2,1,3,213,0,697,8174,2,10
2011-09-27,winter,2011,September,4,Tuesday,Workingday,Light Snow,0.62,0.5455,0.94,0.0896,5,3,8,8,461,8,2,1,3,213,0,697,4428,2,8
2011-09-27,winter,2011,September,5,Tuesday,Workingday,Light Snow,0.62,0.5455,0.94,0.0896,0,24,24,24,461,24,2,1,3,213,0,717,14261,2,24
2011-09-27,winter,2011,September,6,Tuesday,Workingday,Mist,0.62,0.5455,0.94,0.1045,8,116,124,124,461,124,2,2,3,223,0,725,55132,2,124
2011-09-27,winter,2011,September,7,Tuesday,Workingday,Mist,0.62,0.5455,0.94,0.1045,15,234,249,249,461,249,2,3,3,233,0,727,154171,2,249
2011-09-27,winter,2011,September,8,Tuesday,Workingday,Mist,0.64,0.5758,0.89,0.1045,27,400,427,427,461,427,2,4,3,243,0,727,261001,2,427
2011-09-27,winter,2011,September,9,Tuesday,Workingday,Light Snow,0.64,0.5758,0.89,0.194,20,173,193,193,461,193,2,3,3,233,0,727,159438,2,193
2011-09-27,winter,2011,September,10,Tuesday,Workingday,Light Snow,0.64,0.5606,0.94,0.1642,21,101,122,122,461,122,2,2,3,223,0,727,126257,2,122
2011-09-27,winter,2011,September,11,Tuesday,Workingday,Mist,0.66,0.5909,0.89,0.1045,26,97,123,123,461,123,2,2,3,223,0,727,151320,2,123
2011-09-27,winter,2011,September,12,Tuesday,Workingday,Mist,0.66,0.5909,0.89,0.1343,33,129,162,162,461,162,2,3,3,233,0,728,184414,2,162
2011-09-27,winter,2011,September,13,Tuesday,Workingday,Mist,0.7,0.6667,0.74,0.2239,29,122,151,151,461,151,2,3,4,234,0,729,184919,2,151
2011-09-27,winter,2011,September,14,Tuesday,Workingday,Mist,0.68,0.6364,0.79,0.1045,29,123,152,152,461,152,2,3,4,234,0,729,175652,2,152
2011-09-27,winter,2011,September,15,Tuesday,Workingday,Mist,0.68,0.6364,0.83,0.0896,35,170,205,205,461,205,2,3,4,234,0,729,183149,2,205
2011-09-27,winter,2011,September,16,Tuesday,Workingday,Mist,0.66,0.6061,0.83,0.194,33,225,258,258,461,258,2,3,3,233,0,730,227748,2,258
2011-09-27,winter,2011,September,17,Tuesday,Workingday,Mist,0.66,0.5909,0.89,0.194,50,480,530,530,461,530,2,4,3,243,2,730,336860,2,530
2011-09-27,winter,2011,September,18,Tuesday,Workingday,Mist,0.64,0.5758,0.89,0.2239,31,325,356,356,461,356,2,4,3,243,0,728,309772,2,356
2011-09-27,winter,2011,September,19,Tuesday,Workingday,Mist,0.64,0.5758,0.89,0.1343,26,294,320,320,461,320,2,4,3,243,0,728,226789,2,320
2011-09-27,winter,2011,September,20,Tuesday,Workingday,Clear,0.62,0.5909,0.78,0.0,17,221,238,238,461,238,2,3,3,233,0,728,164550,2,238
2011-09-27,winter,2011,September,21,Tuesday,Workingday,Clear,0.6,0.5606,0.83,0.0,17,179,196,196,461,196,2,3,3,233,0,728,125445,2,196
2011-09-27,winter,2011,September,22,Tuesday,Workingday,Clear,0.6,0.5455,0.88,0.0896,19,102,121,121,461,121,2,2,3,223,0,728,95612,2,121
2011-09-27,winter,2011,September,23,Tuesday,Workingday,Clear,0.6,0.5455,0.88,0.0896,11,82,93,93,461,93,2,2,3,223,0,728,63941,2,93
2011-09-28,winter,2011,September,0,Wednesday,Workingday,Clear,0.6,0.5455,0.88,0.0,7,29,36,36,460,36,2,1,3,213,0,726,39130,2,36
2011-09-28,winter,2011,September,1,Wednesday,Workingday,Clear,0.6,0.5455,0.88,0.0,1,13,14,14,460,14,2,1,3,213,0,724,24164,2,14
2011-09-28,winter,2011,September,2,Wednesday,Workingday,Clear,0.6,0.5455,0.88,0.2537,0,9,9,9,460,9,2,1,3,213,0,715,16352,2,9
2011-09-28,winter,2011,September,3,Wednesday,Workingday,Mist,0.6,0.5152,0.94,0.0896,0,3,3,3,460,3,2,1,3,213,0,697,8174,2,3
2011-09-28,winter,2011,September,4,Wednesday,Workingday,Clear,0.6,0.5455,0.88,0.0,1,3,4,4,460,4,2,1,3,213,0,697,4428,2,4
2011-09-28,winter,2011,September,5,Wednesday,Workingday,Mist,0.6,0.5152,0.94,0.0,2,20,22,22,460,22,2,1,3,213,0,717,14261,2,22
2011-09-28,winter,2011,September,6,Wednesday,Workingday,Light Snow,0.6,0.5152,0.94,0.1642,3,111,114,114,460,114,2,2,3,223,0,725,55132,2,114
2011-09-28,winter,2011,September,7,Wednesday,Workingday,Light Snow,0.6,0.5152,0.94,0.1642,8,177,185,185,460,185,2,3,3,233,0,727,154171,2,185
2011-09-28,winter,2011,September,8,Wednesday,Workingday,Light Snow,0.62,0.5455,0.94,0.2239,17,270,287,287,460,287,2,4,3,243,0,727,261001,2,287
2011-09-28,winter,2011,September,9,Wednesday,Workingday,Light Snow,0.62,0.5455,0.94,0.2239,14,141,155,155,460,155,2,3,3,233,0,727,159438,2,155
2011-09-28,winter,2011,September,10,Wednesday,Workingday,Mist,0.62,0.5455,0.94,0.0,20,109,129,129,460,129,2,2,3,223,0,727,126257,2,129
2011-09-28,winter,2011,September,11,Wednesday,Workingday,Mist,0.66,0.6061,0.83,0.1045,24,127,151,151,460,151,2,3,3,233,0,727,151320,2,151
2011-09-28,winter,2011,September,12,Wednesday,Workingday,Mist,0.68,0.6364,0.79,0.0,25,159,184,184,460,184,2,3,4,234,0,728,184414,2,184
2011-09-28,winter,2011,September,13,Wednesday,Workingday,Clear,0.7,0.6667,0.74,0.2537,24,138,162,162,460,162,2,3,4,234,0,729,184919,2,162
2011-09-28,winter,2011,September,14,Wednesday,Workingday,Clear,0.72,0.6818,0.62,0.2537,25,145,170,170,460,170,2,3,4,234,0,729,175652,2,170
2011-09-28,winter,2011,September,15,Wednesday,Workingday,Clear,0.7,0.6515,0.7,0.1343,35,146,181,181,460,181,2,3,4,234,0,729,183149,2,181
2011-09-28,winter,2011,September,16,Wednesday,Workingday,Clear,0.7,0.6515,0.7,0.194,39,241,280,280,460,280,2,3,4,234,0,730,227748,2,280
2011-09-28,winter,2011,September,17,Wednesday,Workingday,Clear,0.7,0.6515,0.7,0.2239,64,527,591,591,460,591,2,4,4,244,2,730,336860,2,591
2011-09-28,winter,2011,September,18,Wednesday,Workingday,Light Snow,0.66,0.6061,0.83,0.2537,65,459,524,524,460,524,2,4,3,243,2,728,309772,2,524
2011-09-28,winter,2011,September,19,Wednesday,Workingday,Light Snow,0.66,0.6061,0.83,0.2537,57,315,372,372,460,372,2,4,3,243,2,728,226789,2,372
2011-09-28,winter,2011,September,20,Wednesday,Workingday,Light Snow,0.6,0.5606,0.83,0.2985,11,91,102,102,460,102,2,2,3,223,0,728,164550,2,102
2011-09-28,winter,2011,September,21,Wednesday,Workingday,Light Snow,0.6,0.5455,0.88,0.2537,7,67,74,74,460,74,2,2,3,223,0,728,125445,2,74
2011-09-28,winter,2011,September,22,Wednesday,Workingday,Clear,0.6,0.5455,0.88,0.0896,19,68,87,87,460,87,2,2,3,223,0,728,95612,2,87
2011-09-28,winter,2011,September,23,Wednesday,Workingday,Clear,0.6,0.5152,0.94,0.1343,12,59,71,71,460,71,2,2,3,223,0,728,63941,2,71
2011-09-29,winter,2011,September,0,Thursday,Workingday,Clear,0.6,0.5152,0.94,0.194,7,33,40,40,459,40,2,1,3,213,0,726,39130,2,40
2011-09-29,winter,2011,September,1,Thursday,Workingday,Mist,0.6,0.5,1.0,0.194,3,20,23,23,459,23,2,1,3,213,0,724,24164,2,23
2011-09-29,winter,2011,September,2,Thursday,Workingday,Mist,0.6,0.5,1.0,0.194,0,2,2,2,459,2,2,1,3,213,0,715,16352,2,2
2011-09-29,winter,2011,September,3,Thursday,Workingday,Mist,0.6,0.5152,0.94,0.194,0,8,8,8,459,8,2,1,3,213,0,697,8174,2,8
2011-09-29,winter,2011,September,4,Thursday,Workingday,Mist,0.6,0.5455,0.88,0.194,2,5,7,7,459,7,2,1,3,213,0,697,4428,2,7
2011-09-29,winter,2011,September,5,Thursday,Workingday,Mist,0.6,0.5455,0.88,0.1045,0,22,22,22,459,22,2,1,3,213,0,717,14261,2,22
2011-09-29,winter,2011,September,6,Thursday,Workingday,Mist,0.6,0.5455,0.88,0.0896,5,106,111,111,459,111,2,2,3,223,0,725,55132,2,111
2011-09-29,winter,2011,September,7,Thursday,Workingday,Clear,0.6,0.5455,0.88,0.1343,14,269,283,283,459,283,2,4,3,243,0,727,154171,2,283
2011-09-29,winter,2011,September,8,Thursday,Workingday,Clear,0.6,0.5606,0.83,0.0,29,402,431,431,459,431,2,4,3,243,0,727,261001,2,431
2011-09-29,winter,2011,September,9,Thursday,Workingday,Clear,0.62,0.5909,0.78,0.2537,27,198,225,225,459,225,2,3,3,233,0,727,159438,2,225
2011-09-29,winter,2011,September,10,Thursday,Workingday,Clear,0.64,0.6061,0.65,0.194,24,103,127,127,459,127,2,2,3,223,0,727,126257,2,127
2011-09-29,winter,2011,September,11,Thursday,Workingday,Clear,0.62,0.6061,0.61,0.194,36,122,158,158,459,158,2,3,3,233,0,727,151320,2,158
2011-09-29,winter,2011,September,12,Thursday,Workingday,Clear,0.66,0.6212,0.61,0.1642,38,157,195,195,459,195,2,3,3,233,0,728,184414,2,195
2011-09-29,winter,2011,September,13,Thursday,Workingday,Clear,0.64,0.6212,0.61,0.194,36,175,211,211,459,211,2,3,3,233,0,729,184919,2,211
2011-09-29,winter,2011,September,14,Thursday,Workingday,Clear,0.68,0.6364,0.51,0.2985,33,134,167,167,459,167,2,3,4,234,2,729,175652,2,167
2011-09-29,winter,2011,September,15,Thursday,Workingday,Clear,0.68,0.6364,0.45,0.3881,42,185,227,227,459,227,2,3,4,234,2,729,183149,2,227
2011-09-29,winter,2011,September,16,Thursday,Workingday,Clear,0.68,0.6364,0.41,0.3582,64,227,291,291,459,291,2,4,4,244,2,730,227748,2,291
2011-09-29,winter,2011,September,17,Thursday,Workingday,Clear,0.66,0.6212,0.47,0.2985,62,527,589,589,459,589,2,4,3,243,2,730,336860,2,589
2011-09-29,winter,2011,September,18,Thursday,Workingday,Clear,0.64,0.6212,0.41,0.2239,84,500,584,584,459,584,2,4,3,243,2,728,309772,2,584
2011-09-29,winter,2011,September,19,Thursday,Workingday,Clear,0.62,0.6212,0.5,0.0896,36,348,384,384,459,384,2,4,3,243,2,728,226789,2,384
2011-09-29,winter,2011,September,20,Thursday,Workingday,Clear,0.6,0.6212,0.53,0.0896,39,234,273,273,459,273,2,3,3,233,2,728,164550,2,273
2011-09-29,winter,2011,September,21,Thursday,Workingday,Clear,0.58,0.5455,0.56,0.0,30,195,225,225,459,225,2,3,3,233,0,728,125445,2,225
2011-09-29,winter,2011,September,22,Thursday,Workingday,Clear,0.56,0.5303,0.68,0.0,25,150,175,175,459,175,2,3,3,233,0,728,95612,2,175
2011-09-29,winter,2011,September,23,Thursday,Workingday,Clear,0.52,0.5,0.77,0.1045,17,64,81,81,459,81,2,2,3,223,0,728,63941,2,81
2011-09-30,winter,2011,September,0,Friday,Workingday,Clear,0.52,0.5,0.83,0.1045,7,53,60,60,458,60,2,2,3,223,0,726,39130,2,60
2011-09-30,winter,2011,September,1,Friday,Workingday,Clear,0.52,0.5,0.77,0.0896,5,18,23,23,458,23,2,1,3,213,0,724,24164,2,23
2011-09-30,winter,2011,September,2,Friday,Workingday,Clear,0.52,0.5,0.83,0.1045,6,9,15,15,458,15,2,1,3,213,0,715,16352,2,15
2011-09-30,winter,2011,September,3,Friday,Workingday,Clear,0.52,0.5,0.83,0.1045,0,3,3,3,458,3,2,1,3,213,0,697,8174,2,3
2011-09-30,winter,2011,September,4,Friday,Workingday,Clear,0.52,0.5,0.83,0.194,2,6,8,8,458,8,2,1,3,213,0,697,4428,2,8
2011-09-30,winter,2011,September,5,Friday,Workingday,Clear,0.52,0.5,0.83,0.194,3,23,26,26,458,26,2,1,3,213,0,717,14261,2,26
2011-09-30,winter,2011,September,6,Friday,Workingday,Clear,0.52,0.5,0.83,0.2239,0,98,98,98,458,98,2,2,3,223,0,725,55132,2,98
2011-09-30,winter,2011,September,7,Friday,Workingday,Clear,0.52,0.5,0.83,0.2239,14,283,297,297,458,297,2,4,3,243,0,727,154171,2,297
2011-09-30,winter,2011,September,8,Friday,Workingday,Clear,0.54,0.5152,0.77,0.1343,31,425,456,456,458,456,2,4,3,243,0,727,261001,2,456
2011-09-30,winter,2011,September,9,Friday,Workingday,Clear,0.56,0.5303,0.73,0.194,23,214,237,237,458,237,2,3,3,233,0,727,159438,2,237
2011-09-30,winter,2011,September,10,Friday,Workingday,Clear,0.6,0.6061,0.64,0.0,46,122,168,168,458,168,2,3,3,233,0,727,126257,2,168
2011-09-30,winter,2011,September,11,Friday,Workingday,Clear,0.64,0.6212,0.57,0.0896,49,168,217,217,458,217,2,3,3,233,0,727,151320,2,217
2011-09-30,winter,2011,September,12,Friday,Workingday,Mist,0.64,0.6212,0.57,0.194,59,195,254,254,458,254,2,3,3,233,2,728,184414,2,254
2011-09-30,winter,2011,September,13,Friday,Workingday,Mist,0.66,0.6212,0.47,0.3284,72,194,266,266,458,266,2,3,3,233,2,729,184919,2,266
2011-09-30,winter,2011,September,14,Friday,Workingday,Mist,0.64,0.6212,0.47,0.2985,93,173,266,266,458,266,2,3,3,233,2,729,175652,2,266
2011-09-30,winter,2011,September,15,Friday,Workingday,Clear,0.64,0.6212,0.5,0.2836,52,193,245,245,458,245,2,3,3,233,2,729,183149,2,245
2011-09-30,winter,2011,September,16,Friday,Workingday,Clear,0.62,0.6212,0.53,0.2239,62,298,360,360,458,360,2,4,3,243,2,730,227748,2,360
2011-09-30,winter,2011,September,17,Friday,Workingday,Clear,0.62,0.6212,0.53,0.194,94,497,591,591,458,591,2,4,3,243,2,730,336860,2,591
2011-09-30,winter,2011,September,18,Friday,Workingday,Clear,0.58,0.5455,0.49,0.3582,62,449,511,511,458,511,2,4,3,243,2,728,309772,2,511
2011-09-30,winter,2011,September,19,Friday,Workingday,Clear,0.54,0.5152,0.52,0.2836,42,332,374,374,458,374,2,4,3,243,2,728,226789,2,374
2011-09-30,winter,2011,September,20,Friday,Workingday,Clear,0.54,0.5152,0.52,0.2836,28,202,230,230,458,230,2,3,3,233,2,728,164550,2,230
2011-09-30,winter,2011,September,21,Friday,Workingday,Clear,0.52,0.5,0.55,0.194,27,179,206,206,458,206,2,3,3,233,0,728,125445,2,206
2011-09-30,winter,2011,September,22,Friday,Workingday,Clear,0.52,0.5,0.55,0.3284,30,129,159,159,458,159,2,3,3,233,1,728,95612,2,159
2011-09-30,winter,2011,September,23,Friday,Workingday,Clear,0.52,0.5,0.55,0.3284,23,109,132,132,458,132,2,2,3,223,1,728,63941,2,132
2011-10-01,winter,2011,October,0,Saturday,Holiday,Clear,0.5,0.4848,0.63,0.3881,24,106,130,130,457,130,2,2,2,222,1,726,39130,2,130
2011-10-01,winter,2011,October,1,Saturday,Holiday,Clear,0.48,0.4697,0.67,0.3284,11,47,58,58,457,58,2,2,2,222,1,724,24164,2,58
2011-10-01,winter,2011,October,2,Saturday,Holiday,Clear,0.46,0.4545,0.63,0.4179,21,46,67,67,457,67,2,2,2,222,1,715,16352,2,67
2011-10-01,winter,2011,October,3,Saturday,Holiday,Clear,0.46,0.4545,0.59,0.4179,8,17,25,25,457,25,2,1,2,212,1,697,8174,2,25
2011-10-01,winter,2011,October,4,Saturday,Holiday,Clear,0.44,0.4394,0.58,0.4179,2,6,8,8,457,8,2,1,2,212,1,697,4428,2,8
2011-10-01,winter,2011,October,5,Saturday,Holiday,Mist,0.44,0.4394,0.62,0.2985,1,4,5,5,457,5,2,1,2,212,1,717,14261,2,5
2011-10-01,winter,2011,October,6,Saturday,Holiday,Clear,0.42,0.4242,0.67,0.3284,4,15,19,19,457,19,2,1,2,212,1,725,55132,2,19
2011-10-01,winter,2011,October,7,Saturday,Holiday,Light Snow,0.42,0.4242,0.67,0.2537,6,30,36,36,457,36,2,1,2,212,1,727,154171,2,36
2011-10-01,winter,2011,October,8,Saturday,Holiday,Mist,0.4,0.4091,0.76,0.3284,9,58,67,67,457,67,2,2,2,222,1,727,261001,2,67
2011-10-01,winter,2011,October,9,Saturday,Holiday,Light Snow,0.4,0.4091,0.82,0.3582,17,112,129,129,457,129,2,2,2,222,1,727,159438,2,129
2011-10-01,winter,2011,October,10,Saturday,Holiday,Light Snow,0.4,0.4091,0.76,0.3582,21,100,121,121,457,121,2,2,2,222,1,727,126257,2,121
2011-10-01,winter,2011,October,11,Saturday,Holiday,Light Snow,0.38,0.3939,0.82,0.3284,30,102,132,132,457,132,2,2,2,222,1,727,151320,2,132
2011-10-01,winter,2011,October,12,Saturday,Holiday,Mist,0.4,0.4091,0.82,0.2537,28,130,158,158,457,158,2,3,2,232,0,728,184414,2,158
2011-10-01,winter,2011,October,13,Saturday,Holiday,Mist,0.4,0.4091,0.82,0.3284,27,98,125,125,457,125,2,2,2,222,1,729,184919,2,125
2011-10-01,winter,2011,October,14,Saturday,Holiday,Mist,0.42,0.4242,0.71,0.3582,33,147,180,180,457,180,2,3,2,232,1,729,175652,2,180
2011-10-01,winter,2011,October,15,Saturday,Holiday,Mist,0.42,0.4242,0.71,0.2836,41,154,195,195,457,195,2,3,2,232,1,729,183149,2,195
2011-10-01,winter,2011,October,16,Saturday,Holiday,Mist,0.4,0.4091,0.76,0.2985,58,165,223,223,457,223,2,3,2,232,1,730,227748,2,223
2011-10-01,winter,2011,October,17,Saturday,Holiday,Light Snow,0.4,0.4091,0.76,0.194,58,170,228,228,457,228,2,3,2,232,0,730,336860,2,228
2011-10-01,winter,2011,October,18,Saturday,Holiday,Light Snow,0.38,0.3939,0.87,0.2239,23,117,140,140,457,140,2,2,2,222,0,728,309772,2,140
2011-10-01,winter,2011,October,19,Saturday,Holiday,Mist,0.38,0.3939,0.82,0.194,27,99,126,126,457,126,2,2,2,222,0,728,226789,2,126
2011-10-01,winter,2011,October,20,Saturday,Holiday,Light Snow,0.36,0.3636,0.87,0.1045,8,58,66,66,457,66,2,2,2,222,0,728,164550,2,66
2011-10-01,winter,2011,October,21,Saturday,Holiday,Light Snow,0.36,0.3636,0.87,0.1045,3,53,56,56,457,56,2,2,2,222,0,728,125445,2,56
2011-10-01,winter,2011,October,22,Saturday,Holiday,Mist,0.36,0.3485,0.93,0.2239,12,58,70,70,457,70,2,2,2,222,0,728,95612,2,70
2011-10-01,winter,2011,October,23,Saturday,Holiday,Light Snow,0.36,0.3485,0.93,0.2239,8,57,65,65,457,65,2,2,2,222,0,728,63941,2,65
2011-10-02,winter,2011,October,0,Sunday,Holiday,Light Snow,0.36,0.3333,0.93,0.2985,4,43,47,47,456,47,2,2,1,221,1,726,39130,2,47
2011-10-02,winter,2011,October,1,Sunday,Holiday,Light Snow,0.34,0.3182,0.87,0.2537,1,23,24,24,456,24,2,1,1,211,1,724,24164,2,24
2011-10-02,winter,2011,October,2,Sunday,Holiday,Light Snow,0.34,0.303,0.87,0.2985,3,27,30,30,456,30,2,1,1,211,1,715,16352,2,30
2011-10-02,winter,2011,October,3,Sunday,Holiday,Light Snow,0.34,0.3182,0.87,0.2836,4,5,9,9,456,9,2,1,1,211,1,697,8174,2,9
2011-10-02,winter,2011,October,4,Sunday,Holiday,Mist,0.34,0.3182,0.87,0.2537,4,3,7,7,456,7,2,1,1,211,1,697,4428,2,7
2011-10-02,winter,2011,October,5,Sunday,Holiday,Clear,0.32,0.303,0.87,0.2836,0,7,7,7,456,7,2,1,1,211,1,717,14261,2,7
2011-10-02,winter,2011,October,6,Sunday,Holiday,Clear,0.32,0.3182,0.81,0.1642,2,13,15,15,456,15,2,1,1,211,1,725,55132,2,15
2011-10-02,winter,2011,October,7,Sunday,Holiday,Clear,0.34,0.3333,0.76,0.194,5,24,29,29,456,29,2,1,1,211,1,727,154171,2,29
2011-10-02,winter,2011,October,8,Sunday,Holiday,Mist,0.34,0.3333,0.76,0.194,14,50,64,64,456,64,2,2,1,221,1,727,261001,2,64
2011-10-02,winter,2011,October,9,Sunday,Holiday,Clear,0.36,0.3333,0.76,0.3582,19,96,115,115,456,115,2,2,1,221,1,727,159438,2,115
2011-10-02,winter,2011,October,10,Sunday,Holiday,Mist,0.36,0.3333,0.71,0.2836,60,188,248,248,456,248,2,3,1,231,1,727,126257,2,248
2011-10-02,winter,2011,October,11,Sunday,Holiday,Mist,0.38,0.3939,0.66,0.2537,74,218,292,292,456,292,2,4,2,242,1,727,151320,2,292
2011-10-02,winter,2011,October,12,Sunday,Holiday,Mist,0.4,0.4091,0.62,0.194,78,243,321,321,456,321,2,4,2,242,1,728,184414,2,321
2011-10-02,winter,2011,October,13,Sunday,Holiday,Light Snow,0.4,0.4091,0.62,0.2239,84,224,308,308,456,308,2,4,2,242,1,729,184919,2,308
2011-10-02,winter,2011,October,14,Sunday,Holiday,Light Snow,0.36,0.3485,0.81,0.1642,61,195,256,256,456,256,2,3,2,232,1,729,175652,2,256
2011-10-02,winter,2011,October,15,Sunday,Holiday,Light Snow,0.36,0.3333,0.81,0.2537,29,144,173,173,456,173,2,3,1,231,1,729,183149,2,173
2011-10-02,winter,2011,October,16,Sunday,Holiday,Light Snow,0.36,0.3485,0.87,0.194,44,162,206,206,456,206,2,3,2,232,1,730,227748,2,206
2011-10-02,winter,2011,October,17,Sunday,Holiday,Light Snow,0.36,0.3485,0.87,0.1642,32,135,167,167,456,167,2,3,2,232,0,730,336860,2,167
2011-10-02,winter,2011,October,18,Sunday,Holiday,Mist,0.36,0.3485,0.81,0.194,16,158,174,174,456,174,2,3,2,232,1,728,309772,2,174
2011-10-02,winter,2011,October,19,Sunday,Holiday,Mist,0.38,0.3939,0.76,0.1642,34,128,162,162,456,162,2,3,2,232,1,728,226789,2,162
2011-10-02,winter,2011,October,20,Sunday,Holiday,Mist,0.36,0.3333,0.76,0.2537,16,71,87,87,456,87,2,2,1,221,1,728,164550,2,87
2011-10-02,winter,2011,October,21,Sunday,Holiday,Clear,0.36,0.3485,0.71,0.2239,17,71,88,88,456,88,2,2,2,222,1,728,125445,2,88
2011-10-02,winter,2011,October,22,Sunday,Holiday,Light Snow,0.36,0.3636,0.81,0.0896,9,55,64,64,456,64,2,2,2,222,0,728,95612,2,64
2011-10-02,winter,2011,October,23,Sunday,Holiday,Clear,0.36,0.3636,0.81,0.0896,6,19,25,25,456,25,2,1,2,212,0,728,63941,2,25
2011-10-03,winter,2011,October,0,Monday,Workingday,Clear,0.34,0.3485,0.87,0.1045,3,13,16,16,455,16,2,1,2,212,0,726,39130,2,16
2011-10-03,winter,2011,October,1,Monday,Workingday,Clear,0.36,0.3636,0.81,0.0896,1,5,6,6,455,6,2,1,2,212,0,724,24164,2,6
2011-10-03,winter,2011,October,2,Monday,Workingday,Clear,0.36,0.3636,0.76,0.1045,0,4,4,4,455,4,2,1,2,212,1,715,16352,2,4
2011-10-03,winter,2011,October,3,Monday,Workingday,Clear,0.36,0.3788,0.81,0.0,1,6,7,7,455,7,2,1,2,212,0,697,8174,2,7
2011-10-03,winter,2011,October,4,Monday,Workingday,Clear,0.34,0.3485,0.87,0.1045,2,6,8,8,455,8,2,1,2,212,0,697,4428,2,8
2011-10-03,winter,2011,October,5,Monday,Workingday,Mist,0.36,0.3636,0.76,0.1045,4,17,21,21,455,21,2,1,2,212,1,717,14261,2,21
2011-10-03,winter,2011,October,6,Monday,Workingday,Mist,0.36,0.3788,0.71,0.0,3,91,94,94,455,94,2,2,2,222,0,725,55132,2,94
2011-10-03,winter,2011,October,7,Monday,Workingday,Mist,0.36,0.3485,0.71,0.1343,8,241,249,249,455,249,2,3,2,232,1,727,154171,2,249
2011-10-03,winter,2011,October,8,Monday,Workingday,Mist,0.36,0.3636,0.71,0.1045,13,359,372,372,455,372,2,4,2,242,1,727,261001,2,372
2011-10-03,winter,2011,October,9,Monday,Workingday,Mist,0.4,0.4091,0.66,0.0896,12,141,153,153,455,153,2,3,2,232,0,727,159438,2,153
2011-10-03,winter,2011,October,10,Monday,Workingday,Mist,0.4,0.4091,0.66,0.1045,19,82,101,101,455,101,2,2,2,222,1,727,126257,2,101
2011-10-03,winter,2011,October,11,Monday,Workingday,Mist,0.4,0.4091,0.71,0.2239,26,100,126,126,455,126,2,2,2,222,1,727,151320,2,126
2011-10-03,winter,2011,October,12,Monday,Workingday,Mist,0.4,0.4091,0.71,0.1343,29,118,147,147,455,147,2,3,2,232,0,728,184414,2,147
2011-10-03,winter,2011,October,13,Monday,Workingday,Light Snow,0.42,0.4242,0.67,0.1642,16,102,118,118,455,118,2,2,2,222,0,729,184919,2,118
2011-10-03,winter,2011,October,14,Monday,Workingday,Light Snow,0.4,0.4091,0.76,0.0,26,94,120,120,455,120,2,2,2,222,0,729,175652,2,120
2011-10-03,winter,2011,October,15,Monday,Workingday,Light Snow,0.4,0.4091,0.76,0.0,22,79,101,101,455,101,2,2,2,222,0,729,183149,2,101
2011-10-03,winter,2011,October,16,Monday,Workingday,Mist,0.4,0.4091,0.76,0.1045,16,202,218,218,455,218,2,3,2,232,0,730,227748,2,218
2011-10-03,winter,2011,October,17,Monday,Workingday,Mist,0.4,0.4091,0.76,0.1642,40,455,495,495,455,495,2,4,2,242,0,730,336860,2,495
2011-10-03,winter,2011,October,18,Monday,Workingday,Mist,0.4,0.4091,0.76,0.1642,28,384,412,412,455,412,2,4,2,242,0,728,309772,2,412
2011-10-03,winter,2011,October,19,Monday,Workingday,Clear,0.4,0.4091,0.76,0.0,15,300,315,315,455,315,2,4,2,242,0,728,226789,2,315
2011-10-03,winter,2011,October,20,Monday,Workingday,Light Snow,0.4,0.4091,0.82,0.0,13,191,204,204,455,204,2,3,2,232,0,728,164550,2,204
2011-10-03,winter,2011,October,21,Monday,Workingday,Mist,0.4,0.4091,0.82,0.0,10,128,138,138,455,138,2,2,2,222,0,728,125445,2,138
2011-10-03,winter,2011,October,22,Monday,Workingday,Mist,0.4,0.4091,0.82,0.0,12,79,91,91,455,91,2,2,2,222,0,728,95612,2,91
2011-10-03,winter,2011,October,23,Monday,Workingday,Mist,0.4,0.4091,0.82,0.1045,11,43,54,54,455,54,2,2,2,222,0,728,63941,2,54
2011-10-04,winter,2011,October,0,Tuesday,Workingday,Mist,0.4,0.4091,0.87,0.0896,5,22,27,27,454,27,2,1,2,212,0,726,39130,2,27
2011-10-04,winter,2011,October,1,Tuesday,Workingday,Mist,0.4,0.4091,0.87,0.1045,1,8,9,9,454,9,2,1,2,212,0,724,24164,2,9
2011-10-04,winter,2011,October,2,Tuesday,Workingday,Mist,0.4,0.4091,0.87,0.0,1,2,3,3,454,3,2,1,2,212,0,715,16352,2,3
2011-10-04,winter,2011,October,3,Tuesday,Workingday,Clear,0.4,0.4091,0.82,0.1045,3,3,6,6,454,6,2,1,2,212,0,697,8174,2,6
2011-10-04,winter,2011,October,4,Tuesday,Workingday,Clear,0.4,0.4091,0.82,0.0896,3,4,7,7,454,7,2,1,2,212,0,697,4428,2,7
2011-10-04,winter,2011,October,5,Tuesday,Workingday,Clear,0.4,0.4091,0.82,0.1343,2,25,27,27,454,27,2,1,2,212,0,717,14261,2,27
2011-10-04,winter,2011,October,6,Tuesday,Workingday,Clear,0.4,0.4091,0.82,0.1045,3,109,112,112,454,112,2,2,2,222,0,725,55132,2,112
2011-10-04,winter,2011,October,7,Tuesday,Workingday,Clear,0.42,0.4242,0.82,0.2836,11,298,309,309,454,309,2,4,2,242,0,727,154171,2,309
2011-10-04,winter,2011,October,8,Tuesday,Workingday,Clear,0.44,0.4394,0.77,0.2239,28,372,400,400,454,400,2,4,2,242,0,727,261001,2,400
2011-10-04,winter,2011,October,9,Tuesday,Workingday,Clear,0.46,0.4545,0.67,0.2537,19,168,187,187,454,187,2,3,2,232,0,727,159438,2,187
2011-10-04,winter,2011,October,10,Tuesday,Workingday,Clear,0.48,0.4697,0.67,0.2836,19,107,126,126,454,126,2,2,2,222,0,727,126257,2,126
2011-10-04,winter,2011,October,11,Tuesday,Workingday,Clear,0.54,0.5152,0.64,0.2836,22,102,124,124,454,124,2,2,3,223,0,727,151320,2,124
2011-10-04,winter,2011,October,12,Tuesday,Workingday,Clear,0.56,0.5303,0.56,0.2985,39,160,199,199,454,199,2,3,3,233,0,728,184414,2,199
2011-10-04,winter,2011,October,13,Tuesday,Workingday,Clear,0.56,0.5303,0.56,0.2985,20,153,173,173,454,173,2,3,3,233,0,729,184919,2,173
2011-10-04,winter,2011,October,14,Tuesday,Workingday,Clear,0.58,0.5455,0.53,0.2537,27,156,183,183,454,183,2,3,3,233,0,729,175652,2,183
2011-10-04,winter,2011,October,15,Tuesday,Workingday,Clear,0.58,0.5455,0.56,0.2836,28,166,194,194,454,194,2,3,3,233,0,729,183149,2,194
2011-10-04,winter,2011,October,16,Tuesday,Workingday,Clear,0.58,0.5455,0.56,0.3284,36,273,309,309,454,309,2,4,3,243,2,730,227748,2,309
2011-10-04,winter,2011,October,17,Tuesday,Workingday,Clear,0.56,0.5303,0.6,0.3881,55,530,585,585,454,585,2,4,3,243,2,730,336860,2,585
2011-10-04,winter,2011,October,18,Tuesday,Workingday,Clear,0.54,0.5152,0.64,0.2836,68,456,524,524,454,524,2,4,3,243,2,728,309772,2,524
2011-10-04,winter,2011,October,19,Tuesday,Workingday,Clear,0.52,0.5,0.68,0.2239,35,310,345,345,454,345,2,4,3,243,0,728,226789,2,345
2011-10-04,winter,2011,October,20,Tuesday,Workingday,Clear,0.52,0.5,0.68,0.2239,25,236,261,261,454,261,2,3,3,233,0,728,164550,2,261
2011-10-04,winter,2011,October,21,Tuesday,Workingday,Clear,0.5,0.4848,0.72,0.1343,22,144,166,166,454,166,2,3,2,232,0,728,125445,2,166
2011-10-04,winter,2011,October,22,Tuesday,Workingday,Clear,0.5,0.4848,0.72,0.1343,8,106,114,114,454,114,2,2,2,222,0,728,95612,2,114
2011-10-04,winter,2011,October,23,Tuesday,Workingday,Clear,0.48,0.4697,0.77,0.1343,6,60,66,66,454,66,2,2,2,222,0,728,63941,2,66
2011-10-05,winter,2011,October,0,Wednesday,Workingday,Clear,0.48,0.4697,0.77,0.1343,7,36,43,43,453,43,2,2,2,222,0,726,39130,2,43
2011-10-05,winter,2011,October,1,Wednesday,Workingday,Clear,0.48,0.4697,0.77,0.1642,4,7,11,11,453,11,2,1,2,212,0,724,24164,2,11
2011-10-05,winter,2011,October,2,Wednesday,Workingday,Clear,0.46,0.4545,0.82,0.1642,1,2,3,3,453,3,2,1,2,212,0,715,16352,2,3
2011-10-05,winter,2011,October,3,Wednesday,Workingday,Clear,0.46,0.4545,0.82,0.1045,1,5,6,6,453,6,2,1,2,212,0,697,8174,2,6
2011-10-05,winter,2011,October,4,Wednesday,Workingday,Clear,0.44,0.4394,0.88,0.0,1,4,5,5,453,5,2,1,2,212,0,697,4428,2,5
2011-10-05,winter,2011,October,5,Wednesday,Workingday,Clear,0.44,0.4394,0.82,0.1343,3,29,32,32,453,32,2,1,2,212,0,717,14261,2,32
2011-10-05,winter,2011,October,6,Wednesday,Workingday,Clear,0.44,0.4394,0.82,0.1045,5,112,117,117,453,117,2,2,2,222,0,725,55132,2,117
2011-10-05,winter,2011,October,7,Wednesday,Workingday,Clear,0.46,0.4545,0.77,0.1045,9,292,301,301,453,301,2,4,2,242,0,727,154171,2,301
2011-10-05,winter,2011,October,8,Wednesday,Workingday,Clear,0.52,0.5,0.63,0.0,26,441,467,467,453,467,2,4,3,243,0,727,261001,2,467
2011-10-05,winter,2011,October,9,Wednesday,Workingday,Clear,0.54,0.5152,0.6,0.2985,32,187,219,219,453,219,2,3,3,233,0,727,159438,2,219
2011-10-05,winter,2011,October,10,Wednesday,Workingday,Clear,0.56,0.5303,0.56,0.3881,30,103,133,133,453,133,2,2,3,223,0,727,126257,2,133
2011-10-05,winter,2011,October,11,Wednesday,Workingday,Clear,0.6,0.6212,0.46,0.2836,32,138,170,170,453,170,2,3,3,233,2,727,151320,2,170
2011-10-05,winter,2011,October,12,Wednesday,Workingday,Clear,0.62,0.6212,0.43,0.3284,34,180,214,214,453,214,2,3,3,233,2,728,184414,2,214
2011-10-05,winter,2011,October,13,Wednesday,Workingday,Clear,0.64,0.6212,0.41,0.2239,30,189,219,219,453,219,2,3,3,233,2,729,184919,2,219
2011-10-05,winter,2011,October,14,Wednesday,Workingday,Clear,0.64,0.6212,0.41,0.2836,34,156,190,190,453,190,2,3,3,233,2,729,175652,2,190
2011-10-05,winter,2011,October,15,Wednesday,Workingday,Clear,0.64,0.6212,0.47,0.2836,35,147,182,182,453,182,2,3,3,233,2,729,183149,2,182
2011-10-05,winter,2011,October,16,Wednesday,Workingday,Clear,0.64,0.6212,0.47,0.3284,37,245,282,282,453,282,2,4,3,243,2,730,227748,2,282
2011-10-05,winter,2011,October,17,Wednesday,Workingday,Clear,0.64,0.6212,0.47,0.2537,66,525,591,591,453,591,2,4,3,243,2,730,336860,2,591
2011-10-05,winter,2011,October,18,Wednesday,Workingday,Clear,0.6,0.6212,0.53,0.1642,57,536,593,593,453,593,2,4,3,243,2,728,309772,2,593
2011-10-05,winter,2011,October,19,Wednesday,Workingday,Clear,0.58,0.5455,0.56,0.1343,40,334,374,374,453,374,2,4,3,243,2,728,226789,2,374
2011-10-05,winter,2011,October,20,Wednesday,Workingday,Clear,0.52,0.5,0.77,0.1642,18,228,246,246,453,246,2,3,3,233,0,728,164550,2,246
2011-10-05,winter,2011,October,21,Wednesday,Workingday,Clear,0.5,0.4848,0.82,0.1045,28,173,201,201,453,201,2,3,2,232,0,728,125445,2,201
2011-10-05,winter,2011,October,22,Wednesday,Workingday,Clear,0.52,0.5,0.72,0.0,20,134,154,154,453,154,2,3,3,233,0,728,95612,2,154
2011-10-05,winter,2011,October,23,Wednesday,Workingday,Clear,0.5,0.4848,0.77,0.1045,9,64,73,73,453,73,2,2,2,222,0,728,63941,2,73
2011-10-06,winter,2011,October,0,Thursday,Workingday,Clear,0.5,0.4848,0.72,0.194,6,34,40,40,452,40,2,1,2,212,0,726,39130,2,40
2011-10-06,winter,2011,October,1,Thursday,Workingday,Clear,0.48,0.4697,0.63,0.194,5,17,22,22,452,22,2,1,2,212,0,724,24164,2,22
2011-10-06,winter,2011,October,2,Thursday,Workingday,Clear,0.46,0.4545,0.67,0.194,2,8,10,10,452,10,2,1,2,212,0,715,16352,2,10
2011-10-06,winter,2011,October,3,Thursday,Workingday,Clear,0.44,0.4394,0.67,0.2239,1,4,5,5,452,5,2,1,2,212,1,697,8174,2,5
2011-10-06,winter,2011,October,4,Thursday,Workingday,Clear,0.44,0.4394,0.62,0.2836,0,5,5,5,452,5,2,1,2,212,1,697,4428,2,5
2011-10-06,winter,2011,October,5,Thursday,Workingday,Clear,0.42,0.4242,0.62,0.194,0,24,24,24,452,24,2,1,2,212,1,717,14261,2,24
2011-10-06,winter,2011,October,6,Thursday,Workingday,Clear,0.4,0.4091,0.66,0.194,4,110,114,114,452,114,2,2,2,222,1,725,55132,2,114
2011-10-06,winter,2011,October,7,Thursday,Workingday,Clear,0.42,0.4242,0.62,0.194,15,287,302,302,452,302,2,4,2,242,1,727,154171,2,302
2011-10-06,winter,2011,October,8,Thursday,Workingday,Clear,0.44,0.4394,0.62,0.1642,20,437,457,457,452,457,2,4,2,242,1,727,261001,2,457
2011-10-06,winter,2011,October,9,Thursday,Workingday,Clear,0.46,0.4545,0.63,0.194,20,188,208,208,452,208,2,3,2,232,0,727,159438,2,208
2011-10-06,winter,2011,October,10,Thursday,Workingday,Clear,0.52,0.5,0.52,0.0,24,105,129,129,452,129,2,2,3,223,0,727,126257,2,129
2011-10-06,winter,2011,October,11,Thursday,Workingday,Clear,0.54,0.5152,0.49,0.0,29,115,144,144,452,144,2,3,3,233,0,727,151320,2,144
2011-10-06,winter,2011,October,12,Thursday,Workingday,Clear,0.56,0.5303,0.49,0.0896,46,180,226,226,452,226,2,3,3,233,0,728,184414,2,226
2011-10-06,winter,2011,October,13,Thursday,Workingday,Clear,0.56,0.5303,0.46,0.0896,33,158,191,191,452,191,2,3,3,233,0,729,184919,2,191
2011-10-06,winter,2011,October,14,Thursday,Workingday,Clear,0.58,0.5455,0.43,0.0896,56,139,195,195,452,195,2,3,3,233,2,729,175652,2,195
2011-10-06,winter,2011,October,15,Thursday,Workingday,Clear,0.58,0.5455,0.46,0.1343,62,157,219,219,452,219,2,3,3,233,2,729,183149,2,219
2011-10-06,winter,2011,October,16,Thursday,Workingday,Clear,0.58,0.5455,0.49,0.194,51,272,323,323,452,323,2,4,3,243,2,730,227748,2,323
2011-10-06,winter,2011,October,17,Thursday,Workingday,Clear,0.56,0.5303,0.52,0.1343,63,505,568,568,452,568,2,4,3,243,2,730,336860,2,568
2011-10-06,winter,2011,October,18,Thursday,Workingday,Clear,0.54,0.5152,0.64,0.0896,59,479,538,538,452,538,2,4,3,243,2,728,309772,2,538
2011-10-06,winter,2011,October,19,Thursday,Workingday,Clear,0.52,0.5,0.59,0.1045,38,305,343,343,452,343,2,4,3,243,0,728,226789,2,343
2011-10-06,winter,2011,October,20,Thursday,Workingday,Clear,0.5,0.4848,0.77,0.1045,29,231,260,260,452,260,2,3,2,232,0,728,164550,2,260
2011-10-06,winter,2011,October,21,Thursday,Workingday,Clear,0.46,0.4545,0.88,0.0896,34,161,195,195,452,195,2,3,2,232,0,728,125445,2,195
2011-10-06,winter,2011,October,22,Thursday,Workingday,Clear,0.46,0.4545,0.82,0.0,24,124,148,148,452,148,2,3,2,232,0,728,95612,2,148
2011-10-06,winter,2011,October,23,Thursday,Workingday,Clear,0.44,0.4394,0.88,0.0896,18,81,99,99,452,99,2,2,2,222,0,728,63941,2,99
2011-10-07,winter,2011,October,0,Friday,Workingday,Clear,0.44,0.4394,0.88,0.0,19,48,67,67,451,67,2,2,2,222,0,726,39130,2,67
2011-10-07,winter,2011,October,1,Friday,Workingday,Clear,0.44,0.4394,0.88,0.0,3,25,28,28,451,28,2,1,2,212,0,724,24164,2,28
2011-10-07,winter,2011,October,2,Friday,Workingday,Clear,0.42,0.4242,0.88,0.0,0,5,5,5,451,5,2,1,2,212,0,715,16352,2,5
2011-10-07,winter,2011,October,3,Friday,Workingday,Clear,0.4,0.4091,0.87,0.0,1,9,10,10,451,10,2,1,2,212,0,697,8174,2,10
2011-10-07,winter,2011,October,4,Friday,Workingday,Clear,0.4,0.4091,0.87,0.1045,0,5,5,5,451,5,2,1,2,212,0,697,4428,2,5
2011-10-07,winter,2011,October,5,Friday,Workingday,Clear,0.42,0.4242,0.82,0.0,3,24,27,27,451,27,2,1,2,212,0,717,14261,2,27
2011-10-07,winter,2011,October,6,Friday,Workingday,Clear,0.42,0.4242,0.88,0.0,3,84,87,87,451,87,2,2,2,222,0,725,55132,2,87
2011-10-07,winter,2011,October,7,Friday,Workingday,Clear,0.42,0.4242,0.94,0.0,5,237,242,242,451,242,2,3,2,232,0,727,154171,2,242
2011-10-07,winter,2011,October,8,Friday,Workingday,Clear,0.46,0.4545,0.82,0.0,31,386,417,417,451,417,2,4,2,242,0,727,261001,2,417
2011-10-07,winter,2011,October,9,Friday,Workingday,Clear,0.48,0.4697,0.77,0.0,34,207,241,241,451,241,2,3,2,232,0,727,159438,2,241
2011-10-07,winter,2011,October,10,Friday,Workingday,Clear,0.52,0.5,0.68,0.0896,48,126,174,174,451,174,2,3,3,233,0,727,126257,2,174
2011-10-07,winter,2011,October,11,Friday,Workingday,Clear,0.56,0.5303,0.63,0.0,80,150,230,230,451,230,2,3,3,233,0,727,151320,2,230
2011-10-07,winter,2011,October,12,Friday,Workingday,Clear,0.6,0.6212,0.53,0.0,61,174,235,235,451,235,2,3,3,233,0,728,184414,2,235
2011-10-07,winter,2011,October,13,Friday,Workingday,Clear,0.6,0.6212,0.46,0.0,95,210,305,305,451,305,2,4,3,243,2,729,184919,2,305
2011-10-07,winter,2011,October,14,Friday,Workingday,Clear,0.62,0.6212,0.5,0.0,77,179,256,256,451,256,2,3,3,233,2,729,175652,2,256
2011-10-07,winter,2011,October,15,Friday,Workingday,Clear,0.66,0.6212,0.41,0.0,68,202,270,270,451,270,2,3,3,233,2,729,183149,2,270
2011-10-07,winter,2011,October,16,Friday,Workingday,Clear,0.64,0.6212,0.44,0.0,73,346,419,419,451,419,2,4,3,243,2,730,227748,2,419
2011-10-07,winter,2011,October,17,Friday,Workingday,Clear,0.6,0.6212,0.56,0.2537,101,462,563,563,451,563,2,4,3,243,2,730,336860,2,563
2011-10-07,winter,2011,October,18,Friday,Workingday,Clear,0.56,0.5303,0.6,0.0896,94,371,465,465,451,465,2,4,3,243,2,728,309772,2,465
2011-10-07,winter,2011,October,19,Friday,Workingday,Clear,0.56,0.5303,0.52,0.0,51,243,294,294,451,294,2,4,3,243,0,728,226789,2,294
2011-10-07,winter,2011,October,20,Friday,Workingday,Clear,0.54,0.5152,0.49,0.0,30,167,197,197,451,197,2,3,3,233,0,728,164550,2,197
2011-10-07,winter,2011,October,21,Friday,Workingday,Clear,0.5,0.4848,0.68,0.0,22,144,166,166,451,166,2,3,2,232,0,728,125445,2,166
2011-10-07,winter,2011,October,22,Friday,Workingday,Clear,0.5,0.4848,0.68,0.0,27,119,146,146,451,146,2,3,2,232,0,728,95612,2,146
2011-10-07,winter,2011,October,23,Friday,Workingday,Clear,0.5,0.4848,0.63,0.0,23,113,136,136,451,136,2,2,2,222,0,728,63941,2,136
2011-10-08,winter,2011,October,0,Saturday,Holiday,Clear,0.48,0.4697,0.72,0.0,17,72,89,89,450,89,2,2,2,222,0,726,39130,2,89
2011-10-08,winter,2011,October,1,Saturday,Holiday,Clear,0.46,0.4545,0.82,0.0,14,51,65,65,450,65,2,2,2,222,0,724,24164,2,65
2011-10-08,winter,2011,October,2,Saturday,Holiday,Clear,0.46,0.4545,0.82,0.0,4,41,45,45,450,45,2,2,2,222,0,715,16352,2,45
2011-10-08,winter,2011,October,3,Saturday,Holiday,Clear,0.44,0.4394,0.88,0.0,4,16,20,20,450,20,2,1,2,212,0,697,8174,2,20
2011-10-08,winter,2011,October,4,Saturday,Holiday,Clear,0.42,0.4242,0.94,0.1343,3,7,10,10,450,10,2,1,2,212,0,697,4428,2,10
2011-10-08,winter,2011,October,5,Saturday,Holiday,Clear,0.42,0.4242,0.88,0.1045,1,7,8,8,450,8,2,1,2,212,0,717,14261,2,8
2011-10-08,winter,2011,October,6,Saturday,Holiday,Clear,0.42,0.4242,0.94,0.0,6,16,22,22,450,22,2,1,2,212,0,725,55132,2,22
2011-10-08,winter,2011,October,7,Saturday,Holiday,Clear,0.42,0.4242,0.94,0.0896,27,46,73,73,450,73,2,2,2,222,0,727,154171,2,73
2011-10-08,winter,2011,October,8,Saturday,Holiday,Clear,0.46,0.4545,0.82,0.0,14,89,103,103,450,103,2,2,2,222,0,727,261001,2,103
2011-10-08,winter,2011,October,9,Saturday,Holiday,Clear,0.5,0.4848,0.77,0.0,54,163,217,217,450,217,2,3,2,232,0,727,159438,2,217
2011-10-08,winter,2011,October,10,Saturday,Holiday,Clear,0.52,0.5,0.77,0.0,120,217,337,337,450,337,2,4,3,243,0,727,126257,2,337
2011-10-08,winter,2011,October,11,Saturday,Holiday,Clear,0.58,0.5455,0.56,0.0,176,221,397,397,450,397,2,4,3,243,2,727,151320,2,397
2011-10-08,winter,2011,October,12,Saturday,Holiday,Clear,0.62,0.6212,0.35,0.0,191,255,446,446,450,446,2,4,3,243,2,728,184414,2,446
2011-10-08,winter,2011,October,13,Saturday,Holiday,Clear,0.62,0.6212,0.46,0.1045,256,229,485,485,450,485,2,4,3,243,2,729,184919,2,485
2011-10-08,winter,2011,October,14,Saturday,Holiday,Clear,0.62,0.6212,0.5,0.0896,251,214,465,465,450,465,2,4,3,243,2,729,175652,2,465
2011-10-08,winter,2011,October,15,Saturday,Holiday,Clear,0.66,0.6212,0.39,0.0,262,234,496,496,450,496,2,4,3,243,2,729,183149,2,496
2011-10-08,winter,2011,October,16,Saturday,Holiday,Clear,0.64,0.6212,0.44,0.0896,221,230,451,451,450,451,2,4,3,243,2,730,227748,2,451
2011-10-08,winter,2011,October,17,Saturday,Holiday,Clear,0.62,0.6212,0.5,0.1343,174,219,393,393,450,393,2,4,3,243,2,730,336860,2,393
2011-10-08,winter,2011,October,18,Saturday,Holiday,Clear,0.6,0.6212,0.46,0.1045,135,224,359,359,450,359,2,4,3,243,2,728,309772,2,359
2011-10-08,winter,2011,October,19,Saturday,Holiday,Clear,0.54,0.5152,0.68,0.1343,76,172,248,248,450,248,2,3,3,233,0,728,226789,2,248
2011-10-08,winter,2011,October,20,Saturday,Holiday,Clear,0.52,0.5,0.77,0.1045,78,124,202,202,450,202,2,3,3,233,0,728,164550,2,202
2011-10-08,winter,2011,October,21,Saturday,Holiday,Clear,0.52,0.5,0.77,0.0,54,133,187,187,450,187,2,3,3,233,0,728,125445,2,187
2011-10-08,winter,2011,October,22,Saturday,Holiday,Clear,0.5,0.4848,0.77,0.0,45,104,149,149,450,149,2,3,2,232,0,728,95612,2,149
2011-10-08,winter,2011,October,23,Saturday,Holiday,Clear,0.48,0.4697,0.88,0.0,52,90,142,142,450,142,2,2,2,222,0,728,63941,2,142
2011-10-09,winter,2011,October,0,Sunday,Holiday,Clear,0.46,0.4545,0.88,0.0896,46,83,129,129,449,129,2,2,2,222,0,726,39130,2,129
2011-10-09,winter,2011,October,1,Sunday,Holiday,Clear,0.46,0.4545,0.88,0.0,15,63,78,78,449,78,2,2,2,222,0,724,24164,2,78
2011-10-09,winter,2011,October,2,Sunday,Holiday,Clear,0.46,0.4545,0.88,0.0,20,35,55,55,449,55,2,2,2,222,0,715,16352,2,55
2011-10-09,winter,2011,October,3,Sunday,Holiday,Clear,0.44,0.4394,0.88,0.0,10,20,30,30,449,30,2,1,2,212,0,697,8174,2,30
2011-10-09,winter,2011,October,4,Sunday,Holiday,Clear,0.44,0.4394,0.88,0.0,7,7,14,14,449,14,2,1,2,212,0,697,4428,2,14
2011-10-09,winter,2011,October,5,Sunday,Holiday,Clear,0.44,0.4394,0.88,0.0,1,14,15,15,449,15,2,1,2,212,0,717,14261,2,15
2011-10-09,winter,2011,October,6,Sunday,Holiday,Clear,0.44,0.4394,0.88,0.0,7,14,21,21,449,21,2,1,2,212,0,725,55132,2,21
2011-10-09,winter,2011,October,7,Sunday,Holiday,Clear,0.44,0.4394,0.86,0.0,18,26,44,44,449,44,2,2,2,222,0,727,154171,2,44
2011-10-09,winter,2011,October,8,Sunday,Holiday,Clear,0.46,0.4545,0.88,0.0,25,82,107,107,449,107,2,2,2,222,0,727,261001,2,107
2011-10-09,winter,2011,October,9,Sunday,Holiday,Clear,0.5,0.4848,0.77,0.0,66,119,185,185,449,185,2,3,2,232,0,727,159438,2,185
2011-10-09,winter,2011,October,10,Sunday,Holiday,Clear,0.56,0.5303,0.68,0.0896,155,210,365,365,449,365,2,4,3,243,2,727,126257,2,365
2011-10-09,winter,2011,October,11,Sunday,Holiday,Clear,0.62,0.6212,0.53,0.0896,189,234,423,423,449,423,2,4,3,243,2,727,151320,2,423
2011-10-09,winter,2011,October,12,Sunday,Holiday,Clear,0.64,0.6212,0.44,0.0896,212,243,455,455,449,455,2,4,3,243,2,728,184414,2,455
2011-10-09,winter,2011,October,13,Sunday,Holiday,Clear,0.66,0.6212,0.44,0.0896,225,193,418,418,449,418,2,4,3,243,2,729,184919,2,418
2011-10-09,winter,2011,October,14,Sunday,Holiday,Clear,0.68,0.6364,0.47,0.1642,272,228,500,500,449,500,2,4,4,244,2,729,175652,2,500
2011-10-09,winter,2011,October,15,Sunday,Holiday,Clear,0.68,0.6364,0.51,0.1642,198,209,407,407,449,407,2,4,4,244,2,729,183149,2,407
2011-10-09,winter,2011,October,16,Sunday,Holiday,Clear,0.66,0.6212,0.5,0.1343,223,247,470,470,449,470,2,4,3,243,2,730,227748,2,470
2011-10-09,winter,2011,October,17,Sunday,Holiday,Clear,0.62,0.6061,0.61,0.1045,208,230,438,438,449,438,2,4,3,243,2,730,336860,2,438
2011-10-09,winter,2011,October,18,Sunday,Holiday,Clear,0.64,0.6212,0.5,0.1045,186,228,414,414,449,414,2,4,3,243,2,728,309772,2,414
2011-10-09,winter,2011,October,19,Sunday,Holiday,Clear,0.56,0.5303,0.73,0.0896,116,186,302,302,449,302,2,4,3,243,2,728,226789,2,302
2011-10-09,winter,2011,October,20,Sunday,Holiday,Clear,0.56,0.5303,0.73,0.1045,59,134,193,193,449,193,2,3,3,233,0,728,164550,2,193
2011-10-09,winter,2011,October,21,Sunday,Holiday,Clear,0.54,0.5152,0.83,0.1045,53,120,173,173,449,173,2,3,3,233,0,728,125445,2,173
2011-10-09,winter,2011,October,22,Sunday,Holiday,Mist,0.52,0.5,0.94,0.0,48,104,152,152,449,152,2,3,3,233,0,728,95612,2,152
2011-10-09,winter,2011,October,23,Sunday,Holiday,Clear,0.5,0.4848,0.88,0.1045,38,85,123,123,449,123,2,2,2,222,0,728,63941,2,123
2011-10-10,winter,2011,October,0,Monday,Holiday,Clear,0.5,0.4848,0.94,0.0,11,42,53,53,448,53,2,2,2,222,0,726,39130,2,53
2011-10-10,winter,2011,October,1,Monday,Holiday,Clear,0.48,0.4697,0.88,0.0,4,30,34,34,448,34,2,1,2,212,0,724,24164,2,34
2011-10-10,winter,2011,October,2,Monday,Holiday,Clear,0.48,0.4697,0.88,0.0,4,15,19,19,448,19,2,1,2,212,0,715,16352,2,19
2011-10-10,winter,2011,October,3,Monday,Holiday,Clear,0.46,0.4545,0.88,0.0,2,9,11,11,448,11,2,1,2,212,0,697,8174,2,11
2011-10-10,winter,2011,October,4,Monday,Holiday,Clear,0.46,0.4545,0.94,0.0,2,4,6,6,448,6,2,1,2,212,0,697,4428,2,6
2011-10-10,winter,2011,October,5,Monday,Holiday,Clear,0.46,0.4545,0.94,0.0,2,19,21,21,448,21,2,1,2,212,0,717,14261,2,21
2011-10-10,winter,2011,October,6,Monday,Holiday,Clear,0.44,0.4394,0.94,0.0,5,39,44,44,448,44,2,2,2,222,0,725,55132,2,44
2011-10-10,winter,2011,October,7,Monday,Holiday,Clear,0.46,0.4545,0.88,0.0,12,102,114,114,448,114,2,2,2,222,0,727,154171,2,114
2011-10-10,winter,2011,October,8,Monday,Holiday,Clear,0.52,0.5,0.83,0.0,27,227,254,254,448,254,2,3,3,233,0,727,261001,2,254
2011-10-10,winter,2011,October,9,Monday,Holiday,Clear,0.54,0.5152,0.77,0.0,58,161,219,219,448,219,2,3,3,233,0,727,159438,2,219
2011-10-10,winter,2011,October,10,Monday,Holiday,Clear,0.56,0.5303,0.73,0.1642,107,158,265,265,448,265,2,3,3,233,2,727,126257,2,265
2011-10-10,winter,2011,October,11,Monday,Holiday,Clear,0.62,0.6061,0.69,0.0896,139,183,322,322,448,322,2,4,3,243,2,727,151320,2,322
2011-10-10,winter,2011,October,12,Monday,Holiday,Mist,0.7,0.6515,0.48,0.0896,164,201,365,365,448,365,2,4,4,244,2,728,184414,2,365
2011-10-10,winter,2011,October,13,Monday,Holiday,Clear,0.72,0.6515,0.37,0.0,146,219,365,365,448,365,2,4,4,244,2,729,184919,2,365
2011-10-10,winter,2011,October,14,Monday,Holiday,Clear,0.74,0.6515,0.37,0.0,147,223,370,370,448,370,2,4,4,244,2,729,175652,2,370
2011-10-10,winter,2011,October,15,Monday,Holiday,Mist,0.72,0.6515,0.42,0.1045,130,254,384,384,448,384,2,4,4,244,2,729,183149,2,384
2011-10-10,winter,2011,October,16,Monday,Holiday,Mist,0.7,0.6364,0.45,0.0896,154,248,402,402,448,402,2,4,4,244,2,730,227748,2,402
2011-10-10,winter,2011,October,17,Monday,Holiday,Mist,0.66,0.6212,0.54,0.1045,125,334,459,459,448,459,2,4,3,243,2,730,336860,2,459
2011-10-10,winter,2011,October,18,Monday,Holiday,Mist,0.64,0.6212,0.53,0.0,108,365,473,473,448,473,2,4,3,243,2,728,309772,2,473
2011-10-10,winter,2011,October,19,Monday,Holiday,Mist,0.58,0.5455,0.78,0.0896,69,267,336,336,448,336,2,4,3,243,0,728,226789,2,336
2011-10-10,winter,2011,October,20,Monday,Holiday,Clear,0.6,0.5909,0.73,0.0,37,188,225,225,448,225,2,3,3,233,0,728,164550,2,225
2011-10-10,winter,2011,October,21,Monday,Holiday,Clear,0.56,0.5303,0.88,0.0896,27,148,175,175,448,175,2,3,3,233,0,728,125445,2,175
2011-10-10,winter,2011,October,22,Monday,Holiday,Clear,0.56,0.5303,0.88,0.0896,22,104,126,126,448,126,2,2,3,223,0,728,95612,2,126
2011-10-10,winter,2011,October,23,Monday,Holiday,Mist,0.54,0.5152,0.88,0.1045,12,63,75,75,448,75,2,2,3,223,0,728,63941,2,75
2011-10-11,winter,2011,October,0,Tuesday,Workingday,Mist,0.54,0.5152,0.88,0.0,14,16,30,30,447,30,2,1,3,213,0,726,39130,2,30
2011-10-11,winter,2011,October,1,Tuesday,Workingday,Mist,0.52,0.5,0.94,0.0896,2,9,11,11,447,11,2,1,3,213,0,724,24164,2,11
2011-10-11,winter,2011,October,2,Tuesday,Workingday,Mist,0.52,0.5,0.94,0.1343,1,4,5,5,447,5,2,1,3,213,0,715,16352,2,5
2011-10-11,winter,2011,October,3,Tuesday,Workingday,Mist,0.52,0.5,0.88,0.1045,2,1,3,3,447,3,2,1,3,213,0,697,8174,2,3
2011-10-11,winter,2011,October,4,Tuesday,Workingday,Mist,0.52,0.5,0.88,0.1343,0,5,5,5,447,5,2,1,3,213,0,697,4428,2,5
2011-10-11,winter,2011,October,5,Tuesday,Workingday,Mist,0.52,0.5,0.88,0.0,0,20,20,20,447,20,2,1,3,213,0,717,14261,2,20
2011-10-11,winter,2011,October,6,Tuesday,Workingday,Clear,0.52,0.5,0.83,0.0896,9,114,123,123,447,123,2,2,3,223,0,725,55132,2,123
2011-10-11,winter,2011,October,7,Tuesday,Workingday,Mist,0.52,0.5,0.88,0.0896,19,333,352,352,447,352,2,4,3,243,0,727,154171,2,352
2011-10-11,winter,2011,October,8,Tuesday,Workingday,Mist,0.56,0.5303,0.83,0.1045,31,375,406,406,447,406,2,4,3,243,0,727,261001,2,406
2011-10-11,winter,2011,October,9,Tuesday,Workingday,Mist,0.6,0.5909,0.69,0.0,40,195,235,235,447,235,2,3,3,233,0,727,159438,2,235
2011-10-11,winter,2011,October,10,Tuesday,Workingday,Mist,0.6,0.5909,0.69,0.1343,38,111,149,149,447,149,2,3,3,233,0,727,126257,2,149
2011-10-11,winter,2011,October,11,Tuesday,Workingday,Mist,0.6,0.5909,0.73,0.1642,31,92,123,123,447,123,2,2,3,223,0,727,151320,2,123
2011-10-11,winter,2011,October,12,Tuesday,Workingday,Mist,0.6,0.5909,0.73,0.1642,51,130,181,181,447,181,2,3,3,233,0,728,184414,2,181
2011-10-11,winter,2011,October,13,Tuesday,Workingday,Mist,0.6,0.5909,0.73,0.194,42,138,180,180,447,180,2,3,3,233,0,729,184919,2,180
2011-10-11,winter,2011,October,14,Tuesday,Workingday,Light Snow,0.6,0.5909,0.73,0.1045,54,117,171,171,447,171,2,3,3,233,0,729,175652,2,171
2011-10-11,winter,2011,October,15,Tuesday,Workingday,Mist,0.6,0.5758,0.78,0.1642,36,139,175,175,447,175,2,3,3,233,0,729,183149,2,175
2011-10-11,winter,2011,October,16,Tuesday,Workingday,Mist,0.6,0.5909,0.73,0.1642,63,257,320,320,447,320,2,4,3,243,0,730,227748,2,320
2011-10-11,winter,2011,October,17,Tuesday,Workingday,Mist,0.6,0.5758,0.78,0.2537,70,534,604,604,447,604,2,4,3,243,2,730,336860,2,604
2011-10-11,winter,2011,October,18,Tuesday,Workingday,Mist,0.6,0.5758,0.78,0.2239,46,493,539,539,447,539,2,4,3,243,2,728,309772,2,539
2011-10-11,winter,2011,October,19,Tuesday,Workingday,Mist,0.58,0.5455,0.83,0.2239,33,285,318,318,447,318,2,4,3,243,0,728,226789,2,318
2011-10-11,winter,2011,October,20,Tuesday,Workingday,Mist,0.58,0.5455,0.83,0.2239,31,203,234,234,447,234,2,3,3,233,0,728,164550,2,234
2011-10-11,winter,2011,October,21,Tuesday,Workingday,Mist,0.58,0.5455,0.78,0.194,17,158,175,175,447,175,2,3,3,233,0,728,125445,2,175
2011-10-11,winter,2011,October,22,Tuesday,Workingday,Mist,0.56,0.5303,0.83,0.194,27,120,147,147,447,147,2,3,3,233,0,728,95612,2,147
2011-10-11,winter,2011,October,23,Tuesday,Workingday,Mist,0.56,0.5303,0.83,0.2836,10,47,57,57,447,57,2,2,3,223,0,728,63941,2,57
2011-10-12,winter,2011,October,0,Wednesday,Workingday,Mist,0.56,0.5303,0.83,0.1343,2,23,25,25,446,25,2,1,3,213,0,726,39130,2,25
2011-10-12,winter,2011,October,1,Wednesday,Workingday,Light Snow,0.56,0.5303,0.83,0.1343,2,8,10,10,446,10,2,1,3,213,0,724,24164,2,10
2011-10-12,winter,2011,October,2,Wednesday,Workingday,Mist,0.56,0.5303,0.83,0.2836,0,2,2,2,446,2,2,1,3,213,0,715,16352,2,2
2011-10-12,winter,2011,October,3,Wednesday,Workingday,Light Snow,0.54,0.5152,0.94,0.2985,0,2,2,2,446,2,2,1,3,213,0,697,8174,2,2
2011-10-12,winter,2011,October,4,Wednesday,Workingday,Light Snow,0.54,0.5152,0.94,0.3881,1,6,7,7,446,7,2,1,3,213,0,697,4428,2,7
2011-10-12,winter,2011,October,5,Wednesday,Workingday,Mist,0.54,0.5152,0.88,0.3284,0,22,22,22,446,22,2,1,3,213,0,717,14261,2,22
2011-10-12,winter,2011,October,6,Wednesday,Workingday,Mist,0.54,0.5152,0.88,0.2537,5,107,112,112,446,112,2,2,3,223,0,725,55132,2,112
2011-10-12,winter,2011,October,7,Wednesday,Workingday,Mist,0.54,0.5152,0.88,0.3881,15,244,259,259,446,259,2,3,3,233,0,727,154171,2,259
2011-10-12,winter,2011,October,8,Wednesday,Workingday,Mist,0.54,0.5152,0.88,0.3881,27,377,404,404,446,404,2,4,3,243,0,727,261001,2,404
2011-10-12,winter,2011,October,9,Wednesday,Workingday,Mist,0.54,0.5152,0.88,0.4478,14,183,197,197,446,197,2,3,3,233,0,727,159438,2,197
2011-10-12,winter,2011,October,10,Wednesday,Workingday,Mist,0.54,0.5152,0.88,0.3881,15,98,113,113,446,113,2,2,3,223,0,727,126257,2,113
2011-10-12,winter,2011,October,11,Wednesday,Workingday,Light Snow,0.54,0.5152,0.94,0.3284,18,102,120,120,446,120,2,2,3,223,0,727,151320,2,120
2011-10-12,winter,2011,October,12,Wednesday,Workingday,Light Snow,0.54,0.5152,0.88,0.3284,9,53,62,62,446,62,2,2,3,223,0,728,184414,2,62
2011-10-12,winter,2011,October,13,Wednesday,Workingday,Light Snow,0.54,0.5152,0.88,0.2239,25,76,101,101,446,101,2,2,3,223,0,729,184919,2,101
2011-10-12,winter,2011,October,14,Wednesday,Workingday,Light Snow,0.54,0.5152,0.94,0.2836,8,70,78,78,446,78,2,2,3,223,0,729,175652,2,78
2011-10-12,winter,2011,October,15,Wednesday,Workingday,Light Snow,0.54,0.5152,0.94,0.2537,3,42,45,45,446,45,2,2,3,223,0,729,183149,2,45
2011-10-12,winter,2011,October,16,Wednesday,Workingday,Mist,0.56,0.5303,0.88,0.2239,5,50,55,55,446,55,2,2,3,223,0,730,227748,2,55
2011-10-12,winter,2011,October,17,Wednesday,Workingday,Light Snow,0.54,0.5152,0.94,0.2239,16,235,251,251,446,251,2,3,3,233,0,730,336860,2,251
2011-10-12,winter,2011,October,18,Wednesday,Workingday,Light Snow,0.54,0.5152,0.94,0.1343,11,161,172,172,446,172,2,3,3,233,0,728,309772,2,172
2011-10-12,winter,2011,October,19,Wednesday,Workingday,Light Snow,0.54,0.5152,0.94,0.1343,7,102,109,109,446,109,2,2,3,223,0,728,226789,2,109
2011-10-12,winter,2011,October,20,Wednesday,Workingday,Light Snow,0.54,0.5152,0.94,0.1045,9,81,90,90,446,90,2,2,3,223,0,728,164550,2,90
2011-10-12,winter,2011,October,21,Wednesday,Workingday,Light Snow,0.54,0.5152,1.0,0.1045,9,74,83,83,446,83,2,2,3,223,0,728,125445,2,83
2011-10-12,winter,2011,October,22,Wednesday,Workingday,Light Snow,0.54,0.5152,0.94,0.0896,3,40,43,43,446,43,2,2,3,223,0,728,95612,2,43
2011-10-12,winter,2011,October,23,Wednesday,Workingday,Light Snow,0.54,0.5152,0.94,0.0896,13,41,54,54,446,54,2,2,3,223,0,728,63941,2,54
2011-10-13,winter,2011,October,0,Thursday,Workingday,Mist,0.54,0.5152,0.94,0.1343,1,14,15,15,445,15,2,1,3,213,0,726,39130,2,15
2011-10-13,winter,2011,October,1,Thursday,Workingday,Mist,0.54,0.5152,0.94,0.0,3,9,12,12,445,12,2,1,3,213,0,724,24164,2,12
2011-10-13,winter,2011,October,2,Thursday,Workingday,Mist,0.54,0.5152,0.94,0.0,0,4,4,4,445,4,2,1,3,213,0,715,16352,2,4
2011-10-13,winter,2011,October,3,Thursday,Workingday,Mist,0.54,0.5152,1.0,0.194,2,4,6,6,445,6,2,1,3,213,0,697,8174,2,6
2011-10-13,winter,2011,October,4,Thursday,Workingday,Mist,0.54,0.5152,1.0,0.1045,2,5,7,7,445,7,2,1,3,213,0,697,4428,2,7
2011-10-13,winter,2011,October,5,Thursday,Workingday,Mist,0.54,0.5152,1.0,0.1045,1,16,17,17,445,17,2,1,3,213,0,717,14261,2,17
2011-10-13,winter,2011,October,6,Thursday,Workingday,Light Snow,0.54,0.5152,1.0,0.0896,1,51,52,52,445,52,2,2,3,223,0,725,55132,2,52
2011-10-13,winter,2011,October,7,Thursday,Workingday,Light Snow,0.54,0.5152,1.0,0.1343,5,76,81,81,445,81,2,2,3,223,0,727,154171,2,81
2011-10-13,winter,2011,October,8,Thursday,Workingday,Light Snow,0.54,0.5152,1.0,0.0896,10,199,209,209,445,209,2,3,3,233,0,727,261001,2,209
2011-10-13,winter,2011,October,9,Thursday,Workingday,Light Snow,0.56,0.5303,1.0,0.1045,3,106,109,109,445,109,2,2,3,223,0,727,159438,2,109
2011-10-13,winter,2011,October,10,Thursday,Workingday,Light Snow,0.56,0.5303,1.0,0.1343,16,53,69,69,445,69,2,2,3,223,0,727,126257,2,69
2011-10-13,winter,2011,October,11,Thursday,Workingday,Mist,0.62,0.5758,0.83,0.0,8,76,84,84,445,84,2,2,3,223,0,727,151320,2,84
2011-10-13,winter,2011,October,12,Thursday,Workingday,Mist,0.62,0.5606,0.88,0.0,10,95,105,105,445,105,2,2,3,223,0,728,184414,2,105
2011-10-13,winter,2011,October,13,Thursday,Workingday,Mist,0.64,0.5758,0.83,0.1642,20,142,162,162,445,162,2,3,3,233,0,729,184919,2,162
2011-10-13,winter,2011,October,14,Thursday,Workingday,Clear,0.66,0.6061,0.78,0.194,22,111,133,133,445,133,2,2,3,223,0,729,175652,2,133
2011-10-13,winter,2011,October,15,Thursday,Workingday,Clear,0.66,0.6061,0.78,0.194,27,128,155,155,445,155,2,3,3,233,0,729,183149,2,155
2011-10-13,winter,2011,October,16,Thursday,Workingday,Clear,0.66,0.6212,0.74,0.2239,36,240,276,276,445,276,2,3,3,233,0,730,227748,2,276
2011-10-13,winter,2011,October,17,Thursday,Workingday,Light Snow,0.62,0.5758,0.83,0.2537,47,432,479,479,445,479,2,4,3,243,2,730,336860,2,479
2011-10-13,winter,2011,October,18,Thursday,Workingday,Light Snow,0.62,0.5758,0.83,0.2537,20,248,268,268,445,268,2,3,3,233,0,728,309772,2,268
2011-10-13,winter,2011,October,19,Thursday,Workingday,Mist,0.62,0.5758,0.83,0.1642,18,187,205,205,445,205,2,3,3,233,0,728,226789,2,205
2011-10-13,winter,2011,October,20,Thursday,Workingday,Clear,0.62,0.5758,0.83,0.2836,15,166,181,181,445,181,2,3,3,233,0,728,164550,2,181
2011-10-13,winter,2011,October,21,Thursday,Workingday,Clear,0.62,0.5758,0.83,0.194,8,115,123,123,445,123,2,2,3,223,0,728,125445,2,123
2011-10-13,winter,2011,October,22,Thursday,Workingday,Clear,0.62,0.5758,0.83,0.194,13,101,114,114,445,114,2,2,3,223,0,728,95612,2,114
2011-10-13,winter,2011,October,23,Thursday,Workingday,Mist,0.58,0.5455,0.88,0.194,2,45,47,47,445,47,2,2,3,223,0,728,63941,2,47
2011-10-14,winter,2011,October,0,Friday,Workingday,Clear,0.58,0.5455,0.94,0.0896,10,29,39,39,444,39,2,1,3,213,0,726,39130,2,39
2011-10-14,winter,2011,October,1,Friday,Workingday,Clear,0.58,0.5455,0.94,0.1343,8,16,24,24,444,24,2,1,3,213,0,724,24164,2,24
2011-10-14,winter,2011,October,2,Friday,Workingday,Clear,0.56,0.5303,0.94,0.1642,0,6,6,6,444,6,2,1,3,213,0,715,16352,2,6
2011-10-14,winter,2011,October,3,Friday,Workingday,Clear,0.56,0.5303,0.94,0.1343,1,6,7,7,444,7,2,1,3,213,0,697,8174,2,7
2011-10-14,winter,2011,October,4,Friday,Workingday,Clear,0.56,0.5303,0.94,0.194,0,8,8,8,444,8,2,1,3,213,0,697,4428,2,8
2011-10-14,winter,2011,October,5,Friday,Workingday,Mist,0.56,0.5303,0.94,0.1642,0,17,17,17,444,17,2,1,3,213,0,717,14261,2,17
2011-10-14,winter,2011,October,6,Friday,Workingday,Light Snow,0.56,0.5303,0.88,0.194,4,90,94,94,444,94,2,2,3,223,0,725,55132,2,94
2011-10-14,winter,2011,October,7,Friday,Workingday,Light Snow,0.56,0.5303,0.88,0.194,10,137,147,147,444,147,2,3,3,233,0,727,154171,2,147
2011-10-14,winter,2011,October,8,Friday,Workingday,Mist,0.56,0.5303,0.9,0.1642,23,186,209,209,444,209,2,3,3,233,0,727,261001,2,209
2011-10-14,winter,2011,October,9,Friday,Workingday,Mist,0.56,0.5303,0.94,0.2239,16,164,180,180,444,180,2,3,3,233,0,727,159438,2,180
2011-10-14,winter,2011,October,10,Friday,Workingday,Light Snow,0.54,0.5152,0.88,0.3582,17,108,125,125,444,125,2,2,3,223,0,727,126257,2,125
2011-10-14,winter,2011,October,11,Friday,Workingday,Light Snow,0.52,0.5,0.88,0.1642,11,76,87,87,444,87,2,2,3,223,0,727,151320,2,87
2011-10-14,winter,2011,October,12,Friday,Workingday,Light Snow,0.52,0.5,0.88,0.1642,13,62,75,75,444,75,2,2,3,223,0,728,184414,2,75
2011-10-14,winter,2011,October,13,Friday,Workingday,Clear,0.56,0.5303,0.73,0.3582,18,114,132,132,444,132,2,2,3,223,0,729,184919,2,132
2011-10-14,winter,2011,October,14,Friday,Workingday,Clear,0.62,0.6212,0.43,0.3582,37,119,156,156,444,156,2,3,3,233,2,729,175652,2,156
2011-10-14,winter,2011,October,15,Friday,Workingday,Clear,0.62,0.6212,0.43,0.2836,61,169,230,230,444,230,2,3,3,233,2,729,183149,2,230
2011-10-14,winter,2011,October,16,Friday,Workingday,Clear,0.6,0.6212,0.43,0.2239,80,264,344,344,444,344,2,4,3,243,2,730,227748,2,344
2011-10-14,winter,2011,October,17,Friday,Workingday,Clear,0.58,0.5455,0.46,0.4179,55,426,481,481,444,481,2,4,3,243,2,730,336860,2,481
2011-10-14,winter,2011,October,18,Friday,Workingday,Clear,0.54,0.5152,0.39,0.2836,62,361,423,423,444,423,2,4,3,243,2,728,309772,2,423
2011-10-14,winter,2011,October,19,Friday,Workingday,Clear,0.54,0.5152,0.39,0.3284,27,221,248,248,444,248,2,3,3,233,2,728,226789,2,248
2011-10-14,winter,2011,October,20,Friday,Workingday,Clear,0.52,0.5,0.42,0.194,19,177,196,196,444,196,2,3,3,233,1,728,164550,2,196
2011-10-14,winter,2011,October,21,Friday,Workingday,Clear,0.5,0.4848,0.45,0.194,22,156,178,178,444,178,2,3,2,232,1,728,125445,2,178
2011-10-14,winter,2011,October,22,Friday,Workingday,Clear,0.46,0.4545,0.59,0.2239,20,123,143,143,444,143,2,3,2,232,1,728,95612,2,143
2011-10-14,winter,2011,October,23,Friday,Workingday,Clear,0.46,0.4545,0.59,0.1642,15,80,95,95,444,95,2,2,2,222,0,728,63941,2,95
2011-10-15,winter,2011,October,0,Saturday,Holiday,Clear,0.46,0.4545,0.55,0.1045,18,88,106,106,443,106,2,2,2,222,0,726,39130,2,106
2011-10-15,winter,2011,October,1,Saturday,Holiday,Clear,0.46,0.4545,0.55,0.2537,9,64,73,73,443,73,2,2,2,222,1,724,24164,2,73
2011-10-15,winter,2011,October,2,Saturday,Holiday,Clear,0.46,0.4545,0.59,0.194,17,39,56,56,443,56,2,2,2,222,1,715,16352,2,56
2011-10-15,winter,2011,October,3,Saturday,Holiday,Clear,0.44,0.4394,0.62,0.194,5,18,23,23,443,23,2,1,2,212,1,697,8174,2,23
2011-10-15,winter,2011,October,4,Saturday,Holiday,Clear,0.42,0.4242,0.67,0.1343,0,6,6,6,443,6,2,1,2,212,0,697,4428,2,6
2011-10-15,winter,2011,October,5,Saturday,Holiday,Clear,0.42,0.4242,0.71,0.1642,1,6,7,7,443,7,2,1,2,212,0,717,14261,2,7
2011-10-15,winter,2011,October,6,Saturday,Holiday,Clear,0.4,0.4091,0.71,0.0,5,15,20,20,443,20,2,1,2,212,0,725,55132,2,20
2011-10-15,winter,2011,October,7,Saturday,Holiday,Clear,0.4,0.4091,0.76,0.1045,17,40,57,57,443,57,2,2,2,222,0,727,154171,2,57
2011-10-15,winter,2011,October,8,Saturday,Holiday,Clear,0.46,0.4545,0.59,0.2836,24,101,125,125,443,125,2,2,2,222,1,727,261001,2,125
2011-10-15,winter,2011,October,9,Saturday,Holiday,Clear,0.52,0.5,0.48,0.2985,50,157,207,207,443,207,2,3,3,233,2,727,159438,2,207
2011-10-15,winter,2011,October,10,Saturday,Holiday,Clear,0.54,0.5152,0.45,0.4478,115,207,322,322,443,322,2,4,3,243,2,727,126257,2,322
2011-10-15,winter,2011,October,11,Saturday,Holiday,Clear,0.56,0.5303,0.4,0.3881,153,221,374,374,443,374,2,4,3,243,2,727,151320,2,374
2011-10-15,winter,2011,October,12,Saturday,Holiday,Clear,0.58,0.5455,0.35,0.5522,195,261,456,456,443,456,2,4,3,243,2,728,184414,2,456
2011-10-15,winter,2011,October,13,Saturday,Holiday,Clear,0.6,0.6212,0.35,0.4627,171,223,394,394,443,394,2,4,3,243,2,729,184919,2,394
2011-10-15,winter,2011,October,14,Saturday,Holiday,Clear,0.6,0.6212,0.33,0.4627,242,230,472,472,443,472,2,4,3,243,2,729,175652,2,472
2011-10-15,winter,2011,October,15,Saturday,Holiday,Clear,0.62,0.6212,0.31,0.4925,166,211,377,377,443,377,2,4,3,243,2,729,183149,2,377
2011-10-15,winter,2011,October,16,Saturday,Holiday,Clear,0.62,0.6212,0.29,0.3881,179,264,443,443,443,443,2,4,3,243,2,730,227748,2,443
2011-10-15,winter,2011,October,17,Saturday,Holiday,Clear,0.58,0.5455,0.32,0.2836,177,264,441,441,443,441,2,4,3,243,2,730,336860,2,441
2011-10-15,winter,2011,October,18,Saturday,Holiday,Clear,0.54,0.5152,0.39,0.194,121,251,372,372,443,372,2,4,3,243,2,728,309772,2,372
2011-10-15,winter,2011,October,19,Saturday,Holiday,Clear,0.5,0.4848,0.51,0.1343,61,177,238,238,443,238,2,3,2,232,0,728,226789,2,238
2011-10-15,winter,2011,October,20,Saturday,Holiday,Clear,0.5,0.4848,0.48,0.1343,42,137,179,179,443,179,2,3,2,232,0,728,164550,2,179
2011-10-15,winter,2011,October,21,Saturday,Holiday,Clear,0.5,0.4848,0.42,0.2239,53,115,168,168,443,168,2,3,2,232,1,728,125445,2,168
2011-10-15,winter,2011,October,22,Saturday,Holiday,Clear,0.5,0.4848,0.36,0.1343,45,121,166,166,443,166,2,3,2,232,1,728,95612,2,166
2011-10-15,winter,2011,October,23,Saturday,Holiday,Clear,0.48,0.4697,0.41,0.1642,33,102,135,135,443,135,2,2,2,222,1,728,63941,2,135
2011-10-16,winter,2011,October,0,Sunday,Holiday,Clear,0.46,0.4545,0.44,0.1343,22,85,107,107,442,107,2,2,2,222,1,726,39130,2,107
2011-10-16,winter,2011,October,1,Sunday,Holiday,Clear,0.44,0.4394,0.47,0.1343,13,64,77,77,442,77,2,2,2,222,1,724,24164,2,77
2011-10-16,winter,2011,October,2,Sunday,Holiday,Clear,0.42,0.4242,0.54,0.1343,13,52,65,65,442,65,2,2,2,222,1,715,16352,2,65
2011-10-16,winter,2011,October,3,Sunday,Holiday,Clear,0.42,0.4242,0.54,0.1343,11,31,42,42,442,42,2,2,2,222,1,697,8174,2,42
2011-10-16,winter,2011,October,4,Sunday,Holiday,Clear,0.42,0.4242,0.54,0.194,5,7,12,12,442,12,2,1,2,212,1,697,4428,2,12
2011-10-16,winter,2011,October,5,Sunday,Holiday,Clear,0.42,0.4242,0.54,0.1642,1,6,7,7,442,7,2,1,2,212,1,717,14261,2,7
2011-10-16,winter,2011,October,6,Sunday,Holiday,Clear,0.38,0.3939,0.66,0.1642,3,7,10,10,442,10,2,1,2,212,1,725,55132,2,10
2011-10-16,winter,2011,October,7,Sunday,Holiday,Clear,0.4,0.4091,0.62,0.1343,9,39,48,48,442,48,2,2,2,222,1,727,154171,2,48
2011-10-16,winter,2011,October,8,Sunday,Holiday,Clear,0.44,0.4394,0.62,0.194,28,71,99,99,442,99,2,2,2,222,1,727,261001,2,99
2011-10-16,winter,2011,October,9,Sunday,Holiday,Clear,0.5,0.4848,0.45,0.2239,39,151,190,190,442,190,2,3,2,232,1,727,159438,2,190
2011-10-16,winter,2011,October,10,Sunday,Holiday,Clear,0.54,0.5152,0.45,0.2537,121,226,347,347,442,347,2,4,3,243,2,727,126257,2,347
2011-10-16,winter,2011,October,11,Sunday,Holiday,Clear,0.56,0.5303,0.35,0.2836,159,218,377,377,442,377,2,4,3,243,2,727,151320,2,377
2011-10-16,winter,2011,October,12,Sunday,Holiday,Clear,0.58,0.5455,0.35,0.2537,167,277,444,444,442,444,2,4,3,243,2,728,184414,2,444
2011-10-16,winter,2011,October,13,Sunday,Holiday,Clear,0.6,0.6212,0.35,0.2985,169,269,438,438,442,438,2,4,3,243,2,729,184919,2,438
2011-10-16,winter,2011,October,14,Sunday,Holiday,Clear,0.6,0.6212,0.4,0.2985,204,258,462,462,442,462,2,4,3,243,2,729,175652,2,462
2011-10-16,winter,2011,October,15,Sunday,Holiday,Clear,0.62,0.6212,0.35,0.3881,182,230,412,412,442,412,2,4,3,243,2,729,183149,2,412
2011-10-16,winter,2011,October,16,Sunday,Holiday,Clear,0.6,0.6212,0.46,0.3881,177,289,466,466,442,466,2,4,3,243,2,730,227748,2,466
2011-10-16,winter,2011,October,17,Sunday,Holiday,Clear,0.58,0.5455,0.49,0.4627,152,253,405,405,442,405,2,4,3,243,2,730,336860,2,405
2011-10-16,winter,2011,October,18,Sunday,Holiday,Clear,0.56,0.5303,0.49,0.4478,102,226,328,328,442,328,2,4,3,243,2,728,309772,2,328
2011-10-16,winter,2011,October,19,Sunday,Holiday,Clear,0.54,0.5152,0.52,0.3881,52,181,233,233,442,233,2,3,3,233,2,728,226789,2,233
2011-10-16,winter,2011,October,20,Sunday,Holiday,Clear,0.54,0.5152,0.52,0.4627,49,129,178,178,442,178,2,3,3,233,2,728,164550,2,178
2011-10-16,winter,2011,October,21,Sunday,Holiday,Clear,0.54,0.5152,0.52,0.3881,14,88,102,102,442,102,2,2,3,223,1,728,125445,2,102
2011-10-16,winter,2011,October,22,Sunday,Holiday,Clear,0.56,0.5303,0.49,0.4179,42,88,130,130,442,130,2,2,3,223,2,728,95612,2,130
2011-10-16,winter,2011,October,23,Sunday,Holiday,Clear,0.56,0.5303,0.52,0.4179,14,48,62,62,442,62,2,2,3,223,1,728,63941,2,62
2011-10-17,winter,2011,October,0,Monday,Workingday,Clear,0.54,0.5152,0.56,0.3284,12,25,37,37,441,37,2,1,3,213,0,726,39130,2,37
2011-10-17,winter,2011,October,1,Monday,Workingday,Clear,0.56,0.5303,0.54,0.3881,2,15,17,17,441,17,2,1,3,213,0,724,24164,2,17
2011-10-17,winter,2011,October,2,Monday,Workingday,Clear,0.56,0.5303,0.54,0.3881,4,3,7,7,441,7,2,1,3,213,0,715,16352,2,7
2011-10-17,winter,2011,October,3,Monday,Workingday,Clear,0.56,0.5303,0.49,0.194,0,2,2,2,441,2,2,1,3,213,0,697,8174,2,2
2011-10-17,winter,2011,October,4,Monday,Workingday,Clear,0.52,0.5,0.59,0.1642,2,3,5,5,441,5,2,1,3,213,0,697,4428,2,5
2011-10-17,winter,2011,October,5,Monday,Workingday,Clear,0.5,0.4848,0.63,0.2985,1,28,29,29,441,29,2,1,2,212,0,717,14261,2,29
2011-10-17,winter,2011,October,6,Monday,Workingday,Clear,0.5,0.4848,0.55,0.2537,7,107,114,114,441,114,2,2,2,222,1,725,55132,2,114
2011-10-17,winter,2011,October,7,Monday,Workingday,Mist,0.5,0.4848,0.55,0.1642,10,299,309,309,441,309,2,4,2,242,0,727,154171,2,309
2011-10-17,winter,2011,October,8,Monday,Workingday,Mist,0.5,0.4848,0.51,0.2537,33,381,414,414,441,414,2,4,2,242,2,727,261001,2,414
2011-10-17,winter,2011,October,9,Monday,Workingday,Mist,0.5,0.4848,0.45,0.2836,26,180,206,206,441,206,2,3,2,232,1,727,159438,2,206
2011-10-17,winter,2011,October,10,Monday,Workingday,Clear,0.52,0.5,0.45,0.1642,43,92,135,135,441,135,2,2,3,223,0,727,126257,2,135
2011-10-17,winter,2011,October,11,Monday,Workingday,Clear,0.56,0.5303,0.43,0.0,35,131,166,166,441,166,2,3,3,233,0,727,151320,2,166
2011-10-17,winter,2011,October,12,Monday,Workingday,Clear,0.56,0.5303,0.4,0.0896,39,166,205,205,441,205,2,3,3,233,2,728,184414,2,205
2011-10-17,winter,2011,October,13,Monday,Workingday,Clear,0.56,0.5303,0.46,0.0896,49,156,205,205,441,205,2,3,3,233,0,729,184919,2,205
2011-10-17,winter,2011,October,14,Monday,Workingday,Clear,0.58,0.5455,0.49,0.194,44,122,166,166,441,166,2,3,3,233,0,729,175652,2,166
2011-10-17,winter,2011,October,15,Monday,Workingday,Clear,0.56,0.5303,0.6,0.2537,66,142,208,208,441,208,2,3,3,233,2,729,183149,2,208
2011-10-17,winter,2011,October,16,Monday,Workingday,Clear,0.58,0.5455,0.56,0.2537,64,238,302,302,441,302,2,4,3,243,2,730,227748,2,302
2011-10-17,winter,2011,October,17,Monday,Workingday,Clear,0.56,0.5303,0.64,0.1343,80,540,620,620,441,620,2,4,3,243,2,730,336860,2,620
2011-10-17,winter,2011,October,18,Monday,Workingday,Clear,0.56,0.5303,0.6,0.0,49,469,518,518,441,518,2,4,3,243,2,728,309772,2,518
2011-10-17,winter,2011,October,19,Monday,Workingday,Clear,0.54,0.5152,0.68,0.1045,45,288,333,333,441,333,2,4,3,243,0,728,226789,2,333
2011-10-17,winter,2011,October,20,Monday,Workingday,Clear,0.52,0.5,0.77,0.1045,40,189,229,229,441,229,2,3,3,233,0,728,164550,2,229
2011-10-17,winter,2011,October,21,Monday,Workingday,Clear,0.5,0.4848,0.77,0.1045,36,141,177,177,441,177,2,3,2,232,0,728,125445,2,177
2011-10-17,winter,2011,October,22,Monday,Workingday,Clear,0.5,0.4848,0.77,0.0,16,88,104,104,441,104,2,2,2,222,0,728,95612,2,104
2011-10-17,winter,2011,October,23,Monday,Workingday,Mist,0.48,0.4697,0.88,0.0,10,52,62,62,441,62,2,2,2,222,0,728,63941,2,62
2011-10-18,winter,2011,October,0,Tuesday,Workingday,Clear,0.48,0.4697,0.82,0.0,8,23,31,31,440,31,2,1,2,212,0,726,39130,2,31
2011-10-18,winter,2011,October,1,Tuesday,Workingday,Mist,0.46,0.4545,0.88,0.0,4,7,11,11,440,11,2,1,2,212,0,724,24164,2,11
2011-10-18,winter,2011,October,2,Tuesday,Workingday,Clear,0.44,0.4394,0.94,0.0896,1,4,5,5,440,5,2,1,2,212,0,715,16352,2,5
2011-10-18,winter,2011,October,3,Tuesday,Workingday,Clear,0.44,0.4394,0.94,0.0896,0,1,1,1,440,1,2,1,2,212,0,697,8174,2,1
2011-10-18,winter,2011,October,4,Tuesday,Workingday,Mist,0.44,0.4394,0.94,0.1045,0,4,4,4,440,4,2,1,2,212,0,697,4428,2,4
2011-10-18,winter,2011,October,5,Tuesday,Workingday,Mist,0.46,0.4545,0.88,0.0,2,19,21,21,440,21,2,1,2,212,0,717,14261,2,21
2011-10-18,winter,2011,October,6,Tuesday,Workingday,Clear,0.46,0.4545,0.82,0.0896,4,105,109,109,440,109,2,2,2,222,0,725,55132,2,109
2011-10-18,winter,2011,October,7,Tuesday,Workingday,Clear,0.46,0.4545,0.88,0.0896,15,326,341,341,440,341,2,4,2,242,0,727,154171,2,341
2011-10-18,winter,2011,October,8,Tuesday,Workingday,Clear,0.5,0.4848,0.77,0.0896,25,474,499,499,440,499,2,4,2,242,0,727,261001,2,499
2011-10-18,winter,2011,October,9,Tuesday,Workingday,Mist,0.52,0.5,0.77,0.0896,29,198,227,227,440,227,2,3,3,233,0,727,159438,2,227
2011-10-18,winter,2011,October,10,Tuesday,Workingday,Mist,0.56,0.5303,0.68,0.0,27,75,102,102,440,102,2,2,3,223,0,727,126257,2,102
2011-10-18,winter,2011,October,11,Tuesday,Workingday,Mist,0.6,0.6212,0.49,0.1045,35,112,147,147,440,147,2,3,3,233,0,727,151320,2,147
2011-10-18,winter,2011,October,12,Tuesday,Workingday,Mist,0.62,0.6212,0.43,0.0896,42,159,201,201,440,201,2,3,3,233,2,728,184414,2,201
2011-10-18,winter,2011,October,13,Tuesday,Workingday,Mist,0.64,0.6212,0.38,0.194,48,171,219,219,440,219,2,3,3,233,2,729,184919,2,219
2011-10-18,winter,2011,October,14,Tuesday,Workingday,Mist,0.62,0.6212,0.41,0.1642,32,137,169,169,440,169,2,3,3,233,2,729,175652,2,169
2011-10-18,winter,2011,October,15,Tuesday,Workingday,Clear,0.62,0.6212,0.5,0.194,66,139,205,205,440,205,2,3,3,233,2,729,183149,2,205
2011-10-18,winter,2011,October,16,Tuesday,Workingday,Clear,0.62,0.6212,0.57,0.2537,58,246,304,304,440,304,2,4,3,243,2,730,227748,2,304
2011-10-18,winter,2011,October,17,Tuesday,Workingday,Clear,0.6,0.6061,0.6,0.1343,72,553,625,625,440,625,2,4,3,243,2,730,336860,2,625
2011-10-18,winter,2011,October,18,Tuesday,Workingday,Clear,0.56,0.5303,0.68,0.1045,58,512,570,570,440,570,2,4,3,243,2,728,309772,2,570
2011-10-18,winter,2011,October,19,Tuesday,Workingday,Clear,0.56,0.5303,0.6,0.1045,31,286,317,317,440,317,2,4,3,243,0,728,226789,2,317
2011-10-18,winter,2011,October,20,Tuesday,Workingday,Clear,0.54,0.5152,0.64,0.1642,23,204,227,227,440,227,2,3,3,233,0,728,164550,2,227
2011-10-18,winter,2011,October,21,Tuesday,Workingday,Mist,0.54,0.5152,0.68,0.1343,28,178,206,206,440,206,2,3,3,233,0,728,125445,2,206
2011-10-18,winter,2011,October,22,Tuesday,Workingday,Mist,0.52,0.5,0.77,0.1642,22,115,137,137,440,137,2,2,3,223,0,728,95612,2,137
2011-10-18,winter,2011,October,23,Tuesday,Workingday,Mist,0.52,0.5,0.77,0.194,7,63,70,70,440,70,2,2,3,223,0,728,63941,2,70
2011-10-19,winter,2011,October,0,Wednesday,Workingday,Mist,0.52,0.5,0.77,0.194,11,23,34,34,439,34,2,1,3,213,0,726,39130,2,34
2011-10-19,winter,2011,October,1,Wednesday,Workingday,Mist,0.52,0.5,0.77,0.194,7,9,16,16,439,16,2,1,3,213,0,724,24164,2,16
2011-10-19,winter,2011,October,2,Wednesday,Workingday,Mist,0.52,0.5,0.77,0.194,1,6,7,7,439,7,2,1,3,213,0,715,16352,2,7
2011-10-19,winter,2011,October,4,Wednesday,Workingday,Light Snow,0.5,0.4848,0.94,0.194,0,3,3,3,439,3,2,1,2,212,0,697,4428,2,3
2011-10-19,winter,2011,October,5,Wednesday,Workingday,Light Snow,0.5,0.4848,1.0,0.1045,0,3,3,3,439,3,2,1,2,212,0,717,14261,2,3
2011-10-19,winter,2011,October,6,Wednesday,Workingday,Light Snow,0.52,0.5,0.83,0.2537,3,28,31,31,439,31,2,1,3,213,0,725,55132,2,31
2011-10-19,winter,2011,October,7,Wednesday,Workingday,Light Snow,0.52,0.5,0.77,0.2537,1,67,68,68,439,68,2,2,3,223,0,727,154171,2,68
2011-10-19,winter,2011,October,8,Wednesday,Workingday,Light Snow,0.54,0.5152,0.7,0.4925,10,200,210,210,439,210,2,3,3,233,0,727,261001,2,210
2011-10-19,winter,2011,October,9,Wednesday,Workingday,Light Snow,0.52,0.5,0.88,0.4925,17,185,202,202,439,202,2,3,3,233,0,727,159438,2,202
2011-10-19,winter,2011,October,10,Wednesday,Workingday,Light Snow,0.52,0.5,0.88,0.4925,14,109,123,123,439,123,2,2,3,223,0,727,126257,2,123
2011-10-19,winter,2011,October,11,Wednesday,Workingday,Light Snow,0.52,0.5,0.94,0.2537,33,116,149,149,439,149,2,3,3,233,0,727,151320,2,149
2011-10-19,winter,2011,October,12,Wednesday,Workingday,Light Snow,0.52,0.5,0.94,0.3284,13,117,130,130,439,130,2,2,3,223,0,728,184414,2,130
2011-10-19,winter,2011,October,13,Wednesday,Workingday,Mist,0.54,0.5152,0.94,0.2836,20,86,106,106,439,106,2,2,3,223,0,729,184919,2,106
2011-10-19,winter,2011,October,14,Wednesday,Workingday,Light Snow,0.54,0.5152,0.94,0.1642,17,80,97,97,439,97,2,2,3,223,0,729,175652,2,97
2011-10-19,winter,2011,October,15,Wednesday,Workingday,Light Snow,0.54,0.5152,1.0,0.1343,21,99,120,120,439,120,2,2,3,223,0,729,183149,2,120
2011-10-19,winter,2011,October,16,Wednesday,Workingday,Light Snow,0.56,0.5303,0.94,0.1642,21,180,201,201,439,201,2,3,3,233,0,730,227748,2,201
2011-10-19,winter,2011,October,17,Wednesday,Workingday,Light Snow,0.56,0.5303,0.94,0.1642,11,170,181,181,439,181,2,3,3,233,0,730,336860,2,181
2011-10-19,winter,2011,October,18,Wednesday,Workingday,Light Snow,0.56,0.5303,1.0,0.1642,8,132,140,140,439,140,2,2,3,223,0,728,309772,2,140
2011-10-19,winter,2011,October,19,Wednesday,Workingday,Mist,0.6,0.5455,0.88,0.1343,8,189,197,197,439,197,2,3,3,233,0,728,226789,2,197
2011-10-19,winter,2011,October,20,Wednesday,Workingday,Light Snow,0.6,0.5152,0.94,0.0896,5,140,145,145,439,145,2,3,3,233,0,728,164550,2,145
2011-10-19,winter,2011,October,21,Wednesday,Workingday,Mist,0.58,0.5455,0.94,0.1343,6,79,85,85,439,85,2,2,3,223,0,728,125445,2,85
2011-10-19,winter,2011,October,22,Wednesday,Workingday,Mist,0.58,0.5455,0.94,0.3582,13,94,107,107,439,107,2,2,3,223,0,728,95612,2,107
2011-10-19,winter,2011,October,23,Wednesday,Workingday,Mist,0.58,0.5455,0.94,0.3582,14,55,69,69,439,69,2,2,3,223,0,728,63941,2,69
2011-10-20,winter,2011,October,0,Thursday,Workingday,Clear,0.56,0.5303,0.94,0.2985,4,22,26,26,438,26,2,1,3,213,0,726,39130,2,26
2011-10-20,winter,2011,October,1,Thursday,Workingday,Clear,0.56,0.5303,0.88,0.3582,4,11,15,15,438,15,2,1,3,213,0,724,24164,2,15
2011-10-20,winter,2011,October,2,Thursday,Workingday,Clear,0.56,0.5303,0.88,0.4478,0,4,4,4,438,4,2,1,3,213,0,715,16352,2,4
2011-10-20,winter,2011,October,3,Thursday,Workingday,Clear,0.5,0.4848,0.82,0.4627,0,1,1,1,438,1,2,1,2,212,0,697,8174,2,1
2011-10-20,winter,2011,October,4,Thursday,Workingday,Clear,0.5,0.4848,0.82,0.4627,2,6,8,8,438,8,2,1,2,212,0,697,4428,2,8
2011-10-20,winter,2011,October,5,Thursday,Workingday,Clear,0.48,0.4697,0.82,0.3582,2,24,26,26,438,26,2,1,2,212,0,717,14261,2,26
2011-10-20,winter,2011,October,6,Thursday,Workingday,Clear,0.44,0.4394,0.82,0.4179,5,87,92,92,438,92,2,2,2,222,1,725,55132,2,92
2011-10-20,winter,2011,October,7,Thursday,Workingday,Clear,0.42,0.4242,0.77,0.4478,15,303,318,318,438,318,2,4,2,242,1,727,154171,2,318
2011-10-20,winter,2011,October,8,Thursday,Workingday,Clear,0.44,0.4394,0.67,0.5224,17,409,426,426,438,426,2,4,2,242,1,727,261001,2,426
2011-10-20,winter,2011,October,9,Thursday,Workingday,Clear,0.44,0.4394,0.67,0.5821,26,197,223,223,438,223,2,3,2,232,1,727,159438,2,223
2011-10-20,winter,2011,October,10,Thursday,Workingday,Clear,0.46,0.4545,0.59,0.4478,25,105,130,130,438,130,2,2,2,222,1,727,126257,2,130
2011-10-20,winter,2011,October,11,Thursday,Workingday,Clear,0.48,0.4697,0.55,0.5224,30,99,129,129,438,129,2,2,2,222,1,727,151320,2,129
2011-10-20,winter,2011,October,12,Thursday,Workingday,Clear,0.48,0.4697,0.48,0.5224,28,171,199,199,438,199,2,3,2,232,1,728,184414,2,199
2011-10-20,winter,2011,October,13,Thursday,Workingday,Clear,0.5,0.4848,0.45,0.5821,28,136,164,164,438,164,2,3,2,232,1,729,184919,2,164
2011-10-20,winter,2011,October,14,Thursday,Workingday,Mist,0.48,0.4697,0.48,0.5522,38,117,155,155,438,155,2,3,2,232,1,729,175652,2,155
2011-10-20,winter,2011,October,15,Thursday,Workingday,Mist,0.48,0.4697,0.51,0.4478,22,138,160,160,438,160,2,3,2,232,1,729,183149,2,160
2011-10-20,winter,2011,October,16,Thursday,Workingday,Mist,0.48,0.4697,0.51,0.4478,31,203,234,234,438,234,2,3,2,232,1,730,227748,2,234
2011-10-20,winter,2011,October,17,Thursday,Workingday,Mist,0.48,0.4697,0.48,0.3881,56,438,494,494,438,494,2,4,2,242,2,730,336860,2,494
2011-10-20,winter,2011,October,18,Thursday,Workingday,Mist,0.46,0.4545,0.51,0.2985,39,430,469,469,438,469,2,4,2,242,2,728,309772,2,469
2011-10-20,winter,2011,October,19,Thursday,Workingday,Clear,0.46,0.4545,0.51,0.3582,20,278,298,298,438,298,2,4,2,242,1,728,226789,2,298
2011-10-20,winter,2011,October,20,Thursday,Workingday,Mist,0.46,0.4545,0.51,0.3284,34,207,241,241,438,241,2,3,2,232,1,728,164550,2,241
2011-10-20,winter,2011,October,21,Thursday,Workingday,Clear,0.44,0.4394,0.51,0.2985,16,149,165,165,438,165,2,3,2,232,1,728,125445,2,165
2011-10-20,winter,2011,October,22,Thursday,Workingday,Clear,0.44,0.4394,0.51,0.3284,22,106,128,128,438,128,2,2,2,222,1,728,95612,2,128
2011-10-20,winter,2011,October,23,Thursday,Workingday,Clear,0.42,0.4242,0.58,0.2537,7,83,90,90,438,90,2,2,2,222,1,728,63941,2,90
2011-10-21,winter,2011,October,0,Friday,Workingday,Clear,0.4,0.4091,0.62,0.2537,8,42,50,50,437,50,2,2,2,222,1,726,39130,2,50
2011-10-21,winter,2011,October,1,Friday,Workingday,Clear,0.4,0.4091,0.62,0.2239,7,19,26,26,437,26,2,1,2,212,1,724,24164,2,26
2011-10-21,winter,2011,October,2,Friday,Workingday,Clear,0.38,0.3939,0.66,0.1642,6,12,18,18,437,18,2,1,2,212,1,715,16352,2,18
2011-10-21,winter,2011,October,3,Friday,Workingday,Clear,0.36,0.3485,0.71,0.1343,0,7,7,7,437,7,2,1,2,212,1,697,8174,2,7
2011-10-21,winter,2011,October,4,Friday,Workingday,Clear,0.36,0.3485,0.71,0.1642,0,6,6,6,437,6,2,1,2,212,1,697,4428,2,6
2011-10-21,winter,2011,October,5,Friday,Workingday,Clear,0.34,0.3333,0.76,0.194,0,31,31,31,437,31,2,1,1,211,1,717,14261,2,31
2011-10-21,winter,2011,October,6,Friday,Workingday,Clear,0.36,0.3485,0.71,0.1642,7,78,85,85,437,85,2,2,2,222,1,725,55132,2,85
2011-10-21,winter,2011,October,7,Friday,Workingday,Clear,0.36,0.3485,0.71,0.1642,5,228,233,233,437,233,2,3,2,232,1,727,154171,2,233
2011-10-21,winter,2011,October,8,Friday,Workingday,Clear,0.4,0.4091,0.62,0.194,16,386,402,402,437,402,2,4,2,242,1,727,261001,2,402
2011-10-21,winter,2011,October,9,Friday,Workingday,Mist,0.42,0.4242,0.58,0.1343,33,189,222,222,437,222,2,3,2,232,1,727,159438,2,222
2011-10-21,winter,2011,October,10,Friday,Workingday,Clear,0.46,0.4545,0.51,0.1642,32,106,138,138,437,138,2,2,2,222,1,727,126257,2,138
2011-10-21,winter,2011,October,11,Friday,Workingday,Clear,0.5,0.4848,0.45,0.2239,39,135,174,174,437,174,2,3,2,232,1,727,151320,2,174
2011-10-21,winter,2011,October,12,Friday,Workingday,Clear,0.5,0.4848,0.45,0.2985,47,193,240,240,437,240,2,3,2,232,2,728,184414,2,240
2011-10-21,winter,2011,October,13,Friday,Workingday,Clear,0.48,0.4697,0.48,0.3284,43,163,206,206,437,206,2,3,2,232,1,729,184919,2,206
2011-10-21,winter,2011,October,14,Friday,Workingday,Clear,0.52,0.5,0.42,0.2985,67,131,198,198,437,198,2,3,3,233,2,729,175652,2,198
2011-10-21,winter,2011,October,15,Friday,Workingday,Clear,0.5,0.4848,0.45,0.2836,57,178,235,235,437,235,2,3,2,232,2,729,183149,2,235
2011-10-21,winter,2011,October,16,Friday,Workingday,Clear,0.5,0.4848,0.45,0.2537,60,242,302,302,437,302,2,4,2,242,2,730,227748,2,302
2011-10-21,winter,2011,October,17,Friday,Workingday,Mist,0.46,0.4545,0.51,0.2537,79,445,524,524,437,524,2,4,2,242,2,730,336860,2,524
2011-10-21,winter,2011,October,18,Friday,Workingday,Mist,0.44,0.4394,0.54,0.2537,43,354,397,397,437,397,2,4,2,242,2,728,309772,2,397
2011-10-21,winter,2011,October,19,Friday,Workingday,Mist,0.44,0.4394,0.54,0.3881,25,228,253,253,437,253,2,3,2,232,1,728,226789,2,253
2011-10-21,winter,2011,October,20,Friday,Workingday,Mist,0.44,0.4394,0.54,0.2239,29,155,184,184,437,184,2,3,2,232,1,728,164550,2,184
2011-10-21,winter,2011,October,21,Friday,Workingday,Clear,0.42,0.4242,0.58,0.1642,31,112,143,143,437,143,2,3,2,232,1,728,125445,2,143
2011-10-21,winter,2011,October,22,Friday,Workingday,Clear,0.42,0.4242,0.54,0.1642,24,89,113,113,437,113,2,2,2,222,1,728,95612,2,113
2011-10-21,winter,2011,October,23,Friday,Workingday,Clear,0.4,0.4091,0.62,0.2239,18,99,117,117,437,117,2,2,2,222,1,728,63941,2,117
2011-10-22,winter,2011,October,0,Saturday,Holiday,Clear,0.4,0.4091,0.62,0.194,16,80,96,96,436,96,2,2,2,222,1,726,39130,2,96
2011-10-22,winter,2011,October,1,Saturday,Holiday,Clear,0.4,0.4091,0.62,0.194,20,50,70,70,436,70,2,2,2,222,1,724,24164,2,70
2011-10-22,winter,2011,October,2,Saturday,Holiday,Clear,0.4,0.4091,0.62,0.2537,6,25,31,31,436,31,2,1,2,212,1,715,16352,2,31
2011-10-22,winter,2011,October,3,Saturday,Holiday,Clear,0.4,0.4091,0.62,0.1343,1,19,20,20,436,20,2,1,2,212,1,697,8174,2,20
2011-10-22,winter,2011,October,4,Saturday,Holiday,Clear,0.38,0.3939,0.66,0.0896,4,4,8,8,436,8,2,1,2,212,1,697,4428,2,8
2011-10-22,winter,2011,October,5,Saturday,Holiday,Clear,0.38,0.3939,0.66,0.0,1,7,8,8,436,8,2,1,2,212,0,717,14261,2,8
2011-10-22,winter,2011,October,6,Saturday,Holiday,Clear,0.36,0.3788,0.71,0.0,1,17,18,18,436,18,2,1,2,212,0,725,55132,2,18
2011-10-22,winter,2011,October,7,Saturday,Holiday,Clear,0.36,0.3636,0.76,0.1045,8,49,57,57,436,57,2,2,2,222,1,727,154171,2,57
2011-10-22,winter,2011,October,8,Saturday,Holiday,Clear,0.4,0.4091,0.71,0.0,26,88,114,114,436,114,2,2,2,222,0,727,261001,2,114
2011-10-22,winter,2011,October,9,Saturday,Holiday,Clear,0.42,0.4242,0.67,0.0896,47,122,169,169,436,169,2,3,2,232,0,727,159438,2,169
2011-10-22,winter,2011,October,10,Saturday,Holiday,Mist,0.44,0.4394,0.62,0.1045,87,149,236,236,436,236,2,3,2,232,0,727,126257,2,236
2011-10-22,winter,2011,October,11,Saturday,Holiday,Mist,0.44,0.4394,0.62,0.1045,110,172,282,282,436,282,2,4,2,242,2,727,151320,2,282
2011-10-22,winter,2011,October,12,Saturday,Holiday,Clear,0.46,0.4545,0.55,0.0896,132,211,343,343,436,343,2,4,2,242,2,728,184414,2,343
2011-10-22,winter,2011,October,13,Saturday,Holiday,Clear,0.5,0.4848,0.45,0.0,136,186,322,322,436,322,2,4,2,242,2,729,184919,2,322
2011-10-22,winter,2011,October,14,Saturday,Holiday,Mist,0.48,0.4697,0.48,0.2239,133,177,310,310,436,310,2,4,2,242,2,729,175652,2,310
2011-10-22,winter,2011,October,15,Saturday,Holiday,Clear,0.48,0.4697,0.51,0.2239,159,223,382,382,436,382,2,4,2,242,2,729,183149,2,382
2011-10-22,winter,2011,October,16,Saturday,Holiday,Clear,0.5,0.4848,0.45,0.194,169,190,359,359,436,359,2,4,2,242,2,730,227748,2,359
2011-10-22,winter,2011,October,17,Saturday,Holiday,Clear,0.46,0.4545,0.55,0.1343,143,217,360,360,436,360,2,4,2,242,2,730,336860,2,360
2011-10-22,winter,2011,October,18,Saturday,Holiday,Clear,0.44,0.4394,0.54,0.0896,111,224,335,335,436,335,2,4,2,242,2,728,309772,2,335
2011-10-22,winter,2011,October,19,Saturday,Holiday,Clear,0.44,0.4394,0.67,0.0,47,173,220,220,436,220,2,3,2,232,0,728,226789,2,220
2011-10-22,winter,2011,October,20,Saturday,Holiday,Clear,0.42,0.4242,0.67,0.0,48,111,159,159,436,159,2,3,2,232,0,728,164550,2,159
2011-10-22,winter,2011,October,21,Saturday,Holiday,Clear,0.4,0.4091,0.76,0.0,37,120,157,157,436,157,2,3,2,232,0,728,125445,2,157
2011-10-22,winter,2011,October,22,Saturday,Holiday,Clear,0.4,0.4091,0.76,0.0,30,114,144,144,436,144,2,3,2,232,0,728,95612,2,144
2011-10-22,winter,2011,October,23,Saturday,Holiday,Clear,0.38,0.3939,0.82,0.0,27,81,108,108,436,108,2,2,2,222,0,728,63941,2,108
2011-10-23,winter,2011,October,0,Sunday,Holiday,Clear,0.36,0.3788,0.87,0.0,24,64,88,88,435,88,2,2,2,222,0,726,39130,2,88
2011-10-23,winter,2011,October,1,Sunday,Holiday,Clear,0.36,0.3788,0.87,0.0,11,60,71,71,435,71,2,2,2,222,0,724,24164,2,71
2011-10-23,winter,2011,October,2,Sunday,Holiday,Clear,0.34,0.3485,0.87,0.0896,10,40,50,50,435,50,2,2,2,222,0,715,16352,2,50
2011-10-23,winter,2011,October,3,Sunday,Holiday,Clear,0.34,0.3636,0.87,0.0,15,31,46,46,435,46,2,2,2,222,0,697,8174,2,46
2011-10-23,winter,2011,October,4,Sunday,Holiday,Clear,0.34,0.3636,0.87,0.0,5,1,6,6,435,6,2,1,2,212,0,697,4428,2,6
2011-10-23,winter,2011,October,5,Sunday,Holiday,Clear,0.32,0.3485,0.87,0.0,1,2,3,3,435,3,2,1,2,212,0,717,14261,2,3
2011-10-23,winter,2011,October,6,Sunday,Holiday,Clear,0.32,0.3333,0.87,0.1045,0,12,12,12,435,12,2,1,1,211,1,725,55132,2,12
2011-10-23,winter,2011,October,7,Sunday,Holiday,Clear,0.34,0.3485,0.87,0.0896,3,18,21,21,435,21,2,1,2,212,0,727,154171,2,21
2011-10-23,winter,2011,October,8,Sunday,Holiday,Clear,0.36,0.3485,0.87,0.1343,32,56,88,88,435,88,2,2,2,222,0,727,261001,2,88
2011-10-23,winter,2011,October,9,Sunday,Holiday,Clear,0.4,0.4091,0.76,0.0,48,95,143,143,435,143,2,3,2,232,0,727,159438,2,143
2011-10-23,winter,2011,October,10,Sunday,Holiday,Clear,0.42,0.4242,0.71,0.0896,104,185,289,289,435,289,2,4,2,242,0,727,126257,2,289
2011-10-23,winter,2011,October,11,Sunday,Holiday,Clear,0.46,0.4545,0.72,0.1642,131,202,333,333,435,333,2,4,2,242,2,727,151320,2,333
2011-10-23,winter,2011,October,12,Sunday,Holiday,Clear,0.5,0.4848,0.59,0.2537,164,249,413,413,435,413,2,4,2,242,2,728,184414,2,413
2011-10-23,winter,2011,October,13,Sunday,Holiday,Clear,0.52,0.5,0.55,0.194,160,255,415,415,435,415,2,4,3,243,2,729,184919,2,415
2011-10-23,winter,2011,October,14,Sunday,Holiday,Clear,0.52,0.5,0.55,0.2239,192,216,408,408,435,408,2,4,3,243,2,729,175652,2,408
2011-10-23,winter,2011,October,15,Sunday,Holiday,Clear,0.52,0.5,0.52,0.1642,171,216,387,387,435,387,2,4,3,243,2,729,183149,2,387
2011-10-23,winter,2011,October,16,Sunday,Holiday,Clear,0.52,0.5,0.55,0.194,188,217,405,405,435,405,2,4,3,243,2,730,227748,2,405
2011-10-23,winter,2011,October,17,Sunday,Holiday,Clear,0.5,0.4848,0.63,0.1343,120,220,340,340,435,340,2,4,2,242,2,730,336860,2,340
2011-10-23,winter,2011,October,18,Sunday,Holiday,Clear,0.5,0.4848,0.63,0.1045,88,196,284,284,435,284,2,4,2,242,0,728,309772,2,284
2011-10-23,winter,2011,October,19,Sunday,Holiday,Clear,0.46,0.4545,0.77,0.0,53,140,193,193,435,193,2,3,2,232,0,728,226789,2,193
2011-10-23,winter,2011,October,20,Sunday,Holiday,Clear,0.44,0.4394,0.72,0.0896,32,112,144,144,435,144,2,3,2,232,0,728,164550,2,144
2011-10-23,winter,2011,October,21,Sunday,Holiday,Clear,0.44,0.4394,0.72,0.0896,24,75,99,99,435,99,2,2,2,222,0,728,125445,2,99
2011-10-23,winter,2011,October,22,Sunday,Holiday,Clear,0.42,0.4242,0.77,0.1045,25,69,94,94,435,94,2,2,2,222,0,728,95612,2,94
2011-10-23,winter,2011,October,23,Sunday,Holiday,Clear,0.42,0.4242,0.77,0.1642,18,31,49,49,435,49,2,2,2,222,0,728,63941,2,49
2011-10-24,winter,2011,October,0,Monday,Workingday,Clear,0.42,0.4242,0.77,0.0,6,26,32,32,434,32,2,1,2,212,0,726,39130,2,32
2011-10-24,winter,2011,October,1,Monday,Workingday,Clear,0.4,0.4091,0.82,0.1343,7,8,15,15,434,15,2,1,2,212,0,724,24164,2,15
2011-10-24,winter,2011,October,2,Monday,Workingday,Clear,0.4,0.4091,0.87,0.1045,1,6,7,7,434,7,2,1,2,212,0,715,16352,2,7
2011-10-24,winter,2011,October,3,Monday,Workingday,Clear,0.4,0.4091,0.82,0.0896,1,3,4,4,434,4,2,1,2,212,0,697,8174,2,4
2011-10-24,winter,2011,October,4,Monday,Workingday,Clear,0.4,0.4091,0.82,0.0,1,5,6,6,434,6,2,1,2,212,0,697,4428,2,6
2011-10-24,winter,2011,October,5,Monday,Workingday,Clear,0.38,0.3939,0.87,0.0,2,19,21,21,434,21,2,1,2,212,0,717,14261,2,21
2011-10-24,winter,2011,October,6,Monday,Workingday,Clear,0.4,0.4091,0.87,0.1045,3,83,86,86,434,86,2,2,2,222,0,725,55132,2,86
2011-10-24,winter,2011,October,7,Monday,Workingday,Mist,0.38,0.3939,0.94,0.1045,11,274,285,285,434,285,2,4,2,242,0,727,154171,2,285
2011-10-24,winter,2011,October,8,Monday,Workingday,Mist,0.42,0.4242,0.88,0.1642,20,378,398,398,434,398,2,4,2,242,0,727,261001,2,398
2011-10-24,winter,2011,October,9,Monday,Workingday,Mist,0.44,0.4394,0.82,0.1642,29,166,195,195,434,195,2,3,2,232,0,727,159438,2,195
2011-10-24,winter,2011,October,10,Monday,Workingday,Mist,0.46,0.4545,0.82,0.2537,47,82,129,129,434,129,2,2,2,222,0,727,126257,2,129
2011-10-24,winter,2011,October,11,Monday,Workingday,Mist,0.5,0.4848,0.72,0.1642,59,109,168,168,434,168,2,3,2,232,0,727,151320,2,168
2011-10-24,winter,2011,October,12,Monday,Workingday,Mist,0.52,0.5,0.68,0.1045,64,156,220,220,434,220,2,3,3,233,0,728,184414,2,220
2011-10-24,winter,2011,October,13,Monday,Workingday,Mist,0.54,0.5152,0.64,0.2239,60,138,198,198,434,198,2,3,3,233,0,729,184919,2,198
2011-10-24,winter,2011,October,14,Monday,Workingday,Mist,0.54,0.5152,0.64,0.194,63,143,206,206,434,206,2,3,3,233,0,729,175652,2,206
2011-10-24,winter,2011,October,15,Monday,Workingday,Clear,0.56,0.5303,0.6,0.1642,52,125,177,177,434,177,2,3,3,233,0,729,183149,2,177
2011-10-24,winter,2011,October,16,Monday,Workingday,Clear,0.54,0.5152,0.64,0.194,68,242,310,310,434,310,2,4,3,243,2,730,227748,2,310
2011-10-24,winter,2011,October,17,Monday,Workingday,Clear,0.52,0.5,0.68,0.1343,87,527,614,614,434,614,2,4,3,243,2,730,336860,2,614
2011-10-24,winter,2011,October,18,Monday,Workingday,Clear,0.54,0.5152,0.6,0.0896,58,428,486,486,434,486,2,4,3,243,2,728,309772,2,486
2011-10-24,winter,2011,October,19,Monday,Workingday,Light Snow,0.48,0.4697,0.82,0.0,25,212,237,237,434,237,2,3,2,232,0,728,226789,2,237
2011-10-24,winter,2011,October,20,Monday,Workingday,Clear,0.48,0.4697,0.82,0.1045,11,118,129,129,434,129,2,2,2,222,0,728,164550,2,129
2011-10-24,winter,2011,October,21,Monday,Workingday,Clear,0.46,0.4545,0.87,0.1045,12,114,126,126,434,126,2,2,2,222,0,728,125445,2,126
2011-10-24,winter,2011,October,22,Monday,Workingday,Clear,0.48,0.4697,0.75,0.1642,3,76,79,79,434,79,2,2,2,222,0,728,95612,2,79
2011-10-24,winter,2011,October,23,Monday,Workingday,Clear,0.46,0.4545,0.77,0.0896,9,50,59,59,434,59,2,2,2,222,0,728,63941,2,59
2011-10-25,winter,2011,October,0,Tuesday,Workingday,Clear,0.44,0.4394,0.77,0.1343,4,26,30,30,433,30,2,1,2,212,0,726,39130,2,30
2011-10-25,winter,2011,October,1,Tuesday,Workingday,Clear,0.44,0.4394,0.77,0.1343,5,6,11,11,433,11,2,1,2,212,0,724,24164,2,11
2011-10-25,winter,2011,October,2,Tuesday,Workingday,Clear,0.42,0.4242,0.82,0.1343,2,3,5,5,433,5,2,1,2,212,0,715,16352,2,5
2011-10-25,winter,2011,October,3,Tuesday,Workingday,Clear,0.4,0.4091,0.87,0.0,1,3,4,4,433,4,2,1,2,212,0,697,8174,2,4
2011-10-25,winter,2011,October,4,Tuesday,Workingday,Clear,0.38,0.3939,0.87,0.1343,0,5,5,5,433,5,2,1,2,212,0,697,4428,2,5
2011-10-25,winter,2011,October,5,Tuesday,Workingday,Clear,0.38,0.3939,0.87,0.1343,0,24,24,24,433,24,2,1,2,212,0,717,14261,2,24
2011-10-25,winter,2011,October,6,Tuesday,Workingday,Clear,0.38,0.3939,0.82,0.1045,3,95,98,98,433,98,2,2,2,222,0,725,55132,2,98
2011-10-25,winter,2011,October,7,Tuesday,Workingday,Clear,0.4,0.4091,0.76,0.194,15,299,314,314,433,314,2,4,2,242,0,727,154171,2,314
2011-10-25,winter,2011,October,8,Tuesday,Workingday,Clear,0.44,0.4394,0.72,0.0,25,383,408,408,433,408,2,4,2,242,0,727,261001,2,408
2011-10-25,winter,2011,October,9,Tuesday,Workingday,Clear,0.48,0.4697,0.55,0.2239,29,194,223,223,433,223,2,3,2,232,1,727,159438,2,223
2011-10-25,winter,2011,October,10,Tuesday,Workingday,Clear,0.5,0.4848,0.51,0.2537,26,102,128,128,433,128,2,2,2,222,1,727,126257,2,128
2011-10-25,winter,2011,October,11,Tuesday,Workingday,Clear,0.52,0.5,0.48,0.2836,46,120,166,166,433,166,2,3,3,233,1,727,151320,2,166
2011-10-25,winter,2011,October,12,Tuesday,Workingday,Clear,0.54,0.5152,0.39,0.3582,35,165,200,200,433,200,2,3,3,233,2,728,184414,2,200
2011-10-25,winter,2011,October,13,Tuesday,Workingday,Clear,0.56,0.5303,0.37,0.3881,37,161,198,198,433,198,2,3,3,233,2,729,184919,2,198
2011-10-25,winter,2011,October,14,Tuesday,Workingday,Clear,0.56,0.5303,0.4,0.2537,66,134,200,200,433,200,2,3,3,233,2,729,175652,2,200
2011-10-25,winter,2011,October,15,Tuesday,Workingday,Clear,0.56,0.5303,0.37,0.1045,63,171,234,234,433,234,2,3,3,233,2,729,183149,2,234
2011-10-25,winter,2011,October,16,Tuesday,Workingday,Clear,0.56,0.5303,0.37,0.194,52,233,285,285,433,285,2,4,3,243,2,730,227748,2,285
2011-10-25,winter,2011,October,17,Tuesday,Workingday,Clear,0.56,0.5303,0.37,0.1045,68,517,585,585,433,585,2,4,3,243,2,730,336860,2,585
2011-10-25,winter,2011,October,18,Tuesday,Workingday,Clear,0.52,0.5,0.42,0.1045,65,453,518,518,433,518,2,4,3,243,2,728,309772,2,518
2011-10-25,winter,2011,October,19,Tuesday,Workingday,Clear,0.48,0.4697,0.67,0.194,44,294,338,338,433,338,2,4,2,242,0,728,226789,2,338
2011-10-25,winter,2011,October,20,Tuesday,Workingday,Clear,0.46,0.4545,0.67,0.1045,40,208,248,248,433,248,2,3,2,232,0,728,164550,2,248
2011-10-25,winter,2011,October,21,Tuesday,Workingday,Clear,0.44,0.4394,0.72,0.1343,32,169,201,201,433,201,2,3,2,232,0,728,125445,2,201
2011-10-25,winter,2011,October,22,Tuesday,Workingday,Clear,0.46,0.4545,0.67,0.194,22,148,170,170,433,170,2,3,2,232,0,728,95612,2,170
2011-10-25,winter,2011,October,23,Tuesday,Workingday,Clear,0.44,0.4394,0.72,0.1343,15,79,94,94,433,94,2,2,2,222,0,728,63941,2,94
2011-10-26,winter,2011,October,0,Wednesday,Workingday,Clear,0.44,0.4394,0.72,0.194,4,28,32,32,432,32,2,1,2,212,0,726,39130,2,32
2011-10-26,winter,2011,October,1,Wednesday,Workingday,Clear,0.44,0.4394,0.67,0.2537,3,9,12,12,432,12,2,1,2,212,1,724,24164,2,12
2011-10-26,winter,2011,October,2,Wednesday,Workingday,Clear,0.44,0.4394,0.67,0.1642,2,1,3,3,432,3,2,1,2,212,0,715,16352,2,3
2011-10-26,winter,2011,October,3,Wednesday,Workingday,Clear,0.44,0.4394,0.67,0.2239,0,3,3,3,432,3,2,1,2,212,1,697,8174,2,3
2011-10-26,winter,2011,October,4,Wednesday,Workingday,Clear,0.42,0.4242,0.71,0.2537,0,5,5,5,432,5,2,1,2,212,1,697,4428,2,5
2011-10-26,winter,2011,October,5,Wednesday,Workingday,Clear,0.42,0.4242,0.71,0.2239,0,21,21,21,432,21,2,1,2,212,1,717,14261,2,21
2011-10-26,winter,2011,October,6,Wednesday,Workingday,Clear,0.42,0.4242,0.71,0.2239,0,92,92,92,432,92,2,2,2,222,1,725,55132,2,92
2011-10-26,winter,2011,October,7,Wednesday,Workingday,Clear,0.42,0.4242,0.71,0.1642,15,284,299,299,432,299,2,4,2,242,0,727,154171,2,299
2011-10-26,winter,2011,October,8,Wednesday,Workingday,Mist,0.44,0.4394,0.67,0.194,26,438,464,464,432,464,2,4,2,242,0,727,261001,2,464
2011-10-26,winter,2011,October,9,Wednesday,Workingday,Mist,0.48,0.4697,0.63,0.2239,14,226,240,240,432,240,2,3,2,232,0,727,159438,2,240
2011-10-26,winter,2011,October,10,Wednesday,Workingday,Mist,0.52,0.5,0.62,0.2537,26,105,131,131,432,131,2,2,3,223,0,727,126257,2,131
2011-10-26,winter,2011,October,11,Wednesday,Workingday,Clear,0.52,0.5,0.59,0.3284,23,132,155,155,432,155,2,3,3,233,0,727,151320,2,155
2011-10-26,winter,2011,October,12,Wednesday,Workingday,Light Snow,0.58,0.5455,0.53,0.2239,39,155,194,194,432,194,2,3,3,233,0,728,184414,2,194
2011-10-26,winter,2011,October,13,Wednesday,Workingday,Light Snow,0.56,0.5303,0.6,0.1045,20,62,82,82,432,82,2,2,3,223,0,729,184919,2,82
2011-10-26,winter,2011,October,14,Wednesday,Workingday,Mist,0.52,0.5,0.77,0.0,14,52,66,66,432,66,2,2,3,223,0,729,175652,2,66
2011-10-26,winter,2011,October,15,Wednesday,Workingday,Mist,0.52,0.5,0.77,0.0,11,59,70,70,432,70,2,2,3,223,0,729,183149,2,70
2011-10-26,winter,2011,October,16,Wednesday,Workingday,Mist,0.52,0.5,0.77,0.0896,17,196,213,213,432,213,2,3,3,233,0,730,227748,2,213
2011-10-26,winter,2011,October,17,Wednesday,Workingday,Mist,0.52,0.5,0.77,0.1045,40,414,454,454,432,454,2,4,3,243,0,730,336860,2,454
2011-10-26,winter,2011,October,18,Wednesday,Workingday,Clear,0.52,0.5,0.77,0.1642,55,398,453,453,432,453,2,4,3,243,2,728,309772,2,453
2011-10-26,winter,2011,October,19,Wednesday,Workingday,Clear,0.5,0.4848,0.82,0.0,25,306,331,331,432,331,2,4,2,242,0,728,226789,2,331
2011-10-26,winter,2011,October,20,Wednesday,Workingday,Clear,0.5,0.4848,0.88,0.0,27,180,207,207,432,207,2,3,2,232,0,728,164550,2,207
2011-10-26,winter,2011,October,21,Wednesday,Workingday,Mist,0.52,0.5,0.77,0.0,17,140,157,157,432,157,2,3,3,233,0,728,125445,2,157
2011-10-26,winter,2011,October,22,Wednesday,Workingday,Mist,0.48,0.4697,0.88,0.0896,23,112,135,135,432,135,2,2,2,222,0,728,95612,2,135
2011-10-26,winter,2011,October,23,Wednesday,Workingday,Mist,0.48,0.4697,0.88,0.0896,3,72,75,75,432,75,2,2,2,222,0,728,63941,2,75
2011-10-27,winter,2011,October,0,Thursday,Workingday,Clear,0.46,0.4545,0.94,0.0,3,23,26,26,431,26,2,1,2,212,0,726,39130,2,26
2011-10-27,winter,2011,October,1,Thursday,Workingday,Clear,0.46,0.4545,0.94,0.0,2,9,11,11,431,11,2,1,2,212,0,724,24164,2,11
2011-10-27,winter,2011,October,2,Thursday,Workingday,Light Snow,0.46,0.4545,0.94,0.0,3,5,8,8,431,8,2,1,2,212,0,715,16352,2,8
2011-10-27,winter,2011,October,3,Thursday,Workingday,Light Snow,0.46,0.4545,0.94,0.0,1,3,4,4,431,4,2,1,2,212,0,697,8174,2,4
2011-10-27,winter,2011,October,4,Thursday,Workingday,Light Snow,0.48,0.4697,0.88,0.0,1,3,4,4,431,4,2,1,2,212,0,697,4428,2,4
2011-10-27,winter,2011,October,5,Thursday,Workingday,Light Snow,0.48,0.4697,0.88,0.0896,1,14,15,15,431,15,2,1,2,212,0,717,14261,2,15
2011-10-27,winter,2011,October,6,Thursday,Workingday,Light Snow,0.5,0.4848,0.82,0.0,4,42,46,46,431,46,2,2,2,222,0,725,55132,2,46
2011-10-27,winter,2011,October,7,Thursday,Workingday,Mist,0.46,0.4545,0.94,0.0896,9,128,137,137,431,137,2,2,2,222,0,727,154171,2,137
2011-10-27,winter,2011,October,8,Thursday,Workingday,Light Snow,0.48,0.4697,0.88,0.194,12,304,316,316,431,316,2,4,2,242,0,727,261001,2,316
2011-10-27,winter,2011,October,9,Thursday,Workingday,Mist,0.5,0.4848,0.82,0.1642,16,155,171,171,431,171,2,3,2,232,0,727,159438,2,171
2011-10-27,winter,2011,October,10,Thursday,Workingday,Light Snow,0.5,0.4848,0.88,0.194,10,52,62,62,431,62,2,2,2,222,0,727,126257,2,62
2011-10-27,winter,2011,October,11,Thursday,Workingday,Light Snow,0.5,0.4848,0.88,0.1343,8,44,52,52,431,52,2,2,2,222,0,727,151320,2,52
2011-10-27,winter,2011,October,12,Thursday,Workingday,Light Snow,0.5,0.4848,0.88,0.1343,8,45,53,53,431,53,2,2,2,222,0,728,184414,2,53
2011-10-27,winter,2011,October,13,Thursday,Workingday,Mist,0.5,0.4848,0.88,0.1642,10,64,74,74,431,74,2,2,2,222,0,729,184919,2,74
2011-10-27,winter,2011,October,14,Thursday,Workingday,Mist,0.52,0.5,0.83,0.0,16,76,92,92,431,92,2,2,3,223,0,729,175652,2,92
2011-10-27,winter,2011,October,15,Thursday,Workingday,Mist,0.52,0.5,0.83,0.1045,12,95,107,107,431,107,2,2,3,223,0,729,183149,2,107
2011-10-27,winter,2011,October,16,Thursday,Workingday,Mist,0.56,0.5303,0.73,0.1642,14,193,207,207,431,207,2,3,3,233,0,730,227748,2,207
2011-10-27,winter,2011,October,17,Thursday,Workingday,Mist,0.5,0.4848,0.72,0.4627,31,291,322,322,431,322,2,4,2,242,2,730,336860,2,322
2011-10-27,winter,2011,October,18,Thursday,Workingday,Mist,0.48,0.4697,0.67,0.4627,14,226,240,240,431,240,2,3,2,232,1,728,309772,2,240
2011-10-27,winter,2011,October,19,Thursday,Workingday,Mist,0.44,0.4394,0.67,0.4627,19,200,219,219,431,219,2,3,2,232,1,728,226789,2,219
2011-10-27,winter,2011,October,20,Thursday,Workingday,Clear,0.42,0.4242,0.67,0.4925,11,171,182,182,431,182,2,3,2,232,1,728,164550,2,182
2011-10-27,winter,2011,October,21,Thursday,Workingday,Clear,0.4,0.4091,0.62,0.5224,13,119,132,132,431,132,2,2,2,222,1,728,125445,2,132
2011-10-27,winter,2011,October,22,Thursday,Workingday,Clear,0.36,0.3182,0.66,0.4925,14,97,111,111,431,111,2,2,1,221,1,728,95612,2,111
2011-10-27,winter,2011,October,23,Thursday,Workingday,Clear,0.34,0.303,0.61,0.4179,8,60,68,68,431,68,2,2,1,221,1,728,63941,2,68
2011-10-28,winter,2011,October,0,Friday,Workingday,Clear,0.34,0.3182,0.66,0.2537,4,40,44,44,430,44,2,2,1,221,1,726,39130,2,44
2011-10-28,winter,2011,October,1,Friday,Workingday,Clear,0.32,0.303,0.66,0.2537,7,9,16,16,430,16,2,1,1,211,1,724,24164,2,16
2011-10-28,winter,2011,October,2,Friday,Workingday,Clear,0.32,0.303,0.66,0.2836,1,3,4,4,430,4,2,1,1,211,1,715,16352,2,4
2011-10-28,winter,2011,October,3,Friday,Workingday,Clear,0.3,0.2879,0.7,0.2836,4,4,8,8,430,8,2,1,1,211,1,697,8174,2,8
2011-10-28,winter,2011,October,4,Friday,Workingday,Clear,0.3,0.2879,0.65,0.2836,5,5,10,10,430,10,2,1,1,211,1,697,4428,2,10
2011-10-28,winter,2011,October,5,Friday,Workingday,Mist,0.3,0.2879,0.61,0.2537,0,25,25,25,430,25,2,1,1,211,1,717,14261,2,25
2011-10-28,winter,2011,October,6,Friday,Workingday,Clear,0.28,0.2727,0.65,0.2537,1,74,75,75,430,75,2,2,1,221,1,725,55132,2,75
2011-10-28,winter,2011,October,7,Friday,Workingday,Clear,0.28,0.2727,0.65,0.2537,6,199,205,205,430,205,2,3,1,231,1,727,154171,2,205
2011-10-28,winter,2011,October,8,Friday,Workingday,Clear,0.3,0.2879,0.61,0.2836,13,361,374,374,430,374,2,4,1,241,1,727,261001,2,374
2011-10-28,winter,2011,October,9,Friday,Workingday,Clear,0.32,0.303,0.57,0.2239,19,210,229,229,430,229,2,3,1,231,1,727,159438,2,229
2011-10-28,winter,2011,October,10,Friday,Workingday,Clear,0.34,0.3182,0.57,0.2239,28,102,130,130,430,130,2,2,1,221,1,727,126257,2,130
2011-10-28,winter,2011,October,11,Friday,Workingday,Clear,0.36,0.3485,0.5,0.2239,40,128,168,168,430,168,2,3,2,232,1,727,151320,2,168
2011-10-28,winter,2011,October,12,Friday,Workingday,Mist,0.38,0.3939,0.4,0.1642,46,167,213,213,430,213,2,3,2,232,1,728,184414,2,213
2011-10-28,winter,2011,October,13,Friday,Workingday,Mist,0.38,0.3939,0.42,0.2239,43,185,228,228,430,228,2,3,2,232,1,729,184919,2,228
2011-10-28,winter,2011,October,14,Friday,Workingday,Mist,0.36,0.3485,0.46,0.194,33,152,185,185,430,185,2,3,2,232,1,729,175652,2,185
2011-10-28,winter,2011,October,15,Friday,Workingday,Mist,0.36,0.3333,0.43,0.2537,44,171,215,215,430,215,2,3,1,231,1,729,183149,2,215
2011-10-28,winter,2011,October,16,Friday,Workingday,Mist,0.36,0.3485,0.46,0.1642,46,262,308,308,430,308,2,4,2,242,1,730,227748,2,308
2011-10-28,winter,2011,October,17,Friday,Workingday,Mist,0.36,0.3485,0.5,0.1343,35,411,446,446,430,446,2,4,2,242,1,730,336860,2,446
2011-10-28,winter,2011,October,18,Friday,Workingday,Mist,0.36,0.3485,0.53,0.1642,36,332,368,368,430,368,2,4,2,242,1,728,309772,2,368
2011-10-28,winter,2011,October,19,Friday,Workingday,Mist,0.36,0.3485,0.5,0.1343,16,188,204,204,430,204,2,3,2,232,1,728,226789,2,204
2011-10-28,winter,2011,October,20,Friday,Workingday,Light Snow,0.34,0.3182,0.61,0.2239,12,131,143,143,430,143,2,3,1,231,1,728,164550,2,143
2011-10-28,winter,2011,October,21,Friday,Workingday,Light Snow,0.32,0.3182,0.7,0.1642,5,69,74,74,430,74,2,2,1,221,1,728,125445,2,74
2011-10-28,winter,2011,October,22,Friday,Workingday,Light Snow,0.3,0.2879,0.75,0.2836,4,32,36,36,430,36,2,1,1,211,1,728,95612,2,36
2011-10-28,winter,2011,October,23,Friday,Workingday,Light Snow,0.3,0.2727,0.81,0.3284,8,31,39,39,430,39,2,1,1,211,1,728,63941,2,39
2011-10-29,winter,2011,October,0,Saturday,Holiday,Light Snow,0.28,0.2576,0.87,0.2985,0,19,19,19,429,19,2,1,1,211,1,726,39130,2,19
2011-10-29,winter,2011,October,1,Saturday,Holiday,Light Snow,0.3,0.2727,0.87,0.2985,0,18,18,18,429,18,2,1,1,211,1,724,24164,2,18
2011-10-29,winter,2011,October,2,Saturday,Holiday,Light Snow,0.3,0.2727,0.87,0.2985,1,16,17,17,429,17,2,1,1,211,1,715,16352,2,17
2011-10-29,winter,2011,October,3,Saturday,Holiday,Light Snow,0.3,0.2727,0.81,0.4179,0,8,8,8,429,8,2,1,1,211,1,697,8174,2,8
2011-10-29,winter,2011,October,4,Saturday,Holiday,Light Snow,0.3,0.2727,0.81,0.4179,0,1,1,1,429,1,2,1,1,211,1,697,4428,2,1
2011-10-29,winter,2011,October,5,Saturday,Holiday,Light Snow,0.26,0.2273,0.93,0.3582,0,1,1,1,429,1,2,1,1,211,1,717,14261,2,1
2011-10-29,winter,2011,October,6,Saturday,Holiday,Light Snow,0.26,0.2273,0.87,0.3582,4,1,5,5,429,5,2,1,1,211,1,725,55132,2,5
2011-10-29,winter,2011,October,7,Saturday,Holiday,Light Snow,0.26,0.2273,0.87,0.3582,1,6,7,7,429,7,2,1,1,211,1,727,154171,2,7
2011-10-29,winter,2011,October,8,Saturday,Holiday,Light Snow,0.28,0.2576,0.87,0.3582,4,16,20,20,429,20,2,1,1,211,1,727,261001,2,20
2011-10-29,winter,2011,October,9,Saturday,Holiday,Light Snow,0.28,0.2576,0.87,0.3582,1,19,20,20,429,20,2,1,1,211,1,727,159438,2,20
2011-10-29,winter,2011,October,10,Saturday,Holiday,Light Snow,0.26,0.2273,0.93,0.3284,0,12,12,12,429,12,2,1,1,211,1,727,126257,2,12
2011-10-29,winter,2011,October,11,Saturday,Holiday,Light Snow,0.26,0.2273,0.93,0.3881,1,26,27,27,429,27,2,1,1,211,1,727,151320,2,27
2011-10-29,winter,2011,October,12,Saturday,Holiday,Light Snow,0.24,0.197,0.87,0.4925,6,44,50,50,429,50,2,2,1,221,1,728,184414,2,50
2011-10-29,winter,2011,October,13,Saturday,Holiday,Light Snow,0.24,0.197,0.87,0.5224,0,30,30,30,429,30,2,1,1,211,1,729,184919,2,30
2011-10-29,winter,2011,October,14,Saturday,Holiday,Light Snow,0.24,0.197,0.87,0.4478,0,29,29,29,429,29,2,1,1,211,1,729,175652,2,29
2011-10-29,winter,2011,October,15,Saturday,Holiday,Light Snow,0.22,0.2121,0.93,0.2537,3,38,41,41,429,41,2,2,1,221,1,729,183149,2,41
2011-10-29,winter,2011,October,16,Saturday,Holiday,Light Snow,0.22,0.197,0.93,0.3284,3,19,22,22,429,22,2,1,1,211,1,730,227748,2,22
2011-10-29,winter,2011,October,17,Saturday,Holiday,Light Snow,0.22,0.197,0.93,0.3284,3,28,31,31,429,31,2,1,1,211,1,730,336860,2,31
2011-10-29,winter,2011,October,18,Saturday,Holiday,Light Snow,0.22,0.197,0.93,0.3284,6,37,43,43,429,43,2,2,1,221,1,728,309772,2,43
2011-10-29,winter,2011,October,19,Saturday,Holiday,Clear,0.24,0.2121,0.87,0.3582,3,36,39,39,429,39,2,1,1,211,1,728,226789,2,39
2011-10-29,winter,2011,October,20,Saturday,Holiday,Clear,0.24,0.2121,0.87,0.3582,7,40,47,47,429,47,2,2,1,221,1,728,164550,2,47
2011-10-29,winter,2011,October,21,Saturday,Holiday,Clear,0.24,0.2121,0.87,0.3582,1,49,50,50,429,50,2,2,1,221,1,728,125445,2,50
2011-10-29,winter,2011,October,22,Saturday,Holiday,Clear,0.22,0.2121,0.87,0.2239,10,44,54,54,429,54,2,2,1,221,1,728,95612,2,54
2011-10-29,winter,2011,October,23,Saturday,Holiday,Clear,0.22,0.2273,0.87,0.194,3,33,36,36,429,36,2,1,1,211,1,728,63941,2,36
2011-10-30,winter,2011,October,0,Sunday,Holiday,Clear,0.22,0.2121,0.87,0.2239,7,47,54,54,428,54,2,2,1,221,1,726,39130,2,54
2011-10-30,winter,2011,October,1,Sunday,Holiday,Clear,0.22,0.2121,0.87,0.2537,9,34,43,43,428,43,2,2,1,221,1,724,24164,2,43
2011-10-30,winter,2011,October,2,Sunday,Holiday,Clear,0.22,0.2121,0.87,0.2836,7,43,50,50,428,50,2,2,1,221,1,715,16352,2,50
2011-10-30,winter,2011,October,3,Sunday,Holiday,Clear,0.24,0.2121,0.75,0.3582,7,26,33,33,428,33,2,1,1,211,1,697,8174,2,33
2011-10-30,winter,2011,October,4,Sunday,Holiday,Clear,0.22,0.197,0.8,0.3284,1,10,11,11,428,11,2,1,1,211,1,697,4428,2,11
2011-10-30,winter,2011,October,5,Sunday,Holiday,Clear,0.24,0.2121,0.75,0.2985,0,4,4,4,428,4,2,1,1,211,1,717,14261,2,4
2011-10-30,winter,2011,October,6,Sunday,Holiday,Clear,0.24,0.2273,0.75,0.2537,2,8,10,10,428,10,2,1,1,211,1,725,55132,2,10
2011-10-30,winter,2011,October,7,Sunday,Holiday,Clear,0.24,0.2879,0.75,0.0,7,15,22,22,428,22,2,1,1,211,1,727,154171,2,22
2011-10-30,winter,2011,October,8,Sunday,Holiday,Clear,0.26,0.2576,0.7,0.2239,20,60,80,80,428,80,2,2,1,221,1,727,261001,2,80
2011-10-30,winter,2011,October,9,Sunday,Holiday,Clear,0.3,0.2879,0.65,0.2537,55,92,147,147,428,147,2,3,1,231,1,727,159438,2,147
2011-10-30,winter,2011,October,10,Sunday,Holiday,Clear,0.32,0.3333,0.61,0.0896,53,125,178,178,428,178,2,3,1,231,1,727,126257,2,178
2011-10-30,winter,2011,October,11,Sunday,Holiday,Clear,0.36,0.3485,0.53,0.2239,58,182,240,240,428,240,2,3,2,232,1,727,151320,2,240
2011-10-30,winter,2011,October,12,Sunday,Holiday,Clear,0.38,0.3939,0.5,0.194,85,229,314,314,428,314,2,4,2,242,1,728,184414,2,314
2011-10-30,winter,2011,October,13,Sunday,Holiday,Clear,0.4,0.4091,0.43,0.2239,113,232,345,345,428,345,2,4,2,242,2,729,184919,2,345
2011-10-30,winter,2011,October,14,Sunday,Holiday,Clear,0.42,0.4242,0.38,0.194,91,209,300,300,428,300,2,4,2,242,2,729,175652,2,300
2011-10-30,winter,2011,October,15,Sunday,Holiday,Clear,0.42,0.4242,0.35,0.1642,88,202,290,290,428,290,2,4,2,242,2,729,183149,2,290
2011-10-30,winter,2011,October,16,Sunday,Holiday,Clear,0.42,0.4242,0.32,0.1343,107,213,320,320,428,320,2,4,2,242,2,730,227748,2,320
2011-10-30,winter,2011,October,17,Sunday,Holiday,Clear,0.4,0.4091,0.35,0.1045,54,191,245,245,428,245,2,3,2,232,1,730,336860,2,245
2011-10-30,winter,2011,October,18,Sunday,Holiday,Clear,0.36,0.3485,0.4,0.1343,51,162,213,213,428,213,2,3,2,232,1,728,309772,2,213
2011-10-30,winter,2011,October,19,Sunday,Holiday,Clear,0.56,0.5303,0.49,0.2985,28,125,153,153,428,153,2,3,3,233,0,728,226789,2,153
2011-10-30,winter,2011,October,20,Sunday,Holiday,Clear,0.34,0.3636,0.57,0.0,18,74,92,92,428,92,2,2,2,222,1,728,164550,2,92
2011-10-30,winter,2011,October,21,Sunday,Holiday,Clear,0.32,0.3485,0.66,0.0,4,75,79,79,428,79,2,2,2,222,1,728,125445,2,79
2011-10-30,winter,2011,October,22,Sunday,Holiday,Clear,0.3,0.3333,0.75,0.0,13,58,71,71,428,71,2,2,1,221,1,728,95612,2,71
2011-10-30,winter,2011,October,23,Sunday,Holiday,Clear,0.26,0.303,0.87,0.0,7,30,37,37,428,37,2,1,1,211,1,728,63941,2,37
2011-10-31,winter,2011,October,0,Monday,Workingday,Clear,0.26,0.303,0.87,0.0,3,20,23,23,427,23,2,1,1,211,1,726,39130,2,23
2011-10-31,winter,2011,October,1,Monday,Workingday,Clear,0.26,0.303,0.81,0.0,5,8,13,13,427,13,2,1,1,211,1,724,24164,2,13
2011-10-31,winter,2011,October,2,Monday,Workingday,Clear,0.24,0.2879,0.87,0.0,0,3,3,3,427,3,2,1,1,211,1,715,16352,2,3
2011-10-31,winter,2011,October,3,Monday,Workingday,Clear,0.24,0.2576,0.87,0.1045,0,3,3,3,427,3,2,1,1,211,1,697,8174,2,3
2011-10-31,winter,2011,October,4,Monday,Workingday,Clear,0.24,0.2879,0.87,0.0,1,5,6,6,427,6,2,1,1,211,1,697,4428,2,6
2011-10-31,winter,2011,October,5,Monday,Workingday,Clear,0.22,0.2727,0.93,0.0,0,18,18,18,427,18,2,1,1,211,1,717,14261,2,18
2011-10-31,winter,2011,October,6,Monday,Workingday,Clear,0.24,0.2879,0.87,0.0,4,82,86,86,427,86,2,2,1,221,1,725,55132,2,86
2011-10-31,winter,2011,October,7,Monday,Workingday,Clear,0.24,0.2879,0.93,0.0,11,216,227,227,427,227,2,3,1,231,1,727,154171,2,227
2011-10-31,winter,2011,October,8,Monday,Workingday,Mist,0.28,0.3182,0.87,0.0,17,355,372,372,427,372,2,4,1,241,1,727,261001,2,372
2011-10-31,winter,2011,October,9,Monday,Workingday,Mist,0.32,0.3182,0.76,0.1642,14,197,211,211,427,211,2,3,1,231,1,727,159438,2,211
2011-10-31,winter,2011,October,10,Monday,Workingday,Mist,0.36,0.3485,0.57,0.1642,18,87,105,105,427,105,2,2,2,222,1,727,126257,2,105
2011-10-31,winter,2011,October,11,Monday,Workingday,Clear,0.4,0.4091,0.5,0.1343,31,97,128,128,427,128,2,2,2,222,1,727,151320,2,128
2011-10-31,winter,2011,October,12,Monday,Workingday,Clear,0.42,0.4242,0.44,0.2239,30,140,170,170,427,170,2,3,2,232,1,728,184414,2,170
2011-10-31,winter,2011,October,13,Monday,Workingday,Mist,0.44,0.4394,0.44,0.2239,24,128,152,152,427,152,2,3,2,232,1,729,184919,2,152
2011-10-31,winter,2011,October,14,Monday,Workingday,Mist,0.44,0.4394,0.47,0.2239,22,119,141,141,427,141,2,2,2,222,1,729,175652,2,141
2011-10-31,winter,2011,October,15,Monday,Workingday,Clear,0.44,0.4394,0.47,0.1642,27,141,168,168,427,168,2,3,2,232,1,729,183149,2,168
2011-10-31,winter,2011,October,16,Monday,Workingday,Clear,0.42,0.4242,0.54,0.1642,30,242,272,272,427,272,2,3,2,232,1,730,227748,2,272
2011-10-31,winter,2011,October,17,Monday,Workingday,Clear,0.42,0.4242,0.54,0.1343,44,442,486,486,427,486,2,4,2,242,2,730,336860,2,486
2011-10-31,winter,2011,October,18,Monday,Workingday,Clear,0.4,0.4091,0.66,0.0896,30,392,422,422,427,422,2,4,2,242,0,728,309772,2,422
2011-10-31,winter,2011,October,19,Monday,Workingday,Clear,0.4,0.4091,0.66,0.0896,12,226,238,238,427,238,2,3,2,232,0,728,226789,2,238
2011-10-31,winter,2011,October,20,Monday,Workingday,Clear,0.4,0.4091,0.66,0.0896,18,154,172,172,427,172,2,3,2,232,0,728,164550,2,172
2011-10-31,winter,2011,October,21,Monday,Workingday,Mist,0.36,0.3485,0.76,0.194,7,109,116,116,427,116,2,2,2,222,1,728,125445,2,116
2011-10-31,winter,2011,October,22,Monday,Workingday,Mist,0.36,0.3485,0.76,0.194,8,77,85,85,427,85,2,2,2,222,1,728,95612,2,85
2011-10-31,winter,2011,October,23,Monday,Workingday,Mist,0.36,0.3485,0.76,0.194,6,46,52,52,427,52,2,2,2,222,1,728,63941,2,52
2011-11-01,winter,2011,November,0,Tuesday,Workingday,Mist,0.36,0.3485,0.87,0.1642,3,18,21,21,426,21,2,1,2,212,1,726,39130,2,21
2011-11-01,winter,2011,November,1,Tuesday,Workingday,Clear,0.36,0.3485,0.81,0.1343,3,8,11,11,426,11,2,1,2,212,1,724,24164,2,11
2011-11-01,winter,2011,November,2,Tuesday,Workingday,Mist,0.36,0.3485,0.81,0.1642,1,3,4,4,426,4,2,1,2,212,1,715,16352,2,4
2011-11-01,winter,2011,November,3,Tuesday,Workingday,Mist,0.36,0.3485,0.81,0.1343,1,5,6,6,426,6,2,1,2,212,1,697,8174,2,6
2011-11-01,winter,2011,November,4,Tuesday,Workingday,Clear,0.34,0.3182,0.81,0.2239,1,7,8,8,426,8,2,1,1,211,1,697,4428,2,8
2011-11-01,winter,2011,November,5,Tuesday,Workingday,Clear,0.32,0.3182,0.81,0.194,0,18,18,18,426,18,2,1,1,211,1,717,14261,2,18
2011-11-01,winter,2011,November,6,Tuesday,Workingday,Clear,0.32,0.3182,0.81,0.194,3,90,93,93,426,93,2,2,1,221,1,725,55132,2,93
2011-11-01,winter,2011,November,7,Tuesday,Workingday,Clear,0.34,0.3333,0.76,0.194,8,246,254,254,426,254,2,3,1,231,1,727,154171,2,254
2011-11-01,winter,2011,November,8,Tuesday,Workingday,Clear,0.36,0.3333,0.71,0.2537,17,402,419,419,426,419,2,4,1,241,1,727,261001,2,419
2011-11-01,winter,2011,November,9,Tuesday,Workingday,Clear,0.4,0.4091,0.66,0.1642,16,206,222,222,426,222,2,3,2,232,1,727,159438,2,222
2011-11-01,winter,2011,November,10,Tuesday,Workingday,Clear,0.44,0.4394,0.62,0.1343,21,114,135,135,426,135,2,2,2,222,0,727,126257,2,135
2011-11-01,winter,2011,November,11,Tuesday,Workingday,Clear,0.46,0.4545,0.63,0.1045,16,101,117,117,426,117,2,2,2,222,0,727,151320,2,117
2011-11-01,winter,2011,November,12,Tuesday,Workingday,Clear,0.5,0.4848,0.48,0.0896,23,153,176,176,426,176,2,3,2,232,0,728,184414,2,176
2011-11-01,winter,2011,November,13,Tuesday,Workingday,Clear,0.48,0.4697,0.55,0.194,20,147,167,167,426,167,2,3,2,232,0,729,184919,2,167
2011-11-01,winter,2011,November,14,Tuesday,Workingday,Clear,0.5,0.4848,0.48,0.2537,32,118,150,150,426,150,2,3,2,232,1,729,175652,2,150
2011-11-01,winter,2011,November,15,Tuesday,Workingday,Clear,0.5,0.4848,0.45,0.1343,38,148,186,186,426,186,2,3,2,232,0,729,183149,2,186
2011-11-01,winter,2011,November,16,Tuesday,Workingday,Clear,0.48,0.4697,0.44,0.1642,46,252,298,298,426,298,2,4,2,242,2,730,227748,2,298
2011-11-01,winter,2011,November,17,Tuesday,Workingday,Clear,0.44,0.4394,0.54,0.1642,36,470,506,506,426,506,2,4,2,242,2,730,336860,2,506
2011-11-01,winter,2011,November,18,Tuesday,Workingday,Clear,0.42,0.4242,0.58,0.1045,39,421,460,460,426,460,2,4,2,242,2,728,309772,2,460
2011-11-01,winter,2011,November,19,Tuesday,Workingday,Clear,0.42,0.4242,0.58,0.0896,39,274,313,313,426,313,2,4,2,242,1,728,226789,2,313
2011-11-01,winter,2011,November,20,Tuesday,Workingday,Clear,0.4,0.4091,0.71,0.0,18,191,209,209,426,209,2,3,2,232,0,728,164550,2,209
2011-11-01,winter,2011,November,21,Tuesday,Workingday,Clear,0.36,0.3788,0.81,0.0,13,114,127,127,426,127,2,2,2,222,0,728,125445,2,127
2011-11-01,winter,2011,November,22,Tuesday,Workingday,Clear,0.36,0.3788,0.81,0.0,5,91,96,96,426,96,2,2,2,222,0,728,95612,2,96
2011-11-01,winter,2011,November,23,Tuesday,Workingday,Clear,0.34,0.3636,0.87,0.0,11,61,72,72,426,72,2,2,2,222,0,728,63941,2,72
2011-11-02,winter,2011,November,0,Wednesday,Workingday,Clear,0.32,0.3485,0.87,0.0,0,19,19,19,425,19,2,1,2,212,0,726,39130,2,19
2011-11-02,winter,2011,November,1,Wednesday,Workingday,Clear,0.3,0.3333,0.87,0.0,2,8,10,10,425,10,2,1,1,211,0,724,24164,2,10
2011-11-02,winter,2011,November,2,Wednesday,Workingday,Clear,0.3,0.3333,0.87,0.0,0,2,2,2,425,2,2,1,1,211,0,715,16352,2,2
2011-11-02,winter,2011,November,3,Wednesday,Workingday,Clear,0.3,0.3333,0.75,0.0,0,2,2,2,425,2,2,1,1,211,1,697,8174,2,2
2011-11-02,winter,2011,November,4,Wednesday,Workingday,Clear,0.3,0.3333,0.87,0.0,0,4,4,4,425,4,2,1,1,211,0,697,4428,2,4
2011-11-02,winter,2011,November,5,Wednesday,Workingday,Clear,0.3,0.3333,0.81,0.0,0,27,27,27,425,27,2,1,1,211,1,717,14261,2,27
2011-11-02,winter,2011,November,6,Wednesday,Workingday,Clear,0.3,0.3333,0.81,0.0,1,91,92,92,425,92,2,2,1,221,1,725,55132,2,92
2011-11-02,winter,2011,November,7,Wednesday,Workingday,Clear,0.3,0.3333,0.81,0.0,11,240,251,251,425,251,2,3,1,231,1,727,154171,2,251
2011-11-02,winter,2011,November,8,Wednesday,Workingday,Clear,0.32,0.3485,0.87,0.0,20,452,472,472,425,472,2,4,2,242,0,727,261001,2,472
2011-11-02,winter,2011,November,9,Wednesday,Workingday,Clear,0.34,0.3636,0.87,0.0,15,213,228,228,425,228,2,3,2,232,0,727,159438,2,228
2011-11-02,winter,2011,November,10,Wednesday,Workingday,Clear,0.4,0.4091,0.71,0.0896,25,108,133,133,425,133,2,2,2,222,0,727,126257,2,133
2011-11-02,winter,2011,November,11,Wednesday,Workingday,Clear,0.42,0.4242,0.71,0.1343,27,117,144,144,425,144,2,3,2,232,0,727,151320,2,144
2011-11-02,winter,2011,November,12,Wednesday,Workingday,Clear,0.46,0.4545,0.55,0.1642,32,157,189,189,425,189,2,3,2,232,1,728,184414,2,189
2011-11-02,winter,2011,November,13,Wednesday,Workingday,Clear,0.48,0.4697,0.48,0.1642,22,139,161,161,425,161,2,3,2,232,1,729,184919,2,161
2011-11-02,winter,2011,November,14,Wednesday,Workingday,Clear,0.5,0.4848,0.45,0.1642,40,132,172,172,425,172,2,3,2,232,1,729,175652,2,172
2011-11-02,winter,2011,November,15,Wednesday,Workingday,Clear,0.48,0.4697,0.51,0.1642,26,161,187,187,425,187,2,3,2,232,1,729,183149,2,187
2011-11-02,winter,2011,November,16,Wednesday,Workingday,Clear,0.48,0.4697,0.51,0.1045,35,231,266,266,425,266,2,3,2,232,0,730,227748,2,266
2011-11-02,winter,2011,November,17,Wednesday,Workingday,Clear,0.44,0.4394,0.62,0.194,30,523,553,553,425,553,2,4,2,242,2,730,336860,2,553
2011-11-02,winter,2011,November,18,Wednesday,Workingday,Clear,0.42,0.4242,0.71,0.1642,31,448,479,479,425,479,2,4,2,242,0,728,309772,2,479
2011-11-02,winter,2011,November,19,Wednesday,Workingday,Clear,0.4,0.4091,0.76,0.1343,25,257,282,282,425,282,2,4,2,242,0,728,226789,2,282
2011-11-02,winter,2011,November,20,Wednesday,Workingday,Clear,0.4,0.4091,0.66,0.1343,5,177,182,182,425,182,2,3,2,232,1,728,164550,2,182
2011-11-02,winter,2011,November,21,Wednesday,Workingday,Clear,0.38,0.3939,0.71,0.1343,13,155,168,168,425,168,2,3,2,232,1,728,125445,2,168
2011-11-02,winter,2011,November,22,Wednesday,Workingday,Clear,0.36,0.3485,0.71,0.1343,7,99,106,106,425,106,2,2,2,222,1,728,95612,2,106
2011-11-02,winter,2011,November,23,Wednesday,Workingday,Clear,0.36,0.3636,0.76,0.0896,3,54,57,57,425,57,2,2,2,222,1,728,63941,2,57
2011-11-03,winter,2011,November,0,Thursday,Workingday,Clear,0.36,0.3636,0.76,0.0896,3,28,31,31,424,31,2,1,2,212,1,726,39130,2,31
2011-11-03,winter,2011,November,1,Thursday,Workingday,Clear,0.34,0.3333,0.81,0.1343,3,12,15,15,424,15,2,1,1,211,1,724,24164,2,15
2011-11-03,winter,2011,November,2,Thursday,Workingday,Clear,0.34,0.3333,0.76,0.1343,2,5,7,7,424,7,2,1,1,211,1,715,16352,2,7
2011-11-03,winter,2011,November,3,Thursday,Workingday,Clear,0.34,0.3333,0.81,0.1343,1,4,5,5,424,5,2,1,1,211,1,697,8174,2,5
2011-11-03,winter,2011,November,4,Thursday,Workingday,Clear,0.32,0.3333,0.81,0.0896,1,3,4,4,424,4,2,1,1,211,1,697,4428,2,4
2011-11-03,winter,2011,November,5,Thursday,Workingday,Clear,0.32,0.3333,0.81,0.1343,1,27,28,28,424,28,2,1,1,211,1,717,14261,2,28
2011-11-03,winter,2011,November,6,Thursday,Workingday,Clear,0.34,0.3333,0.76,0.194,3,96,99,99,424,99,2,2,1,221,1,725,55132,2,99
2011-11-03,winter,2011,November,7,Thursday,Workingday,Mist,0.32,0.3333,0.81,0.0896,12,280,292,292,424,292,2,4,1,241,1,727,154171,2,292
2011-11-03,winter,2011,November,8,Thursday,Workingday,Mist,0.34,0.3485,0.81,0.0896,8,394,402,402,424,402,2,4,2,242,1,727,261001,2,402
2011-11-03,winter,2011,November,9,Thursday,Workingday,Mist,0.36,0.3485,0.81,0.194,9,155,164,164,424,164,2,3,2,232,1,727,159438,2,164
2011-11-03,winter,2011,November,10,Thursday,Workingday,Mist,0.4,0.4091,0.76,0.194,12,98,110,110,424,110,2,2,2,222,0,727,126257,2,110
2011-11-03,winter,2011,November,11,Thursday,Workingday,Clear,0.44,0.4394,0.67,0.194,12,108,120,120,424,120,2,2,2,222,0,727,151320,2,120
2011-11-03,winter,2011,November,12,Thursday,Workingday,Clear,0.5,0.4848,0.51,0.194,17,162,179,179,424,179,2,3,2,232,0,728,184414,2,179
2011-11-03,winter,2011,November,13,Thursday,Workingday,Mist,0.52,0.5,0.48,0.2537,19,150,169,169,424,169,2,3,3,233,1,729,184919,2,169
2011-11-03,winter,2011,November,14,Thursday,Workingday,Clear,0.52,0.5,0.52,0.1642,32,120,152,152,424,152,2,3,3,233,0,729,175652,2,152
2011-11-03,winter,2011,November,15,Thursday,Workingday,Clear,0.52,0.5,0.52,0.1642,24,138,162,162,424,162,2,3,3,233,0,729,183149,2,162
2011-11-03,winter,2011,November,16,Thursday,Workingday,Clear,0.52,0.5,0.48,0.194,33,234,267,267,424,267,2,3,3,233,2,730,227748,2,267
2011-11-03,winter,2011,November,17,Thursday,Workingday,Clear,0.48,0.4697,0.55,0.0896,33,465,498,498,424,498,2,4,2,242,2,730,336860,2,498
2011-11-03,winter,2011,November,18,Thursday,Workingday,Clear,0.46,0.4545,0.63,0.1343,24,409,433,433,424,433,2,4,2,242,0,728,309772,2,433
2011-11-03,winter,2011,November,19,Thursday,Workingday,Clear,0.44,0.4394,0.67,0.0896,18,234,252,252,424,252,2,3,2,232,0,728,226789,2,252
2011-11-03,winter,2011,November,20,Thursday,Workingday,Clear,0.42,0.4242,0.71,0.1045,11,198,209,209,424,209,2,3,2,232,0,728,164550,2,209
2011-11-03,winter,2011,November,21,Thursday,Workingday,Clear,0.4,0.4091,0.76,0.1343,4,140,144,144,424,144,2,3,2,232,0,728,125445,2,144
2011-11-03,winter,2011,November,22,Thursday,Workingday,Clear,0.4,0.4091,0.82,0.0,21,116,137,137,424,137,2,2,2,222,0,728,95612,2,137
2011-11-03,winter,2011,November,23,Thursday,Workingday,Clear,0.4,0.4091,0.82,0.0896,15,80,95,95,424,95,2,2,2,222,0,728,63941,2,95
2011-11-04,winter,2011,November,0,Friday,Workingday,Mist,0.4,0.4091,0.82,0.0,11,32,43,43,423,43,2,2,2,222,0,726,39130,2,43
2011-11-04,winter,2011,November,1,Friday,Workingday,Mist,0.4,0.4091,0.82,0.0,1,16,17,17,423,17,2,1,2,212,0,724,24164,2,17
2011-11-04,winter,2011,November,2,Friday,Workingday,Mist,0.4,0.4091,0.76,0.0,2,8,10,10,423,10,2,1,2,212,0,715,16352,2,10
2011-11-04,winter,2011,November,3,Friday,Workingday,Mist,0.38,0.3939,0.87,0.1642,1,7,8,8,423,8,2,1,2,212,0,697,8174,2,8
2011-11-04,winter,2011,November,4,Friday,Workingday,Mist,0.38,0.3939,0.87,0.0896,1,6,7,7,423,7,2,1,2,212,0,697,4428,2,7
2011-11-04,winter,2011,November,5,Friday,Workingday,Mist,0.38,0.3939,0.87,0.0,0,23,23,23,423,23,2,1,2,212,0,717,14261,2,23
2011-11-04,winter,2011,November,6,Friday,Workingday,Mist,0.38,0.3939,0.87,0.0896,2,64,66,66,423,66,2,2,2,222,0,725,55132,2,66
2011-11-04,winter,2011,November,7,Friday,Workingday,Mist,0.4,0.4091,0.86,0.2239,10,235,245,245,423,245,2,3,2,232,0,727,154171,2,245
2011-11-04,winter,2011,November,8,Friday,Workingday,Mist,0.4,0.4091,0.87,0.3582,8,387,395,395,423,395,2,4,2,242,1,727,261001,2,395
2011-11-04,winter,2011,November,9,Friday,Workingday,Mist,0.42,0.4242,0.71,0.4627,15,239,254,254,423,254,2,3,2,232,1,727,159438,2,254
2011-11-04,winter,2011,November,10,Friday,Workingday,Mist,0.42,0.4242,0.71,0.3284,19,115,134,134,423,134,2,2,2,222,1,727,126257,2,134
2011-11-04,winter,2011,November,11,Friday,Workingday,Mist,0.44,0.4394,0.67,0.4478,34,128,162,162,423,162,2,3,2,232,1,727,151320,2,162
2011-11-04,winter,2011,November,12,Friday,Workingday,Mist,0.48,0.4697,0.55,0.4925,44,153,197,197,423,197,2,3,2,232,1,728,184414,2,197
2011-11-04,winter,2011,November,13,Friday,Workingday,Clear,0.44,0.4394,0.51,0.4179,33,161,194,194,423,194,2,3,2,232,1,729,184919,2,194
2011-11-04,winter,2011,November,14,Friday,Workingday,Clear,0.44,0.4394,0.47,0.2985,54,147,201,201,423,201,2,3,2,232,1,729,175652,2,201
2011-11-04,winter,2011,November,15,Friday,Workingday,Clear,0.46,0.4545,0.44,0.3881,45,192,237,237,423,237,2,3,2,232,1,729,183149,2,237
2011-11-04,winter,2011,November,16,Friday,Workingday,Clear,0.46,0.4545,0.36,0.3881,53,237,290,290,423,290,2,4,2,242,2,730,227748,2,290
2011-11-04,winter,2011,November,17,Friday,Workingday,Clear,0.42,0.4242,0.38,0.3582,42,438,480,480,423,480,2,4,2,242,2,730,336860,2,480
2011-11-04,winter,2011,November,18,Friday,Workingday,Clear,0.42,0.4242,0.32,0.4627,35,339,374,374,423,374,2,4,2,242,2,728,309772,2,374
2011-11-04,winter,2011,November,19,Friday,Workingday,Clear,0.4,0.4091,0.37,0.3582,14,182,196,196,423,196,2,3,2,232,1,728,226789,2,196
2011-11-04,winter,2011,November,20,Friday,Workingday,Clear,0.36,0.3333,0.43,0.2836,15,171,186,186,423,186,2,3,1,231,1,728,164550,2,186
2011-11-04,winter,2011,November,21,Friday,Workingday,Clear,0.34,0.3182,0.46,0.2537,8,115,123,123,423,123,2,2,1,221,1,728,125445,2,123
2011-11-04,winter,2011,November,22,Friday,Workingday,Clear,0.34,0.303,0.46,0.3284,6,109,115,115,423,115,2,2,1,221,1,728,95612,2,115
2011-11-04,winter,2011,November,23,Friday,Workingday,Clear,0.32,0.303,0.49,0.3284,17,72,89,89,423,89,2,2,1,221,1,728,63941,2,89
2011-11-05,winter,2011,November,0,Saturday,Holiday,Clear,0.32,0.2879,0.45,0.3582,4,48,52,52,422,52,2,2,1,221,1,726,39130,2,52
2011-11-05,winter,2011,November,1,Saturday,Holiday,Clear,0.32,0.303,0.45,0.2985,5,57,62,62,422,62,2,2,1,221,1,724,24164,2,62
2011-11-05,winter,2011,November,2,Saturday,Holiday,Clear,0.3,0.2727,0.52,0.3284,7,24,31,31,422,31,2,1,1,211,1,715,16352,2,31
2011-11-05,winter,2011,November,3,Saturday,Holiday,Clear,0.3,0.2727,0.52,0.2985,0,8,8,8,422,8,2,1,1,211,1,697,8174,2,8
2011-11-05,winter,2011,November,4,Saturday,Holiday,Clear,0.28,0.2576,0.56,0.3284,3,5,8,8,422,8,2,1,1,211,1,697,4428,2,8
2011-11-05,winter,2011,November,5,Saturday,Holiday,Clear,0.26,0.2273,0.6,0.3284,0,2,2,2,422,2,2,1,1,211,1,717,14261,2,2
2011-11-05,winter,2011,November,6,Saturday,Holiday,Clear,0.26,0.2424,0.6,0.2537,3,20,23,23,422,23,2,1,1,211,1,725,55132,2,23
2011-11-05,winter,2011,November,7,Saturday,Holiday,Clear,0.26,0.2424,0.6,0.2836,3,31,34,34,422,34,2,1,1,211,1,727,154171,2,34
2011-11-05,winter,2011,November,8,Saturday,Holiday,Clear,0.28,0.2576,0.56,0.3284,4,80,84,84,422,84,2,2,1,221,1,727,261001,2,84
2011-11-05,winter,2011,November,9,Saturday,Holiday,Clear,0.3,0.2727,0.56,0.2985,30,111,141,141,422,141,2,2,1,221,1,727,159438,2,141
2011-11-05,winter,2011,November,10,Saturday,Holiday,Clear,0.32,0.303,0.53,0.2537,56,171,227,227,422,227,2,3,1,231,1,727,126257,2,227
2011-11-05,winter,2011,November,11,Saturday,Holiday,Clear,0.36,0.3636,0.46,0.1045,69,169,238,238,422,238,2,3,2,232,1,727,151320,2,238
2011-11-05,winter,2011,November,12,Saturday,Holiday,Clear,0.36,0.3485,0.46,0.1642,137,235,372,372,422,372,2,4,2,242,2,728,184414,2,372
2011-11-05,winter,2011,November,13,Saturday,Holiday,Clear,0.4,0.4091,0.37,0.1045,148,207,355,355,422,355,2,4,2,242,2,729,184919,2,355
2011-11-05,winter,2011,November,14,Saturday,Holiday,Clear,0.42,0.4242,0.35,0.1343,159,227,386,386,422,386,2,4,2,242,2,729,175652,2,386
2011-11-05,winter,2011,November,15,Saturday,Holiday,Clear,0.4,0.4091,0.37,0.194,141,202,343,343,422,343,2,4,2,242,2,729,183149,2,343
2011-11-05,winter,2011,November,16,Saturday,Holiday,Clear,0.4,0.4091,0.4,0.2239,128,207,335,335,422,335,2,4,2,242,2,730,227748,2,335
2011-11-05,winter,2011,November,17,Saturday,Holiday,Clear,0.38,0.3939,0.4,0.1642,100,234,334,334,422,334,2,4,2,242,2,730,336860,2,334
2011-11-05,winter,2011,November,18,Saturday,Holiday,Clear,0.36,0.3636,0.5,0.0896,52,185,237,237,422,237,2,3,2,232,1,728,309772,2,237
2011-11-05,winter,2011,November,19,Saturday,Holiday,Clear,0.34,0.3636,0.53,0.0,45,159,204,204,422,204,2,3,2,232,1,728,226789,2,204
2011-11-05,winter,2011,November,20,Saturday,Holiday,Clear,0.32,0.3485,0.66,0.0,29,136,165,165,422,165,2,3,2,232,1,728,164550,2,165
2011-11-05,winter,2011,November,21,Saturday,Holiday,Clear,0.32,0.3485,0.66,0.0,19,99,118,118,422,118,2,2,2,222,1,728,125445,2,118
2011-11-05,winter,2011,November,22,Saturday,Holiday,Clear,0.3,0.3333,0.65,0.0,10,72,82,82,422,82,2,2,1,221,1,728,95612,2,82
2011-11-05,winter,2011,November,23,Saturday,Holiday,Clear,0.28,0.3182,0.7,0.0,4,81,85,85,422,85,2,2,1,221,1,728,63941,2,85
2011-11-06,winter,2011,November,0,Sunday,Holiday,Clear,0.28,0.3182,0.75,0.0,10,65,75,75,421,75,2,2,1,221,1,726,39130,2,75
2011-11-06,winter,2011,November,1,Sunday,Holiday,Clear,0.26,0.303,0.81,0.0,11,104,115,115,421,115,2,2,1,221,1,724,24164,2,115
2011-11-06,winter,2011,November,2,Sunday,Holiday,Clear,0.26,0.303,0.81,0.0,6,23,29,29,421,29,2,1,1,211,1,715,16352,2,29
2011-11-06,winter,2011,November,3,Sunday,Holiday,Clear,0.24,0.2879,0.87,0.0,5,4,9,9,421,9,2,1,1,211,1,697,8174,2,9
2011-11-06,winter,2011,November,4,Sunday,Holiday,Clear,0.24,0.2879,0.87,0.0,0,6,6,6,421,6,2,1,1,211,1,697,4428,2,6
2011-11-06,winter,2011,November,5,Sunday,Holiday,Clear,0.24,0.2424,0.87,0.1343,0,5,5,5,421,5,2,1,1,211,1,717,14261,2,5
2011-11-06,winter,2011,November,6,Sunday,Holiday,Clear,0.26,0.2879,0.81,0.0896,5,11,16,16,421,16,2,1,1,211,1,725,55132,2,16
2011-11-06,winter,2011,November,7,Sunday,Holiday,Clear,0.26,0.2727,0.87,0.1045,4,24,28,28,421,28,2,1,1,211,1,727,154171,2,28
2011-11-06,winter,2011,November,8,Sunday,Holiday,Mist,0.28,0.303,0.87,0.0896,19,71,90,90,421,90,2,2,1,221,1,727,261001,2,90
2011-11-06,winter,2011,November,9,Sunday,Holiday,Mist,0.3,0.3182,0.75,0.0896,36,134,170,170,421,170,2,3,1,231,1,727,159438,2,170
2011-11-06,winter,2011,November,10,Sunday,Holiday,Clear,0.36,0.3636,0.66,0.0896,76,186,262,262,421,262,2,3,2,232,1,727,126257,2,262
2011-11-06,winter,2011,November,11,Sunday,Holiday,Clear,0.42,0.4242,0.58,0.0896,104,216,320,320,421,320,2,4,2,242,2,727,151320,2,320
2011-11-06,winter,2011,November,12,Sunday,Holiday,Clear,0.44,0.4394,0.54,0.0,120,226,346,346,421,346,2,4,2,242,2,728,184414,2,346
2011-11-06,winter,2011,November,13,Sunday,Holiday,Clear,0.46,0.4545,0.51,0.1642,105,209,314,314,421,314,2,4,2,242,2,729,184919,2,314
2011-11-06,winter,2011,November,14,Sunday,Holiday,Clear,0.46,0.4545,0.55,0.194,101,219,320,320,421,320,2,4,2,242,2,729,175652,2,320
2011-11-06,winter,2011,November,15,Sunday,Holiday,Clear,0.48,0.4697,0.51,0.194,96,210,306,306,421,306,2,4,2,242,2,729,183149,2,306
2011-11-06,winter,2011,November,16,Sunday,Holiday,Clear,0.46,0.4545,0.55,0.2239,84,263,347,347,421,347,2,4,2,242,2,730,227748,2,347
2011-11-06,winter,2011,November,17,Sunday,Holiday,Clear,0.44,0.4394,0.62,0.1642,71,185,256,256,421,256,2,3,2,232,0,730,336860,2,256
2011-11-06,winter,2011,November,18,Sunday,Holiday,Clear,0.42,0.4242,0.71,0.1045,39,146,185,185,421,185,2,3,2,232,0,728,309772,2,185
2011-11-06,winter,2011,November,19,Sunday,Holiday,Clear,0.38,0.3939,0.76,0.194,21,130,151,151,421,151,2,3,2,232,1,728,226789,2,151
2011-11-06,winter,2011,November,20,Sunday,Holiday,Clear,0.36,0.3636,0.81,0.1045,16,100,116,116,421,116,2,2,2,222,0,728,164550,2,116
2011-11-06,winter,2011,November,21,Sunday,Holiday,Clear,0.36,0.3636,0.81,0.0896,11,77,88,88,421,88,2,2,2,222,0,728,125445,2,88
2011-11-06,winter,2011,November,22,Sunday,Holiday,Clear,0.36,0.3788,0.87,0.0,5,40,45,45,421,45,2,2,2,222,0,728,95612,2,45
2011-11-06,winter,2011,November,23,Sunday,Holiday,Clear,0.34,0.3485,0.87,0.0896,7,43,50,50,421,50,2,2,2,222,0,728,63941,2,50
2011-11-07,winter,2011,November,0,Monday,Workingday,Clear,0.34,0.3636,0.87,0.0,1,14,15,15,420,15,2,1,2,212,0,726,39130,2,15
2011-11-07,winter,2011,November,1,Monday,Workingday,Clear,0.34,0.3636,0.87,0.0,2,6,8,8,420,8,2,1,2,212,0,724,24164,2,8
2011-11-07,winter,2011,November,2,Monday,Workingday,Clear,0.32,0.3485,0.93,0.0,0,2,2,2,420,2,2,1,2,212,0,715,16352,2,2
2011-11-07,winter,2011,November,3,Monday,Workingday,Clear,0.32,0.3485,0.93,0.0,0,3,3,3,420,3,2,1,2,212,0,697,8174,2,3
2011-11-07,winter,2011,November,4,Monday,Workingday,Clear,0.32,0.3485,0.93,0.0,2,4,6,6,420,6,2,1,2,212,0,697,4428,2,6
2011-11-07,winter,2011,November,5,Monday,Workingday,Clear,0.3,0.3333,0.93,0.0,1,25,26,26,420,26,2,1,1,211,0,717,14261,2,26
2011-11-07,winter,2011,November,6,Monday,Workingday,Mist,0.28,0.3182,0.93,0.0,2,97,99,99,420,99,2,2,1,221,0,725,55132,2,99
2011-11-07,winter,2011,November,7,Monday,Workingday,Mist,0.28,0.3182,0.93,0.0,6,305,311,311,420,311,2,4,1,241,0,727,154171,2,311
2011-11-07,winter,2011,November,8,Monday,Workingday,Mist,0.3,0.3182,1.0,0.0896,13,397,410,410,420,410,2,4,1,241,0,727,261001,2,410
2011-11-07,winter,2011,November,9,Monday,Workingday,Mist,0.34,0.3333,1.0,0.1343,18,156,174,174,420,174,2,3,1,231,0,727,159438,2,174
2011-11-07,winter,2011,November,10,Monday,Workingday,Clear,0.36,0.3485,0.93,0.1343,28,95,123,123,420,123,2,2,2,222,0,727,126257,2,123
2011-11-07,winter,2011,November,11,Monday,Workingday,Clear,0.42,0.4242,0.77,0.1045,28,100,128,128,420,128,2,2,2,222,0,727,151320,2,128
2011-11-07,winter,2011,November,12,Monday,Workingday,Clear,0.46,0.4545,0.67,0.0,21,158,179,179,420,179,2,3,2,232,0,728,184414,2,179
2011-11-07,winter,2011,November,13,Monday,Workingday,Clear,0.54,0.5152,0.49,0.0896,32,157,189,189,420,189,2,3,3,233,0,729,184919,2,189
2011-11-07,winter,2011,November,14,Monday,Workingday,Clear,0.56,0.5303,0.37,0.1642,30,115,145,145,420,145,2,3,3,233,2,729,175652,2,145
2011-11-07,winter,2011,November,15,Monday,Workingday,Clear,0.56,0.5303,0.37,0.1045,38,132,170,170,420,170,2,3,3,233,2,729,183149,2,170
2011-11-07,winter,2011,November,16,Monday,Workingday,Clear,0.52,0.5,0.45,0.0,40,255,295,295,420,295,2,4,3,243,0,730,227748,2,295
2011-11-07,winter,2011,November,17,Monday,Workingday,Clear,0.5,0.4848,0.45,0.1642,39,489,528,528,420,528,2,4,2,242,2,730,336860,2,528
2011-11-07,winter,2011,November,18,Monday,Workingday,Clear,0.46,0.4545,0.59,0.1045,18,407,425,425,420,425,2,4,2,242,0,728,309772,2,425
2011-11-07,winter,2011,November,19,Monday,Workingday,Clear,0.46,0.4545,0.59,0.0,20,280,300,300,420,300,2,4,2,242,0,728,226789,2,300
2011-11-07,winter,2011,November,20,Monday,Workingday,Clear,0.4,0.4091,0.71,0.0,17,187,204,204,420,204,2,3,2,232,0,728,164550,2,204
2011-11-07,winter,2011,November,21,Monday,Workingday,Clear,0.38,0.3939,0.82,0.1045,10,129,139,139,420,139,2,2,2,222,0,728,125445,2,139
2011-11-07,winter,2011,November,22,Monday,Workingday,Clear,0.36,0.3636,0.81,0.0896,6,102,108,108,420,108,2,2,2,222,0,728,95612,2,108
2011-11-07,winter,2011,November,23,Monday,Workingday,Clear,0.36,0.3636,0.87,0.0896,1,47,48,48,420,48,2,2,2,222,0,728,63941,2,48
2011-11-08,winter,2011,November,0,Tuesday,Workingday,Clear,0.34,0.3485,0.87,0.0896,0,18,18,18,419,18,2,1,2,212,0,726,39130,2,18
2011-11-08,winter,2011,November,1,Tuesday,Workingday,Clear,0.32,0.3333,0.93,0.1045,3,8,11,11,419,11,2,1,1,211,0,724,24164,2,11
2011-11-08,winter,2011,November,2,Tuesday,Workingday,Clear,0.32,0.3485,0.87,0.0,0,1,1,1,419,1,2,1,2,212,0,715,16352,2,1
2011-11-08,winter,2011,November,3,Tuesday,Workingday,Clear,0.32,0.3485,0.87,0.0,0,3,3,3,419,3,2,1,2,212,0,697,8174,2,3
2011-11-08,winter,2011,November,4,Tuesday,Workingday,Clear,0.3,0.3333,0.87,0.0,0,4,4,4,419,4,2,1,1,211,0,697,4428,2,4
2011-11-08,winter,2011,November,5,Tuesday,Workingday,Clear,0.3,0.3182,0.87,0.0896,1,17,18,18,419,18,2,1,1,211,1,717,14261,2,18
2011-11-08,winter,2011,November,6,Tuesday,Workingday,Clear,0.3,0.3333,0.87,0.0,3,96,99,99,419,99,2,2,1,221,0,725,55132,2,99
2011-11-08,winter,2011,November,7,Tuesday,Workingday,Clear,0.3,0.3182,0.87,0.1045,7,316,323,323,419,323,2,4,1,241,1,727,154171,2,323
2011-11-08,winter,2011,November,8,Tuesday,Workingday,Clear,0.32,0.3333,0.93,0.1045,11,455,466,466,419,466,2,4,1,241,0,727,261001,2,466
2011-11-08,winter,2011,November,9,Tuesday,Workingday,Clear,0.36,0.3788,0.87,0.0,14,177,191,191,419,191,2,3,2,232,0,727,159438,2,191
2011-11-08,winter,2011,November,10,Tuesday,Workingday,Clear,0.42,0.4242,0.71,0.0896,25,104,129,129,419,129,2,2,2,222,0,727,126257,2,129
2011-11-08,winter,2011,November,11,Tuesday,Workingday,Clear,0.46,0.4545,0.63,0.1343,21,126,147,147,419,147,2,3,2,232,0,727,151320,2,147
2011-11-08,winter,2011,November,12,Tuesday,Workingday,Clear,0.52,0.5,0.52,0.1343,28,175,203,203,419,203,2,3,3,233,0,728,184414,2,203
2011-11-08,winter,2011,November,13,Tuesday,Workingday,Clear,0.54,0.5152,0.49,0.1642,31,165,196,196,419,196,2,3,3,233,0,729,184919,2,196
2011-11-08,winter,2011,November,14,Tuesday,Workingday,Clear,0.56,0.5303,0.46,0.1045,32,129,161,161,419,161,2,3,3,233,0,729,175652,2,161
2011-11-08,winter,2011,November,15,Tuesday,Workingday,Clear,0.58,0.5455,0.46,0.1045,33,155,188,188,419,188,2,3,3,233,0,729,183149,2,188
2011-11-08,winter,2011,November,16,Tuesday,Workingday,Clear,0.56,0.5303,0.46,0.1343,39,250,289,289,419,289,2,4,3,243,2,730,227748,2,289
2011-11-08,winter,2011,November,17,Tuesday,Workingday,Clear,0.52,0.5,0.43,0.1642,40,459,499,499,419,499,2,4,3,243,2,730,336860,2,499
2011-11-08,winter,2011,November,18,Tuesday,Workingday,Clear,0.48,0.4697,0.55,0.1343,30,432,462,462,419,462,2,4,2,242,2,728,309772,2,462
2011-11-08,winter,2011,November,19,Tuesday,Workingday,Clear,0.46,0.4545,0.59,0.0,14,264,278,278,419,278,2,3,2,232,0,728,226789,2,278
2011-11-08,winter,2011,November,20,Tuesday,Workingday,Clear,0.4,0.4091,0.76,0.0,12,169,181,181,419,181,2,3,2,232,0,728,164550,2,181
2011-11-08,winter,2011,November,21,Tuesday,Workingday,Clear,0.4,0.4091,0.76,0.0,16,166,182,182,419,182,2,3,2,232,0,728,125445,2,182
2011-11-08,winter,2011,November,22,Tuesday,Workingday,Clear,0.36,0.3788,0.87,0.0,13,95,108,108,419,108,2,2,2,222,0,728,95612,2,108
2011-11-08,winter,2011,November,23,Tuesday,Workingday,Clear,0.36,0.3788,0.81,0.0,3,45,48,48,419,48,2,2,2,222,0,728,63941,2,48
2011-11-09,winter,2011,November,0,Wednesday,Workingday,Clear,0.36,0.3788,0.87,0.0,0,13,13,13,418,13,2,1,2,212,0,726,39130,2,13
2011-11-09,winter,2011,November,1,Wednesday,Workingday,Clear,0.34,0.3636,0.87,0.0,0,10,10,10,418,10,2,1,2,212,0,724,24164,2,10
2011-11-09,winter,2011,November,2,Wednesday,Workingday,Clear,0.32,0.3485,0.93,0.0,0,5,5,5,418,5,2,1,2,212,0,715,16352,2,5
2011-11-09,winter,2011,November,3,Wednesday,Workingday,Clear,0.32,0.3485,0.93,0.0,0,4,4,4,418,4,2,1,2,212,0,697,8174,2,4
2011-11-09,winter,2011,November,4,Wednesday,Workingday,Clear,0.32,0.3485,0.87,0.0,0,4,4,4,418,4,2,1,2,212,0,697,4428,2,4
2011-11-09,winter,2011,November,5,Wednesday,Workingday,Clear,0.3,0.3333,0.87,0.0,0,28,28,28,418,28,2,1,1,211,0,717,14261,2,28
2011-11-09,winter,2011,November,6,Wednesday,Workingday,Clear,0.3,0.3333,0.87,0.0,0,98,98,98,418,98,2,2,1,221,0,725,55132,2,98
2011-11-09,winter,2011,November,7,Wednesday,Workingday,Clear,0.3,0.3333,0.87,0.0,0,300,300,300,418,300,2,4,1,241,0,727,154171,2,300
2011-11-09,winter,2011,November,8,Wednesday,Workingday,Clear,0.32,0.3485,0.93,0.0,19,437,456,456,418,456,2,4,2,242,0,727,261001,2,456
2011-11-09,winter,2011,November,9,Wednesday,Workingday,Clear,0.34,0.3636,0.93,0.0,22,197,219,219,418,219,2,3,2,232,0,727,159438,2,219
2011-11-09,winter,2011,November,10,Wednesday,Workingday,Clear,0.4,0.4091,0.76,0.1045,16,89,105,105,418,105,2,2,2,222,0,727,126257,2,105
2011-11-09,winter,2011,November,11,Wednesday,Workingday,Clear,0.46,0.4545,0.67,0.1642,21,131,152,152,418,152,2,3,2,232,0,727,151320,2,152
2011-11-09,winter,2011,November,12,Wednesday,Workingday,Clear,0.5,0.4848,0.51,0.1642,24,156,180,180,418,180,2,3,2,232,0,728,184414,2,180
2011-11-09,winter,2011,November,13,Wednesday,Workingday,Clear,0.5,0.4848,0.51,0.1642,31,136,167,167,418,167,2,3,2,232,0,729,184919,2,167
2011-11-09,winter,2011,November,14,Wednesday,Workingday,Clear,0.52,0.5,0.48,0.1642,26,153,179,179,418,179,2,3,3,233,0,729,175652,2,179
2011-11-09,winter,2011,November,15,Wednesday,Workingday,Clear,0.52,0.5,0.45,0.2239,21,130,151,151,418,151,2,3,3,233,1,729,183149,2,151
2011-11-09,winter,2011,November,16,Wednesday,Workingday,Clear,0.52,0.5,0.48,0.194,24,257,281,281,418,281,2,3,3,233,2,730,227748,2,281
2011-11-09,winter,2011,November,17,Wednesday,Workingday,Clear,0.46,0.4545,0.63,0.1045,27,458,485,485,418,485,2,4,2,242,2,730,336860,2,485
2011-11-09,winter,2011,November,18,Wednesday,Workingday,Clear,0.44,0.4394,0.67,0.1045,21,387,408,408,418,408,2,4,2,242,0,728,309772,2,408
2011-11-09,winter,2011,November,19,Wednesday,Workingday,Clear,0.44,0.4394,0.72,0.1045,12,292,304,304,418,304,2,4,2,242,0,728,226789,2,304
2011-11-09,winter,2011,November,20,Wednesday,Workingday,Clear,0.44,0.4394,0.77,0.0,18,201,219,219,418,219,2,3,2,232,0,728,164550,2,219
2011-11-09,winter,2011,November,21,Wednesday,Workingday,Clear,0.4,0.4091,0.87,0.0,9,152,161,161,418,161,2,3,2,232,0,728,125445,2,161
2011-11-09,winter,2011,November,22,Wednesday,Workingday,Clear,0.4,0.4091,0.87,0.0,9,105,114,114,418,114,2,2,2,222,0,728,95612,2,114
2011-11-09,winter,2011,November,23,Wednesday,Workingday,Clear,0.38,0.3939,0.87,0.0,5,61,66,66,418,66,2,2,2,222,0,728,63941,2,66
2011-11-10,winter,2011,November,0,Thursday,Workingday,Clear,0.4,0.4091,0.87,0.0,0,24,24,24,417,24,2,1,2,212,0,726,39130,2,24
2011-11-10,winter,2011,November,1,Thursday,Workingday,Mist,0.4,0.4091,0.87,0.0,1,10,11,11,417,11,2,1,2,212,0,724,24164,2,11
2011-11-10,winter,2011,November,2,Thursday,Workingday,Mist,0.38,0.3939,0.94,0.0,0,5,5,5,417,5,2,1,2,212,0,715,16352,2,5
2011-11-10,winter,2011,November,3,Thursday,Workingday,Clear,0.38,0.3939,0.94,0.0896,0,11,11,11,417,11,2,1,2,212,0,697,8174,2,11
2011-11-10,winter,2011,November,4,Thursday,Workingday,Clear,0.38,0.3939,0.94,0.0896,1,2,3,3,417,3,2,1,2,212,0,697,4428,2,3
2011-11-10,winter,2011,November,5,Thursday,Workingday,Mist,0.36,0.3485,1.0,0.1343,1,22,23,23,417,23,2,1,2,212,0,717,14261,2,23
2011-11-10,winter,2011,November,6,Thursday,Workingday,Mist,0.36,0.3485,1.0,0.1343,4,110,114,114,417,114,2,2,2,222,0,725,55132,2,114
2011-11-10,winter,2011,November,7,Thursday,Workingday,Mist,0.38,0.3939,0.94,0.1642,6,266,272,272,417,272,2,3,2,232,0,727,154171,2,272
2011-11-10,winter,2011,November,8,Thursday,Workingday,Mist,0.4,0.4091,0.94,0.0896,18,418,436,436,417,436,2,4,2,242,0,727,261001,2,436
2011-11-10,winter,2011,November,9,Thursday,Workingday,Mist,0.42,0.4242,0.94,0.1045,23,188,211,211,417,211,2,3,2,232,0,727,159438,2,211
2011-11-10,winter,2011,November,10,Thursday,Workingday,Mist,0.44,0.4394,0.88,0.2239,17,100,117,117,417,117,2,2,2,222,0,727,126257,2,117
2011-11-10,winter,2011,November,11,Thursday,Workingday,Mist,0.46,0.4545,0.67,0.3881,9,99,108,108,417,108,2,2,2,222,1,727,151320,2,108
2011-11-10,winter,2011,November,12,Thursday,Workingday,Mist,0.42,0.4242,0.67,0.3582,18,149,167,167,417,167,2,3,2,232,1,728,184414,2,167
2011-11-10,winter,2011,November,13,Thursday,Workingday,Light Snow,0.36,0.3333,0.81,0.3582,9,87,96,96,417,96,2,2,1,221,1,729,184919,2,96
2011-11-10,winter,2011,November,14,Thursday,Workingday,Light Snow,0.36,0.3333,0.87,0.2836,6,58,64,64,417,64,2,2,1,221,1,729,175652,2,64
2011-11-10,winter,2011,November,15,Thursday,Workingday,Light Snow,0.36,0.3333,0.81,0.2985,5,57,62,62,417,62,2,2,1,221,1,729,183149,2,62
2011-11-10,winter,2011,November,16,Thursday,Workingday,Light Snow,0.36,0.3485,0.81,0.2239,6,67,73,73,417,73,2,2,2,222,1,730,227748,2,73
2011-11-10,winter,2011,November,17,Thursday,Workingday,Light Snow,0.36,0.3485,0.81,0.2239,9,168,177,177,417,177,2,3,2,232,1,730,336860,2,177
2011-11-10,winter,2011,November,18,Thursday,Workingday,Mist,0.36,0.3485,0.81,0.1642,10,263,273,273,417,273,2,3,2,232,1,728,309772,2,273
2011-11-10,winter,2011,November,19,Thursday,Workingday,Mist,0.36,0.3485,0.71,0.2239,19,192,211,211,417,211,2,3,2,232,1,728,226789,2,211
2011-11-10,winter,2011,November,20,Thursday,Workingday,Mist,0.36,0.3333,0.62,0.2836,8,160,168,168,417,168,2,3,1,231,1,728,164550,2,168
2011-11-10,winter,2011,November,21,Thursday,Workingday,Clear,0.36,0.3333,0.57,0.2537,6,130,136,136,417,136,2,2,1,221,1,728,125445,2,136
2011-11-10,winter,2011,November,22,Thursday,Workingday,Clear,0.36,0.3333,0.53,0.2836,5,84,89,89,417,89,2,2,1,221,1,728,95612,2,89
2011-11-10,winter,2011,November,23,Thursday,Workingday,Mist,0.34,0.3333,0.57,0.1642,9,73,82,82,417,82,2,2,1,221,1,728,63941,2,82
2011-11-11,winter,2011,November,0,Friday,Holiday,Clear,0.34,0.3182,0.53,0.2537,10,56,66,66,416,66,2,2,1,221,1,726,39130,2,66
2011-11-11,winter,2011,November,1,Friday,Holiday,Clear,0.32,0.303,0.57,0.3284,3,16,19,19,416,19,2,1,1,211,1,724,24164,2,19
2011-11-11,winter,2011,November,2,Friday,Holiday,Clear,0.32,0.2879,0.57,0.2836,1,10,11,11,416,11,2,1,1,211,1,715,16352,2,11
2011-11-11,winter,2011,November,3,Friday,Holiday,Clear,0.3,0.2879,0.61,0.194,0,6,6,6,416,6,2,1,1,211,1,697,8174,2,6
2011-11-11,winter,2011,November,4,Friday,Holiday,Clear,0.3,0.2879,0.61,0.194,0,8,8,8,416,8,2,1,1,211,1,697,4428,2,8
2011-11-11,winter,2011,November,5,Friday,Holiday,Clear,0.3,0.2879,0.49,0.2537,0,13,13,13,416,13,2,1,1,211,1,717,14261,2,13
2011-11-11,winter,2011,November,6,Friday,Holiday,Clear,0.28,0.2576,0.45,0.3284,0,46,46,46,416,46,2,2,1,221,1,725,55132,2,46
2011-11-11,winter,2011,November,7,Friday,Holiday,Clear,0.28,0.2727,0.45,0.2537,5,116,121,121,416,121,2,2,1,221,1,727,154171,2,121
2011-11-11,winter,2011,November,8,Friday,Holiday,Clear,0.3,0.2727,0.42,0.3582,9,249,258,258,416,258,2,3,1,231,1,727,261001,2,258
2011-11-11,winter,2011,November,9,Friday,Holiday,Clear,0.32,0.2879,0.45,0.4478,15,186,201,201,416,201,2,3,1,231,1,727,159438,2,201
2011-11-11,winter,2011,November,10,Friday,Holiday,Clear,0.32,0.2727,0.42,0.5522,38,162,200,200,416,200,2,3,1,231,1,727,126257,2,200
2011-11-11,winter,2011,November,11,Friday,Holiday,Clear,0.34,0.2879,0.42,0.4925,20,150,170,170,416,170,2,3,1,231,1,727,151320,2,170
2011-11-11,winter,2011,November,12,Friday,Holiday,Clear,0.34,0.2879,0.42,0.4627,41,198,239,239,416,239,2,3,1,231,1,728,184414,2,239
2011-11-11,winter,2011,November,13,Friday,Holiday,Clear,0.38,0.3939,0.37,0.5522,57,179,236,236,416,236,2,3,2,232,1,729,184919,2,236
2011-11-11,winter,2011,November,14,Friday,Holiday,Clear,0.38,0.3939,0.37,0.4627,64,183,247,247,416,247,2,3,2,232,1,729,175652,2,247
2011-11-11,winter,2011,November,15,Friday,Holiday,Clear,0.36,0.3333,0.37,0.4179,29,187,216,216,416,216,2,3,1,231,1,729,183149,2,216
2011-11-11,winter,2011,November,16,Friday,Holiday,Clear,0.36,0.3333,0.34,0.3284,49,189,238,238,416,238,2,3,1,231,1,730,227748,2,238
2011-11-11,winter,2011,November,17,Friday,Holiday,Clear,0.34,0.303,0.39,0.3284,24,286,310,310,416,310,2,4,1,241,1,730,336860,2,310
2011-11-11,winter,2011,November,18,Friday,Holiday,Clear,0.34,0.3182,0.39,0.2537,23,185,208,208,416,208,2,3,1,231,1,728,309772,2,208
2011-11-11,winter,2011,November,19,Friday,Holiday,Clear,0.32,0.3182,0.39,0.1642,17,182,199,199,416,199,2,3,1,231,1,728,226789,2,199
2011-11-11,winter,2011,November,20,Friday,Holiday,Clear,0.32,0.3182,0.39,0.194,12,97,109,109,416,109,2,2,1,221,1,728,164550,2,109
2011-11-11,winter,2011,November,21,Friday,Holiday,Clear,0.3,0.303,0.45,0.1642,4,79,83,83,416,83,2,2,1,221,1,728,125445,2,83
2011-11-11,winter,2011,November,22,Friday,Holiday,Clear,0.32,0.3182,0.39,0.194,13,78,91,91,416,91,2,2,1,221,1,728,95612,2,91
2011-11-11,winter,2011,November,23,Friday,Holiday,Clear,0.3,0.3182,0.45,0.0896,6,67,73,73,416,73,2,2,1,221,1,728,63941,2,73
2011-11-12,winter,2011,November,0,Saturday,Holiday,Clear,0.24,0.2424,0.6,0.1343,12,52,64,64,415,64,2,2,1,221,1,726,39130,2,64
2011-11-12,winter,2011,November,1,Saturday,Holiday,Clear,0.24,0.2424,0.6,0.1343,9,45,54,54,415,54,2,2,1,221,1,724,24164,2,54
2011-11-12,winter,2011,November,2,Saturday,Holiday,Clear,0.24,0.2576,0.65,0.0896,7,39,46,46,415,46,2,2,1,221,1,715,16352,2,46
2011-11-12,winter,2011,November,3,Saturday,Holiday,Clear,0.24,0.2424,0.7,0.1343,4,13,17,17,415,17,2,1,1,211,1,697,8174,2,17
2011-11-12,winter,2011,November,4,Saturday,Holiday,Clear,0.2,0.2121,0.8,0.1343,0,7,7,7,415,7,2,1,1,211,1,697,4428,2,7
2011-11-12,winter,2011,November,5,Saturday,Holiday,Clear,0.22,0.2576,0.75,0.0896,1,3,4,4,415,4,2,1,1,211,1,717,14261,2,4
2011-11-12,winter,2011,November,6,Saturday,Holiday,Clear,0.22,0.2273,0.75,0.1642,0,7,7,7,415,7,2,1,1,211,1,725,55132,2,7
2011-11-12,winter,2011,November,7,Saturday,Holiday,Clear,0.22,0.2273,0.75,0.194,3,24,27,27,415,27,2,1,1,211,1,727,154171,2,27
2011-11-12,winter,2011,November,8,Saturday,Holiday,Clear,0.26,0.2576,0.7,0.194,14,87,101,101,415,101,2,2,1,221,1,727,261001,2,101
2011-11-12,winter,2011,November,9,Saturday,Holiday,Clear,0.3,0.303,0.61,0.1642,18,142,160,160,415,160,2,3,1,231,1,727,159438,2,160
2011-11-12,winter,2011,November,10,Saturday,Holiday,Clear,0.34,0.3182,0.61,0.2836,62,170,232,232,415,232,2,3,1,231,1,727,126257,2,232
2011-11-12,winter,2011,November,11,Saturday,Holiday,Clear,0.38,0.3939,0.54,0.2836,102,213,315,315,415,315,2,4,2,242,1,727,151320,2,315
2011-11-12,winter,2011,November,12,Saturday,Holiday,Clear,0.44,0.4394,0.44,0.2836,142,224,366,366,415,366,2,4,2,242,2,728,184414,2,366
2011-11-12,winter,2011,November,13,Saturday,Holiday,Clear,0.48,0.4697,0.36,0.2836,128,225,353,353,415,353,2,4,2,242,2,729,184919,2,353
2011-11-12,winter,2011,November,14,Saturday,Holiday,Clear,0.5,0.4848,0.36,0.2985,191,244,435,435,415,435,2,4,2,242,2,729,175652,2,435
2011-11-12,winter,2011,November,15,Saturday,Holiday,Clear,0.52,0.5,0.29,0.2836,165,221,386,386,415,386,2,4,3,243,2,729,183149,2,386
2011-11-12,winter,2011,November,16,Saturday,Holiday,Clear,0.52,0.5,0.32,0.2537,137,224,361,361,415,361,2,4,3,243,2,730,227748,2,361
2011-11-12,winter,2011,November,17,Saturday,Holiday,Clear,0.5,0.4848,0.34,0.2537,92,193,285,285,415,285,2,4,2,242,2,730,336860,2,285
2011-11-12,winter,2011,November,18,Saturday,Holiday,Clear,0.42,0.4242,0.58,0.194,53,150,203,203,415,203,2,3,2,232,1,728,309772,2,203
2011-11-12,winter,2011,November,19,Saturday,Holiday,Clear,0.42,0.4242,0.5,0.2537,32,139,171,171,415,171,2,3,2,232,1,728,226789,2,171
2011-11-12,winter,2011,November,20,Saturday,Holiday,Clear,0.42,0.4242,0.5,0.2836,31,101,132,132,415,132,2,2,2,222,1,728,164550,2,132
2011-11-12,winter,2011,November,21,Saturday,Holiday,Clear,0.42,0.4242,0.47,0.2836,19,103,122,122,415,122,2,2,2,222,1,728,125445,2,122
2011-11-12,winter,2011,November,22,Saturday,Holiday,Clear,0.42,0.4242,0.47,0.2537,30,88,118,118,415,118,2,2,2,222,1,728,95612,2,118
2011-11-12,winter,2011,November,23,Saturday,Holiday,Clear,0.4,0.4091,0.58,0.1642,23,78,101,101,415,101,2,2,2,222,1,728,63941,2,101
2011-11-13,winter,2011,November,0,Sunday,Holiday,Mist,0.4,0.4091,0.58,0.194,12,61,73,73,414,73,2,2,2,222,1,726,39130,2,73
2011-11-13,winter,2011,November,1,Sunday,Holiday,Mist,0.36,0.3485,0.66,0.194,13,58,71,71,414,71,2,2,2,222,1,724,24164,2,71
2011-11-13,winter,2011,November,2,Sunday,Holiday,Clear,0.36,0.3636,0.57,0.1045,9,48,57,57,414,57,2,2,2,222,1,715,16352,2,57
2011-11-13,winter,2011,November,3,Sunday,Holiday,Mist,0.36,0.3485,0.62,0.1343,8,20,28,28,414,28,2,1,2,212,1,697,8174,2,28
2011-11-13,winter,2011,November,4,Sunday,Holiday,Mist,0.36,0.3485,0.62,0.1343,1,5,6,6,414,6,2,1,2,212,1,697,4428,2,6
2011-11-13,winter,2011,November,5,Sunday,Holiday,Clear,0.34,0.3333,0.61,0.1642,2,3,5,5,414,5,2,1,1,211,1,717,14261,2,5
2011-11-13,winter,2011,November,6,Sunday,Holiday,Clear,0.34,0.3333,0.66,0.1343,5,18,23,23,414,23,2,1,1,211,1,725,55132,2,23
2011-11-13,winter,2011,November,7,Sunday,Holiday,Clear,0.34,0.3182,0.66,0.2239,13,30,43,43,414,43,2,2,1,221,1,727,154171,2,43
2011-11-13,winter,2011,November,8,Sunday,Holiday,Clear,0.34,0.3485,0.66,0.0896,24,55,79,79,414,79,2,2,2,222,1,727,261001,2,79
2011-11-13,winter,2011,November,9,Sunday,Holiday,Clear,0.4,0.4091,0.54,0.2836,38,97,135,135,414,135,2,2,2,222,1,727,159438,2,135
2011-11-13,winter,2011,November,10,Sunday,Holiday,Clear,0.44,0.4394,0.44,0.3284,63,178,241,241,414,241,2,3,2,232,1,727,126257,2,241
2011-11-13,winter,2011,November,11,Sunday,Holiday,Clear,0.46,0.4545,0.4,0.4179,108,187,295,295,414,295,2,4,2,242,2,727,151320,2,295
2011-11-13,winter,2011,November,12,Sunday,Holiday,Mist,0.52,0.5,0.29,0.4179,112,242,354,354,414,354,2,4,3,243,2,728,184414,2,354
2011-11-13,winter,2011,November,13,Sunday,Holiday,Mist,0.52,0.5,0.29,0.4179,105,234,339,339,414,339,2,4,3,243,2,729,184919,2,339
2011-11-13,winter,2011,November,14,Sunday,Holiday,Mist,0.54,0.5152,0.28,0.4925,108,263,371,371,414,371,2,4,3,243,2,729,175652,2,371
2011-11-13,winter,2011,November,15,Sunday,Holiday,Mist,0.5,0.4848,0.42,0.3284,89,221,310,310,414,310,2,4,2,242,2,729,183149,2,310
2011-11-13,winter,2011,November,16,Sunday,Holiday,Mist,0.54,0.5152,0.28,0.3881,93,226,319,319,414,319,2,4,3,243,2,730,227748,2,319
2011-11-13,winter,2011,November,17,Sunday,Holiday,Clear,0.52,0.5,0.27,0.3284,44,187,231,231,414,231,2,3,3,233,2,730,336860,2,231
2011-11-13,winter,2011,November,18,Sunday,Holiday,Clear,0.52,0.5,0.27,0.3284,35,155,190,190,414,190,2,3,3,233,2,728,309772,2,190
2011-11-13,winter,2011,November,19,Sunday,Holiday,Clear,0.5,0.4848,0.29,0.3582,36,121,157,157,414,157,2,3,2,232,1,728,226789,2,157
2011-11-13,winter,2011,November,20,Sunday,Holiday,Clear,0.5,0.4848,0.31,0.3582,24,115,139,139,414,139,2,2,2,222,1,728,164550,2,139
2011-11-13,winter,2011,November,21,Sunday,Holiday,Clear,0.48,0.4697,0.36,0.2537,19,76,95,95,414,95,2,2,2,222,1,728,125445,2,95
2011-11-13,winter,2011,November,22,Sunday,Holiday,Clear,0.48,0.4697,0.41,0.3881,25,64,89,89,414,89,2,2,2,222,1,728,95612,2,89
2011-11-13,winter,2011,November,23,Sunday,Holiday,Clear,0.46,0.4545,0.51,0.2985,18,49,67,67,414,67,2,2,2,222,1,728,63941,2,67
2011-11-14,winter,2011,November,0,Monday,Workingday,Clear,0.46,0.4545,0.59,0.2836,8,22,30,30,413,30,2,1,2,212,1,726,39130,2,30
2011-11-14,winter,2011,November,1,Monday,Workingday,Clear,0.46,0.4545,0.63,0.2985,5,6,11,11,413,11,2,1,2,212,1,724,24164,2,11
2011-11-14,winter,2011,November,2,Monday,Workingday,Clear,0.46,0.4545,0.63,0.3582,7,10,17,17,413,17,2,1,2,212,1,715,16352,2,17
2011-11-14,winter,2011,November,3,Monday,Workingday,Clear,0.44,0.4394,0.67,0.2836,4,3,7,7,413,7,2,1,2,212,1,697,8174,2,7
2011-11-14,winter,2011,November,4,Monday,Workingday,Clear,0.44,0.4394,0.67,0.2239,0,5,5,5,413,5,2,1,2,212,1,697,4428,2,5
2011-11-14,winter,2011,November,5,Monday,Workingday,Mist,0.44,0.4394,0.67,0.2537,0,19,19,19,413,19,2,1,2,212,1,717,14261,2,19
2011-11-14,winter,2011,November,6,Monday,Workingday,Mist,0.44,0.4394,0.72,0.2239,10,104,114,114,413,114,2,2,2,222,0,725,55132,2,114
2011-11-14,winter,2011,November,7,Monday,Workingday,Clear,0.44,0.4394,0.72,0.2537,11,311,322,322,413,322,2,4,2,242,0,727,154171,2,322
2011-11-14,winter,2011,November,8,Monday,Workingday,Mist,0.46,0.4545,0.67,0.194,27,425,452,452,413,452,2,4,2,242,2,727,261001,2,452
2011-11-14,winter,2011,November,9,Monday,Workingday,Mist,0.48,0.4697,0.67,0.3284,29,204,233,233,413,233,2,3,2,232,0,727,159438,2,233
2011-11-14,winter,2011,November,10,Monday,Workingday,Mist,0.5,0.4848,0.63,0.2836,26,85,111,111,413,111,2,2,2,222,0,727,126257,2,111
2011-11-14,winter,2011,November,11,Monday,Workingday,Mist,0.54,0.5152,0.6,0.2836,22,106,128,128,413,128,2,2,3,223,0,727,151320,2,128
2011-11-14,winter,2011,November,12,Monday,Workingday,Clear,0.56,0.5303,0.56,0.2985,36,166,202,202,413,202,2,3,3,233,0,728,184414,2,202
2011-11-14,winter,2011,November,13,Monday,Workingday,Clear,0.6,0.6212,0.49,0.3881,50,153,203,203,413,203,2,3,3,233,2,729,184919,2,203
2011-11-14,winter,2011,November,14,Monday,Workingday,Clear,0.62,0.6212,0.46,0.4478,47,138,185,185,413,185,2,3,3,233,2,729,175652,2,185
2011-11-14,winter,2011,November,15,Monday,Workingday,Clear,0.64,0.6212,0.44,0.3284,53,142,195,195,413,195,2,3,3,233,2,729,183149,2,195
2011-11-14,winter,2011,November,16,Monday,Workingday,Clear,0.62,0.6212,0.46,0.4179,51,264,315,315,413,315,2,4,3,243,2,730,227748,2,315
2011-11-14,winter,2011,November,17,Monday,Workingday,Clear,0.62,0.6212,0.46,0.2537,55,464,519,519,413,519,2,4,3,243,2,730,336860,2,519
2011-11-14,winter,2011,November,18,Monday,Workingday,Clear,0.56,0.5303,0.56,0.2836,29,460,489,489,413,489,2,4,3,243,2,728,309772,2,489
2011-11-14,winter,2011,November,19,Monday,Workingday,Clear,0.6,0.6212,0.53,0.2985,28,274,302,302,413,302,2,4,3,243,2,728,226789,2,302
2011-11-14,winter,2011,November,20,Monday,Workingday,Clear,0.6,0.6212,0.53,0.3582,30,210,240,240,413,240,2,3,3,233,2,728,164550,2,240
2011-11-14,winter,2011,November,21,Monday,Workingday,Clear,0.6,0.6212,0.53,0.3582,37,176,213,213,413,213,2,3,3,233,2,728,125445,2,213
2011-11-14,winter,2011,November,22,Monday,Workingday,Clear,0.58,0.5455,0.56,0.3582,17,96,113,113,413,113,2,2,3,223,0,728,95612,2,113
2011-11-14,winter,2011,November,23,Monday,Workingday,Clear,0.56,0.5303,0.64,0.2985,13,48,61,61,413,61,2,2,3,223,0,728,63941,2,61
2011-11-15,winter,2011,November,0,Tuesday,Workingday,Clear,0.56,0.5303,0.64,0.3582,7,15,22,22,412,22,2,1,3,213,0,726,39130,2,22
2011-11-15,winter,2011,November,1,Tuesday,Workingday,Clear,0.56,0.5303,0.6,0.2985,5,5,10,10,412,10,2,1,3,213,0,724,24164,2,10
2011-11-15,winter,2011,November,2,Tuesday,Workingday,Clear,0.56,0.5303,0.64,0.2537,7,8,15,15,412,15,2,1,3,213,0,715,16352,2,15
2011-11-15,winter,2011,November,3,Tuesday,Workingday,Mist,0.54,0.5152,0.68,0.3284,0,4,4,4,412,4,2,1,3,213,0,697,8174,2,4
2011-11-15,winter,2011,November,4,Tuesday,Workingday,Clear,0.56,0.5303,0.64,0.2985,1,6,7,7,412,7,2,1,3,213,0,697,4428,2,7
2011-11-15,winter,2011,November,5,Tuesday,Workingday,Clear,0.54,0.5152,0.68,0.2836,2,26,28,28,412,28,2,1,3,213,0,717,14261,2,28
2011-11-15,winter,2011,November,6,Tuesday,Workingday,Mist,0.56,0.5303,0.64,0.0896,4,104,108,108,412,108,2,2,3,223,0,725,55132,2,108
2011-11-15,winter,2011,November,7,Tuesday,Workingday,Mist,0.54,0.5152,0.68,0.1642,21,298,319,319,412,319,2,4,3,243,0,727,154171,2,319
2011-11-15,winter,2011,November,8,Tuesday,Workingday,Mist,0.54,0.5152,0.68,0.1045,27,453,480,480,412,480,2,4,3,243,2,727,261001,2,480
2011-11-15,winter,2011,November,9,Tuesday,Workingday,Mist,0.56,0.5303,0.64,0.0896,26,174,200,200,412,200,2,3,3,233,0,727,159438,2,200
2011-11-15,winter,2011,November,10,Tuesday,Workingday,Mist,0.56,0.5303,0.64,0.2836,23,115,138,138,412,138,2,2,3,223,0,727,126257,2,138
2011-11-15,winter,2011,November,11,Tuesday,Workingday,Mist,0.56,0.5303,0.64,0.194,18,116,134,134,412,134,2,2,3,223,0,727,151320,2,134
2011-11-15,winter,2011,November,12,Tuesday,Workingday,Mist,0.54,0.5152,0.68,0.0,28,148,176,176,412,176,2,3,3,233,0,728,184414,2,176
2011-11-15,winter,2011,November,13,Tuesday,Workingday,Light Snow,0.54,0.5152,0.6,0.2239,21,132,153,153,412,153,2,3,3,233,0,729,184919,2,153
2011-11-15,winter,2011,November,14,Tuesday,Workingday,Mist,0.54,0.5152,0.6,0.2836,27,120,147,147,412,147,2,3,3,233,0,729,175652,2,147
2011-11-15,winter,2011,November,15,Tuesday,Workingday,Mist,0.54,0.5152,0.6,0.1343,36,155,191,191,412,191,2,3,3,233,0,729,183149,2,191
2011-11-15,winter,2011,November,16,Tuesday,Workingday,Mist,0.52,0.5,0.68,0.1343,31,240,271,271,412,271,2,3,3,233,0,730,227748,2,271
2011-11-15,winter,2011,November,17,Tuesday,Workingday,Mist,0.5,0.4848,0.72,0.194,29,422,451,451,412,451,2,4,2,242,0,730,336860,2,451
2011-11-15,winter,2011,November,18,Tuesday,Workingday,Mist,0.5,0.4848,0.72,0.2836,27,414,441,441,412,441,2,4,2,242,2,728,309772,2,441
2011-11-15,winter,2011,November,19,Tuesday,Workingday,Mist,0.5,0.4848,0.72,0.3582,27,259,286,286,412,286,2,4,2,242,0,728,226789,2,286
2011-11-15,winter,2011,November,20,Tuesday,Workingday,Mist,0.48,0.4697,0.82,0.1343,26,212,238,238,412,238,2,3,2,232,0,728,164550,2,238
2011-11-15,winter,2011,November,21,Tuesday,Workingday,Mist,0.5,0.4848,0.77,0.0896,23,145,168,168,412,168,2,3,2,232,0,728,125445,2,168
2011-11-15,winter,2011,November,22,Tuesday,Workingday,Mist,0.46,0.4545,0.88,0.1045,19,109,128,128,412,128,2,2,2,222,0,728,95612,2,128
2011-11-15,winter,2011,November,23,Tuesday,Workingday,Mist,0.46,0.4545,0.94,0.1045,14,66,80,80,412,80,2,2,2,222,0,728,63941,2,80
2011-11-16,winter,2011,November,0,Wednesday,Workingday,Mist,0.46,0.4545,0.94,0.0,5,26,31,31,411,31,2,1,2,212,0,726,39130,2,31
2011-11-16,winter,2011,November,1,Wednesday,Workingday,Light Snow,0.46,0.4545,0.94,0.0896,0,5,5,5,411,5,2,1,2,212,0,724,24164,2,5
2011-11-16,winter,2011,November,2,Wednesday,Workingday,Mist,0.46,0.4545,0.94,0.1045,4,6,10,10,411,10,2,1,2,212,0,715,16352,2,10
2011-11-16,winter,2011,November,3,Wednesday,Workingday,Mist,0.46,0.4545,0.94,0.1045,2,3,5,5,411,5,2,1,2,212,0,697,8174,2,5
2011-11-16,winter,2011,November,4,Wednesday,Workingday,Mist,0.44,0.4394,1.0,0.2239,1,3,4,4,411,4,2,1,2,212,0,697,4428,2,4
2011-11-16,winter,2011,November,5,Wednesday,Workingday,Light Snow,0.46,0.4545,0.94,0.1045,0,13,13,13,411,13,2,1,2,212,0,717,14261,2,13
2011-11-16,winter,2011,November,6,Wednesday,Workingday,Mist,0.46,0.4545,0.94,0.0896,4,52,56,56,411,56,2,2,2,222,0,725,55132,2,56
2011-11-16,winter,2011,November,7,Wednesday,Workingday,Light Snow,0.46,0.4545,0.94,0.0,7,130,137,137,411,137,2,2,2,222,0,727,154171,2,137
2011-11-16,winter,2011,November,8,Wednesday,Workingday,Light Snow,0.46,0.4545,0.94,0.0,9,223,232,232,411,232,2,3,2,232,0,727,261001,2,232
2011-11-16,winter,2011,November,9,Wednesday,Workingday,Light Snow,0.46,0.4545,0.94,0.0,5,77,82,82,411,82,2,2,2,222,0,727,159438,2,82
2011-11-16,winter,2011,November,10,Wednesday,Workingday,Light Snow,0.46,0.4545,0.94,0.0,4,32,36,36,411,36,2,1,2,212,0,727,126257,2,36
2011-11-16,winter,2011,November,11,Wednesday,Workingday,Light Snow,0.46,0.4545,0.94,0.0896,7,53,60,60,411,60,2,2,2,222,0,727,151320,2,60
2011-11-16,winter,2011,November,12,Wednesday,Workingday,Light Snow,0.46,0.4545,1.0,0.0,5,49,54,54,411,54,2,2,2,222,0,728,184414,2,54
2011-11-16,winter,2011,November,13,Wednesday,Workingday,Light Snow,0.46,0.4545,0.94,0.1343,6,52,58,58,411,58,2,2,2,222,0,729,184919,2,58
2011-11-16,winter,2011,November,14,Wednesday,Workingday,Mist,0.46,0.4545,1.0,0.1343,12,49,61,61,411,61,2,2,2,222,0,729,175652,2,61
2011-11-16,winter,2011,November,15,Wednesday,Workingday,Light Snow,0.48,0.4697,0.94,0.1045,16,50,66,66,411,66,2,2,2,222,0,729,183149,2,66
2011-11-16,winter,2011,November,16,Wednesday,Workingday,Light Snow,0.48,0.4697,0.94,0.1045,13,110,123,123,411,123,2,2,2,222,0,730,227748,2,123
2011-11-16,winter,2011,November,17,Wednesday,Workingday,Mist,0.48,0.4697,0.88,0.194,17,216,233,233,411,233,2,3,2,232,0,730,336860,2,233
2011-11-16,winter,2011,November,18,Wednesday,Workingday,Light Snow,0.46,0.4545,0.88,0.3881,13,176,189,189,411,189,2,3,2,232,0,728,309772,2,189
2011-11-16,winter,2011,November,19,Wednesday,Workingday,Light Snow,0.46,0.4545,0.88,0.3881,3,108,111,111,411,111,2,2,2,222,0,728,226789,2,111
2011-11-16,winter,2011,November,20,Wednesday,Workingday,Light Snow,0.44,0.4394,0.88,0.3881,5,94,99,99,411,99,2,2,2,222,0,728,164550,2,99
2011-11-16,winter,2011,November,21,Wednesday,Workingday,Light Snow,0.44,0.4394,0.88,0.2836,3,72,75,75,411,75,2,2,2,222,0,728,125445,2,75
2011-11-16,winter,2011,November,22,Wednesday,Workingday,Light Snow,0.42,0.4242,0.88,0.2239,1,45,46,46,411,46,2,2,2,222,0,728,95612,2,46
2011-11-16,winter,2011,November,23,Wednesday,Workingday,Light Snow,0.42,0.4242,0.88,0.1343,3,28,31,31,411,31,2,1,2,212,0,728,63941,2,31
2011-11-17,winter,2011,November,0,Thursday,Workingday,Mist,0.42,0.4242,0.88,0.2537,2,22,24,24,410,24,2,1,2,212,0,726,39130,2,24
2011-11-17,winter,2011,November,1,Thursday,Workingday,Mist,0.42,0.4242,0.82,0.1642,0,5,5,5,410,5,2,1,2,212,0,724,24164,2,5
2011-11-17,winter,2011,November,2,Thursday,Workingday,Mist,0.42,0.4242,0.82,0.2239,0,5,5,5,410,5,2,1,2,212,0,715,16352,2,5
2011-11-17,winter,2011,November,3,Thursday,Workingday,Mist,0.42,0.4242,0.77,0.3284,0,3,3,3,410,3,2,1,2,212,1,697,8174,2,3
2011-11-17,winter,2011,November,4,Thursday,Workingday,Mist,0.4,0.4091,0.62,0.4179,1,3,4,4,410,4,2,1,2,212,1,697,4428,2,4
2011-11-17,winter,2011,November,5,Thursday,Workingday,Light Snow,0.34,0.303,0.71,0.3284,1,21,22,22,410,22,2,1,1,211,1,717,14261,2,22
2011-11-17,winter,2011,November,6,Thursday,Workingday,Light Snow,0.36,0.3485,0.57,0.2239,3,72,75,75,410,75,2,2,2,222,1,725,55132,2,75
2011-11-17,winter,2011,November,7,Thursday,Workingday,Light Snow,0.34,0.3182,0.61,0.2836,4,164,168,168,410,168,2,3,1,231,1,727,154171,2,168
2011-11-17,winter,2011,November,8,Thursday,Workingday,Light Snow,0.34,0.303,0.61,0.2985,12,343,355,355,410,355,2,4,1,241,1,727,261001,2,355
2011-11-17,winter,2011,November,9,Thursday,Workingday,Mist,0.34,0.303,0.61,0.3284,14,184,198,198,410,198,2,3,1,231,1,727,159438,2,198
2011-11-17,winter,2011,November,10,Thursday,Workingday,Mist,0.34,0.303,0.61,0.3284,7,74,81,81,410,81,2,2,1,221,1,727,126257,2,81
2011-11-17,winter,2011,November,11,Thursday,Workingday,Light Snow,0.32,0.303,0.66,0.3284,4,93,97,97,410,97,2,2,1,221,1,727,151320,2,97
2011-11-17,winter,2011,November,12,Thursday,Workingday,Mist,0.34,0.303,0.53,0.2985,6,115,121,121,410,121,2,2,1,221,1,728,184414,2,121
2011-11-17,winter,2011,November,13,Thursday,Workingday,Mist,0.34,0.303,0.49,0.4478,15,109,124,124,410,124,2,2,1,221,1,729,184919,2,124
2011-11-17,winter,2011,November,14,Thursday,Workingday,Mist,0.34,0.303,0.49,0.3881,5,105,110,110,410,110,2,2,1,221,1,729,175652,2,110
2011-11-17,winter,2011,November,15,Thursday,Workingday,Mist,0.34,0.303,0.49,0.4478,10,106,116,116,410,116,2,2,1,221,1,729,183149,2,116
2011-11-17,winter,2011,November,16,Thursday,Workingday,Clear,0.32,0.2879,0.39,0.4179,8,187,195,195,410,195,2,3,1,231,1,730,227748,2,195
2011-11-17,winter,2011,November,17,Thursday,Workingday,Clear,0.32,0.2879,0.42,0.3881,20,379,399,399,410,399,2,4,1,241,1,730,336860,2,399
2011-11-17,winter,2011,November,18,Thursday,Workingday,Clear,0.32,0.3182,0.39,0.194,9,298,307,307,410,307,2,4,1,241,1,728,309772,2,307
2011-11-17,winter,2011,November,19,Thursday,Workingday,Clear,0.3,0.2879,0.45,0.2239,7,210,217,217,410,217,2,3,1,231,1,728,226789,2,217
2011-11-17,winter,2011,November,20,Thursday,Workingday,Clear,0.3,0.2879,0.42,0.2836,7,162,169,169,410,169,2,3,1,231,1,728,164550,2,169
2011-11-17,winter,2011,November,21,Thursday,Workingday,Clear,0.3,0.2879,0.42,0.2537,3,113,116,116,410,116,2,2,1,221,1,728,125445,2,116
2011-11-17,winter,2011,November,22,Thursday,Workingday,Clear,0.26,0.2424,0.52,0.2537,1,83,84,84,410,84,2,2,1,221,1,728,95612,2,84
2011-11-17,winter,2011,November,23,Thursday,Workingday,Clear,0.26,0.2576,0.52,0.2239,0,58,58,58,410,58,2,2,1,221,1,728,63941,2,58
2011-11-18,winter,2011,November,0,Friday,Workingday,Clear,0.26,0.2576,0.48,0.1642,2,28,30,30,409,30,2,1,1,211,1,726,39130,2,30
2011-11-18,winter,2011,November,1,Friday,Workingday,Clear,0.26,0.2273,0.44,0.3284,0,10,10,10,409,10,2,1,1,211,1,724,24164,2,10
2011-11-18,winter,2011,November,2,Friday,Workingday,Clear,0.24,0.2273,0.44,0.2239,2,8,10,10,409,10,2,1,1,211,1,715,16352,2,10
2011-11-18,winter,2011,November,3,Friday,Workingday,Clear,0.24,0.2121,0.41,0.2836,0,2,2,2,409,2,2,1,1,211,1,697,8174,2,2
2011-11-18,winter,2011,November,4,Friday,Workingday,Clear,0.22,0.2273,0.44,0.1642,0,5,5,5,409,5,2,1,1,211,1,697,4428,2,5
2011-11-18,winter,2011,November,5,Friday,Workingday,Clear,0.22,0.2273,0.44,0.1343,0,22,22,22,409,22,2,1,1,211,1,717,14261,2,22
2011-11-18,winter,2011,November,6,Friday,Workingday,Clear,0.22,0.2576,0.44,0.0896,1,70,71,71,409,71,2,2,1,221,1,725,55132,2,71
2011-11-18,winter,2011,November,7,Friday,Workingday,Clear,0.22,0.2273,0.44,0.1642,5,211,216,216,409,216,2,3,1,231,1,727,154171,2,216
2011-11-18,winter,2011,November,8,Friday,Workingday,Clear,0.22,0.2273,0.44,0.194,6,369,375,375,409,375,2,4,1,241,1,727,261001,2,375
2011-11-18,winter,2011,November,9,Friday,Workingday,Clear,0.26,0.2576,0.41,0.194,6,207,213,213,409,213,2,3,1,231,1,727,159438,2,213
2011-11-18,winter,2011,November,10,Friday,Workingday,Clear,0.26,0.2424,0.41,0.2836,10,105,115,115,409,115,2,2,1,221,1,727,126257,2,115
2011-11-18,winter,2011,November,11,Friday,Workingday,Clear,0.3,0.303,0.36,0.1343,18,122,140,140,409,140,2,2,1,221,1,727,151320,2,140
2011-11-18,winter,2011,November,12,Friday,Workingday,Clear,0.32,0.3333,0.33,0.0,22,143,165,165,409,165,2,3,1,231,1,728,184414,2,165
2011-11-18,winter,2011,November,13,Friday,Workingday,Clear,0.34,0.3182,0.31,0.2239,31,146,177,177,409,177,2,3,1,231,1,729,184919,2,177
2011-11-18,winter,2011,November,14,Friday,Workingday,Clear,0.34,0.3333,0.31,0.1343,31,123,154,154,409,154,2,3,1,231,1,729,175652,2,154
2011-11-18,winter,2011,November,15,Friday,Workingday,Clear,0.34,0.3333,0.29,0.1343,27,151,178,178,409,178,2,3,1,231,1,729,183149,2,178
2011-11-18,winter,2011,November,16,Friday,Workingday,Clear,0.34,0.3333,0.29,0.1343,19,190,209,209,409,209,2,3,1,231,1,730,227748,2,209
2011-11-18,winter,2011,November,17,Friday,Workingday,Clear,0.32,0.3333,0.31,0.1343,17,361,378,378,409,378,2,4,1,241,1,730,336860,2,378
2011-11-18,winter,2011,November,18,Friday,Workingday,Clear,0.3,0.303,0.36,0.1642,16,312,328,328,409,328,2,4,1,241,1,728,309772,2,328
2011-11-18,winter,2011,November,19,Friday,Workingday,Clear,0.28,0.2727,0.41,0.1642,7,183,190,190,409,190,2,3,1,231,1,728,226789,2,190
2011-11-18,winter,2011,November,20,Friday,Workingday,Clear,0.28,0.2727,0.48,0.194,8,129,137,137,409,137,2,2,1,221,1,728,164550,2,137
2011-11-18,winter,2011,November,21,Friday,Workingday,Clear,0.28,0.2727,0.48,0.1642,3,108,111,111,409,111,2,2,1,221,1,728,125445,2,111
2011-11-18,winter,2011,November,22,Friday,Workingday,Clear,0.26,0.2727,0.52,0.1045,9,88,97,97,409,97,2,2,1,221,1,728,95612,2,97
2011-11-18,winter,2011,November,23,Friday,Workingday,Clear,0.26,0.2727,0.6,0.1343,5,54,59,59,409,59,2,2,1,221,1,728,63941,2,59
2011-11-19,winter,2011,November,0,Saturday,Holiday,Clear,0.26,0.2576,0.56,0.194,4,49,53,53,408,53,2,2,1,221,1,726,39130,2,53
2011-11-19,winter,2011,November,1,Saturday,Holiday,Clear,0.26,0.2273,0.52,0.2985,1,34,35,35,408,35,2,1,1,211,1,724,24164,2,35
2011-11-19,winter,2011,November,2,Saturday,Holiday,Clear,0.24,0.2424,0.56,0.1642,12,34,46,46,408,46,2,2,1,221,1,715,16352,2,46
2011-11-19,winter,2011,November,3,Saturday,Holiday,Clear,0.26,0.2424,0.48,0.2537,4,11,15,15,408,15,2,1,1,211,1,697,8174,2,15
2011-11-19,winter,2011,November,4,Saturday,Holiday,Clear,0.26,0.2273,0.48,0.3284,4,4,8,8,408,8,2,1,1,211,1,697,4428,2,8
2011-11-19,winter,2011,November,5,Saturday,Holiday,Clear,0.24,0.2273,0.56,0.2537,0,2,2,2,408,2,2,1,1,211,1,717,14261,2,2
2011-11-19,winter,2011,November,6,Saturday,Holiday,Clear,0.24,0.2121,0.6,0.3284,2,10,12,12,408,12,2,1,1,211,1,725,55132,2,12
2011-11-19,winter,2011,November,7,Saturday,Holiday,Clear,0.24,0.2273,0.6,0.2537,3,38,41,41,408,41,2,2,1,221,1,727,154171,2,41
2011-11-19,winter,2011,November,8,Saturday,Holiday,Clear,0.26,0.2424,0.56,0.2537,12,80,92,92,408,92,2,2,1,221,1,727,261001,2,92
2011-11-19,winter,2011,November,9,Saturday,Holiday,Clear,0.28,0.2576,0.52,0.2985,12,130,142,142,408,142,2,2,1,221,1,727,159438,2,142
2011-11-19,winter,2011,November,10,Saturday,Holiday,Clear,0.32,0.303,0.45,0.2537,35,165,200,200,408,200,2,3,1,231,1,727,126257,2,200
2011-11-19,winter,2011,November,11,Saturday,Holiday,Clear,0.36,0.3788,0.4,0.0,50,183,233,233,408,233,2,3,2,232,1,727,151320,2,233
2011-11-19,winter,2011,November,12,Saturday,Holiday,Clear,0.4,0.4091,0.35,0.2836,93,218,311,311,408,311,2,4,2,242,2,728,184414,2,311
2011-11-19,winter,2011,November,13,Saturday,Holiday,Clear,0.42,0.4242,0.3,0.2836,118,245,363,363,408,363,2,4,2,242,2,729,184919,2,363
2011-11-19,winter,2011,November,14,Saturday,Holiday,Clear,0.42,0.4242,0.32,0.2985,121,228,349,349,408,349,2,4,2,242,2,729,175652,2,349
2011-11-19,winter,2011,November,15,Saturday,Holiday,Clear,0.42,0.4242,0.41,0.194,120,262,382,382,408,382,2,4,2,242,2,729,183149,2,382
2011-11-19,winter,2011,November,16,Saturday,Holiday,Clear,0.42,0.4242,0.38,0.2985,99,188,287,287,408,287,2,4,2,242,2,730,227748,2,287
2011-11-19,winter,2011,November,17,Saturday,Holiday,Clear,0.4,0.4091,0.4,0.194,61,171,232,232,408,232,2,3,2,232,1,730,336860,2,232
2011-11-19,winter,2011,November,18,Saturday,Holiday,Clear,0.38,0.3939,0.46,0.1343,36,172,208,208,408,208,2,3,2,232,1,728,309772,2,208
2011-11-19,winter,2011,November,19,Saturday,Holiday,Mist,0.34,0.3333,0.71,0.1343,33,149,182,182,408,182,2,3,1,231,1,728,226789,2,182
2011-11-19,winter,2011,November,20,Saturday,Holiday,Mist,0.36,0.3636,0.57,0.1045,48,115,163,163,408,163,2,3,2,232,1,728,164550,2,163
2011-11-19,winter,2011,November,21,Saturday,Holiday,Mist,0.36,0.3485,0.62,0.194,29,79,108,108,408,108,2,2,2,222,1,728,125445,2,108
2011-11-19,winter,2011,November,22,Saturday,Holiday,Mist,0.38,0.3939,0.62,0.1642,26,80,106,106,408,106,2,2,2,222,1,728,95612,2,106
2011-11-19,winter,2011,November,23,Saturday,Holiday,Clear,0.38,0.3939,0.62,0.2239,20,73,93,93,408,93,2,2,2,222,1,728,63941,2,93
2011-11-20,winter,2011,November,0,Sunday,Holiday,Clear,0.38,0.3939,0.66,0.1642,14,79,93,93,407,93,2,2,2,222,1,726,39130,2,93
2011-11-20,winter,2011,November,1,Sunday,Holiday,Clear,0.4,0.4091,0.62,0.2537,11,73,84,84,407,84,2,2,2,222,1,724,24164,2,84
2011-11-20,winter,2011,November,2,Sunday,Holiday,Clear,0.4,0.4091,0.62,0.2836,12,44,56,56,407,56,2,2,2,222,1,715,16352,2,56
2011-11-20,winter,2011,November,3,Sunday,Holiday,Mist,0.4,0.4091,0.66,0.2836,6,31,37,37,407,37,2,1,2,212,1,697,8174,2,37
2011-11-20,winter,2011,November,4,Sunday,Holiday,Mist,0.4,0.4091,0.71,0.2836,2,10,12,12,407,12,2,1,2,212,1,697,4428,2,12
2011-11-20,winter,2011,November,5,Sunday,Holiday,Mist,0.42,0.4242,0.67,0.2836,0,4,4,4,407,4,2,1,2,212,1,717,14261,2,4
2011-11-20,winter,2011,November,6,Sunday,Holiday,Mist,0.42,0.4242,0.67,0.2537,3,6,9,9,407,9,2,1,2,212,1,725,55132,2,9
2011-11-20,winter,2011,November,7,Sunday,Holiday,Clear,0.42,0.4242,0.67,0.2239,4,19,23,23,407,23,2,1,2,212,1,727,154171,2,23
2011-11-20,winter,2011,November,8,Sunday,Holiday,Mist,0.42,0.4242,0.71,0.2836,13,52,65,65,407,65,2,2,2,222,1,727,261001,2,65
2011-11-20,winter,2011,November,9,Sunday,Holiday,Clear,0.44,0.4394,0.72,0.1642,29,109,138,138,407,138,2,2,2,222,0,727,159438,2,138
2011-11-20,winter,2011,November,10,Sunday,Holiday,Mist,0.44,0.4394,0.72,0.1045,46,183,229,229,407,229,2,3,2,232,0,727,126257,2,229
2011-11-20,winter,2011,November,11,Sunday,Holiday,Mist,0.5,0.4848,0.63,0.1045,74,212,286,286,407,286,2,4,2,242,0,727,151320,2,286
2011-11-20,winter,2011,November,12,Sunday,Holiday,Mist,0.5,0.4848,0.63,0.1343,70,234,304,304,407,304,2,4,2,242,0,728,184414,2,304
2011-11-20,winter,2011,November,13,Sunday,Holiday,Mist,0.54,0.5152,0.6,0.194,84,285,369,369,407,369,2,4,3,243,2,729,184919,2,369
2011-11-20,winter,2011,November,14,Sunday,Holiday,Clear,0.52,0.5,0.63,0.2537,113,250,363,363,407,363,2,4,3,243,2,729,175652,2,363
2011-11-20,winter,2011,November,15,Sunday,Holiday,Mist,0.52,0.5,0.68,0.194,109,242,351,351,407,351,2,4,3,243,2,729,183149,2,351
2011-11-20,winter,2011,November,16,Sunday,Holiday,Mist,0.52,0.5,0.63,0.1343,81,225,306,306,407,306,2,4,3,243,2,730,227748,2,306
2011-11-20,winter,2011,November,17,Sunday,Holiday,Mist,0.52,0.5,0.63,0.194,35,168,203,203,407,203,2,3,3,233,0,730,336860,2,203
2011-11-20,winter,2011,November,18,Sunday,Holiday,Mist,0.54,0.5152,0.64,0.194,22,123,145,145,407,145,2,3,3,233,0,728,309772,2,145
2011-11-20,winter,2011,November,19,Sunday,Holiday,Mist,0.5,0.4848,0.72,0.1045,17,140,157,157,407,157,2,3,2,232,0,728,226789,2,157
2011-11-20,winter,2011,November,20,Sunday,Holiday,Mist,0.52,0.5,0.68,0.1045,23,90,113,113,407,113,2,2,3,223,0,728,164550,2,113
2011-11-20,winter,2011,November,21,Sunday,Holiday,Mist,0.48,0.4697,0.77,0.0896,11,94,105,105,407,105,2,2,2,222,0,728,125445,2,105
2011-11-20,winter,2011,November,22,Sunday,Holiday,Light Snow,0.46,0.4545,0.88,0.0896,5,35,40,40,407,40,2,1,2,212,0,728,95612,2,40
2011-11-20,winter,2011,November,23,Sunday,Holiday,Light Snow,0.46,0.4545,0.88,0.0896,3,25,28,28,407,28,2,1,2,212,0,728,63941,2,28
2011-11-21,winter,2011,November,0,Monday,Workingday,Mist,0.46,0.4545,0.94,0.0,4,13,17,17,406,17,2,1,2,212,0,726,39130,2,17
2011-11-21,winter,2011,November,1,Monday,Workingday,Light Snow,0.46,0.4545,0.94,0.194,4,8,12,12,406,12,2,1,2,212,0,724,24164,2,12
2011-11-21,winter,2011,November,2,Monday,Workingday,Light Snow,0.44,0.4394,1.0,0.194,1,2,3,3,406,3,2,1,2,212,0,715,16352,2,3
2011-11-21,winter,2011,November,3,Monday,Workingday,Light Snow,0.44,0.4394,1.0,0.1343,0,4,4,4,406,4,2,1,2,212,0,697,8174,2,4
2011-11-21,winter,2011,November,4,Monday,Workingday,Light Snow,0.44,0.4394,1.0,0.1343,0,5,5,5,406,5,2,1,2,212,0,697,4428,2,5
2011-11-21,winter,2011,November,5,Monday,Workingday,Mist,0.44,0.4394,1.0,0.0,0,20,20,20,406,20,2,1,2,212,0,717,14261,2,20
2011-11-21,winter,2011,November,6,Monday,Workingday,Mist,0.42,0.4242,1.0,0.0,0,76,76,76,406,76,2,2,2,222,0,725,55132,2,76
2011-11-21,winter,2011,November,7,Monday,Workingday,Mist,0.46,0.4545,0.94,0.1642,17,229,246,246,406,246,2,3,2,232,0,727,154171,2,246
2011-11-21,winter,2011,November,8,Monday,Workingday,Mist,0.46,0.4545,0.94,0.0,13,378,391,391,406,391,2,4,2,242,0,727,261001,2,391
2011-11-21,winter,2011,November,9,Monday,Workingday,Mist,0.48,0.4697,0.94,0.1045,15,222,237,237,406,237,2,3,2,232,0,727,159438,2,237
2011-11-21,winter,2011,November,10,Monday,Workingday,Mist,0.52,0.5,0.83,0.0,25,110,135,135,406,135,2,2,3,223,0,727,126257,2,135
2011-11-21,winter,2011,November,11,Monday,Workingday,Mist,0.52,0.5,0.83,0.1045,16,112,128,128,406,128,2,2,3,223,0,727,151320,2,128
2011-11-21,winter,2011,November,12,Monday,Workingday,Mist,0.5,0.4848,0.77,0.1343,24,138,162,162,406,162,2,3,2,232,0,728,184414,2,162
2011-11-21,winter,2011,November,13,Monday,Workingday,Mist,0.5,0.4848,0.77,0.1343,13,121,134,134,406,134,2,2,2,222,0,729,184919,2,134
2011-11-21,winter,2011,November,14,Monday,Workingday,Mist,0.48,0.4697,0.82,0.194,14,121,135,135,406,135,2,2,2,222,0,729,175652,2,135
2011-11-21,winter,2011,November,15,Monday,Workingday,Light Snow,0.44,0.4394,0.94,0.2239,15,93,108,108,406,108,2,2,2,222,0,729,183149,2,108
2011-11-21,winter,2011,November,16,Monday,Workingday,Light Snow,0.44,0.4394,0.94,0.2239,13,95,108,108,406,108,2,2,2,222,0,730,227748,2,108
2011-11-21,winter,2011,November,17,Monday,Workingday,Light Snow,0.42,0.4242,0.94,0.2985,10,200,210,210,406,210,2,3,2,232,0,730,336860,2,210
2011-11-21,winter,2011,November,18,Monday,Workingday,Light Snow,0.42,0.4242,0.88,0.194,8,184,192,192,406,192,2,3,2,232,0,728,309772,2,192
2011-11-21,winter,2011,November,19,Monday,Workingday,Light Snow,0.4,0.4091,0.94,0.194,2,135,137,137,406,137,2,2,2,222,0,728,226789,2,137
2011-11-21,winter,2011,November,20,Monday,Workingday,Light Snow,0.4,0.4091,0.87,0.2239,5,75,80,80,406,80,2,2,2,222,0,728,164550,2,80
2011-11-21,winter,2011,November,21,Monday,Workingday,Light Snow,0.4,0.4091,0.87,0.1642,11,103,114,114,406,114,2,2,2,222,0,728,125445,2,114
2011-11-21,winter,2011,November,22,Monday,Workingday,Light Snow,0.4,0.4091,0.87,0.1343,6,72,78,78,406,78,2,2,2,222,0,728,95612,2,78
2011-11-21,winter,2011,November,23,Monday,Workingday,Light Snow,0.4,0.4091,0.87,0.1642,4,29,33,33,406,33,2,1,2,212,0,728,63941,2,33
2011-11-22,winter,2011,November,0,Tuesday,Workingday,Light Snow,0.38,0.3939,0.94,0.1045,0,14,14,14,405,14,2,1,2,212,0,726,39130,2,14
2011-11-22,winter,2011,November,1,Tuesday,Workingday,Light Snow,0.4,0.4091,0.94,0.1343,1,5,6,6,405,6,2,1,2,212,0,724,24164,2,6
2011-11-22,winter,2011,November,2,Tuesday,Workingday,Light Snow,0.38,0.3939,1.0,0.1045,2,4,6,6,405,6,2,1,2,212,0,715,16352,2,6
2011-11-22,winter,2011,November,3,Tuesday,Workingday,Light Snow,0.38,0.3939,1.0,0.1045,1,2,3,3,405,3,2,1,2,212,0,697,8174,2,3
2011-11-22,winter,2011,November,4,Tuesday,Workingday,Light Snow,0.38,0.3939,0.94,0.1642,0,7,7,7,405,7,2,1,2,212,0,697,4428,2,7
2011-11-22,winter,2011,November,5,Tuesday,Workingday,Light Snow,0.38,0.3939,0.94,0.1642,1,17,18,18,405,18,2,1,2,212,0,717,14261,2,18
2011-11-22,winter,2011,November,6,Tuesday,Workingday,Mist,0.38,0.3939,0.94,0.1045,1,63,64,64,405,64,2,2,2,222,0,725,55132,2,64
2011-11-22,winter,2011,November,7,Tuesday,Workingday,Light Snow,0.38,0.3939,0.94,0.2239,2,119,121,121,405,121,2,2,2,222,0,727,154171,2,121
2011-11-22,winter,2011,November,8,Tuesday,Workingday,Light Snow,0.38,0.3939,0.94,0.2239,5,185,190,190,405,190,2,3,2,232,0,727,261001,2,190
2011-11-22,winter,2011,November,9,Tuesday,Workingday,Light Snow,0.4,0.4091,0.94,0.0,2,147,149,149,405,149,2,3,2,232,0,727,159438,2,149
2011-11-22,winter,2011,November,10,Tuesday,Workingday,Light Snow,0.4,0.4091,0.94,0.0,6,46,52,52,405,52,2,2,2,222,0,727,126257,2,52
2011-11-22,winter,2011,November,11,Tuesday,Workingday,Light Snow,0.4,0.4091,0.94,0.1343,4,28,32,32,405,32,2,1,2,212,0,727,151320,2,32
2011-11-22,winter,2011,November,12,Tuesday,Workingday,Light Snow,0.4,0.4091,1.0,0.0896,3,18,21,21,405,21,2,1,2,212,0,728,184414,2,21
2011-11-22,winter,2011,November,13,Tuesday,Workingday,Light Snow,0.42,0.4242,1.0,0.0896,4,22,26,26,405,26,2,1,2,212,0,729,184919,2,26
2011-11-22,winter,2011,November,14,Tuesday,Workingday,Light Snow,0.42,0.4242,1.0,0.0896,4,31,35,35,405,35,2,1,2,212,0,729,175652,2,35
2011-11-22,winter,2011,November,15,Tuesday,Workingday,Light Snow,0.44,0.4394,0.94,0.0,2,32,34,34,405,34,2,1,2,212,0,729,183149,2,34
2011-11-22,winter,2011,November,16,Tuesday,Workingday,Light Snow,0.44,0.4394,0.94,0.0,3,59,62,62,405,62,2,2,2,222,0,730,227748,2,62
2011-11-22,winter,2011,November,17,Tuesday,Workingday,Light Snow,0.44,0.4394,1.0,0.0896,4,161,165,165,405,165,2,3,2,232,0,730,336860,2,165
2011-11-22,winter,2011,November,18,Tuesday,Workingday,Light Snow,0.44,0.4394,1.0,0.0,0,148,148,148,405,148,2,3,2,232,0,728,309772,2,148
2011-11-22,winter,2011,November,19,Tuesday,Workingday,Light Snow,0.46,0.4545,0.94,0.1045,5,106,111,111,405,111,2,2,2,222,0,728,226789,2,111
2011-11-22,winter,2011,November,20,Tuesday,Workingday,Mist,0.46,0.4545,1.0,0.2239,6,121,127,127,405,127,2,2,2,222,0,728,164550,2,127
2011-11-22,winter,2011,November,21,Tuesday,Workingday,Mist,0.46,0.4545,1.0,0.2537,4,86,90,90,405,90,2,2,2,222,0,728,125445,2,90
2011-11-22,winter,2011,November,22,Tuesday,Workingday,Mist,0.5,0.4848,0.94,0.194,6,81,87,87,405,87,2,2,2,222,0,728,95612,2,87
2011-11-22,winter,2011,November,23,Tuesday,Workingday,Mist,0.48,0.4697,0.94,0.2537,3,36,39,39,405,39,2,1,2,212,0,728,63941,2,39
2011-11-23,winter,2011,November,0,Wednesday,Workingday,Mist,0.48,0.4697,0.94,0.2537,2,14,16,16,404,16,2,1,2,212,0,726,39130,2,16
2011-11-23,winter,2011,November,1,Wednesday,Workingday,Mist,0.48,0.4697,0.94,0.2985,0,8,8,8,404,8,2,1,2,212,0,724,24164,2,8
2011-11-23,winter,2011,November,2,Wednesday,Workingday,Light Snow,0.5,0.4848,0.94,0.3582,1,5,6,6,404,6,2,1,2,212,0,715,16352,2,6
2011-11-23,winter,2011,November,3,Wednesday,Workingday,Light Snow,0.5,0.4848,0.94,0.3582,1,2,3,3,404,3,2,1,2,212,0,697,8174,2,3
2011-11-23,winter,2011,November,4,Wednesday,Workingday,Light Snow,0.52,0.5,0.88,0.3582,0,5,5,5,404,5,2,1,3,213,0,697,4428,2,5
2011-11-23,winter,2011,November,5,Wednesday,Workingday,Mist,0.46,0.4545,0.94,0.194,1,16,17,17,404,17,2,1,2,212,0,717,14261,2,17
2011-11-23,winter,2011,November,6,Wednesday,Workingday,Mist,0.44,0.4394,1.0,0.0,1,68,69,69,404,69,2,2,2,222,0,725,55132,2,69
2011-11-23,winter,2011,November,7,Wednesday,Workingday,Mist,0.46,0.4545,1.0,0.0896,2,154,156,156,404,156,2,3,2,232,0,727,154171,2,156
2011-11-23,winter,2011,November,8,Wednesday,Workingday,Mist,0.48,0.4697,0.94,0.1045,7,316,323,323,404,323,2,4,2,242,0,727,261001,2,323
2011-11-23,winter,2011,November,9,Wednesday,Workingday,Mist,0.52,0.5,0.94,0.194,3,164,167,167,404,167,2,3,3,233,0,727,159438,2,167
2011-11-23,winter,2011,November,10,Wednesday,Workingday,Mist,0.52,0.5,0.94,0.194,6,70,76,76,404,76,2,2,3,223,0,727,126257,2,76
2011-11-23,winter,2011,November,11,Wednesday,Workingday,Mist,0.5,0.4848,0.72,0.4179,9,107,116,116,404,116,2,2,2,222,0,727,151320,2,116
2011-11-23,winter,2011,November,12,Wednesday,Workingday,Clear,0.48,0.4697,0.55,0.4179,9,151,160,160,404,160,2,3,2,232,1,728,184414,2,160
2011-11-23,winter,2011,November,13,Wednesday,Workingday,Mist,0.44,0.4394,0.54,0.4925,12,162,174,174,404,174,2,3,2,232,1,729,184919,2,174
2011-11-23,winter,2011,November,14,Wednesday,Workingday,Clear,0.42,0.4242,0.54,0.4627,13,200,213,213,404,213,2,3,2,232,1,729,175652,2,213
2011-11-23,winter,2011,November,15,Wednesday,Workingday,Mist,0.42,0.4242,0.54,0.4478,13,194,207,207,404,207,2,3,2,232,1,729,183149,2,207
2011-11-23,winter,2011,November,16,Wednesday,Workingday,Mist,0.4,0.4091,0.62,0.4627,4,169,173,173,404,173,2,3,2,232,1,730,227748,2,173
2011-11-23,winter,2011,November,17,Wednesday,Workingday,Light Snow,0.38,0.3939,0.71,0.3881,7,156,163,163,404,163,2,3,2,232,1,730,336860,2,163
2011-11-23,winter,2011,November,18,Wednesday,Workingday,Mist,0.4,0.4091,0.58,0.5224,7,138,145,145,404,145,2,3,2,232,1,728,309772,2,145
2011-11-23,winter,2011,November,19,Wednesday,Workingday,Clear,0.38,0.3939,0.58,0.3881,6,116,122,122,404,122,2,2,2,222,1,728,226789,2,122
2011-11-23,winter,2011,November,20,Wednesday,Workingday,Clear,0.36,0.3333,0.62,0.3881,1,67,68,68,404,68,2,2,1,221,1,728,164550,2,68
2011-11-23,winter,2011,November,21,Wednesday,Workingday,Clear,0.36,0.3182,0.57,0.4627,0,66,66,66,404,66,2,2,1,221,1,728,125445,2,66
2011-11-23,winter,2011,November,22,Wednesday,Workingday,Clear,0.34,0.303,0.61,0.4478,3,59,62,62,404,62,2,2,1,221,1,728,95612,2,62
2011-11-23,winter,2011,November,23,Wednesday,Workingday,Clear,0.34,0.303,0.61,0.3582,4,47,51,51,404,51,2,2,1,221,1,728,63941,2,51
2011-11-24,winter,2011,November,0,Thursday,Holiday,Clear,0.32,0.303,0.57,0.2239,1,22,23,23,403,23,2,1,1,211,1,726,39130,2,23
2011-11-24,winter,2011,November,1,Thursday,Holiday,Clear,0.32,0.2879,0.57,0.4179,1,23,24,24,403,24,2,1,1,211,1,724,24164,2,24
2011-11-24,winter,2011,November,2,Thursday,Holiday,Clear,0.3,0.2879,0.61,0.2836,3,19,22,22,403,22,2,1,1,211,1,715,16352,2,22
2011-11-24,winter,2011,November,3,Thursday,Holiday,Clear,0.28,0.2879,0.65,0.1343,1,4,5,5,403,5,2,1,1,211,1,697,8174,2,5
2011-11-24,winter,2011,November,4,Thursday,Holiday,Clear,0.3,0.3182,0.61,0.0896,1,1,2,2,403,2,2,1,1,211,1,697,4428,2,2
2011-11-24,winter,2011,November,5,Thursday,Holiday,Clear,0.3,0.3182,0.61,0.1045,1,10,11,11,403,11,2,1,1,211,1,717,14261,2,11
2011-11-24,winter,2011,November,6,Thursday,Holiday,Clear,0.3,0.3182,0.61,0.0896,1,5,6,6,403,6,2,1,1,211,1,725,55132,2,6
2011-11-24,winter,2011,November,7,Thursday,Holiday,Clear,0.26,0.2727,0.75,0.1045,9,31,40,40,403,40,2,1,1,211,1,727,154171,2,40
2011-11-24,winter,2011,November,8,Thursday,Holiday,Clear,0.3,0.3182,0.65,0.0896,4,42,46,46,403,46,2,2,1,221,1,727,261001,2,46
2011-11-24,winter,2011,November,9,Thursday,Holiday,Clear,0.34,0.3485,0.61,0.0,13,68,81,81,403,81,2,2,2,222,1,727,159438,2,81
2011-11-24,winter,2011,November,10,Thursday,Holiday,Clear,0.36,0.3788,0.57,0.0,34,64,98,98,403,98,2,2,2,222,1,727,126257,2,98
2011-11-24,winter,2011,November,11,Thursday,Holiday,Clear,0.42,0.4242,0.41,0.2985,52,90,142,142,403,142,2,2,2,222,1,727,151320,2,142
2011-11-24,winter,2011,November,12,Thursday,Holiday,Clear,0.46,0.4545,0.36,0.2239,62,88,150,150,403,150,2,3,2,232,1,728,184414,2,150
2011-11-24,winter,2011,November,13,Thursday,Holiday,Clear,0.48,0.4697,0.33,0.2239,84,91,175,175,403,175,2,3,2,232,2,729,184919,2,175
2011-11-24,winter,2011,November,14,Thursday,Holiday,Clear,0.5,0.4848,0.31,0.2985,74,94,168,168,403,168,2,3,2,232,2,729,175652,2,168
2011-11-24,winter,2011,November,15,Thursday,Holiday,Clear,0.5,0.4848,0.31,0.2537,78,71,149,149,403,149,2,3,2,232,2,729,183149,2,149
2011-11-24,winter,2011,November,16,Thursday,Holiday,Clear,0.5,0.4848,0.34,0.2836,48,66,114,114,403,114,2,2,2,222,1,730,227748,2,114
2011-11-24,winter,2011,November,17,Thursday,Holiday,Clear,0.48,0.4697,0.33,0.1045,34,40,74,74,403,74,2,2,2,222,1,730,336860,2,74
2011-11-24,winter,2011,November,18,Thursday,Holiday,Clear,0.42,0.4242,0.5,0.0896,13,24,37,37,403,37,2,1,2,212,1,728,309772,2,37
2011-11-24,winter,2011,November,19,Thursday,Holiday,Clear,0.4,0.4091,0.54,0.1045,15,13,28,28,403,28,2,1,2,212,1,728,226789,2,28
2011-11-24,winter,2011,November,20,Thursday,Holiday,Clear,0.36,0.3485,0.76,0.1642,14,17,31,31,403,31,2,1,2,212,1,728,164550,2,31
2011-11-24,winter,2011,November,21,Thursday,Holiday,Clear,0.36,0.3485,0.71,0.1642,7,19,26,26,403,26,2,1,2,212,1,728,125445,2,26
2011-11-24,winter,2011,November,22,Thursday,Holiday,Clear,0.36,0.3485,0.71,0.1642,8,14,22,22,403,22,2,1,2,212,1,728,95612,2,22
2011-11-24,winter,2011,November,23,Thursday,Holiday,Clear,0.34,0.3485,0.76,0.1045,2,19,21,21,403,21,2,1,2,212,1,728,63941,2,21
2011-11-25,winter,2011,November,0,Friday,Workingday,Clear,0.34,0.3333,0.76,0.1642,7,22,29,29,402,29,2,1,1,211,1,726,39130,2,29
2011-11-25,winter,2011,November,1,Friday,Workingday,Clear,0.34,0.3636,0.76,0.0,2,12,14,14,402,14,2,1,2,212,0,724,24164,2,14
2011-11-25,winter,2011,November,2,Friday,Workingday,Clear,0.28,0.2879,0.81,0.1045,4,6,10,10,402,10,2,1,1,211,1,715,16352,2,10
2011-11-25,winter,2011,November,3,Friday,Workingday,Clear,0.28,0.2879,0.75,0.1045,0,2,2,2,402,2,2,1,1,211,1,697,8174,2,2
2011-11-25,winter,2011,November,4,Friday,Workingday,Clear,0.3,0.3182,0.75,0.1045,4,3,7,7,402,7,2,1,1,211,1,697,4428,2,7
2011-11-25,winter,2011,November,5,Friday,Workingday,Clear,0.28,0.3182,0.75,0.0,2,3,5,5,402,5,2,1,1,211,1,717,14261,2,5
2011-11-25,winter,2011,November,6,Friday,Workingday,Clear,0.26,0.2727,0.81,0.1045,4,9,13,13,402,13,2,1,1,211,1,725,55132,2,13
2011-11-25,winter,2011,November,7,Friday,Workingday,Clear,0.26,0.303,0.81,0.0,4,31,35,35,402,35,2,1,1,211,1,727,154171,2,35
2011-11-25,winter,2011,November,8,Friday,Workingday,Clear,0.26,0.2727,0.81,0.1343,6,68,74,74,402,74,2,2,1,221,1,727,261001,2,74
2011-11-25,winter,2011,November,9,Friday,Workingday,Clear,0.32,0.3485,0.76,0.0,25,70,95,95,402,95,2,2,2,222,1,727,159438,2,95
2011-11-25,winter,2011,November,10,Friday,Workingday,Clear,0.36,0.3485,0.71,0.1642,60,82,142,142,402,142,2,2,2,222,1,727,126257,2,142
2011-11-25,winter,2011,November,11,Friday,Workingday,Clear,0.4,0.4091,0.66,0.1045,99,127,226,226,402,226,2,3,2,232,0,727,151320,2,226
2011-11-25,winter,2011,November,12,Friday,Workingday,Clear,0.46,0.4545,0.51,0.1045,126,146,272,272,402,272,2,3,2,232,2,728,184414,2,272
2011-11-25,winter,2011,November,13,Friday,Workingday,Clear,0.5,0.4848,0.45,0.2239,143,140,283,283,402,283,2,4,2,242,2,729,184919,2,283
2011-11-25,winter,2011,November,14,Friday,Workingday,Clear,0.52,0.5,0.39,0.2239,122,150,272,272,402,272,2,3,3,233,2,729,175652,2,272
2011-11-25,winter,2011,November,15,Friday,Workingday,Clear,0.52,0.5,0.36,0.194,165,145,310,310,402,310,2,4,3,243,2,729,183149,2,310
2011-11-25,winter,2011,November,16,Friday,Workingday,Clear,0.5,0.4848,0.39,0.1642,122,139,261,261,402,261,2,3,2,232,2,730,227748,2,261
2011-11-25,winter,2011,November,17,Friday,Workingday,Clear,0.5,0.4848,0.34,0.1045,57,127,184,184,402,184,2,3,2,232,2,730,336860,2,184
2011-11-25,winter,2011,November,18,Friday,Workingday,Clear,0.46,0.4545,0.44,0.0896,45,108,153,153,402,153,2,3,2,232,1,728,309772,2,153
2011-11-25,winter,2011,November,19,Friday,Workingday,Clear,0.42,0.4242,0.67,0.0,38,96,134,134,402,134,2,2,2,222,0,728,226789,2,134
2011-11-25,winter,2011,November,20,Friday,Workingday,Clear,0.4,0.4091,0.58,0.0896,19,76,95,95,402,95,2,2,2,222,1,728,164550,2,95
2011-11-25,winter,2011,November,21,Friday,Workingday,Clear,0.36,0.3788,0.71,0.0,24,61,85,85,402,85,2,2,2,222,0,728,125445,2,85
2011-11-25,winter,2011,November,22,Friday,Workingday,Clear,0.34,0.3485,0.71,0.0896,12,46,58,58,402,58,2,2,2,222,1,728,95612,2,58
2011-11-25,winter,2011,November,23,Friday,Workingday,Clear,0.34,0.3485,0.76,0.1045,5,28,33,33,402,33,2,1,2,212,1,728,63941,2,33
2011-11-26,winter,2011,November,0,Saturday,Holiday,Clear,0.34,0.3485,0.76,0.1045,9,38,47,47,401,47,2,2,2,222,1,726,39130,2,47
2011-11-26,winter,2011,November,1,Saturday,Holiday,Clear,0.32,0.3333,0.76,0.0896,5,24,29,29,401,29,2,1,1,211,1,724,24164,2,29
2011-11-26,winter,2011,November,2,Saturday,Holiday,Clear,0.3,0.3182,0.81,0.1045,3,20,23,23,401,23,2,1,1,211,1,715,16352,2,23
2011-11-26,winter,2011,November,3,Saturday,Holiday,Clear,0.3,0.3333,0.81,0.0,8,9,17,17,401,17,2,1,1,211,1,697,8174,2,17
2011-11-26,winter,2011,November,4,Saturday,Holiday,Clear,0.3,0.3333,0.81,0.0,0,4,4,4,401,4,2,1,1,211,1,697,4428,2,4
2011-11-26,winter,2011,November,5,Saturday,Holiday,Clear,0.3,0.3182,0.75,0.1045,0,3,3,3,401,3,2,1,1,211,1,717,14261,2,3
2011-11-26,winter,2011,November,6,Saturday,Holiday,Mist,0.3,0.3182,0.75,0.0896,2,8,10,10,401,10,2,1,1,211,1,725,55132,2,10
2011-11-26,winter,2011,November,7,Saturday,Holiday,Clear,0.26,0.2727,0.87,0.1045,4,13,17,17,401,17,2,1,1,211,1,727,154171,2,17
2011-11-26,winter,2011,November,8,Saturday,Holiday,Clear,0.32,0.3333,0.76,0.0896,10,50,60,60,401,60,2,2,1,221,1,727,261001,2,60
2011-11-26,winter,2011,November,9,Saturday,Holiday,Clear,0.34,0.3485,0.76,0.0896,16,67,83,83,401,83,2,2,2,222,1,727,159438,2,83
2011-11-26,winter,2011,November,10,Saturday,Holiday,Clear,0.36,0.3788,0.81,0.0,57,84,141,141,401,141,2,2,2,222,0,727,126257,2,141
2011-11-26,winter,2011,November,11,Saturday,Holiday,Clear,0.4,0.4091,0.62,0.1045,107,123,230,230,401,230,2,3,2,232,1,727,151320,2,230
2011-11-26,winter,2011,November,12,Saturday,Holiday,Clear,0.44,0.4394,0.51,0.0,137,172,309,309,401,309,2,4,2,242,2,728,184414,2,309
2011-11-26,winter,2011,November,13,Saturday,Holiday,Clear,0.48,0.4697,0.44,0.0,177,148,325,325,401,325,2,4,2,242,2,729,184919,2,325
2011-11-26,winter,2011,November,14,Saturday,Holiday,Mist,0.48,0.4697,0.48,0.1343,141,158,299,299,401,299,2,4,2,242,2,729,175652,2,299
2011-11-26,winter,2011,November,15,Saturday,Holiday,Mist,0.5,0.4848,0.42,0.1045,154,160,314,314,401,314,2,4,2,242,2,729,183149,2,314
2011-11-26,winter,2011,November,16,Saturday,Holiday,Mist,0.46,0.4545,0.47,0.1343,137,138,275,275,401,275,2,3,2,232,2,730,227748,2,275
2011-11-26,winter,2011,November,17,Saturday,Holiday,Mist,0.46,0.4545,0.47,0.1343,62,122,184,184,401,184,2,3,2,232,1,730,336860,2,184
2011-11-26,winter,2011,November,18,Saturday,Holiday,Mist,0.42,0.4242,0.62,0.1642,67,118,185,185,401,185,2,3,2,232,1,728,309772,2,185
2011-11-26,winter,2011,November,19,Saturday,Holiday,Mist,0.4,0.4091,0.71,0.0896,46,100,146,146,401,146,2,3,2,232,0,728,226789,2,146
2011-11-26,winter,2011,November,20,Saturday,Holiday,Mist,0.42,0.4242,0.58,0.0,55,86,141,141,401,141,2,2,2,222,0,728,164550,2,141
2011-11-26,winter,2011,November,21,Saturday,Holiday,Mist,0.38,0.3939,0.82,0.0,20,72,92,92,401,92,2,2,2,222,0,728,125445,2,92
2011-11-26,winter,2011,November,22,Saturday,Holiday,Mist,0.38,0.3939,0.76,0.0,14,51,65,65,401,65,2,2,2,222,0,728,95612,2,65
2011-11-26,winter,2011,November,23,Saturday,Holiday,Clear,0.36,0.3788,0.81,0.0,18,51,69,69,401,69,2,2,2,222,0,728,63941,2,69
2011-11-27,winter,2011,November,0,Sunday,Holiday,Clear,0.36,0.3788,0.81,0.0,7,39,46,46,400,46,2,2,2,222,0,726,39130,2,46
2011-11-27,winter,2011,November,1,Sunday,Holiday,Clear,0.36,0.3788,0.81,0.0,9,35,44,44,400,44,2,2,2,222,0,724,24164,2,44
2011-11-27,winter,2011,November,2,Sunday,Holiday,Clear,0.34,0.3636,0.81,0.0,9,22,31,31,400,31,2,1,2,212,0,715,16352,2,31
2011-11-27,winter,2011,November,3,Sunday,Holiday,Clear,0.34,0.3636,0.87,0.0,9,8,17,17,400,17,2,1,2,212,0,697,8174,2,17
2011-11-27,winter,2011,November,4,Sunday,Holiday,Clear,0.34,0.3485,0.87,0.1045,0,4,4,4,400,4,2,1,2,212,0,697,4428,2,4
2011-11-27,winter,2011,November,5,Sunday,Holiday,Clear,0.36,0.3485,0.87,0.194,0,5,5,5,400,5,2,1,2,212,1,717,14261,2,5
2011-11-27,winter,2011,November,6,Sunday,Holiday,Clear,0.38,0.3939,0.82,0.1642,0,9,9,9,400,9,2,1,2,212,0,725,55132,2,9
2011-11-27,winter,2011,November,7,Sunday,Holiday,Clear,0.38,0.3939,0.87,0.2239,12,11,23,23,400,23,2,1,2,212,0,727,154171,2,23
2011-11-27,winter,2011,November,8,Sunday,Holiday,Clear,0.4,0.4091,0.82,0.2985,6,36,42,42,400,42,2,2,2,222,1,727,261001,2,42
2011-11-27,winter,2011,November,9,Sunday,Holiday,Clear,0.46,0.4545,0.72,0.2836,21,90,111,111,400,111,2,2,2,222,0,727,159438,2,111
2011-11-27,winter,2011,November,10,Sunday,Holiday,Clear,0.46,0.4545,0.72,0.2836,58,131,189,189,400,189,2,3,2,232,0,727,126257,2,189
2011-11-27,winter,2011,November,11,Sunday,Holiday,Clear,0.5,0.4848,0.63,0.3582,83,157,240,240,400,240,2,3,2,232,2,727,151320,2,240
2011-11-27,winter,2011,November,12,Sunday,Holiday,Clear,0.54,0.5152,0.56,0.2836,63,193,256,256,400,256,2,3,3,233,2,728,184414,2,256
2011-11-27,winter,2011,November,13,Sunday,Holiday,Clear,0.54,0.5152,0.6,0.194,97,216,313,313,400,313,2,4,3,243,2,729,184919,2,313
2011-11-27,winter,2011,November,14,Sunday,Holiday,Clear,0.62,0.6212,0.43,0.4627,113,200,313,313,400,313,2,4,3,243,2,729,175652,2,313
2011-11-27,winter,2011,November,15,Sunday,Holiday,Clear,0.62,0.6212,0.43,0.2836,96,221,317,317,400,317,2,4,3,243,2,729,183149,2,317
2011-11-27,winter,2011,November,16,Sunday,Holiday,Clear,0.56,0.5303,0.52,0.2537,94,229,323,323,400,323,2,4,3,243,2,730,227748,2,323
2011-11-27,winter,2011,November,17,Sunday,Holiday,Clear,0.54,0.5152,0.56,0.194,37,167,204,204,400,204,2,3,3,233,0,730,336860,2,204
2011-11-27,winter,2011,November,18,Sunday,Holiday,Clear,0.5,0.4848,0.63,0.1642,25,130,155,155,400,155,2,3,2,232,0,728,309772,2,155
2011-11-27,winter,2011,November,19,Sunday,Holiday,Clear,0.48,0.4697,0.67,0.2239,30,109,139,139,400,139,2,2,2,222,0,728,226789,2,139
2011-11-27,winter,2011,November,20,Sunday,Holiday,Clear,0.5,0.4848,0.63,0.2537,10,94,104,104,400,104,2,2,2,222,0,728,164550,2,104
2011-11-27,winter,2011,November,21,Sunday,Holiday,Clear,0.48,0.4697,0.67,0.2836,13,75,88,88,400,88,2,2,2,222,0,728,125445,2,88
2011-11-27,winter,2011,November,22,Sunday,Holiday,Clear,0.48,0.4697,0.72,0.2537,13,53,66,66,400,66,2,2,2,222,0,728,95612,2,66
2011-11-27,winter,2011,November,23,Sunday,Holiday,Clear,0.48,0.4697,0.72,0.2537,5,27,32,32,400,32,2,1,2,212,0,728,63941,2,32
2011-11-28,winter,2011,November,0,Monday,Workingday,Clear,0.46,0.4545,0.77,0.2836,6,10,16,16,399,16,2,1,2,212,0,726,39130,2,16
2011-11-28,winter,2011,November,1,Monday,Workingday,Clear,0.46,0.4545,0.77,0.2985,1,12,13,13,399,13,2,1,2,212,0,724,24164,2,13
2011-11-28,winter,2011,November,3,Monday,Workingday,Clear,0.44,0.4394,0.88,0.2239,1,4,5,5,399,5,2,1,2,212,0,697,8174,2,5
2011-11-28,winter,2011,November,4,Monday,Workingday,Clear,0.44,0.4394,0.82,0.0896,0,4,4,4,399,4,2,1,2,212,0,697,4428,2,4
2011-11-28,winter,2011,November,5,Monday,Workingday,Clear,0.4,0.4091,0.87,0.0,0,34,34,34,399,34,2,1,2,212,0,717,14261,2,34
2011-11-28,winter,2011,November,6,Monday,Workingday,Clear,0.42,0.4242,0.82,0.0896,6,98,104,104,399,104,2,2,2,222,0,725,55132,2,104
2011-11-28,winter,2011,November,7,Monday,Workingday,Clear,0.42,0.4242,0.88,0.0,7,270,277,277,399,277,2,3,2,232,0,727,154171,2,277
2011-11-28,winter,2011,November,8,Monday,Workingday,Mist,0.42,0.4242,0.94,0.0,13,394,407,407,399,407,2,4,2,242,0,727,261001,2,407
2011-11-28,winter,2011,November,9,Monday,Workingday,Mist,0.44,0.4394,0.88,0.2239,17,191,208,208,399,208,2,3,2,232,0,727,159438,2,208
2011-11-28,winter,2011,November,10,Monday,Workingday,Mist,0.48,0.4697,0.77,0.1343,21,86,107,107,399,107,2,2,2,222,0,727,126257,2,107
2011-11-28,winter,2011,November,11,Monday,Workingday,Mist,0.52,0.5,0.68,0.1045,11,107,118,118,399,118,2,2,3,223,0,727,151320,2,118
2011-11-28,winter,2011,November,12,Monday,Workingday,Clear,0.56,0.5303,0.6,0.1045,13,165,178,178,399,178,2,3,3,233,0,728,184414,2,178
2011-11-28,winter,2011,November,13,Monday,Workingday,Mist,0.58,0.5455,0.56,0.0,25,137,162,162,399,162,2,3,3,233,0,729,184919,2,162
2011-11-28,winter,2011,November,14,Monday,Workingday,Clear,0.6,0.6212,0.56,0.0,14,129,143,143,399,143,2,3,3,233,0,729,175652,2,143
2011-11-28,winter,2011,November,15,Monday,Workingday,Clear,0.58,0.5455,0.6,0.1642,18,132,150,150,399,150,2,3,3,233,0,729,183149,2,150
2011-11-28,winter,2011,November,16,Monday,Workingday,Clear,0.56,0.5303,0.6,0.194,24,240,264,264,399,264,2,3,3,233,0,730,227748,2,264
2011-11-28,winter,2011,November,17,Monday,Workingday,Clear,0.58,0.5455,0.56,0.194,24,444,468,468,399,468,2,4,3,243,2,730,336860,2,468
2011-11-28,winter,2011,November,18,Monday,Workingday,Clear,0.56,0.5303,0.64,0.2239,20,396,416,416,399,416,2,4,3,243,2,728,309772,2,416
2011-11-28,winter,2011,November,19,Monday,Workingday,Clear,0.54,0.5152,0.73,0.2239,4,260,264,264,399,264,2,3,3,233,0,728,226789,2,264
2011-11-28,winter,2011,November,20,Monday,Workingday,Mist,0.54,0.5152,0.73,0.2537,12,206,218,218,399,218,2,3,3,233,0,728,164550,2,218
2011-11-28,winter,2011,November,21,Monday,Workingday,Mist,0.54,0.5152,0.77,0.2239,4,152,156,156,399,156,2,3,3,233,0,728,125445,2,156
2011-11-28,winter,2011,November,22,Monday,Workingday,Mist,0.52,0.5,0.83,0.1045,7,102,109,109,399,109,2,2,3,223,0,728,95612,2,109
2011-11-28,winter,2011,November,23,Monday,Workingday,Mist,0.52,0.5,0.83,0.1343,5,41,46,46,399,46,2,2,3,223,0,728,63941,2,46
2011-11-29,winter,2011,November,0,Tuesday,Workingday,Clear,0.52,0.5,0.83,0.0,4,18,22,22,398,22,2,1,3,213,0,726,39130,2,22
2011-11-29,winter,2011,November,1,Tuesday,Workingday,Clear,0.52,0.5,0.83,0.0896,1,16,17,17,398,17,2,1,3,213,0,724,24164,2,17
2011-11-29,winter,2011,November,2,Tuesday,Workingday,Mist,0.5,0.4848,0.88,0.0,0,5,5,5,398,5,2,1,2,212,0,715,16352,2,5
2011-11-29,winter,2011,November,3,Tuesday,Workingday,Mist,0.5,0.4848,0.88,0.0,0,2,2,2,398,2,2,1,2,212,0,697,8174,2,2
2011-11-29,winter,2011,November,4,Tuesday,Workingday,Mist,0.52,0.5,0.83,0.3284,1,5,6,6,398,6,2,1,3,213,0,697,4428,2,6
2011-11-29,winter,2011,November,5,Tuesday,Workingday,Clear,0.5,0.4848,0.88,0.2836,1,21,22,22,398,22,2,1,2,212,0,717,14261,2,22
2011-11-29,winter,2011,November,6,Tuesday,Workingday,Clear,0.52,0.5,0.83,0.2836,1,88,89,89,398,89,2,2,3,223,0,725,55132,2,89
2011-11-29,winter,2011,November,7,Tuesday,Workingday,Clear,0.52,0.5,0.77,0.2239,12,330,342,342,398,342,2,4,3,243,0,727,154171,2,342
2011-11-29,winter,2011,November,8,Tuesday,Workingday,Clear,0.54,0.5152,0.77,0.2836,9,440,449,449,398,449,2,4,3,243,0,727,261001,2,449
2011-11-29,winter,2011,November,9,Tuesday,Workingday,Light Snow,0.56,0.5303,0.73,0.4179,5,197,202,202,398,202,2,3,3,233,0,727,159438,2,202
2011-11-29,winter,2011,November,10,Tuesday,Workingday,Light Snow,0.56,0.5303,0.73,0.4179,2,34,36,36,398,36,2,1,3,213,0,727,126257,2,36
2011-11-29,winter,2011,November,11,Tuesday,Workingday,Light Snow,0.5,0.4848,0.88,0.2985,1,10,11,11,398,11,2,1,2,212,0,727,151320,2,11
2011-11-29,winter,2011,November,12,Tuesday,Workingday,Light Snow,0.42,0.4242,0.82,0.4179,1,17,18,18,398,18,2,1,2,212,1,728,184414,2,18
2011-11-29,winter,2011,November,13,Tuesday,Workingday,Light Snow,0.42,0.4242,0.77,0.2836,0,22,22,22,398,22,2,1,2,212,1,729,184919,2,22
2011-11-29,winter,2011,November,14,Tuesday,Workingday,Light Snow,0.4,0.4091,0.94,0.194,1,35,36,36,398,36,2,1,2,212,0,729,175652,2,36
2011-11-29,winter,2011,November,15,Tuesday,Workingday,Light Snow,0.4,0.4091,0.87,0.3284,5,60,65,65,398,65,2,2,2,222,1,729,183149,2,65
2011-11-29,winter,2011,November,16,Tuesday,Workingday,Light Snow,0.4,0.4091,0.87,0.2239,5,146,151,151,398,151,2,3,2,232,0,730,227748,2,151
2011-11-29,winter,2011,November,17,Tuesday,Workingday,Mist,0.4,0.4091,0.87,0.2985,8,346,354,354,398,354,2,4,2,242,0,730,336860,2,354
2011-11-29,winter,2011,November,18,Tuesday,Workingday,Mist,0.4,0.4091,0.82,0.2985,11,347,358,358,398,358,2,4,2,242,1,728,309772,2,358
2011-11-29,winter,2011,November,19,Tuesday,Workingday,Mist,0.4,0.4091,0.82,0.3284,6,244,250,250,398,250,2,3,2,232,1,728,226789,2,250
2011-11-29,winter,2011,November,20,Tuesday,Workingday,Mist,0.38,0.3939,0.87,0.2537,8,176,184,184,398,184,2,3,2,232,0,728,164550,2,184
2011-11-29,winter,2011,November,21,Tuesday,Workingday,Mist,0.38,0.3939,0.87,0.2537,9,116,125,125,398,125,2,2,2,222,0,728,125445,2,125
2011-11-29,winter,2011,November,22,Tuesday,Workingday,Clear,0.38,0.3939,0.82,0.2985,5,90,95,95,398,95,2,2,2,222,1,728,95612,2,95
2011-11-29,winter,2011,November,23,Tuesday,Workingday,Clear,0.36,0.3333,0.76,0.3881,0,53,53,53,398,53,2,2,1,221,1,728,63941,2,53
2011-11-30,winter,2011,November,0,Wednesday,Workingday,Clear,0.36,0.3333,0.62,0.4179,1,23,24,24,397,24,2,1,1,211,1,726,39130,2,24
2011-11-30,winter,2011,November,1,Wednesday,Workingday,Clear,0.34,0.303,0.66,0.3284,0,8,8,8,397,8,2,1,1,211,1,724,24164,2,8
2011-11-30,winter,2011,November,2,Wednesday,Workingday,Clear,0.32,0.3182,0.7,0.1642,0,5,5,5,397,5,2,1,1,211,1,715,16352,2,5
2011-11-30,winter,2011,November,3,Wednesday,Workingday,Clear,0.32,0.3182,0.7,0.1642,0,1,1,1,397,1,2,1,1,211,1,697,8174,2,1
2011-11-30,winter,2011,November,4,Wednesday,Workingday,Clear,0.3,0.2879,0.75,0.2239,0,5,5,5,397,5,2,1,1,211,1,697,4428,2,5
2011-11-30,winter,2011,November,5,Wednesday,Workingday,Clear,0.28,0.2727,0.81,0.194,1,21,22,22,397,22,2,1,1,211,1,717,14261,2,22
2011-11-30,winter,2011,November,6,Wednesday,Workingday,Clear,0.26,0.2727,0.87,0.1045,3,100,103,103,397,103,2,2,1,221,1,725,55132,2,103
2011-11-30,winter,2011,November,7,Wednesday,Workingday,Clear,0.26,0.2727,0.81,0.1045,9,276,285,285,397,285,2,4,1,241,1,727,154171,2,285
2011-11-30,winter,2011,November,8,Wednesday,Workingday,Clear,0.28,0.2727,0.81,0.194,13,465,478,478,397,478,2,4,1,241,1,727,261001,2,478
2011-11-30,winter,2011,November,9,Wednesday,Workingday,Clear,0.3,0.2879,0.75,0.2836,7,186,193,193,397,193,2,3,1,231,1,727,159438,2,193
2011-11-30,winter,2011,November,10,Wednesday,Workingday,Clear,0.34,0.3182,0.66,0.2239,15,95,110,110,397,110,2,2,1,221,1,727,126257,2,110
2011-11-30,winter,2011,November,11,Wednesday,Workingday,Clear,0.38,0.3939,0.54,0.2985,10,112,122,122,397,122,2,2,2,222,1,727,151320,2,122
2011-11-30,winter,2011,November,12,Wednesday,Workingday,Mist,0.36,0.3333,0.53,0.2836,12,148,160,160,397,160,2,3,1,231,1,728,184414,2,160
2011-11-30,winter,2011,November,13,Wednesday,Workingday,Mist,0.38,0.3939,0.43,0.3582,16,131,147,147,397,147,2,3,2,232,1,729,184919,2,147
2011-11-30,winter,2011,November,14,Wednesday,Workingday,Mist,0.38,0.3939,0.43,0.3582,13,99,112,112,397,112,2,2,2,222,1,729,175652,2,112
2011-11-30,winter,2011,November,15,Wednesday,Workingday,Clear,0.36,0.3333,0.46,0.3284,11,104,115,115,397,115,2,2,1,221,1,729,183149,2,115
2011-11-30,winter,2011,November,16,Wednesday,Workingday,Clear,0.36,0.3333,0.46,0.2836,27,199,226,226,397,226,2,3,1,231,1,730,227748,2,226
2011-11-30,winter,2011,November,17,Wednesday,Workingday,Mist,0.34,0.303,0.49,0.3284,15,365,380,380,397,380,2,4,1,241,1,730,336860,2,380
2011-11-30,winter,2011,November,18,Wednesday,Workingday,Clear,0.34,0.303,0.49,0.3284,7,369,376,376,397,376,2,4,1,241,1,728,309772,2,376
2011-11-30,winter,2011,November,19,Wednesday,Workingday,Mist,0.32,0.303,0.57,0.2836,6,273,279,279,397,279,2,3,1,231,1,728,226789,2,279
2011-11-30,winter,2011,November,20,Wednesday,Workingday,Mist,0.32,0.303,0.57,0.2836,6,184,190,190,397,190,2,3,1,231,1,728,164550,2,190
2011-11-30,winter,2011,November,21,Wednesday,Workingday,Clear,0.32,0.2879,0.53,0.3881,7,128,135,135,397,135,2,2,1,221,1,728,125445,2,135
2011-11-30,winter,2011,November,22,Wednesday,Workingday,Clear,0.3,0.2727,0.56,0.2985,5,82,87,87,397,87,2,2,1,221,1,728,95612,2,87
2011-11-30,winter,2011,November,23,Wednesday,Workingday,Clear,0.28,0.2576,0.52,0.2836,4,46,50,50,397,50,2,2,1,221,1,728,63941,2,50
2011-12-01,winter,2011,December,0,Thursday,Workingday,Clear,0.28,0.2576,0.52,0.3284,1,19,20,20,396,20,2,1,1,211,1,726,39130,2,20
2011-12-01,winter,2011,December,1,Thursday,Workingday,Clear,0.26,0.2424,0.6,0.2836,1,9,10,10,396,10,2,1,1,211,1,724,24164,2,10
2011-12-01,winter,2011,December,2,Thursday,Workingday,Clear,0.26,0.2273,0.56,0.2985,1,8,9,9,396,9,2,1,1,211,1,715,16352,2,9
2011-12-01,winter,2011,December,3,Thursday,Workingday,Clear,0.26,0.2424,0.56,0.2537,1,6,7,7,396,7,2,1,1,211,1,697,8174,2,7
2011-12-01,winter,2011,December,4,Thursday,Workingday,Clear,0.26,0.2424,0.56,0.2836,0,1,1,1,396,1,2,1,1,211,1,697,4428,2,1
2011-12-01,winter,2011,December,5,Thursday,Workingday,Clear,0.26,0.2424,0.56,0.2537,1,23,24,24,396,24,2,1,1,211,1,717,14261,2,24
2011-12-01,winter,2011,December,6,Thursday,Workingday,Clear,0.24,0.2121,0.65,0.2836,5,92,97,97,396,97,2,2,1,221,1,725,55132,2,97
2011-12-01,winter,2011,December,7,Thursday,Workingday,Clear,0.24,0.2121,0.65,0.3582,11,265,276,276,396,276,2,3,1,231,1,727,154171,2,276
2011-12-01,winter,2011,December,8,Thursday,Workingday,Clear,0.26,0.2273,0.6,0.3284,15,462,477,477,396,477,2,4,1,241,1,727,261001,2,477
2011-12-01,winter,2011,December,9,Thursday,Workingday,Clear,0.3,0.2727,0.52,0.3284,9,215,224,224,396,224,2,3,1,231,1,727,159438,2,224
2011-12-01,winter,2011,December,10,Thursday,Workingday,Clear,0.32,0.303,0.53,0.2985,7,86,93,93,396,93,2,2,1,221,1,727,126257,2,93
2011-12-01,winter,2011,December,11,Thursday,Workingday,Clear,0.34,0.3182,0.49,0.2537,7,95,102,102,396,102,2,2,1,221,1,727,151320,2,102
2011-12-01,winter,2011,December,12,Thursday,Workingday,Clear,0.36,0.3485,0.46,0.2239,9,139,148,148,396,148,2,3,2,232,1,728,184414,2,148
2011-12-01,winter,2011,December,13,Thursday,Workingday,Clear,0.4,0.4091,0.4,0.2239,17,137,154,154,396,154,2,3,2,232,1,729,184919,2,154
2011-12-01,winter,2011,December,14,Thursday,Workingday,Clear,0.4,0.4091,0.4,0.2239,20,130,150,150,396,150,2,3,2,232,1,729,175652,2,150
2011-12-01,winter,2011,December,15,Thursday,Workingday,Clear,0.4,0.4091,0.4,0.2239,10,144,154,154,396,154,2,3,2,232,1,729,183149,2,154
2011-12-01,winter,2011,December,16,Thursday,Workingday,Clear,0.4,0.4091,0.4,0.194,9,192,201,201,396,201,2,3,2,232,1,730,227748,2,201
2011-12-01,winter,2011,December,17,Thursday,Workingday,Clear,0.36,0.3485,0.46,0.1343,9,409,418,418,396,418,2,4,2,242,1,730,336860,2,418
2011-12-01,winter,2011,December,18,Thursday,Workingday,Clear,0.36,0.3636,0.43,0.1045,12,393,405,405,396,405,2,4,2,242,1,728,309772,2,405
2011-12-01,winter,2011,December,19,Thursday,Workingday,Clear,0.34,0.3485,0.46,0.1045,9,219,228,228,396,228,2,3,2,232,1,728,226789,2,228
2011-12-01,winter,2011,December,20,Thursday,Workingday,Clear,0.34,0.3485,0.46,0.1045,12,178,190,190,396,190,2,3,2,232,1,728,164550,2,190
2011-12-01,winter,2011,December,21,Thursday,Workingday,Clear,0.3,0.3182,0.61,0.1045,8,154,162,162,396,162,2,3,1,231,1,728,125445,2,162
2011-12-01,winter,2011,December,22,Thursday,Workingday,Clear,0.3,0.3333,0.61,0.0,5,99,104,104,396,104,2,2,1,221,1,728,95612,2,104
2011-12-01,winter,2011,December,23,Thursday,Workingday,Clear,0.26,0.2879,0.7,0.0896,3,70,73,73,396,73,2,2,1,221,1,728,63941,2,73
2011-12-02,winter,2011,December,0,Friday,Workingday,Clear,0.26,0.2879,0.7,0.0896,6,32,38,38,395,38,2,1,1,211,1,726,39130,2,38
2011-12-02,winter,2011,December,1,Friday,Workingday,Clear,0.24,0.2879,0.75,0.0,1,14,15,15,395,15,2,1,1,211,1,724,24164,2,15
2011-12-02,winter,2011,December,2,Friday,Workingday,Clear,0.24,0.2879,0.75,0.0,0,10,10,10,395,10,2,1,1,211,1,715,16352,2,10
2011-12-02,winter,2011,December,3,Friday,Workingday,Clear,0.22,0.2727,0.8,0.0,0,1,1,1,395,1,2,1,1,211,1,697,8174,2,1
2011-12-02,winter,2011,December,4,Friday,Workingday,Clear,0.22,0.2727,0.8,0.0,0,3,3,3,395,3,2,1,1,211,1,697,4428,2,3
2011-12-02,winter,2011,December,5,Friday,Workingday,Clear,0.22,0.2576,0.8,0.0896,0,23,23,23,395,23,2,1,1,211,1,717,14261,2,23
2011-12-02,winter,2011,December,6,Friday,Workingday,Clear,0.22,0.2727,0.8,0.0,3,84,87,87,395,87,2,2,1,221,1,725,55132,2,87
2011-12-02,winter,2011,December,7,Friday,Workingday,Clear,0.22,0.2576,0.87,0.0896,6,199,205,205,395,205,2,3,1,231,1,727,154171,2,205
2011-12-02,winter,2011,December,8,Friday,Workingday,Clear,0.24,0.2879,0.87,0.0,13,432,445,445,395,445,2,4,1,241,1,727,261001,2,445
2011-12-02,winter,2011,December,9,Friday,Workingday,Clear,0.28,0.3182,0.81,0.0,12,234,246,246,395,246,2,3,1,231,1,727,159438,2,246
2011-12-02,winter,2011,December,10,Friday,Workingday,Clear,0.3,0.2879,0.75,0.2239,16,89,105,105,395,105,2,2,1,221,1,727,126257,2,105
2011-12-02,winter,2011,December,11,Friday,Workingday,Clear,0.34,0.3333,0.66,0.1642,18,142,160,160,395,160,2,3,1,231,1,727,151320,2,160
2011-12-02,winter,2011,December,12,Friday,Workingday,Clear,0.36,0.3485,0.57,0.1343,18,186,204,204,395,204,2,3,2,232,1,728,184414,2,204
2011-12-02,winter,2011,December,13,Friday,Workingday,Clear,0.4,0.4091,0.47,0.1343,19,188,207,207,395,207,2,3,2,232,1,729,184919,2,207
2011-12-02,winter,2011,December,14,Friday,Workingday,Clear,0.42,0.4242,0.44,0.1045,25,145,170,170,395,170,2,3,2,232,1,729,175652,2,170
2011-12-02,winter,2011,December,15,Friday,Workingday,Clear,0.42,0.4242,0.41,0.0896,24,175,199,199,395,199,2,3,2,232,1,729,183149,2,199
2011-12-02,winter,2011,December,16,Friday,Workingday,Clear,0.42,0.4242,0.41,0.0896,22,254,276,276,395,276,2,3,2,232,1,730,227748,2,276
2011-12-02,winter,2011,December,17,Friday,Workingday,Clear,0.42,0.4242,0.38,0.0,20,391,411,411,395,411,2,4,2,242,1,730,336860,2,411
2011-12-02,winter,2011,December,18,Friday,Workingday,Clear,0.4,0.4091,0.5,0.0,10,362,372,372,395,372,2,4,2,242,1,728,309772,2,372
2011-12-02,winter,2011,December,19,Friday,Workingday,Clear,0.34,0.3182,0.53,0.2537,13,252,265,265,395,265,2,3,1,231,1,728,226789,2,265
2011-12-02,winter,2011,December,20,Friday,Workingday,Clear,0.38,0.3939,0.4,0.2836,12,178,190,190,395,190,2,3,2,232,1,728,164550,2,190
2011-12-02,winter,2011,December,21,Friday,Workingday,Clear,0.34,0.3333,0.49,0.194,9,102,111,111,395,111,2,2,1,221,1,728,125445,2,111
2011-12-02,winter,2011,December,22,Friday,Workingday,Clear,0.32,0.3182,0.53,0.194,7,95,102,102,395,102,2,2,1,221,1,728,95612,2,102
2011-12-02,winter,2011,December,23,Friday,Workingday,Clear,0.32,0.303,0.53,0.2836,14,81,95,95,395,95,2,2,1,221,1,728,63941,2,95
2011-12-03,winter,2011,December,0,Saturday,Holiday,Clear,0.3,0.2879,0.56,0.2537,10,65,75,75,394,75,2,2,1,221,1,726,39130,2,75
2011-12-03,winter,2011,December,1,Saturday,Holiday,Clear,0.26,0.2576,0.65,0.194,9,62,71,71,394,71,2,2,1,221,1,724,24164,2,71
2011-12-03,winter,2011,December,2,Saturday,Holiday,Clear,0.26,0.2576,0.65,0.1642,9,41,50,50,394,50,2,2,1,221,1,715,16352,2,50
2011-12-03,winter,2011,December,3,Saturday,Holiday,Clear,0.24,0.2424,0.7,0.1343,4,5,9,9,394,9,2,1,1,211,1,697,8174,2,9
2011-12-03,winter,2011,December,4,Saturday,Holiday,Clear,0.22,0.2273,0.75,0.1343,1,7,8,8,394,8,2,1,1,211,1,697,4428,2,8
2011-12-03,winter,2011,December,5,Saturday,Holiday,Clear,0.24,0.2576,0.7,0.0896,0,6,6,6,394,6,2,1,1,211,1,717,14261,2,6
2011-12-03,winter,2011,December,6,Saturday,Holiday,Clear,0.24,0.2576,0.65,0.1045,1,10,11,11,394,11,2,1,1,211,1,725,55132,2,11
2011-12-03,winter,2011,December,7,Saturday,Holiday,Clear,0.22,0.2576,0.75,0.0896,2,24,26,26,394,26,2,1,1,211,1,727,154171,2,26
2011-12-03,winter,2011,December,8,Saturday,Holiday,Clear,0.24,0.2576,0.75,0.0896,1,62,63,63,394,63,2,2,1,221,1,727,261001,2,63
2011-12-03,winter,2011,December,9,Saturday,Holiday,Clear,0.26,0.2727,0.7,0.1045,25,99,124,124,394,124,2,2,1,221,1,727,159438,2,124
2011-12-03,winter,2011,December,10,Saturday,Holiday,Clear,0.32,0.3333,0.61,0.1343,22,173,195,195,394,195,2,3,1,231,1,727,126257,2,195
2011-12-03,winter,2011,December,11,Saturday,Holiday,Clear,0.32,0.3333,0.57,0.0896,48,227,275,275,394,275,2,3,1,231,1,727,151320,2,275
2011-12-03,winter,2011,December,12,Saturday,Holiday,Clear,0.36,0.3788,0.5,0.0,78,280,358,358,394,358,2,4,2,242,1,728,184414,2,358
2011-12-03,winter,2011,December,13,Saturday,Holiday,Clear,0.36,0.3636,0.5,0.0896,70,222,292,292,394,292,2,4,2,242,1,729,184919,2,292
2011-12-03,winter,2011,December,14,Saturday,Holiday,Clear,0.36,0.3788,0.46,0.0,92,251,343,343,394,343,2,4,2,242,1,729,175652,2,343
2011-12-03,winter,2011,December,15,Saturday,Holiday,Clear,0.38,0.3939,0.46,0.0,100,237,337,337,394,337,2,4,2,242,2,729,183149,2,337
2011-12-03,winter,2011,December,16,Saturday,Holiday,Clear,0.38,0.3939,0.46,0.0,75,230,305,305,394,305,2,4,2,242,1,730,227748,2,305
2011-12-03,winter,2011,December,17,Saturday,Holiday,Clear,0.36,0.3788,0.62,0.0,46,186,232,232,394,232,2,3,2,232,1,730,336860,2,232
2011-12-03,winter,2011,December,18,Saturday,Holiday,Clear,0.34,0.3333,0.53,0.1343,31,193,224,224,394,224,2,3,1,231,1,728,309772,2,224
2011-12-03,winter,2011,December,19,Saturday,Holiday,Clear,0.3,0.3182,0.61,0.0896,31,144,175,175,394,175,2,3,1,231,1,728,226789,2,175
2011-12-03,winter,2011,December,20,Saturday,Holiday,Clear,0.3,0.3182,0.61,0.0896,17,110,127,127,394,127,2,2,1,221,1,728,164550,2,127
2011-12-03,winter,2011,December,21,Saturday,Holiday,Mist,0.3,0.3182,0.61,0.0896,5,104,109,109,394,109,2,2,1,221,1,728,125445,2,109
2011-12-03,winter,2011,December,22,Saturday,Holiday,Mist,0.32,0.3333,0.61,0.0896,17,97,114,114,394,114,2,2,1,221,1,728,95612,2,114
2011-12-03,winter,2011,December,23,Saturday,Holiday,Clear,0.3,0.303,0.7,0.1343,12,73,85,85,394,85,2,2,1,221,1,728,63941,2,85
2011-12-04,winter,2011,December,0,Sunday,Holiday,Clear,0.3,0.3182,0.7,0.1045,19,64,83,83,393,83,2,2,1,221,1,726,39130,2,83
2011-12-04,winter,2011,December,1,Sunday,Holiday,Clear,0.3,0.3182,0.75,0.0896,20,54,74,74,393,74,2,2,1,221,1,724,24164,2,74
2011-12-04,winter,2011,December,2,Sunday,Holiday,Clear,0.26,0.303,0.81,0.0,11,51,62,62,393,62,2,2,1,221,1,715,16352,2,62
2011-12-04,winter,2011,December,3,Sunday,Holiday,Clear,0.28,0.3182,0.75,0.0,7,34,41,41,393,41,2,2,1,221,1,697,8174,2,41
2011-12-04,winter,2011,December,4,Sunday,Holiday,Clear,0.26,0.303,0.87,0.0,2,9,11,11,393,11,2,1,1,211,1,697,4428,2,11
2011-12-04,winter,2011,December,5,Sunday,Holiday,Clear,0.26,0.303,0.81,0.0,2,2,4,4,393,4,2,1,1,211,1,717,14261,2,4
2011-12-04,winter,2011,December,6,Sunday,Holiday,Clear,0.24,0.2879,0.93,0.0,1,3,4,4,393,4,2,1,1,211,1,725,55132,2,4
2011-12-04,winter,2011,December,7,Sunday,Holiday,Clear,0.26,0.303,0.87,0.0,3,23,26,26,393,26,2,1,1,211,1,727,154171,2,26
2011-12-04,winter,2011,December,8,Sunday,Holiday,Clear,0.26,0.303,0.87,0.0,7,48,55,55,393,55,2,2,1,221,1,727,261001,2,55
2011-12-04,winter,2011,December,9,Sunday,Holiday,Clear,0.3,0.3333,0.81,0.0,12,114,126,126,393,126,2,2,1,221,1,727,159438,2,126
2011-12-04,winter,2011,December,10,Sunday,Holiday,Clear,0.32,0.3333,0.81,0.1343,36,180,216,216,393,216,2,3,1,231,1,727,126257,2,216
2011-12-04,winter,2011,December,11,Sunday,Holiday,Clear,0.34,0.3333,0.81,0.1642,48,206,254,254,393,254,2,3,1,231,1,727,151320,2,254
2011-12-04,winter,2011,December,12,Sunday,Holiday,Clear,0.36,0.3485,0.81,0.1642,82,247,329,329,393,329,2,4,2,242,1,728,184414,2,329
2011-12-04,winter,2011,December,13,Sunday,Holiday,Clear,0.4,0.4091,0.66,0.2239,88,269,357,357,393,357,2,4,2,242,1,729,184919,2,357
2011-12-04,winter,2011,December,14,Sunday,Holiday,Clear,0.42,0.4242,0.62,0.1343,77,246,323,323,393,323,2,4,2,242,0,729,175652,2,323
2011-12-04,winter,2011,December,15,Sunday,Holiday,Clear,0.42,0.4242,0.62,0.194,69,227,296,296,393,296,2,4,2,242,1,729,183149,2,296
2011-12-04,winter,2011,December,16,Sunday,Holiday,Clear,0.42,0.4242,0.58,0.2239,64,266,330,330,393,330,2,4,2,242,1,730,227748,2,330
2011-12-04,winter,2011,December,17,Sunday,Holiday,Clear,0.38,0.3939,0.76,0.1343,38,207,245,245,393,245,2,3,2,232,0,730,336860,2,245
2011-12-04,winter,2011,December,18,Sunday,Holiday,Clear,0.38,0.3939,0.71,0.0,10,161,171,171,393,171,2,3,2,232,0,728,309772,2,171
2011-12-04,winter,2011,December,19,Sunday,Holiday,Clear,0.38,0.3939,0.76,0.0,15,158,173,173,393,173,2,3,2,232,0,728,226789,2,173
2011-12-04,winter,2011,December,20,Sunday,Holiday,Clear,0.36,0.3485,0.76,0.1343,8,116,124,124,393,124,2,2,2,222,1,728,164550,2,124
2011-12-04,winter,2011,December,21,Sunday,Holiday,Clear,0.36,0.3636,0.81,0.1045,7,65,72,72,393,72,2,2,2,222,0,728,125445,2,72
2011-12-04,winter,2011,December,22,Sunday,Holiday,Clear,0.34,0.3485,0.87,0.1045,5,59,64,64,393,64,2,2,2,222,0,728,95612,2,64
2011-12-04,winter,2011,December,23,Sunday,Holiday,Clear,0.34,0.3485,0.87,0.1045,3,42,45,45,393,45,2,2,2,222,0,728,63941,2,45
2011-12-05,winter,2011,December,0,Monday,Workingday,Clear,0.32,0.3333,0.87,0.0896,3,21,24,24,392,24,2,1,1,211,1,726,39130,2,24
2011-12-05,winter,2011,December,1,Monday,Workingday,Clear,0.32,0.3485,0.87,0.0,2,10,12,12,392,12,2,1,2,212,0,724,24164,2,12
2011-12-05,winter,2011,December,2,Monday,Workingday,Clear,0.32,0.3485,0.87,0.0,0,8,8,8,392,8,2,1,2,212,0,715,16352,2,8
2011-12-05,winter,2011,December,3,Monday,Workingday,Clear,0.32,0.3485,0.87,0.0,0,2,2,2,392,2,2,1,2,212,0,697,8174,2,2
2011-12-05,winter,2011,December,4,Monday,Workingday,Clear,0.3,0.3182,0.87,0.1045,0,7,7,7,392,7,2,1,1,211,1,697,4428,2,7
2011-12-05,winter,2011,December,5,Monday,Workingday,Clear,0.3,0.3182,0.87,0.1045,1,24,25,25,392,25,2,1,1,211,1,717,14261,2,25
2011-12-05,winter,2011,December,6,Monday,Workingday,Clear,0.3,0.3182,0.93,0.0896,1,89,90,90,392,90,2,2,1,221,1,725,55132,2,90
2011-12-05,winter,2011,December,7,Monday,Workingday,Clear,0.32,0.3485,0.9,0.0,9,274,283,283,392,283,2,4,2,242,0,727,154171,2,283
2011-12-05,winter,2011,December,8,Monday,Workingday,Clear,0.32,0.3485,0.93,0.0,12,392,404,404,392,404,2,4,2,242,0,727,261001,2,404
2011-12-05,winter,2011,December,9,Monday,Workingday,Mist,0.36,0.3636,0.87,0.0896,12,178,190,190,392,190,2,3,2,232,0,727,159438,2,190
2011-12-05,winter,2011,December,10,Monday,Workingday,Mist,0.36,0.3636,0.87,0.0896,9,78,87,87,392,87,2,2,2,222,0,727,126257,2,87
2011-12-05,winter,2011,December,11,Monday,Workingday,Mist,0.36,0.3636,0.87,0.0896,17,106,123,123,392,123,2,2,2,222,0,727,151320,2,123
2011-12-05,winter,2011,December,12,Monday,Workingday,Mist,0.4,0.4091,0.76,0.1045,29,125,154,154,392,154,2,3,2,232,0,728,184414,2,154
2011-12-05,winter,2011,December,13,Monday,Workingday,Mist,0.42,0.4242,0.71,0.0896,18,153,171,171,392,171,2,3,2,232,0,729,184919,2,171
2011-12-05,winter,2011,December,14,Monday,Workingday,Mist,0.46,0.4545,0.67,0.0,7,126,133,133,392,133,2,2,2,222,0,729,175652,2,133
2011-12-05,winter,2011,December,15,Monday,Workingday,Mist,0.46,0.4545,0.72,0.0896,16,132,148,148,392,148,2,3,2,232,0,729,183149,2,148
2011-12-05,winter,2011,December,16,Monday,Workingday,Clear,0.5,0.4848,0.63,0.0896,10,238,248,248,392,248,2,3,2,232,0,730,227748,2,248
2011-12-05,winter,2011,December,17,Monday,Workingday,Clear,0.42,0.4242,0.77,0.0,16,430,446,446,392,446,2,4,2,242,0,730,336860,2,446
2011-12-05,winter,2011,December,18,Monday,Workingday,Clear,0.44,0.4394,0.77,0.0,13,386,399,399,392,399,2,4,2,242,0,728,309772,2,399
2011-12-05,winter,2011,December,19,Monday,Workingday,Mist,0.46,0.4545,0.77,0.0,13,295,308,308,392,308,2,4,2,242,0,728,226789,2,308
2011-12-05,winter,2011,December,20,Monday,Workingday,Mist,0.46,0.4545,0.82,0.1045,15,190,205,205,392,205,2,3,2,232,0,728,164550,2,205
2011-12-05,winter,2011,December,21,Monday,Workingday,Mist,0.44,0.4394,0.88,0.0896,10,166,176,176,392,176,2,3,2,232,0,728,125445,2,176
2011-12-05,winter,2011,December,22,Monday,Workingday,Mist,0.44,0.4394,0.88,0.1343,12,94,106,106,392,106,2,2,2,222,0,728,95612,2,106
2011-12-05,winter,2011,December,23,Monday,Workingday,Mist,0.46,0.4545,0.88,0.1343,8,54,62,62,392,62,2,2,2,222,0,728,63941,2,62
2011-12-06,winter,2011,December,0,Tuesday,Workingday,Mist,0.5,0.4848,0.77,0.2985,3,25,28,28,391,28,2,1,2,212,0,726,39130,2,28
2011-12-06,winter,2011,December,1,Tuesday,Workingday,Mist,0.46,0.4545,0.88,0.2985,2,14,16,16,391,16,2,1,2,212,0,724,24164,2,16
2011-12-06,winter,2011,December,2,Tuesday,Workingday,Mist,0.46,0.4545,0.87,0.194,0,3,3,3,391,3,2,1,2,212,0,715,16352,2,3
2011-12-06,winter,2011,December,3,Tuesday,Workingday,Mist,0.46,0.4545,0.87,0.194,0,3,3,3,391,3,2,1,2,212,0,697,8174,2,3
2011-12-06,winter,2011,December,4,Tuesday,Workingday,Light Snow,0.46,0.4545,0.88,0.2239,0,7,7,7,391,7,2,1,2,212,0,697,4428,2,7
2011-12-06,winter,2011,December,5,Tuesday,Workingday,Light Snow,0.46,0.4545,0.88,0.2239,0,20,20,20,391,20,2,1,2,212,0,717,14261,2,20
2011-12-06,winter,2011,December,6,Tuesday,Workingday,Mist,0.44,0.4394,0.94,0.2836,5,81,86,86,391,86,2,2,2,222,0,725,55132,2,86
2011-12-06,winter,2011,December,7,Tuesday,Workingday,Mist,0.46,0.4545,0.94,0.194,7,227,234,234,391,234,2,3,2,232,0,727,154171,2,234
2011-12-06,winter,2011,December,8,Tuesday,Workingday,Mist,0.46,0.4545,0.94,0.194,13,401,414,414,391,414,2,4,2,242,0,727,261001,2,414
2011-12-06,winter,2011,December,9,Tuesday,Workingday,Mist,0.46,0.4545,0.94,0.2239,4,200,204,204,391,204,2,3,2,232,0,727,159438,2,204
2011-12-06,winter,2011,December,10,Tuesday,Workingday,Light Snow,0.46,0.4545,0.94,0.2836,6,44,50,50,391,50,2,2,2,222,0,727,126257,2,50
2011-12-06,winter,2011,December,11,Tuesday,Workingday,Light Snow,0.46,0.4545,0.94,0.2537,4,28,32,32,391,32,2,1,2,212,0,727,151320,2,32
2011-12-06,winter,2011,December,12,Tuesday,Workingday,Light Snow,0.46,0.4545,1.0,0.2239,5,50,55,55,391,55,2,2,2,222,0,728,184414,2,55
2011-12-06,winter,2011,December,13,Tuesday,Workingday,Light Snow,0.46,0.4545,1.0,0.194,6,65,71,71,391,71,2,2,2,222,0,729,184919,2,71
2011-12-06,winter,2011,December,14,Tuesday,Workingday,Light Snow,0.48,0.4697,1.0,0.2239,6,69,75,75,391,75,2,2,2,222,0,729,175652,2,75
2011-12-06,winter,2011,December,15,Tuesday,Workingday,Light Snow,0.5,0.4848,1.0,0.194,2,43,45,45,391,45,2,2,2,222,0,729,183149,2,45
2011-12-06,winter,2011,December,16,Tuesday,Workingday,Light Snow,0.46,0.4545,1.0,0.2537,4,84,88,88,391,88,2,2,2,222,0,730,227748,2,88
2011-12-06,winter,2011,December,17,Tuesday,Workingday,Mist,0.46,0.4545,1.0,0.2239,13,249,262,262,391,262,2,3,2,232,0,730,336860,2,262
2011-12-06,winter,2011,December,18,Tuesday,Workingday,Mist,0.46,0.4545,1.0,0.2836,17,287,304,304,391,304,2,4,2,242,0,728,309772,2,304
2011-12-06,winter,2011,December,19,Tuesday,Workingday,Light Snow,0.46,0.4545,1.0,0.2985,10,223,233,233,391,233,2,3,2,232,0,728,226789,2,233
2011-12-06,winter,2011,December,20,Tuesday,Workingday,Light Snow,0.46,0.4545,1.0,0.2985,3,107,110,110,391,110,2,2,2,222,0,728,164550,2,110
2011-12-06,winter,2011,December,21,Tuesday,Workingday,Mist,0.44,0.4394,1.0,0.194,6,108,114,114,391,114,2,2,2,222,0,728,125445,2,114
2011-12-06,winter,2011,December,22,Tuesday,Workingday,Light Snow,0.46,0.4545,1.0,0.1642,5,82,87,87,391,87,2,2,2,222,0,728,95612,2,87
2011-12-06,winter,2011,December,23,Tuesday,Workingday,Light Snow,0.46,0.4545,1.0,0.1642,5,48,53,53,391,53,2,2,2,222,0,728,63941,2,53
2011-12-07,winter,2011,December,0,Wednesday,Workingday,Clear,0.44,0.4394,1.0,0.194,3,30,33,33,390,33,2,1,2,212,0,726,39130,2,33
2011-12-07,winter,2011,December,1,Wednesday,Workingday,Mist,0.46,0.4545,1.0,0.2537,4,9,13,13,390,13,2,1,2,212,0,724,24164,2,13
2011-12-07,winter,2011,December,2,Wednesday,Workingday,Light Snow,0.46,0.4545,1.0,0.2239,2,4,6,6,390,6,2,1,2,212,0,715,16352,2,6
2011-12-07,winter,2011,December,3,Wednesday,Workingday,Light Snow,0.46,0.4545,1.0,0.2239,0,3,3,3,390,3,2,1,2,212,0,697,8174,2,3
2011-12-07,winter,2011,December,4,Wednesday,Workingday,Light Snow,0.46,0.4545,1.0,0.1642,0,1,1,1,390,1,2,1,2,212,0,697,4428,2,1
2011-12-07,winter,2011,December,5,Wednesday,Workingday,Light Snow,0.46,0.4545,1.0,0.1642,0,3,3,3,390,3,2,1,2,212,0,717,14261,2,3
2011-12-07,winter,2011,December,6,Wednesday,Workingday,Light Snow,0.48,0.4697,1.0,0.4179,0,18,18,18,390,18,2,1,2,212,0,725,55132,2,18
2011-12-07,winter,2011,December,7,Wednesday,Workingday,Light Snow,0.44,0.4394,1.0,0.1045,3,43,46,46,390,46,2,2,2,222,0,727,154171,2,46
2011-12-07,winter,2011,December,8,Wednesday,Workingday,Light Snow,0.44,0.4394,1.0,0.0,6,80,86,86,390,86,2,2,2,222,0,727,261001,2,86
2011-12-07,winter,2011,December,9,Wednesday,Workingday,Light Snow,0.44,0.4394,1.0,0.2537,0,64,64,64,390,64,2,2,2,222,0,727,159438,2,64
2011-12-07,winter,2011,December,10,Wednesday,Workingday,Light Snow,0.44,0.4394,1.0,0.0896,1,32,33,33,390,33,2,1,2,212,0,727,126257,2,33
2011-12-07,winter,2011,December,11,Wednesday,Workingday,Light Snow,0.44,0.4394,1.0,0.0896,3,47,50,50,390,50,2,2,2,222,0,727,151320,2,50
2011-12-07,winter,2011,December,12,Wednesday,Workingday,Light Snow,0.44,0.4394,1.0,0.1343,4,29,33,33,390,33,2,1,2,212,0,728,184414,2,33
2011-12-07,winter,2011,December,13,Wednesday,Workingday,Light Snow,0.44,0.4394,1.0,0.194,5,28,33,33,390,33,2,1,2,212,0,729,184919,2,33
2011-12-07,winter,2011,December,14,Wednesday,Workingday,Light Snow,0.44,0.4394,1.0,0.194,1,24,25,25,390,25,2,1,2,212,0,729,175652,2,25
2011-12-07,winter,2011,December,15,Wednesday,Workingday,Light Snow,0.42,0.4242,0.94,0.2239,5,25,30,30,390,30,2,1,2,212,0,729,183149,2,30
2011-12-07,winter,2011,December,16,Wednesday,Workingday,Light Snow,0.42,0.4242,0.94,0.194,3,28,31,31,390,31,2,1,2,212,0,730,227748,2,31
2011-12-07,winter,2011,December,17,Wednesday,Workingday,Light Snow,0.4,0.4091,1.0,0.3284,4,48,52,52,390,52,2,2,2,222,0,730,336860,2,52
2011-12-07,winter,2011,December,18,Wednesday,Workingday,Light Snow,0.4,0.4091,0.94,0.2985,3,48,51,51,390,51,2,2,2,222,0,728,309772,2,51
2011-12-07,winter,2011,December,19,Wednesday,Workingday,Light Snow,0.34,0.2879,0.87,0.6418,2,31,33,33,390,33,2,1,1,211,1,728,226789,2,33
2011-12-07,winter,2011,December,20,Wednesday,Workingday,Light Snow,0.34,0.2879,0.87,0.6418,1,25,26,26,390,26,2,1,1,211,1,728,164550,2,26
2011-12-07,winter,2011,December,21,Wednesday,Workingday,Light Snow,0.3,0.2576,0.87,0.5224,0,6,6,6,390,6,2,1,1,211,1,728,125445,2,6
2011-12-07,winter,2011,December,22,Wednesday,Workingday,Light Snow,0.24,0.197,0.93,0.4478,0,13,13,13,390,13,2,1,1,211,1,728,95612,2,13
2011-12-07,winter,2011,December,23,Wednesday,Workingday,Clear,0.24,0.2121,0.93,0.3881,0,16,16,16,390,16,2,1,1,211,1,728,63941,2,16
2011-12-08,winter,2011,December,0,Thursday,Workingday,Mist,0.26,0.2273,0.87,0.2985,0,21,21,21,389,21,2,1,1,211,1,726,39130,2,21
2011-12-08,winter,2011,December,1,Thursday,Workingday,Clear,0.26,0.2273,0.81,0.3582,1,6,7,7,389,7,2,1,1,211,1,724,24164,2,7
2011-12-08,winter,2011,December,2,Thursday,Workingday,Clear,0.28,0.2727,0.65,0.2239,0,4,4,4,389,4,2,1,1,211,1,715,16352,2,4
2011-12-08,winter,2011,December,3,Thursday,Workingday,Clear,0.26,0.2273,0.6,0.2985,0,1,1,1,389,1,2,1,1,211,1,697,8174,2,1
2011-12-08,winter,2011,December,4,Thursday,Workingday,Mist,0.24,0.197,0.6,0.4627,0,2,2,2,389,2,2,1,1,211,1,697,4428,2,2
2011-12-08,winter,2011,December,5,Thursday,Workingday,Clear,0.22,0.2121,0.64,0.2239,0,12,12,12,389,12,2,1,1,211,1,717,14261,2,12
2011-12-08,winter,2011,December,6,Thursday,Workingday,Clear,0.22,0.2121,0.55,0.2836,0,71,71,71,389,71,2,2,1,221,1,725,55132,2,71
2011-12-08,winter,2011,December,7,Thursday,Workingday,Clear,0.22,0.2121,0.6,0.2239,11,233,244,244,389,244,2,3,1,231,1,727,154171,2,244
2011-12-08,winter,2011,December,8,Thursday,Workingday,Clear,0.22,0.2121,0.55,0.2836,11,418,429,429,389,429,2,4,1,241,1,727,261001,2,429
2011-12-08,winter,2011,December,9,Thursday,Workingday,Clear,0.24,0.2121,0.52,0.3881,7,218,225,225,389,225,2,3,1,231,1,727,159438,2,225
2011-12-08,winter,2011,December,10,Thursday,Workingday,Clear,0.26,0.2273,0.52,0.3284,1,109,110,110,389,110,2,2,1,221,1,727,126257,2,110
2011-12-08,winter,2011,December,11,Thursday,Workingday,Clear,0.28,0.2727,0.52,0.2537,6,100,106,106,389,106,2,2,1,221,1,727,151320,2,106
2011-12-08,winter,2011,December,12,Thursday,Workingday,Clear,0.28,0.2576,0.52,0.3284,8,148,156,156,389,156,2,3,1,231,1,728,184414,2,156
2011-12-08,winter,2011,December,13,Thursday,Workingday,Clear,0.3,0.2727,0.49,0.3582,9,115,124,124,389,124,2,2,1,221,1,729,184919,2,124
2011-12-08,winter,2011,December,14,Thursday,Workingday,Clear,0.32,0.303,0.45,0.2537,16,121,137,137,389,137,2,2,1,221,1,729,175652,2,137
2011-12-08,winter,2011,December,15,Thursday,Workingday,Clear,0.32,0.3333,0.45,0.1343,19,98,117,117,389,117,2,2,1,221,1,729,183149,2,117
2011-12-08,winter,2011,December,16,Thursday,Workingday,Clear,0.32,0.3182,0.45,0.194,7,201,208,208,389,208,2,3,1,231,1,730,227748,2,208
2011-12-08,winter,2011,December,17,Thursday,Workingday,Clear,0.3,0.3182,0.49,0.1045,10,321,331,331,389,331,2,4,1,241,1,730,336860,2,331
2011-12-08,winter,2011,December,18,Thursday,Workingday,Clear,0.28,0.2727,0.52,0.2239,12,306,318,318,389,318,2,4,1,241,1,728,309772,2,318
2011-12-08,winter,2011,December,19,Thursday,Workingday,Clear,0.26,0.2727,0.56,0.1045,12,220,232,232,389,232,2,3,1,231,1,728,226789,2,232
2011-12-08,winter,2011,December,20,Thursday,Workingday,Clear,0.26,0.2727,0.6,0.1045,5,170,175,175,389,175,2,3,1,231,1,728,164550,2,175
2011-12-08,winter,2011,December,21,Thursday,Workingday,Clear,0.28,0.303,0.61,0.0896,4,135,139,139,389,139,2,2,1,221,1,728,125445,2,139
2011-12-08,winter,2011,December,22,Thursday,Workingday,Clear,0.26,0.2727,0.65,0.1343,8,84,92,92,389,92,2,2,1,221,1,728,95612,2,92
2011-12-08,winter,2011,December,23,Thursday,Workingday,Clear,0.24,0.2576,0.7,0.1045,3,58,61,61,389,61,2,2,1,221,1,728,63941,2,61
2011-12-09,winter,2011,December,0,Friday,Workingday,Clear,0.24,0.2879,0.65,0.0,8,26,34,34,388,34,2,1,1,211,1,726,39130,2,34
2011-12-09,winter,2011,December,1,Friday,Workingday,Clear,0.24,0.2879,0.65,0.0,2,12,14,14,388,14,2,1,1,211,1,724,24164,2,14
2011-12-09,winter,2011,December,2,Friday,Workingday,Clear,0.24,0.2879,0.7,0.0,2,10,12,12,388,12,2,1,1,211,1,715,16352,2,12
2011-12-09,winter,2011,December,3,Friday,Workingday,Clear,0.22,0.2727,0.8,0.0,1,5,6,6,388,6,2,1,1,211,1,697,8174,2,6
2011-12-09,winter,2011,December,4,Friday,Workingday,Clear,0.22,0.2727,0.8,0.0,1,1,2,2,388,2,2,1,1,211,1,697,4428,2,2
2011-12-09,winter,2011,December,5,Friday,Workingday,Clear,0.22,0.2727,0.8,0.0,0,20,20,20,388,20,2,1,1,211,1,717,14261,2,20
2011-12-09,winter,2011,December,6,Friday,Workingday,Clear,0.22,0.2576,0.8,0.0896,1,62,63,63,388,63,2,2,1,221,1,725,55132,2,63
2011-12-09,winter,2011,December,7,Friday,Workingday,Clear,0.22,0.2576,0.75,0.0896,4,195,199,199,388,199,2,3,1,231,1,727,154171,2,199
2011-12-09,winter,2011,December,8,Friday,Workingday,Clear,0.24,0.2879,0.81,0.0,7,378,385,385,388,385,2,4,1,241,1,727,261001,2,385
2011-12-09,winter,2011,December,9,Friday,Workingday,Clear,0.26,0.2879,0.81,0.0896,8,256,264,264,388,264,2,3,1,231,1,727,159438,2,264
2011-12-09,winter,2011,December,10,Friday,Workingday,Mist,0.3,0.303,0.7,0.1642,11,115,126,126,388,126,2,2,1,221,1,727,126257,2,126
2011-12-09,winter,2011,December,11,Friday,Workingday,Clear,0.32,0.303,0.7,0.2537,15,121,136,136,388,136,2,2,1,221,1,727,151320,2,136
2011-12-09,winter,2011,December,12,Friday,Workingday,Clear,0.36,0.3333,0.57,0.2985,27,146,173,173,388,173,2,3,1,231,1,728,184414,2,173
2011-12-09,winter,2011,December,13,Friday,Workingday,Clear,0.38,0.3939,0.5,0.194,27,141,168,168,388,168,2,3,2,232,1,729,184919,2,168
2011-12-09,winter,2011,December,14,Friday,Workingday,Clear,0.38,0.3939,0.46,0.2836,24,163,187,187,388,187,2,3,2,232,1,729,175652,2,187
2011-12-09,winter,2011,December,15,Friday,Workingday,Clear,0.38,0.3939,0.46,0.2836,29,160,189,189,388,189,2,3,2,232,1,729,183149,2,189
2011-12-09,winter,2011,December,16,Friday,Workingday,Clear,0.36,0.3485,0.62,0.1343,24,226,250,250,388,250,2,3,2,232,1,730,227748,2,250
2011-12-09,winter,2011,December,17,Friday,Workingday,Clear,0.34,0.3485,0.66,0.1045,10,352,362,362,388,362,2,4,2,242,1,730,336860,2,362
2011-12-09,winter,2011,December,18,Friday,Workingday,Clear,0.34,0.3636,0.61,0.0,10,308,318,318,388,318,2,4,2,242,1,728,309772,2,318
2011-12-09,winter,2011,December,19,Friday,Workingday,Clear,0.34,0.3636,0.61,0.0,10,189,199,199,388,199,2,3,2,232,1,728,226789,2,199
2011-12-09,winter,2011,December,20,Friday,Workingday,Clear,0.3,0.3333,0.81,0.0,10,140,150,150,388,150,2,3,1,231,1,728,164550,2,150
2011-12-09,winter,2011,December,21,Friday,Workingday,Clear,0.3,0.3333,0.75,0.0,9,131,140,140,388,140,2,2,1,221,1,728,125445,2,140
2011-12-09,winter,2011,December,22,Friday,Workingday,Clear,0.28,0.3182,0.87,0.0,15,114,129,129,388,129,2,2,1,221,1,728,95612,2,129
2011-12-09,winter,2011,December,23,Friday,Workingday,Clear,0.28,0.3182,0.81,0.0,6,88,94,94,388,94,2,2,1,221,1,728,63941,2,94
2011-12-10,winter,2011,December,0,Saturday,Holiday,Mist,0.26,0.2727,0.81,0.1045,11,66,77,77,387,77,2,2,1,221,1,726,39130,2,77
2011-12-10,winter,2011,December,1,Saturday,Holiday,Mist,0.26,0.2576,0.7,0.1642,11,55,66,66,387,66,2,2,1,221,1,724,24164,2,66
2011-12-10,winter,2011,December,2,Saturday,Holiday,Mist,0.28,0.303,0.61,0.0896,12,48,60,60,387,60,2,2,1,221,1,715,16352,2,60
2011-12-10,winter,2011,December,3,Saturday,Holiday,Mist,0.28,0.303,0.61,0.0896,5,20,25,25,387,25,2,1,1,211,1,697,8174,2,25
2011-12-10,winter,2011,December,4,Saturday,Holiday,Mist,0.26,0.2727,0.65,0.1045,0,3,3,3,387,3,2,1,1,211,1,697,4428,2,3
2011-12-10,winter,2011,December,5,Saturday,Holiday,Clear,0.26,0.2576,0.6,0.1642,0,6,6,6,387,6,2,1,1,211,1,717,14261,2,6
2011-12-10,winter,2011,December,6,Saturday,Holiday,Clear,0.24,0.2576,0.65,0.1045,1,10,11,11,387,11,2,1,1,211,1,725,55132,2,11
2011-12-10,winter,2011,December,7,Saturday,Holiday,Clear,0.24,0.2273,0.65,0.194,0,11,11,11,387,11,2,1,1,211,1,727,154171,2,11
2011-12-10,winter,2011,December,8,Saturday,Holiday,Clear,0.26,0.2727,0.65,0.1343,5,68,73,73,387,73,2,2,1,221,1,727,261001,2,73
2011-12-10,winter,2011,December,9,Saturday,Holiday,Clear,0.28,0.2576,0.61,0.2836,15,134,149,149,387,149,2,3,1,231,1,727,159438,2,149
2011-12-10,winter,2011,December,10,Saturday,Holiday,Clear,0.32,0.303,0.57,0.2537,31,161,192,192,387,192,2,3,1,231,1,727,126257,2,192
2011-12-10,winter,2011,December,11,Saturday,Holiday,Clear,0.32,0.2879,0.53,0.4179,44,192,236,236,387,236,2,3,1,231,1,727,151320,2,236
2011-12-10,winter,2011,December,12,Saturday,Holiday,Clear,0.32,0.2879,0.45,0.4179,48,235,283,283,387,283,2,4,1,241,1,728,184414,2,283
2011-12-10,winter,2011,December,13,Saturday,Holiday,Clear,0.34,0.303,0.34,0.4179,47,239,286,286,387,286,2,4,1,241,1,729,184919,2,286
2011-12-10,winter,2011,December,14,Saturday,Holiday,Clear,0.34,0.303,0.31,0.3284,51,242,293,293,387,293,2,4,1,241,1,729,175652,2,293
2011-12-10,winter,2011,December,15,Saturday,Holiday,Clear,0.34,0.303,0.34,0.3582,60,239,299,299,387,299,2,4,1,241,1,729,183149,2,299
2011-12-10,winter,2011,December,16,Saturday,Holiday,Clear,0.32,0.2879,0.31,0.3881,58,183,241,241,387,241,2,3,1,231,1,730,227748,2,241
2011-12-10,winter,2011,December,17,Saturday,Holiday,Clear,0.28,0.2576,0.36,0.3284,34,151,185,185,387,185,2,3,1,231,1,730,336860,2,185
2011-12-10,winter,2011,December,18,Saturday,Holiday,Clear,0.26,0.2576,0.38,0.2239,28,144,172,172,387,172,2,3,1,231,1,728,309772,2,172
2011-12-10,winter,2011,December,19,Saturday,Holiday,Clear,0.26,0.2424,0.38,0.2836,15,139,154,154,387,154,2,3,1,231,1,728,226789,2,154
2011-12-10,winter,2011,December,20,Saturday,Holiday,Clear,0.24,0.2273,0.35,0.2239,10,114,124,124,387,124,2,2,1,221,1,728,164550,2,124
2011-12-10,winter,2011,December,21,Saturday,Holiday,Clear,0.22,0.2121,0.44,0.2239,4,79,83,83,387,83,2,2,1,221,1,728,125445,2,83
2011-12-10,winter,2011,December,22,Saturday,Holiday,Clear,0.22,0.2273,0.41,0.1343,7,88,95,95,387,95,2,2,1,221,1,728,95612,2,95
2011-12-10,winter,2011,December,23,Saturday,Holiday,Clear,0.2,0.2121,0.47,0.1642,5,61,66,66,387,66,2,2,1,221,1,728,63941,2,66
2011-12-11,winter,2011,December,0,Sunday,Holiday,Clear,0.2,0.197,0.51,0.2239,5,69,74,74,386,74,2,2,1,221,1,726,39130,2,74
2011-12-11,winter,2011,December,1,Sunday,Holiday,Clear,0.16,0.1515,0.59,0.2239,8,54,62,62,386,62,2,2,1,221,1,724,24164,2,62
2011-12-11,winter,2011,December,2,Sunday,Holiday,Clear,0.18,0.1667,0.55,0.2537,5,47,52,52,386,52,2,2,1,221,1,715,16352,2,52
2011-12-11,winter,2011,December,3,Sunday,Holiday,Clear,0.16,0.1818,0.59,0.1343,2,17,19,19,386,19,2,1,1,211,1,697,8174,2,19
2011-12-11,winter,2011,December,4,Sunday,Holiday,Clear,0.16,0.1667,0.59,0.1642,0,5,5,5,386,5,2,1,1,211,1,697,4428,2,5
2011-12-11,winter,2011,December,5,Sunday,Holiday,Clear,0.18,0.2121,0.59,0.1045,0,6,6,6,386,6,2,1,1,211,1,717,14261,2,6
2011-12-11,winter,2011,December,6,Sunday,Holiday,Clear,0.16,0.2273,0.59,0.0,0,10,10,10,386,10,2,1,1,211,1,725,55132,2,10
2011-12-11,winter,2011,December,7,Sunday,Holiday,Clear,0.18,0.2424,0.55,0.0,1,30,31,31,386,31,2,1,1,211,1,727,154171,2,31
2011-12-11,winter,2011,December,8,Sunday,Holiday,Clear,0.16,0.2273,0.69,0.0,4,68,72,72,386,72,2,2,1,221,1,727,261001,2,72
2011-12-11,winter,2011,December,9,Sunday,Holiday,Clear,0.2,0.2576,0.59,0.0,19,88,107,107,386,107,2,2,1,221,1,727,159438,2,107
2011-12-11,winter,2011,December,10,Sunday,Holiday,Clear,0.24,0.2879,0.44,0.0,30,164,194,194,386,194,2,3,1,231,1,727,126257,2,194
2011-12-11,winter,2011,December,11,Sunday,Holiday,Clear,0.26,0.303,0.35,0.0,31,166,197,197,386,197,2,3,1,231,1,727,151320,2,197
2011-12-11,winter,2011,December,12,Sunday,Holiday,Clear,0.26,0.303,0.35,0.0,42,246,288,288,386,288,2,4,1,241,1,728,184414,2,288
2011-12-11,winter,2011,December,13,Sunday,Holiday,Clear,0.3,0.3333,0.31,0.0,44,224,268,268,386,268,2,3,1,231,1,729,184919,2,268
2011-12-11,winter,2011,December,14,Sunday,Holiday,Clear,0.3,0.3333,0.28,0.0,44,198,242,242,386,242,2,3,1,231,1,729,175652,2,242
2011-12-11,winter,2011,December,15,Sunday,Holiday,Clear,0.3,0.3333,0.26,0.0,47,219,266,266,386,266,2,3,1,231,1,729,183149,2,266
2011-12-11,winter,2011,December,16,Sunday,Holiday,Clear,0.3,0.3333,0.26,0.0,32,174,206,206,386,206,2,3,1,231,1,730,227748,2,206
2011-12-11,winter,2011,December,17,Sunday,Holiday,Clear,0.28,0.3182,0.3,0.0,13,150,163,163,386,163,2,3,1,231,1,730,336860,2,163
2011-12-11,winter,2011,December,18,Sunday,Holiday,Clear,0.24,0.2273,0.48,0.194,12,151,163,163,386,163,2,3,1,231,1,728,309772,2,163
2011-12-11,winter,2011,December,19,Sunday,Holiday,Clear,0.22,0.2273,0.55,0.194,7,98,105,105,386,105,2,2,1,221,1,728,226789,2,105
2011-12-11,winter,2011,December,20,Sunday,Holiday,Clear,0.22,0.2424,0.55,0.1045,10,62,72,72,386,72,2,2,1,221,1,728,164550,2,72
2011-12-11,winter,2011,December,21,Sunday,Holiday,Clear,0.22,0.2727,0.55,0.0,10,53,63,63,386,63,2,2,1,221,1,728,125445,2,63
2011-12-11,winter,2011,December,22,Sunday,Holiday,Clear,0.22,0.2727,0.55,0.0,7,36,43,43,386,43,2,2,1,221,1,728,95612,2,43
2011-12-11,winter,2011,December,23,Sunday,Holiday,Clear,0.2,0.2576,0.69,0.0,4,31,35,35,386,35,2,1,1,211,1,728,63941,2,35
2011-12-12,winter,2011,December,0,Monday,Workingday,Clear,0.2,0.2273,0.69,0.0896,4,16,20,20,385,20,2,1,1,211,1,726,39130,2,20
2011-12-12,winter,2011,December,1,Monday,Workingday,Clear,0.2,0.2576,0.69,0.0,0,9,9,9,385,9,2,1,1,211,1,724,24164,2,9
2011-12-12,winter,2011,December,2,Monday,Workingday,Clear,0.2,0.2576,0.69,0.0,0,4,4,4,385,4,2,1,1,211,1,715,16352,2,4
2011-12-12,winter,2011,December,3,Monday,Workingday,Clear,0.18,0.2424,0.74,0.0,0,2,2,2,385,2,2,1,1,211,1,697,8174,2,2
2011-12-12,winter,2011,December,4,Monday,Workingday,Clear,0.18,0.2424,0.74,0.0,0,3,3,3,385,3,2,1,1,211,1,697,4428,2,3
2011-12-12,winter,2011,December,5,Monday,Workingday,Clear,0.16,0.2273,0.8,0.0,0,21,21,21,385,21,2,1,1,211,1,717,14261,2,21
2011-12-12,winter,2011,December,6,Monday,Workingday,Clear,0.16,0.1818,0.8,0.1045,1,63,64,64,385,64,2,2,1,221,1,725,55132,2,64
2011-12-12,winter,2011,December,7,Monday,Workingday,Clear,0.14,0.1515,0.86,0.1343,4,231,235,235,385,235,2,3,1,231,1,727,154171,2,235
2011-12-12,winter,2011,December,8,Monday,Workingday,Mist,0.16,0.1818,0.8,0.1045,7,378,385,385,385,385,2,4,1,241,1,727,261001,2,385
2011-12-12,winter,2011,December,9,Monday,Workingday,Mist,0.18,0.2121,0.74,0.0896,12,208,220,220,385,220,2,3,1,231,1,727,159438,2,220
2011-12-12,winter,2011,December,10,Monday,Workingday,Mist,0.22,0.2424,0.69,0.1045,14,91,105,105,385,105,2,2,1,221,1,727,126257,2,105
2011-12-12,winter,2011,December,11,Monday,Workingday,Mist,0.26,0.2879,0.6,0.0896,15,100,115,115,385,115,2,2,1,221,1,727,151320,2,115
2011-12-12,winter,2011,December,12,Monday,Workingday,Clear,0.28,0.2879,0.52,0.1045,7,138,145,145,385,145,2,3,1,231,1,728,184414,2,145
2011-12-12,winter,2011,December,13,Monday,Workingday,Mist,0.3,0.3182,0.52,0.1045,13,153,166,166,385,166,2,3,1,231,1,729,184919,2,166
2011-12-12,winter,2011,December,14,Monday,Workingday,Mist,0.32,0.3333,0.53,0.1343,16,95,111,111,385,111,2,2,1,221,1,729,175652,2,111
2011-12-12,winter,2011,December,15,Monday,Workingday,Mist,0.32,0.3333,0.57,0.1045,8,124,132,132,385,132,2,2,1,221,1,729,183149,2,132
2011-12-12,winter,2011,December,16,Monday,Workingday,Mist,0.32,0.3333,0.57,0.0896,5,209,214,214,385,214,2,3,1,231,1,730,227748,2,214
2011-12-12,winter,2011,December,17,Monday,Workingday,Mist,0.3,0.3333,0.56,0.0,7,352,359,359,385,359,2,4,1,241,1,730,336860,2,359
2011-12-12,winter,2011,December,18,Monday,Workingday,Clear,0.3,0.3182,0.56,0.0896,8,349,357,357,385,357,2,4,1,241,1,728,309772,2,357
2011-12-12,winter,2011,December,19,Monday,Workingday,Clear,0.28,0.303,0.61,0.0896,9,232,241,241,385,241,2,3,1,231,1,728,226789,2,241
2011-12-12,winter,2011,December,20,Monday,Workingday,Clear,0.3,0.3182,0.56,0.0896,8,157,165,165,385,165,2,3,1,231,1,728,164550,2,165
2011-12-12,winter,2011,December,21,Monday,Workingday,Clear,0.26,0.303,0.81,0.0,2,119,121,121,385,121,2,2,1,221,1,728,125445,2,121
2011-12-12,winter,2011,December,22,Monday,Workingday,Clear,0.26,0.303,0.7,0.0,0,71,71,71,385,71,2,2,1,221,1,728,95612,2,71
2011-12-12,winter,2011,December,23,Monday,Workingday,Clear,0.24,0.2879,0.75,0.0,3,42,45,45,385,45,2,2,1,221,1,728,63941,2,45
2011-12-13,winter,2011,December,0,Tuesday,Workingday,Clear,0.22,0.2727,0.8,0.0,1,16,17,17,384,17,2,1,1,211,1,726,39130,2,17
2011-12-13,winter,2011,December,1,Tuesday,Workingday,Clear,0.2,0.2576,0.8,0.0,0,4,4,4,384,4,2,1,1,211,1,724,24164,2,4
2011-12-13,winter,2011,December,2,Tuesday,Workingday,Clear,0.2,0.2576,0.8,0.0,1,1,2,2,384,2,2,1,1,211,1,715,16352,2,2
2011-12-13,winter,2011,December,3,Tuesday,Workingday,Clear,0.18,0.2424,0.8,0.0,0,3,3,3,384,3,2,1,1,211,1,697,8174,2,3
2011-12-13,winter,2011,December,4,Tuesday,Workingday,Clear,0.2,0.2576,0.8,0.0,0,4,4,4,384,4,2,1,1,211,1,697,4428,2,4
2011-12-13,winter,2011,December,5,Tuesday,Workingday,Clear,0.18,0.2424,0.86,0.0,0,20,20,20,384,20,2,1,1,211,1,717,14261,2,20
2011-12-13,winter,2011,December,6,Tuesday,Workingday,Clear,0.2,0.2576,0.8,0.0,0,92,92,92,384,92,2,2,1,221,1,725,55132,2,92
2011-12-13,winter,2011,December,7,Tuesday,Workingday,Clear,0.16,0.1667,0.8,0.1642,2,221,223,223,384,223,2,3,1,231,1,727,154171,2,223
2011-12-13,winter,2011,December,8,Tuesday,Workingday,Clear,0.2,0.2273,0.69,0.1045,9,391,400,400,384,400,2,4,1,241,1,727,261001,2,400
2011-12-13,winter,2011,December,9,Tuesday,Workingday,Clear,0.26,0.2576,0.6,0.1642,10,223,233,233,384,233,2,3,1,231,1,727,159438,2,233
2011-12-13,winter,2011,December,10,Tuesday,Workingday,Clear,0.3,0.303,0.52,0.1642,3,99,102,102,384,102,2,2,1,221,1,727,126257,2,102
2011-12-13,winter,2011,December,11,Tuesday,Workingday,Clear,0.34,0.3182,0.46,0.2537,9,115,124,124,384,124,2,2,1,221,1,727,151320,2,124
2011-12-13,winter,2011,December,12,Tuesday,Workingday,Clear,0.36,0.3333,0.43,0.3582,20,147,167,167,384,167,2,3,1,231,1,728,184414,2,167
2011-12-13,winter,2011,December,13,Tuesday,Workingday,Clear,0.4,0.4091,0.37,0.3284,7,120,127,127,384,127,2,2,2,222,1,729,184919,2,127
2011-12-13,winter,2011,December,14,Tuesday,Workingday,Clear,0.4,0.4091,0.37,0.2537,18,116,134,134,384,134,2,2,2,222,1,729,175652,2,134
2011-12-13,winter,2011,December,15,Tuesday,Workingday,Clear,0.4,0.4091,0.35,0.2537,7,144,151,151,384,151,2,3,2,232,1,729,183149,2,151
2011-12-13,winter,2011,December,16,Tuesday,Workingday,Clear,0.38,0.3939,0.37,0.2537,13,194,207,207,384,207,2,3,2,232,1,730,227748,2,207
2011-12-13,winter,2011,December,17,Tuesday,Workingday,Clear,0.36,0.3485,0.4,0.194,17,381,398,398,384,398,2,4,2,242,1,730,336860,2,398
2011-12-13,winter,2011,December,18,Tuesday,Workingday,Clear,0.34,0.3182,0.42,0.2239,12,370,382,382,384,382,2,4,1,241,1,728,309772,2,382
2011-12-13,winter,2011,December,19,Tuesday,Workingday,Clear,0.32,0.3182,0.49,0.1642,5,262,267,267,384,267,2,3,1,231,1,728,226789,2,267
2011-12-13,winter,2011,December,20,Tuesday,Workingday,Clear,0.32,0.3182,0.49,0.1642,7,154,161,161,384,161,2,3,1,231,1,728,164550,2,161
2011-12-13,winter,2011,December,21,Tuesday,Workingday,Clear,0.3,0.303,0.52,0.1642,5,134,139,139,384,139,2,2,1,221,1,728,125445,2,139
2011-12-13,winter,2011,December,22,Tuesday,Workingday,Clear,0.3,0.303,0.52,0.1642,5,102,107,107,384,107,2,2,1,221,1,728,95612,2,107
2011-12-13,winter,2011,December,23,Tuesday,Workingday,Clear,0.26,0.303,0.7,0.0,4,55,59,59,384,59,2,2,1,221,1,728,63941,2,59
2011-12-14,winter,2011,December,0,Wednesday,Workingday,Clear,0.26,0.303,0.75,0.0,0,22,22,22,383,22,2,1,1,211,1,726,39130,2,22
2011-12-14,winter,2011,December,1,Wednesday,Workingday,Clear,0.26,0.303,0.75,0.0,0,8,8,8,383,8,2,1,1,211,1,724,24164,2,8
2011-12-14,winter,2011,December,2,Wednesday,Workingday,Clear,0.26,0.303,0.75,0.0,0,2,2,2,383,2,2,1,1,211,1,715,16352,2,2
2011-12-14,winter,2011,December,3,Wednesday,Workingday,Clear,0.28,0.3182,0.65,0.0,0,3,3,3,383,3,2,1,1,211,1,697,8174,2,3
2011-12-14,winter,2011,December,4,Wednesday,Workingday,Clear,0.26,0.303,0.75,0.0,0,4,4,4,383,4,2,1,1,211,1,697,4428,2,4
2011-12-14,winter,2011,December,5,Wednesday,Workingday,Mist,0.26,0.303,0.81,0.0,0,26,26,26,383,26,2,1,1,211,1,717,14261,2,26
2011-12-14,winter,2011,December,6,Wednesday,Workingday,Mist,0.26,0.303,0.87,0.0,0,87,87,87,383,87,2,2,1,221,1,725,55132,2,87
2011-12-14,winter,2011,December,7,Wednesday,Workingday,Clear,0.28,0.3182,0.75,0.0,4,243,247,247,383,247,2,3,1,231,1,727,154171,2,247
2011-12-14,winter,2011,December,8,Wednesday,Workingday,Mist,0.26,0.303,0.87,0.0,9,458,467,467,383,467,2,4,1,241,1,727,261001,2,467
2011-12-14,winter,2011,December,9,Wednesday,Workingday,Mist,0.3,0.3333,0.61,0.0,9,230,239,239,383,239,2,3,1,231,1,727,159438,2,239
2011-12-14,winter,2011,December,10,Wednesday,Workingday,Mist,0.32,0.3485,0.57,0.0,9,133,142,142,383,142,2,2,2,222,1,727,126257,2,142
2011-12-14,winter,2011,December,11,Wednesday,Workingday,Mist,0.34,0.3636,0.55,0.0,12,103,115,115,383,115,2,2,2,222,1,727,151320,2,115
2011-12-14,winter,2011,December,12,Wednesday,Workingday,Mist,0.36,0.3636,0.57,0.0896,6,138,144,144,383,144,2,3,2,232,1,728,184414,2,144
2011-12-14,winter,2011,December,13,Wednesday,Workingday,Mist,0.36,0.3636,0.57,0.1045,14,119,133,133,383,133,2,2,2,222,1,729,184919,2,133
2011-12-14,winter,2011,December,14,Wednesday,Workingday,Mist,0.38,0.3939,0.54,0.0896,17,134,151,151,383,151,2,3,2,232,1,729,175652,2,151
2011-12-14,winter,2011,December,15,Wednesday,Workingday,Mist,0.38,0.3939,0.54,0.1045,24,143,167,167,383,167,2,3,2,232,1,729,183149,2,167
2011-12-14,winter,2011,December,16,Wednesday,Workingday,Mist,0.38,0.3939,0.54,0.1045,12,233,245,245,383,245,2,3,2,232,1,730,227748,2,245
2011-12-14,winter,2011,December,17,Wednesday,Workingday,Mist,0.36,0.3636,0.57,0.1045,19,377,396,396,383,396,2,4,2,242,1,730,336860,2,396
2011-12-14,winter,2011,December,18,Wednesday,Workingday,Mist,0.36,0.3485,0.62,0.1642,11,379,390,390,383,390,2,4,2,242,1,728,309772,2,390
2011-12-14,winter,2011,December,19,Wednesday,Workingday,Mist,0.36,0.3636,0.62,0.1045,9,259,268,268,383,268,2,3,2,232,1,728,226789,2,268
2011-12-14,winter,2011,December,20,Wednesday,Workingday,Mist,0.34,0.3485,0.66,0.1045,6,169,175,175,383,175,2,3,2,232,1,728,164550,2,175
2011-12-14,winter,2011,December,21,Wednesday,Workingday,Mist,0.34,0.3333,0.66,0.1642,9,145,154,154,383,154,2,3,1,231,1,728,125445,2,154
2011-12-14,winter,2011,December,22,Wednesday,Workingday,Clear,0.34,0.3333,0.66,0.1642,5,99,104,104,383,104,2,2,1,221,1,728,95612,2,104
2011-12-14,winter,2011,December,23,Wednesday,Workingday,Clear,0.32,0.3182,0.7,0.1642,3,48,51,51,383,51,2,2,1,221,1,728,63941,2,51
2011-12-15,winter,2011,December,0,Thursday,Workingday,Clear,0.32,0.3182,0.7,0.1642,5,45,50,50,382,50,2,2,1,221,1,726,39130,2,50
2011-12-15,winter,2011,December,1,Thursday,Workingday,Mist,0.32,0.3182,0.7,0.1642,5,15,20,20,382,20,2,1,1,211,1,724,24164,2,20
2011-12-15,winter,2011,December,2,Thursday,Workingday,Mist,0.32,0.3333,0.7,0.1343,2,5,7,7,382,7,2,1,1,211,1,715,16352,2,7
2011-12-15,winter,2011,December,3,Thursday,Workingday,Mist,0.32,0.3333,0.7,0.1343,1,2,3,3,382,3,2,1,1,211,1,697,8174,2,3
2011-12-15,winter,2011,December,4,Thursday,Workingday,Mist,0.32,0.303,0.7,0.2239,0,6,6,6,382,6,2,1,1,211,1,697,4428,2,6
2011-12-15,winter,2011,December,5,Thursday,Workingday,Mist,0.32,0.303,0.7,0.2836,0,24,24,24,382,24,2,1,1,211,1,717,14261,2,24
2011-12-15,winter,2011,December,6,Thursday,Workingday,Clear,0.32,0.3182,0.66,0.194,2,90,92,92,382,92,2,2,1,221,1,725,55132,2,92
2011-12-15,winter,2011,December,7,Thursday,Workingday,Clear,0.32,0.3182,0.7,0.194,6,252,258,258,382,258,2,3,1,231,1,727,154171,2,258
2011-12-15,winter,2011,December,8,Thursday,Workingday,Mist,0.34,0.3182,0.66,0.2239,8,449,457,457,382,457,2,4,1,241,1,727,261001,2,457
2011-12-15,winter,2011,December,9,Thursday,Workingday,Mist,0.36,0.3333,0.62,0.2836,6,274,280,280,382,280,2,3,1,231,1,727,159438,2,280
2011-12-15,winter,2011,December,10,Thursday,Workingday,Mist,0.4,0.4091,0.58,0.2985,4,105,109,109,382,109,2,2,2,222,1,727,126257,2,109
2011-12-15,winter,2011,December,11,Thursday,Workingday,Mist,0.4,0.4091,0.62,0.4179,9,126,135,135,382,135,2,2,2,222,1,727,151320,2,135
2011-12-15,winter,2011,December,12,Thursday,Workingday,Mist,0.46,0.4545,0.59,0.4925,17,140,157,157,382,157,2,3,2,232,1,728,184414,2,157
2011-12-15,winter,2011,December,13,Thursday,Workingday,Mist,0.5,0.4848,0.55,0.3582,14,150,164,164,382,164,2,3,2,232,1,729,184919,2,164
2011-12-15,winter,2011,December,14,Thursday,Workingday,Mist,0.52,0.5,0.52,0.3284,8,124,132,132,382,132,2,2,3,223,1,729,175652,2,132
2011-12-15,winter,2011,December,15,Thursday,Workingday,Light Snow,0.52,0.5,0.55,0.2239,6,76,82,82,382,82,2,2,3,223,0,729,183149,2,82
2011-12-15,winter,2011,December,16,Thursday,Workingday,Light Snow,0.46,0.4545,0.72,0.1642,7,124,131,131,382,131,2,2,2,222,0,730,227748,2,131
2011-12-15,winter,2011,December,17,Thursday,Workingday,Mist,0.52,0.5,0.59,0.2836,14,310,324,324,382,324,2,4,3,243,2,730,336860,2,324
2011-12-15,winter,2011,December,18,Thursday,Workingday,Mist,0.52,0.5,0.59,0.2985,14,363,377,377,382,377,2,4,3,243,2,728,309772,2,377
2011-12-15,winter,2011,December,19,Thursday,Workingday,Mist,0.52,0.5,0.59,0.2836,13,274,287,287,382,287,2,4,3,243,0,728,226789,2,287
2011-12-15,winter,2011,December,20,Thursday,Workingday,Clear,0.52,0.5,0.59,0.3284,12,209,221,221,382,221,2,3,3,233,0,728,164550,2,221
2011-12-15,winter,2011,December,21,Thursday,Workingday,Clear,0.5,0.4848,0.63,0.2985,10,145,155,155,382,155,2,3,2,232,0,728,125445,2,155
2011-12-15,winter,2011,December,22,Thursday,Workingday,Clear,0.52,0.5,0.63,0.3284,8,116,124,124,382,124,2,2,3,223,0,728,95612,2,124
2011-12-15,winter,2011,December,23,Thursday,Workingday,Clear,0.52,0.5,0.63,0.3284,10,104,114,114,382,114,2,2,3,223,0,728,63941,2,114
2011-12-16,winter,2011,December,0,Friday,Workingday,Clear,0.5,0.4848,0.72,0.3284,12,60,72,72,381,72,2,2,2,222,0,726,39130,2,72
2011-12-16,winter,2011,December,1,Friday,Workingday,Clear,0.5,0.4848,0.72,0.2239,3,28,31,31,381,31,2,1,2,212,0,724,24164,2,31
2011-12-16,winter,2011,December,2,Friday,Workingday,Clear,0.48,0.4697,0.77,0.1045,0,23,23,23,381,23,2,1,2,212,0,715,16352,2,23
2011-12-16,winter,2011,December,3,Friday,Workingday,Clear,0.46,0.4545,0.82,0.1343,2,3,5,5,381,5,2,1,2,212,0,697,8174,2,5
2011-12-16,winter,2011,December,4,Friday,Workingday,Mist,0.5,0.4848,0.59,0.194,1,4,5,5,381,5,2,1,2,212,0,697,4428,2,5
2011-12-16,winter,2011,December,5,Friday,Workingday,Clear,0.48,0.4697,0.44,0.3881,0,26,26,26,381,26,2,1,2,212,1,717,14261,2,26
2011-12-16,winter,2011,December,6,Friday,Workingday,Mist,0.44,0.4394,0.33,0.2985,2,80,82,82,381,82,2,2,2,222,1,725,55132,2,82
2011-12-16,winter,2011,December,7,Friday,Workingday,Mist,0.38,0.3939,0.46,0.2985,5,226,231,231,381,231,2,3,2,232,1,727,154171,2,231
2011-12-16,winter,2011,December,8,Friday,Workingday,Clear,0.36,0.3333,0.46,0.4179,10,449,459,459,381,459,2,4,1,241,1,727,261001,2,459
2011-12-16,winter,2011,December,9,Friday,Workingday,Clear,0.36,0.3333,0.46,0.3881,8,235,243,243,381,243,2,3,1,231,1,727,159438,2,243
2011-12-16,winter,2011,December,10,Friday,Workingday,Clear,0.34,0.303,0.46,0.2985,10,122,132,132,381,132,2,2,1,221,1,727,126257,2,132
2011-12-16,winter,2011,December,11,Friday,Workingday,Mist,0.34,0.303,0.42,0.2985,9,135,144,144,381,144,2,3,1,231,1,727,151320,2,144
2011-12-16,winter,2011,December,12,Friday,Workingday,Mist,0.34,0.303,0.42,0.3582,10,163,173,173,381,173,2,3,1,231,1,728,184414,2,173
2011-12-16,winter,2011,December,13,Friday,Workingday,Mist,0.34,0.303,0.39,0.3582,12,125,137,137,381,137,2,2,1,221,1,729,184919,2,137
2011-12-16,winter,2011,December,14,Friday,Workingday,Mist,0.34,0.3182,0.42,0.2239,13,115,128,128,381,128,2,2,1,221,1,729,175652,2,128
2011-12-16,winter,2011,December,15,Friday,Workingday,Mist,0.32,0.303,0.45,0.2985,12,141,153,153,381,153,2,3,1,231,1,729,183149,2,153
2011-12-16,winter,2011,December,16,Friday,Workingday,Mist,0.32,0.303,0.45,0.2239,12,212,224,224,381,224,2,3,1,231,1,730,227748,2,224
2011-12-16,winter,2011,December,17,Friday,Workingday,Mist,0.32,0.303,0.45,0.2836,13,352,365,365,381,365,2,4,1,241,1,730,336860,2,365
2011-12-16,winter,2011,December,18,Friday,Workingday,Mist,0.32,0.303,0.45,0.2537,10,285,295,295,381,295,2,4,1,241,1,728,309772,2,295
2011-12-16,winter,2011,December,19,Friday,Workingday,Mist,0.32,0.303,0.45,0.2239,11,203,214,214,381,214,2,3,1,231,1,728,226789,2,214
2011-12-16,winter,2011,December,20,Friday,Workingday,Mist,0.32,0.3182,0.45,0.194,6,146,152,152,381,152,2,3,1,231,1,728,164550,2,152
2011-12-16,winter,2011,December,21,Friday,Workingday,Mist,0.32,0.3182,0.45,0.1642,7,95,102,102,381,102,2,2,1,221,1,728,125445,2,102
2011-12-16,winter,2011,December,22,Friday,Workingday,Mist,0.3,0.303,0.49,0.1642,6,100,106,106,381,106,2,2,1,221,1,728,95612,2,106
2011-12-16,winter,2011,December,23,Friday,Workingday,Mist,0.3,0.303,0.49,0.1343,4,71,75,75,381,75,2,2,1,221,1,728,63941,2,75
2011-12-17,winter,2011,December,0,Saturday,Holiday,Clear,0.3,0.2879,0.49,0.2836,3,59,62,62,380,62,2,2,1,221,1,726,39130,2,62
2011-12-17,winter,2011,December,1,Saturday,Holiday,Mist,0.3,0.2879,0.52,0.2537,4,39,43,43,380,43,2,2,1,221,1,724,24164,2,43
2011-12-17,winter,2011,December,2,Saturday,Holiday,Mist,0.28,0.2727,0.56,0.2239,11,47,58,58,380,58,2,2,1,221,1,715,16352,2,58
2011-12-17,winter,2011,December,3,Saturday,Holiday,Clear,0.26,0.2576,0.6,0.194,4,22,26,26,380,26,2,1,1,211,1,697,8174,2,26
2011-12-17,winter,2011,December,4,Saturday,Holiday,Clear,0.24,0.2424,0.65,0.1642,0,9,9,9,380,9,2,1,1,211,1,697,4428,2,9
2011-12-17,winter,2011,December,5,Saturday,Holiday,Mist,0.26,0.2576,0.6,0.194,2,7,9,9,380,9,2,1,1,211,1,717,14261,2,9
2011-12-17,winter,2011,December,6,Saturday,Holiday,Mist,0.26,0.2424,0.56,0.2836,0,17,17,17,380,17,2,1,1,211,1,725,55132,2,17
2011-12-17,winter,2011,December,7,Saturday,Holiday,Mist,0.26,0.2576,0.56,0.2239,0,20,20,20,380,20,2,1,1,211,1,727,154171,2,20
2011-12-17,winter,2011,December,8,Saturday,Holiday,Mist,0.26,0.2576,0.56,0.2239,4,55,59,59,380,59,2,2,1,221,1,727,261001,2,59
2011-12-17,winter,2011,December,9,Saturday,Holiday,Mist,0.26,0.2424,0.56,0.2537,5,95,100,100,380,100,2,2,1,221,1,727,159438,2,100
2011-12-17,winter,2011,December,10,Saturday,Holiday,Mist,0.26,0.2424,0.52,0.2836,10,171,181,181,380,181,2,3,1,231,1,727,126257,2,181
2011-12-17,winter,2011,December,11,Saturday,Holiday,Mist,0.28,0.2576,0.45,0.3284,21,188,209,209,380,209,2,3,1,231,1,727,151320,2,209
2011-12-17,winter,2011,December,12,Saturday,Holiday,Mist,0.28,0.2576,0.45,0.2836,28,216,244,244,380,244,2,3,1,231,1,728,184414,2,244
2011-12-17,winter,2011,December,13,Saturday,Holiday,Mist,0.28,0.2727,0.48,0.2537,32,204,236,236,380,236,2,3,1,231,1,729,184919,2,236
2011-12-17,winter,2011,December,14,Saturday,Holiday,Clear,0.28,0.2576,0.45,0.3582,30,207,237,237,380,237,2,3,1,231,1,729,175652,2,237
2011-12-17,winter,2011,December,15,Saturday,Holiday,Clear,0.28,0.2576,0.45,0.2836,33,195,228,228,380,228,2,3,1,231,1,729,183149,2,228
2011-12-17,winter,2011,December,16,Saturday,Holiday,Clear,0.28,0.2727,0.45,0.2239,30,192,222,222,380,222,2,3,1,231,1,730,227748,2,222
2011-12-17,winter,2011,December,17,Saturday,Holiday,Clear,0.26,0.2576,0.48,0.2239,12,153,165,165,380,165,2,3,1,231,1,730,336860,2,165
2011-12-17,winter,2011,December,18,Saturday,Holiday,Clear,0.26,0.2273,0.48,0.3881,7,150,157,157,380,157,2,3,1,231,1,728,309772,2,157
2011-12-17,winter,2011,December,19,Saturday,Holiday,Light Snow,0.24,0.2121,0.65,0.3284,11,95,106,106,380,106,2,2,1,221,1,728,226789,2,106
2011-12-17,winter,2011,December,20,Saturday,Holiday,Clear,0.22,0.2121,0.69,0.2537,7,99,106,106,380,106,2,2,1,221,1,728,164550,2,106
2011-12-17,winter,2011,December,21,Saturday,Holiday,Clear,0.2,0.2121,0.75,0.1642,8,88,96,96,380,96,2,2,1,221,1,728,125445,2,96
2011-12-17,winter,2011,December,22,Saturday,Holiday,Clear,0.2,0.2121,0.75,0.1642,7,73,80,80,380,80,2,2,1,221,1,728,95612,2,80
2011-12-17,winter,2011,December,23,Saturday,Holiday,Clear,0.2,0.2273,0.75,0.0,6,63,69,69,380,69,2,2,1,221,1,728,63941,2,69
2011-12-18,winter,2011,December,0,Sunday,Holiday,Clear,0.2,0.2121,0.75,0.1343,7,64,71,71,379,71,2,2,1,221,1,726,39130,2,71
2011-12-18,winter,2011,December,1,Sunday,Holiday,Clear,0.2,0.2273,0.69,0.1045,3,43,46,46,379,46,2,2,1,221,1,724,24164,2,46
2011-12-18,winter,2011,December,2,Sunday,Holiday,Clear,0.22,0.2424,0.55,0.1045,2,39,41,41,379,41,2,2,1,221,1,715,16352,2,41
2011-12-18,winter,2011,December,3,Sunday,Holiday,Clear,0.22,0.2121,0.55,0.2239,2,16,18,18,379,18,2,1,1,211,1,697,8174,2,18
2011-12-18,winter,2011,December,4,Sunday,Holiday,Clear,0.22,0.2121,0.55,0.2239,0,1,1,1,379,1,2,1,1,211,1,697,4428,2,1
2011-12-18,winter,2011,December,5,Sunday,Holiday,Clear,0.2,0.2273,0.59,0.1045,1,4,5,5,379,5,2,1,1,211,1,717,14261,2,5
2011-12-18,winter,2011,December,6,Sunday,Holiday,Clear,0.2,0.2121,0.59,0.1343,0,3,3,3,379,3,2,1,1,211,1,725,55132,2,3
2011-12-18,winter,2011,December,7,Sunday,Holiday,Clear,0.2,0.2121,0.59,0.1642,1,11,12,12,379,12,2,1,1,211,1,727,154171,2,12
2011-12-18,winter,2011,December,8,Sunday,Holiday,Clear,0.2,0.2576,0.69,0.0,1,31,32,32,379,32,2,1,1,211,1,727,261001,2,32
2011-12-18,winter,2011,December,9,Sunday,Holiday,Clear,0.22,0.2273,0.64,0.1642,6,75,81,81,379,81,2,2,1,221,1,727,159438,2,81
2011-12-18,winter,2011,December,10,Sunday,Holiday,Clear,0.24,0.2273,0.6,0.2537,7,122,129,129,379,129,2,2,1,221,1,727,126257,2,129
2011-12-18,winter,2011,December,11,Sunday,Holiday,Mist,0.24,0.2273,0.6,0.2239,20,168,188,188,379,188,2,3,1,231,1,727,151320,2,188
2011-12-18,winter,2011,December,12,Sunday,Holiday,Clear,0.26,0.2576,0.6,0.2239,26,202,228,228,379,228,2,3,1,231,1,728,184414,2,228
2011-12-18,winter,2011,December,13,Sunday,Holiday,Clear,0.3,0.2727,0.49,0.2985,18,210,228,228,379,228,2,3,1,231,1,729,184919,2,228
2011-12-18,winter,2011,December,14,Sunday,Holiday,Clear,0.3,0.2879,0.49,0.2836,19,200,219,219,379,219,2,3,1,231,1,729,175652,2,219
2011-12-18,winter,2011,December,15,Sunday,Holiday,Clear,0.32,0.303,0.45,0.2836,23,184,207,207,379,207,2,3,1,231,1,729,183149,2,207
2011-12-18,winter,2011,December,16,Sunday,Holiday,Clear,0.28,0.2727,0.48,0.2537,27,207,234,234,379,234,2,3,1,231,1,730,227748,2,234
2011-12-18,winter,2011,December,17,Sunday,Holiday,Clear,0.28,0.2727,0.46,0.1642,10,126,136,136,379,136,2,2,1,221,1,730,336860,2,136
2011-12-18,winter,2011,December,18,Sunday,Holiday,Clear,0.28,0.2727,0.45,0.194,15,123,138,138,379,138,2,2,1,221,1,728,309772,2,138
2011-12-18,winter,2011,December,19,Sunday,Holiday,Clear,0.26,0.2727,0.52,0.1343,5,130,135,135,379,135,2,2,1,221,1,728,226789,2,135
2011-12-18,winter,2011,December,20,Sunday,Holiday,Clear,0.24,0.2576,0.6,0.1045,10,94,104,104,379,104,2,2,1,221,1,728,164550,2,104
2011-12-18,winter,2011,December,21,Sunday,Holiday,Clear,0.22,0.2727,0.64,0.0,9,80,89,89,379,89,2,2,1,221,1,728,125445,2,89
2011-12-18,winter,2011,December,22,Sunday,Holiday,Clear,0.22,0.2273,0.75,0.194,2,47,49,49,379,49,2,2,1,221,1,728,95612,2,49
2011-12-18,winter,2011,December,23,Sunday,Holiday,Clear,0.2,0.2273,0.75,0.1045,6,31,37,37,379,37,2,1,1,211,1,728,63941,2,37
2011-12-19,winter,2011,December,0,Monday,Workingday,Clear,0.2,0.2273,0.75,0.0896,3,14,17,17,378,17,2,1,1,211,1,726,39130,2,17
2011-12-19,winter,2011,December,1,Monday,Workingday,Clear,0.18,0.2121,0.8,0.0896,3,8,11,11,378,11,2,1,1,211,1,724,24164,2,11
2011-12-19,winter,2011,December,2,Monday,Workingday,Clear,0.18,0.2121,0.8,0.0896,0,3,3,3,378,3,2,1,1,211,1,715,16352,2,3
2011-12-19,winter,2011,December,3,Monday,Workingday,Clear,0.16,0.197,0.86,0.0896,0,3,3,3,378,3,2,1,1,211,1,697,8174,2,3
2011-12-19,winter,2011,December,4,Monday,Workingday,Clear,0.16,0.1818,0.86,0.1343,0,4,4,4,378,4,2,1,1,211,1,697,4428,2,4
2011-12-19,winter,2011,December,5,Monday,Workingday,Clear,0.14,0.1667,0.93,0.1045,0,21,21,21,378,21,2,1,1,211,1,717,14261,2,21
2011-12-19,winter,2011,December,6,Monday,Workingday,Clear,0.16,0.1818,0.86,0.1045,0,68,68,68,378,68,2,2,1,221,1,725,55132,2,68
2011-12-19,winter,2011,December,7,Monday,Workingday,Clear,0.18,0.2121,0.74,0.1045,4,187,191,191,378,191,2,3,1,231,1,727,154171,2,191
2011-12-19,winter,2011,December,8,Monday,Workingday,Clear,0.2,0.197,0.75,0.194,8,389,397,397,378,397,2,4,1,241,1,727,261001,2,397
2011-12-19,winter,2011,December,9,Monday,Workingday,Clear,0.22,0.2121,0.69,0.2239,17,166,183,183,378,183,2,3,1,231,1,727,159438,2,183
2011-12-19,winter,2011,December,10,Monday,Workingday,Clear,0.24,0.2273,0.67,0.194,12,96,108,108,378,108,2,2,1,221,1,727,126257,2,108
2011-12-19,winter,2011,December,11,Monday,Workingday,Clear,0.26,0.2424,0.65,0.2537,22,105,127,127,378,127,2,2,1,221,1,727,151320,2,127
2011-12-19,winter,2011,December,12,Monday,Workingday,Clear,0.3,0.2727,0.61,0.3284,13,128,141,141,378,141,2,2,1,221,1,728,184414,2,141
2011-12-19,winter,2011,December,13,Monday,Workingday,Clear,0.34,0.303,0.49,0.3284,15,127,142,142,378,142,2,2,1,221,1,729,184919,2,142
2011-12-19,winter,2011,December,14,Monday,Workingday,Clear,0.36,0.3485,0.46,0.2239,30,107,137,137,378,137,2,2,2,222,1,729,175652,2,137
2011-12-19,winter,2011,December,15,Monday,Workingday,Clear,0.38,0.3939,0.46,0.1642,24,135,159,159,378,159,2,3,2,232,1,729,183149,2,159
2011-12-19,winter,2011,December,16,Monday,Workingday,Clear,0.4,0.4091,0.4,0.2537,19,189,208,208,378,208,2,3,2,232,1,730,227748,2,208
2011-12-19,winter,2011,December,17,Monday,Workingday,Clear,0.38,0.3939,0.46,0.194,16,362,378,378,378,378,2,4,2,242,1,730,336860,2,378
2011-12-19,winter,2011,December,18,Monday,Workingday,Clear,0.36,0.3485,0.5,0.194,11,343,354,354,378,354,2,4,2,242,1,728,309772,2,354
2011-12-19,winter,2011,December,19,Monday,Workingday,Mist,0.36,0.3485,0.53,0.1642,17,234,251,251,378,251,2,3,2,232,1,728,226789,2,251
2011-12-19,winter,2011,December,20,Monday,Workingday,Clear,0.4,0.4091,0.4,0.1642,9,197,206,206,378,206,2,3,2,232,1,728,164550,2,206
2011-12-19,winter,2011,December,21,Monday,Workingday,Mist,0.36,0.3485,0.53,0.1343,15,112,127,127,378,127,2,2,2,222,1,728,125445,2,127
2011-12-19,winter,2011,December,22,Monday,Workingday,Mist,0.36,0.3485,0.57,0.1642,12,95,107,107,378,107,2,2,2,222,1,728,95612,2,107
2011-12-19,winter,2011,December,23,Monday,Workingday,Clear,0.36,0.3485,0.53,0.1642,10,50,60,60,378,60,2,2,2,222,1,728,63941,2,60
2011-12-20,winter,2011,December,0,Tuesday,Workingday,Clear,0.36,0.3636,0.57,0.1045,0,21,21,21,377,21,2,1,2,212,1,726,39130,2,21
2011-12-20,winter,2011,December,1,Tuesday,Workingday,Clear,0.36,0.3788,0.53,0.0,0,6,6,6,377,6,2,1,2,212,1,724,24164,2,6
2011-12-20,winter,2011,December,2,Tuesday,Workingday,Mist,0.34,0.3636,0.61,0.0,1,10,11,11,377,11,2,1,2,212,1,715,16352,2,11
2011-12-20,winter,2011,December,3,Tuesday,Workingday,Mist,0.34,0.3636,0.61,0.0,1,1,2,2,377,2,2,1,2,212,1,697,8174,2,2
2011-12-20,winter,2011,December,4,Tuesday,Workingday,Mist,0.36,0.3636,0.53,0.1045,0,4,4,4,377,4,2,1,2,212,1,697,4428,2,4
2011-12-20,winter,2011,December,5,Tuesday,Workingday,Mist,0.36,0.3788,0.57,0.0,0,15,15,15,377,15,2,1,2,212,1,717,14261,2,15
2011-12-20,winter,2011,December,6,Tuesday,Workingday,Mist,0.36,0.3788,0.57,0.0,1,71,72,72,377,72,2,2,2,222,1,725,55132,2,72
2011-12-20,winter,2011,December,7,Tuesday,Workingday,Mist,0.36,0.3788,0.62,0.0,7,261,268,268,377,268,2,3,2,232,1,727,154171,2,268
2011-12-20,winter,2011,December,8,Tuesday,Workingday,Mist,0.42,0.4242,0.54,0.0896,10,422,432,432,377,432,2,4,2,242,1,727,261001,2,432
2011-12-20,winter,2011,December,9,Tuesday,Workingday,Mist,0.36,0.3788,0.66,0.0,14,245,259,259,377,259,2,3,2,232,1,727,159438,2,259
2011-12-20,winter,2011,December,10,Tuesday,Workingday,Mist,0.42,0.4242,0.58,0.194,20,109,129,129,377,129,2,2,2,222,1,727,126257,2,129
2011-12-20,winter,2011,December,11,Tuesday,Workingday,Mist,0.4,0.4091,0.62,0.1642,13,116,129,129,377,129,2,2,2,222,1,727,151320,2,129
2011-12-20,winter,2011,December,12,Tuesday,Workingday,Mist,0.44,0.4394,0.54,0.1343,16,159,175,175,377,175,2,3,2,232,1,728,184414,2,175
2011-12-20,winter,2011,December,13,Tuesday,Workingday,Mist,0.44,0.4394,0.54,0.1343,18,163,181,181,377,181,2,3,2,232,1,729,184919,2,181
2011-12-20,winter,2011,December,14,Tuesday,Workingday,Mist,0.44,0.4394,0.58,0.1045,11,127,138,138,377,138,2,2,2,222,0,729,175652,2,138
2011-12-20,winter,2011,December,15,Tuesday,Workingday,Mist,0.44,0.4394,0.54,0.0,15,139,154,154,377,154,2,3,2,232,0,729,183149,2,154
2011-12-20,winter,2011,December,16,Tuesday,Workingday,Clear,0.44,0.4394,0.54,0.0,20,218,238,238,377,238,2,3,2,232,0,730,227748,2,238
2011-12-20,winter,2011,December,17,Tuesday,Workingday,Clear,0.4,0.4091,0.62,0.1642,14,417,431,431,377,431,2,4,2,242,1,730,336860,2,431
2011-12-20,winter,2011,December,18,Tuesday,Workingday,Clear,0.38,0.3939,0.66,0.194,26,385,411,411,377,411,2,4,2,242,1,728,309772,2,411
2011-12-20,winter,2011,December,19,Tuesday,Workingday,Clear,0.38,0.3939,0.66,0.0,6,218,224,224,377,224,2,3,2,232,0,728,226789,2,224
2011-12-20,winter,2011,December,20,Tuesday,Workingday,Clear,0.36,0.3788,0.66,0.0,3,144,147,147,377,147,2,3,2,232,1,728,164550,2,147
2011-12-20,winter,2011,December,21,Tuesday,Workingday,Clear,0.36,0.3636,0.66,0.0896,4,139,143,143,377,143,2,3,2,232,1,728,125445,2,143
2011-12-20,winter,2011,December,22,Tuesday,Workingday,Mist,0.36,0.3788,0.66,0.0,3,104,107,107,377,107,2,2,2,222,1,728,95612,2,107
2011-12-20,winter,2011,December,23,Tuesday,Workingday,Mist,0.38,0.3939,0.62,0.0,13,40,53,53,377,53,2,2,2,222,0,728,63941,2,53
2011-12-21,spring,2011,December,0,Wednesday,Workingday,Mist,0.34,0.3333,0.71,0.1343,7,18,25,25,376,25,2,1,1,211,1,726,39130,2,25
2011-12-21,spring,2011,December,1,Wednesday,Workingday,Mist,0.36,0.3636,0.66,0.1045,1,10,11,11,376,11,2,1,2,212,1,724,24164,2,11
2011-12-21,spring,2011,December,2,Wednesday,Workingday,Mist,0.36,0.3788,0.71,0.0,0,4,4,4,376,4,2,1,2,212,0,715,16352,2,4
2011-12-21,spring,2011,December,3,Wednesday,Workingday,Mist,0.36,0.3788,0.71,0.0,0,2,2,2,376,2,2,1,2,212,0,697,8174,2,2
2011-12-21,spring,2011,December,4,Wednesday,Workingday,Mist,0.36,0.3788,0.71,0.0,0,2,2,2,376,2,2,1,2,212,0,697,4428,2,2
2011-12-21,spring,2011,December,5,Wednesday,Workingday,Mist,0.38,0.3939,0.82,0.1045,0,28,28,28,376,28,2,1,2,212,0,717,14261,2,28
2011-12-21,spring,2011,December,6,Wednesday,Workingday,Mist,0.36,0.3788,0.87,0.0,1,75,76,76,376,76,2,2,2,222,0,725,55132,2,76
2011-12-21,spring,2011,December,7,Wednesday,Workingday,Mist,0.36,0.3636,0.87,0.1045,5,224,229,229,376,229,2,3,2,232,0,727,154171,2,229
2011-12-21,spring,2011,December,8,Wednesday,Workingday,Light Snow,0.36,0.3788,0.93,0.0,12,393,405,405,376,405,2,4,2,242,0,727,261001,2,405
2011-12-21,spring,2011,December,9,Wednesday,Workingday,Mist,0.4,0.4091,0.87,0.2239,14,220,234,234,376,234,2,3,2,232,0,727,159438,2,234
2011-12-21,spring,2011,December,10,Wednesday,Workingday,Mist,0.48,0.4697,0.82,0.4179,6,83,89,89,376,89,2,2,2,222,0,727,126257,2,89
2011-12-21,spring,2011,December,11,Wednesday,Workingday,Mist,0.48,0.4697,0.82,0.4179,3,53,56,56,376,56,2,2,2,222,0,727,151320,2,56
2011-12-21,spring,2011,December,12,Wednesday,Workingday,Light Snow,0.46,0.4545,0.88,0.3881,3,58,61,61,376,61,2,2,2,222,0,728,184414,2,61
2011-12-21,spring,2011,December,13,Wednesday,Workingday,Light Snow,0.44,0.4394,0.94,0.2985,3,55,58,58,376,58,2,2,2,222,0,729,184919,2,58
2011-12-21,spring,2011,December,14,Wednesday,Workingday,Mist,0.48,0.4697,0.88,0.3582,11,40,51,51,376,51,2,2,2,222,0,729,175652,2,51
2011-12-21,spring,2011,December,15,Wednesday,Workingday,Mist,0.48,0.4697,0.88,0.3881,4,57,61,61,376,61,2,2,2,222,0,729,183149,2,61
2011-12-21,spring,2011,December,16,Wednesday,Workingday,Light Snow,0.44,0.4394,1.0,0.3284,6,95,101,101,376,101,2,2,2,222,0,730,227748,2,101
2011-12-21,spring,2011,December,17,Wednesday,Workingday,Light Snow,0.44,0.4394,1.0,0.3284,3,226,229,229,376,229,2,3,2,232,0,730,336860,2,229
2011-12-21,spring,2011,December,18,Wednesday,Workingday,Mist,0.44,0.4394,1.0,0.2985,2,278,280,280,376,280,2,3,2,232,0,728,309772,2,280
2011-12-21,spring,2011,December,19,Wednesday,Workingday,Mist,0.5,0.4848,0.94,0.3284,9,200,209,209,376,209,2,3,2,232,0,728,226789,2,209
2011-12-21,spring,2011,December,20,Wednesday,Workingday,Mist,0.5,0.4848,0.94,0.3582,5,162,167,167,376,167,2,3,2,232,0,728,164550,2,167
2011-12-21,spring,2011,December,21,Wednesday,Workingday,Clear,0.5,0.4848,0.88,0.2836,9,114,123,123,376,123,2,2,2,222,0,728,125445,2,123
2011-12-21,spring,2011,December,22,Wednesday,Workingday,Clear,0.5,0.4848,0.88,0.2537,3,102,105,105,376,105,2,2,2,222,0,728,95612,2,105
2011-12-21,spring,2011,December,23,Wednesday,Workingday,Clear,0.5,0.4848,0.88,0.194,0,54,54,54,376,54,2,2,2,222,0,728,63941,2,54
2011-12-22,spring,2011,December,0,Thursday,Workingday,Mist,0.5,0.4848,0.82,0.1045,3,24,27,27,375,27,2,1,2,212,0,726,39130,2,27
2011-12-22,spring,2011,December,1,Thursday,Workingday,Clear,0.44,0.4394,0.94,0.0896,0,15,15,15,375,15,2,1,2,212,0,724,24164,2,15
2011-12-22,spring,2011,December,2,Thursday,Workingday,Clear,0.48,0.4697,0.82,0.1045,1,10,11,11,375,11,2,1,2,212,0,715,16352,2,11
2011-12-22,spring,2011,December,3,Thursday,Workingday,Clear,0.44,0.4394,0.67,0.1642,0,6,6,6,375,6,2,1,2,212,0,697,8174,2,6
2011-12-22,spring,2011,December,4,Thursday,Workingday,Clear,0.38,0.3939,0.82,0.1343,0,3,3,3,375,3,2,1,2,212,0,697,4428,2,3
2011-12-22,spring,2011,December,5,Thursday,Workingday,Clear,0.38,0.3939,0.82,0.0,1,15,16,16,375,16,2,1,2,212,0,717,14261,2,16
2011-12-22,spring,2011,December,6,Thursday,Workingday,Clear,0.36,0.3788,0.87,0.0,1,63,64,64,375,64,2,2,2,222,0,725,55132,2,64
2011-12-22,spring,2011,December,7,Thursday,Workingday,Clear,0.34,0.3636,0.93,0.0,4,182,186,186,375,186,2,3,2,232,0,727,154171,2,186
2011-12-22,spring,2011,December,8,Thursday,Workingday,Mist,0.36,0.3788,0.87,0.0,10,333,343,343,375,343,2,4,2,242,0,727,261001,2,343
2011-12-22,spring,2011,December,9,Thursday,Workingday,Mist,0.38,0.3939,0.87,0.0896,10,218,228,228,375,228,2,3,2,232,0,727,159438,2,228
2011-12-22,spring,2011,December,10,Thursday,Workingday,Mist,0.4,0.4091,0.82,0.0896,13,128,141,141,375,141,2,2,2,222,0,727,126257,2,141
2011-12-22,spring,2011,December,11,Thursday,Workingday,Mist,0.44,0.4394,0.77,0.0,10,135,145,145,375,145,2,3,2,232,0,727,151320,2,145
2011-12-22,spring,2011,December,12,Thursday,Workingday,Mist,0.48,0.4697,0.55,0.0,22,180,202,202,375,202,2,3,2,232,0,728,184414,2,202
2011-12-22,spring,2011,December,13,Thursday,Workingday,Mist,0.46,0.4545,0.63,0.0,21,167,188,188,375,188,2,3,2,232,0,729,184919,2,188
2011-12-22,spring,2011,December,14,Thursday,Workingday,Mist,0.46,0.4545,0.63,0.0,23,136,159,159,375,159,2,3,2,232,0,729,175652,2,159
2011-12-22,spring,2011,December,15,Thursday,Workingday,Mist,0.48,0.4697,0.59,0.0,28,186,214,214,375,214,2,3,2,232,0,729,183149,2,214
2011-12-22,spring,2011,December,16,Thursday,Workingday,Mist,0.46,0.4545,0.63,0.0,30,226,256,256,375,256,2,3,2,232,0,730,227748,2,256
2011-12-22,spring,2011,December,17,Thursday,Workingday,Mist,0.44,0.4394,0.67,0.1642,24,332,356,356,375,356,2,4,2,242,0,730,336860,2,356
2011-12-22,spring,2011,December,18,Thursday,Workingday,Mist,0.44,0.4394,0.62,0.0896,11,277,288,288,375,288,2,4,2,242,0,728,309772,2,288
2011-12-22,spring,2011,December,19,Thursday,Workingday,Mist,0.44,0.4394,0.62,0.0,12,130,142,142,375,142,2,2,2,222,0,728,226789,2,142
2011-12-22,spring,2011,December,20,Thursday,Workingday,Light Snow,0.42,0.4242,0.71,0.0,0,33,33,33,375,33,2,1,2,212,0,728,164550,2,33
2011-12-22,spring,2011,December,21,Thursday,Workingday,Light Snow,0.42,0.4242,0.71,0.0,2,15,17,17,375,17,2,1,2,212,0,728,125445,2,17
2011-12-22,spring,2011,December,22,Thursday,Workingday,Light Snow,0.36,0.3636,0.93,0.1045,0,17,17,17,375,17,2,1,2,212,0,728,95612,2,17
2011-12-22,spring,2011,December,23,Thursday,Workingday,Light Snow,0.4,0.4091,0.87,0.0,1,10,11,11,375,11,2,1,2,212,0,728,63941,2,11
2011-12-23,spring,2011,December,0,Friday,Workingday,Light Snow,0.4,0.4091,0.87,0.194,2,7,9,9,374,9,2,1,2,212,0,726,39130,2,9
2011-12-23,spring,2011,December,1,Friday,Workingday,Light Snow,0.4,0.4091,0.87,0.194,1,11,12,12,374,12,2,1,2,212,0,724,24164,2,12
2011-12-23,spring,2011,December,2,Friday,Workingday,Light Snow,0.38,0.3939,0.94,0.1343,1,12,13,13,374,13,2,1,2,212,0,715,16352,2,13
2011-12-23,spring,2011,December,3,Friday,Workingday,Light Snow,0.38,0.3939,0.94,0.1343,0,4,4,4,374,4,2,1,2,212,0,697,8174,2,4
2011-12-23,spring,2011,December,4,Friday,Workingday,Light Snow,0.38,0.3939,0.94,0.2836,0,2,2,2,374,2,2,1,2,212,0,697,4428,2,2
2011-12-23,spring,2011,December,5,Friday,Workingday,Clear,0.36,0.3485,0.93,0.194,0,8,8,8,374,8,2,1,2,212,0,717,14261,2,8
2011-12-23,spring,2011,December,6,Friday,Workingday,Clear,0.38,0.3939,0.82,0.2537,0,40,40,40,374,40,2,1,2,212,1,725,55132,2,40
2011-12-23,spring,2011,December,7,Friday,Workingday,Clear,0.38,0.3939,0.82,0.2239,4,88,92,92,374,92,2,2,2,222,1,727,154171,2,92
2011-12-23,spring,2011,December,8,Friday,Workingday,Clear,0.4,0.4091,0.76,0.2537,9,173,182,182,374,182,2,3,2,232,1,727,261001,2,182
2011-12-23,spring,2011,December,9,Friday,Workingday,Clear,0.4,0.4091,0.66,0.2985,4,152,156,156,374,156,2,3,2,232,1,727,159438,2,156
2011-12-23,spring,2011,December,10,Friday,Workingday,Clear,0.4,0.4091,0.62,0.3582,8,96,104,104,374,104,2,2,2,222,1,727,126257,2,104
2011-12-23,spring,2011,December,11,Friday,Workingday,Clear,0.4,0.4091,0.58,0.4478,26,148,174,174,374,174,2,3,2,232,1,727,151320,2,174
2011-12-23,spring,2011,December,12,Friday,Workingday,Clear,0.4,0.4091,0.54,0.5224,14,156,170,170,374,170,2,3,2,232,1,728,184414,2,170
2011-12-23,spring,2011,December,13,Friday,Workingday,Clear,0.4,0.4091,0.5,0.4627,17,177,194,194,374,194,2,3,2,232,1,729,184919,2,194
2011-12-23,spring,2011,December,14,Friday,Workingday,Clear,0.4,0.4091,0.54,0.4179,23,177,200,200,374,200,2,3,2,232,1,729,175652,2,200
2011-12-23,spring,2011,December,15,Friday,Workingday,Clear,0.38,0.3939,0.54,0.3582,12,191,203,203,374,203,2,3,2,232,1,729,183149,2,203
2011-12-23,spring,2011,December,16,Friday,Workingday,Clear,0.38,0.3939,0.5,0.2985,15,166,181,181,374,181,2,3,2,232,1,730,227748,2,181
2011-12-23,spring,2011,December,17,Friday,Workingday,Clear,0.36,0.3485,0.53,0.2239,11,129,140,140,374,140,2,2,2,222,1,730,336860,2,140
2011-12-23,spring,2011,December,18,Friday,Workingday,Clear,0.36,0.3333,0.5,0.2537,4,91,95,95,374,95,2,2,1,221,1,728,309772,2,95
2011-12-23,spring,2011,December,19,Friday,Workingday,Clear,0.34,0.3333,0.53,0.194,1,75,76,76,374,76,2,2,1,221,1,728,226789,2,76
2011-12-23,spring,2011,December,20,Friday,Workingday,Clear,0.32,0.303,0.61,0.3284,3,47,50,50,374,50,2,2,1,221,1,728,164550,2,50
2011-12-23,spring,2011,December,21,Friday,Workingday,Clear,0.32,0.303,0.61,0.2239,0,32,32,32,374,32,2,1,1,211,1,728,125445,2,32
2011-12-23,spring,2011,December,22,Friday,Workingday,Clear,0.32,0.3182,0.66,0.194,4,43,47,47,374,47,2,2,1,221,1,728,95612,2,47
2011-12-23,spring,2011,December,23,Friday,Workingday,Clear,0.32,0.3333,0.66,0.1343,4,21,25,25,374,25,2,1,1,211,1,728,63941,2,25
2011-12-24,spring,2011,December,0,Saturday,Holiday,Mist,0.32,0.3182,0.7,0.1642,3,20,23,23,373,23,2,1,1,211,1,726,39130,2,23
2011-12-24,spring,2011,December,1,Saturday,Holiday,Mist,0.32,0.3485,0.66,0.0,1,15,16,16,373,16,2,1,2,212,1,724,24164,2,16
2011-12-24,spring,2011,December,2,Saturday,Holiday,Mist,0.32,0.3333,0.66,0.0896,4,22,26,26,373,26,2,1,1,211,1,715,16352,2,26
2011-12-24,spring,2011,December,3,Saturday,Holiday,Mist,0.32,0.3333,0.7,0.0896,0,5,5,5,373,5,2,1,1,211,1,697,8174,2,5
2011-12-24,spring,2011,December,4,Saturday,Holiday,Mist,0.32,0.3182,0.66,0.1642,0,3,3,3,373,3,2,1,1,211,1,697,4428,2,3
2011-12-24,spring,2011,December,5,Saturday,Holiday,Mist,0.32,0.3182,0.66,0.1642,1,3,4,4,373,4,2,1,1,211,1,717,14261,2,4
2011-12-24,spring,2011,December,6,Saturday,Holiday,Mist,0.3,0.303,0.75,0.1642,0,10,10,10,373,10,2,1,1,211,1,725,55132,2,10
2011-12-24,spring,2011,December,7,Saturday,Holiday,Clear,0.3,0.2727,0.7,0.3582,0,10,10,10,373,10,2,1,1,211,1,727,154171,2,10
2011-12-24,spring,2011,December,8,Saturday,Holiday,Clear,0.28,0.2727,0.7,0.194,0,27,27,27,373,27,2,1,1,211,1,727,261001,2,27
2011-12-24,spring,2011,December,9,Saturday,Holiday,Clear,0.3,0.2727,0.45,0.4179,3,53,56,56,373,56,2,2,1,221,1,727,159438,2,56
2011-12-24,spring,2011,December,10,Saturday,Holiday,Clear,0.3,0.2576,0.42,0.4925,4,52,56,56,373,56,2,2,1,221,1,727,126257,2,56
2011-12-24,spring,2011,December,11,Saturday,Holiday,Clear,0.32,0.2879,0.39,0.3582,9,62,71,71,373,71,2,2,1,221,1,727,151320,2,71
2011-12-24,spring,2011,December,12,Saturday,Holiday,Clear,0.34,0.3182,0.39,0.2836,15,79,94,94,373,94,2,2,1,221,1,728,184414,2,94
2011-12-24,spring,2011,December,13,Saturday,Holiday,Clear,0.34,0.303,0.39,0.2985,24,97,121,121,373,121,2,2,1,221,1,729,184919,2,121
2011-12-24,spring,2011,December,14,Saturday,Holiday,Clear,0.34,0.303,0.39,0.2985,15,70,85,85,373,85,2,2,1,221,1,729,175652,2,85
2011-12-24,spring,2011,December,15,Saturday,Holiday,Clear,0.32,0.303,0.39,0.2239,15,82,97,97,373,97,2,2,1,221,1,729,183149,2,97
2011-12-24,spring,2011,December,16,Saturday,Holiday,Clear,0.32,0.3182,0.42,0.194,25,74,99,99,373,99,2,2,1,221,1,730,227748,2,99
2011-12-24,spring,2011,December,17,Saturday,Holiday,Clear,0.28,0.2879,0.45,0.1343,15,53,68,68,373,68,2,2,1,221,1,730,336860,2,68
2011-12-24,spring,2011,December,18,Saturday,Holiday,Clear,0.3,0.3182,0.42,0.0896,2,33,35,35,373,35,2,1,1,211,1,728,309772,2,35
2011-12-24,spring,2011,December,19,Saturday,Holiday,Clear,0.3,0.3182,0.52,0.0896,1,24,25,25,373,25,2,1,1,211,1,728,226789,2,25
2011-12-24,spring,2011,December,20,Saturday,Holiday,Clear,0.26,0.2727,0.56,0.1343,5,19,24,24,373,24,2,1,1,211,1,728,164550,2,24
2011-12-24,spring,2011,December,21,Saturday,Holiday,Clear,0.26,0.2576,0.56,0.1642,4,15,19,19,373,19,2,1,1,211,1,728,125445,2,19
2011-12-24,spring,2011,December,22,Saturday,Holiday,Clear,0.24,0.2879,0.52,0.0,8,12,20,20,373,20,2,1,1,211,1,728,95612,2,20
2011-12-24,spring,2011,December,23,Saturday,Holiday,Clear,0.24,0.2576,0.56,0.0,1,16,17,17,373,17,2,1,1,211,1,728,63941,2,17
2011-12-25,spring,2011,December,0,Sunday,Holiday,Clear,0.24,0.2273,0.6,0.194,2,4,6,6,372,6,2,1,1,211,1,726,39130,2,6
2011-12-25,spring,2011,December,1,Sunday,Holiday,Clear,0.22,0.2273,0.69,0.1343,2,2,4,4,372,4,2,1,1,211,1,724,24164,2,4
2011-12-25,spring,2011,December,2,Sunday,Holiday,Clear,0.22,0.2576,0.75,0.0896,0,2,2,2,372,2,2,1,1,211,1,715,16352,2,2
2011-12-25,spring,2011,December,3,Sunday,Holiday,Clear,0.22,0.2727,0.72,0.0,1,3,4,4,372,4,2,1,1,211,1,697,8174,2,4
2011-12-25,spring,2011,December,5,Sunday,Holiday,Clear,0.2,0.2273,0.75,0.1045,0,1,1,1,372,1,2,1,1,211,1,717,14261,2,1
2011-12-25,spring,2011,December,6,Sunday,Holiday,Clear,0.2,0.2273,0.75,0.1045,0,1,1,1,372,1,2,1,1,211,1,725,55132,2,1
2011-12-25,spring,2011,December,7,Sunday,Holiday,Clear,0.22,0.2424,0.8,0.1045,0,4,4,4,372,4,2,1,1,211,1,727,154171,2,4
2011-12-25,spring,2011,December,8,Sunday,Holiday,Clear,0.2,0.2121,0.8,0.1642,1,4,5,5,372,5,2,1,1,211,1,727,261001,2,5
2011-12-25,spring,2011,December,9,Sunday,Holiday,Clear,0.24,0.2424,0.87,0.1642,3,20,23,23,372,23,2,1,1,211,1,727,159438,2,23
2011-12-25,spring,2011,December,10,Sunday,Holiday,Clear,0.26,0.2424,0.81,0.2537,31,12,43,43,372,43,2,2,1,221,1,727,126257,2,43
2011-12-25,spring,2011,December,11,Sunday,Holiday,Clear,0.3,0.303,0.7,0.1642,43,42,85,85,372,85,2,2,1,221,1,727,151320,2,85
2011-12-25,spring,2011,December,12,Sunday,Holiday,Clear,0.3,0.2727,0.75,0.2985,25,41,66,66,372,66,2,2,1,221,1,728,184414,2,66
2011-12-25,spring,2011,December,13,Sunday,Holiday,Clear,0.32,0.303,0.7,0.2537,40,39,79,79,372,79,2,2,1,221,1,729,184919,2,79
2011-12-25,spring,2011,December,14,Sunday,Holiday,Clear,0.34,0.3182,0.61,0.2537,41,45,86,86,372,86,2,2,1,221,1,729,175652,2,86
2011-12-25,spring,2011,December,15,Sunday,Holiday,Clear,0.34,0.3333,0.61,0.194,43,48,91,91,372,91,2,2,1,221,1,729,183149,2,91
2011-12-25,spring,2011,December,16,Sunday,Holiday,Clear,0.36,0.3636,0.57,0.1045,35,51,86,86,372,86,2,2,2,222,1,730,227748,2,86
2011-12-25,spring,2011,December,17,Sunday,Holiday,Clear,0.34,0.3333,0.61,0.1343,11,33,44,44,372,44,2,2,1,221,1,730,336860,2,44
2011-12-25,spring,2011,December,18,Sunday,Holiday,Clear,0.32,0.3182,0.7,0.194,7,23,30,30,372,30,2,1,1,211,1,728,309772,2,30
2011-12-25,spring,2011,December,19,Sunday,Holiday,Clear,0.32,0.3333,0.57,0.1343,2,14,16,16,372,16,2,1,1,211,1,728,226789,2,16
2011-12-25,spring,2011,December,20,Sunday,Holiday,Clear,0.32,0.3333,0.49,0.0896,8,18,26,26,372,26,2,1,1,211,1,728,164550,2,26
2011-12-25,spring,2011,December,21,Sunday,Holiday,Clear,0.3,0.303,0.56,0.1343,4,15,19,19,372,19,2,1,1,211,1,728,125445,2,19
2011-12-25,spring,2011,December,22,Sunday,Holiday,Clear,0.28,0.2727,0.61,0.1642,2,15,17,17,372,17,2,1,1,211,1,728,95612,2,17
2011-12-25,spring,2011,December,23,Sunday,Holiday,Clear,0.26,0.2727,0.65,0.1343,2,14,16,16,372,16,2,1,1,211,1,728,63941,2,16
2011-12-26,spring,2011,December,0,Monday,Holiday,Clear,0.22,0.2273,0.75,0.1642,5,6,11,11,371,11,2,1,1,211,1,726,39130,2,11
2011-12-26,spring,2011,December,1,Monday,Holiday,Clear,0.28,0.2727,0.56,0.194,3,7,10,10,371,10,2,1,1,211,1,724,24164,2,10
2011-12-26,spring,2011,December,2,Monday,Holiday,Clear,0.34,0.3182,0.46,0.2239,2,5,7,7,371,7,2,1,1,211,1,715,16352,2,7
2011-12-26,spring,2011,December,4,Monday,Holiday,Clear,0.34,0.303,0.46,0.2985,0,2,2,2,371,2,2,1,1,211,1,697,4428,2,2
2011-12-26,spring,2011,December,5,Monday,Holiday,Clear,0.34,0.303,0.42,0.3881,0,4,4,4,371,4,2,1,1,211,1,717,14261,2,4
2011-12-26,spring,2011,December,6,Monday,Holiday,Clear,0.32,0.303,0.45,0.2836,0,4,4,4,371,4,2,1,1,211,1,725,55132,2,4
2011-12-26,spring,2011,December,7,Monday,Holiday,Clear,0.32,0.3182,0.45,0.194,2,17,19,19,371,19,2,1,1,211,1,727,154171,2,19
2011-12-26,spring,2011,December,8,Monday,Holiday,Clear,0.32,0.3333,0.45,0.1343,5,13,18,18,371,18,2,1,1,211,1,727,261001,2,18
2011-12-26,spring,2011,December,9,Monday,Holiday,Clear,0.34,0.303,0.46,0.2985,24,38,62,62,371,62,2,2,1,221,1,727,159438,2,62
2011-12-26,spring,2011,December,10,Monday,Holiday,Clear,0.34,0.2879,0.42,0.5224,31,39,70,70,371,70,2,2,1,221,1,727,126257,2,70
2011-12-26,spring,2011,December,11,Monday,Holiday,Clear,0.34,0.2879,0.46,0.5821,40,51,91,91,371,91,2,2,1,221,1,727,151320,2,91
2011-12-26,spring,2011,December,12,Monday,Holiday,Clear,0.36,0.3182,0.43,0.4627,34,66,100,100,371,100,2,2,1,221,1,728,184414,2,100
2011-12-26,spring,2011,December,13,Monday,Holiday,Clear,0.38,0.3939,0.4,0.2985,57,83,140,140,371,140,2,2,2,222,1,729,184919,2,140
2011-12-26,spring,2011,December,14,Monday,Holiday,Clear,0.38,0.3939,0.4,0.3284,73,80,153,153,371,153,2,3,2,232,1,729,175652,2,153
2011-12-26,spring,2011,December,15,Monday,Holiday,Clear,0.38,0.3939,0.4,0.2537,26,105,131,131,371,131,2,2,2,222,1,729,183149,2,131
2011-12-26,spring,2011,December,16,Monday,Holiday,Clear,0.36,0.3333,0.43,0.2836,28,69,97,97,371,97,2,2,1,221,1,730,227748,2,97
2011-12-26,spring,2011,December,17,Monday,Holiday,Clear,0.34,0.3182,0.46,0.2239,30,67,97,97,371,97,2,2,1,221,1,730,336860,2,97
2011-12-26,spring,2011,December,18,Monday,Holiday,Clear,0.32,0.3333,0.49,0.0896,21,54,75,75,371,75,2,2,1,221,1,728,309772,2,75
2011-12-26,spring,2011,December,19,Monday,Holiday,Clear,0.3,0.3182,0.65,0.0896,16,49,65,65,371,65,2,2,1,221,1,728,226789,2,65
2011-12-26,spring,2011,December,20,Monday,Holiday,Clear,0.3,0.3182,0.56,0.0896,14,42,56,56,371,56,2,2,1,221,1,728,164550,2,56
2011-12-26,spring,2011,December,21,Monday,Holiday,Clear,0.26,0.303,0.7,0.0,10,39,49,49,371,49,2,2,1,221,1,728,125445,2,49
2011-12-26,spring,2011,December,22,Monday,Holiday,Clear,0.26,0.303,0.7,0.0,5,22,27,27,371,27,2,1,1,211,1,728,95612,2,27
2011-12-26,spring,2011,December,23,Monday,Holiday,Clear,0.26,0.2727,0.7,0.1045,4,25,29,29,371,29,2,1,1,211,1,728,63941,2,29
2011-12-27,spring,2011,December,0,Tuesday,Workingday,Clear,0.26,0.2576,0.7,0.1642,3,9,12,12,370,12,2,1,1,211,1,726,39130,2,12
2011-12-27,spring,2011,December,1,Tuesday,Workingday,Clear,0.26,0.2727,0.7,0.1343,0,6,6,6,370,6,2,1,1,211,1,724,24164,2,6
2011-12-27,spring,2011,December,2,Tuesday,Workingday,Clear,0.26,0.2727,0.7,0.1343,2,2,4,4,370,4,2,1,1,211,1,715,16352,2,4
2011-12-27,spring,2011,December,3,Tuesday,Workingday,Mist,0.3,0.2879,0.61,0.2239,0,3,3,3,370,3,2,1,1,211,1,697,8174,2,3
2011-12-27,spring,2011,December,4,Tuesday,Workingday,Mist,0.3,0.2879,0.65,0.2239,0,3,3,3,370,3,2,1,1,211,1,697,4428,2,3
2011-12-27,spring,2011,December,5,Tuesday,Workingday,Mist,0.3,0.2727,0.64,0.2836,0,8,8,8,370,8,2,1,1,211,1,717,14261,2,8
2011-12-27,spring,2011,December,6,Tuesday,Workingday,Mist,0.3,0.2727,0.61,0.2985,0,35,35,35,370,35,2,1,1,211,1,725,55132,2,35
2011-12-27,spring,2011,December,7,Tuesday,Workingday,Mist,0.3,0.2879,0.65,0.2836,1,79,80,80,370,80,2,2,1,221,1,727,154171,2,80
2011-12-27,spring,2011,December,8,Tuesday,Workingday,Mist,0.3,0.303,0.65,0.1642,9,155,164,164,370,164,2,3,1,231,1,727,261001,2,164
2011-12-27,spring,2011,December,9,Tuesday,Workingday,Light Snow,0.32,0.3333,0.66,0.1045,19,85,104,104,370,104,2,2,1,221,1,727,159438,2,104
2011-12-27,spring,2011,December,10,Tuesday,Workingday,Mist,0.32,0.3333,0.66,0.0896,13,47,60,60,370,60,2,2,1,221,1,727,126257,2,60
2011-12-27,spring,2011,December,11,Tuesday,Workingday,Light Snow,0.32,0.3333,0.66,0.1045,6,24,30,30,370,30,2,1,1,211,1,727,151320,2,30
2011-12-27,spring,2011,December,12,Tuesday,Workingday,Light Snow,0.3,0.3182,0.81,0.0896,8,16,24,24,370,24,2,1,1,211,1,728,184414,2,24
2011-12-27,spring,2011,December,13,Tuesday,Workingday,Light Snow,0.3,0.303,0.87,0.1343,1,19,20,20,370,20,2,1,1,211,1,729,184919,2,20
2011-12-27,spring,2011,December,14,Tuesday,Workingday,Light Snow,0.42,0.4242,0.82,0.3881,0,14,14,14,370,14,2,1,2,212,1,729,175652,2,14
2011-12-27,spring,2011,December,15,Tuesday,Workingday,Light Snow,0.42,0.4242,0.82,0.3881,2,17,19,19,370,19,2,1,2,212,1,729,183149,2,19
2011-12-27,spring,2011,December,16,Tuesday,Workingday,Light Snow,0.44,0.4394,0.88,0.3284,2,44,46,46,370,46,2,2,2,222,0,730,227748,2,46
2011-12-27,spring,2011,December,17,Tuesday,Workingday,Light Snow,0.4,0.4091,0.87,0.1343,6,109,115,115,370,115,2,2,2,222,0,730,336860,2,115
2011-12-27,spring,2011,December,18,Tuesday,Workingday,Clear,0.38,0.3939,0.87,0.2836,9,126,135,135,370,135,2,2,2,222,1,728,309772,2,135
2011-12-27,spring,2011,December,19,Tuesday,Workingday,Clear,0.34,0.3333,0.87,0.1642,3,87,90,90,370,90,2,2,1,221,1,728,226789,2,90
2011-12-27,spring,2011,December,20,Tuesday,Workingday,Clear,0.32,0.3333,0.93,0.0896,3,66,69,69,370,69,2,2,1,221,0,728,164550,2,69
2011-12-27,spring,2011,December,21,Tuesday,Workingday,Clear,0.32,0.3333,0.87,0.0896,11,52,63,63,370,63,2,2,1,221,1,728,125445,2,63
2011-12-27,spring,2011,December,22,Tuesday,Workingday,Clear,0.32,0.3333,0.87,0.0896,3,29,32,32,370,32,2,1,1,211,1,728,95612,2,32
2011-12-27,spring,2011,December,23,Tuesday,Workingday,Clear,0.3,0.303,0.93,0.1343,2,24,26,26,370,26,2,1,1,211,1,728,63941,2,26
2011-12-28,spring,2011,December,0,Wednesday,Workingday,Clear,0.32,0.3182,0.87,0.1642,0,10,10,10,369,10,2,1,1,211,1,726,39130,2,10
2011-12-28,spring,2011,December,1,Wednesday,Workingday,Clear,0.32,0.3182,0.76,0.1642,0,12,12,12,369,12,2,1,1,211,1,724,24164,2,12
2011-12-28,spring,2011,December,2,Wednesday,Workingday,Clear,0.32,0.303,0.61,0.2537,0,7,7,7,369,7,2,1,1,211,1,715,16352,2,7
2011-12-28,spring,2011,December,3,Wednesday,Workingday,Clear,0.32,0.303,0.61,0.2537,0,4,4,4,369,4,2,1,1,211,1,697,8174,2,4
2011-12-28,spring,2011,December,5,Wednesday,Workingday,Clear,0.32,0.2879,0.57,0.3582,0,9,9,9,369,9,2,1,1,211,1,717,14261,2,9
2011-12-28,spring,2011,December,6,Wednesday,Workingday,Clear,0.32,0.303,0.57,0.2537,1,42,43,43,369,43,2,2,1,221,1,725,55132,2,43
2011-12-28,spring,2011,December,7,Wednesday,Workingday,Clear,0.32,0.303,0.57,0.2537,4,106,110,110,369,110,2,2,1,221,1,727,154171,2,110
2011-12-28,spring,2011,December,8,Wednesday,Workingday,Clear,0.32,0.2879,0.57,0.3582,11,206,217,217,369,217,2,3,1,231,1,727,261001,2,217
2011-12-28,spring,2011,December,9,Wednesday,Workingday,Clear,0.32,0.303,0.57,0.3284,18,171,189,189,369,189,2,3,1,231,1,727,159438,2,189
2011-12-28,spring,2011,December,10,Wednesday,Workingday,Clear,0.34,0.3182,0.57,0.2239,12,84,96,96,369,96,2,2,1,221,1,727,126257,2,96
2011-12-28,spring,2011,December,11,Wednesday,Workingday,Clear,0.36,0.3333,0.46,0.3582,18,93,111,111,369,111,2,2,1,221,1,727,151320,2,111
2011-12-28,spring,2011,December,12,Wednesday,Workingday,Clear,0.34,0.2879,0.46,0.5522,32,108,140,140,369,140,2,2,1,221,1,728,184414,2,140
2011-12-28,spring,2011,December,13,Wednesday,Workingday,Clear,0.34,0.2879,0.39,0.4627,24,135,159,159,369,159,2,3,1,231,1,729,184919,2,159
2011-12-28,spring,2011,December,14,Wednesday,Workingday,Clear,0.32,0.2879,0.39,0.3881,24,96,120,120,369,120,2,2,1,221,1,729,175652,2,120
2011-12-28,spring,2011,December,15,Wednesday,Workingday,Clear,0.32,0.2879,0.36,0.4179,16,101,117,117,369,117,2,2,1,221,1,729,183149,2,117
2011-12-28,spring,2011,December,16,Wednesday,Workingday,Clear,0.3,0.2727,0.36,0.4179,23,144,167,167,369,167,2,3,1,231,1,730,227748,2,167
2011-12-28,spring,2011,December,17,Wednesday,Workingday,Clear,0.28,0.2727,0.38,0.2537,25,225,250,250,369,250,2,3,1,231,1,730,336860,2,250
2011-12-28,spring,2011,December,18,Wednesday,Workingday,Clear,0.26,0.2273,0.38,0.3284,10,159,169,169,369,169,2,3,1,231,1,728,309772,2,169
2011-12-28,spring,2011,December,19,Wednesday,Workingday,Clear,0.24,0.2273,0.41,0.2537,16,135,151,151,369,151,2,3,1,231,1,728,226789,2,151
2011-12-28,spring,2011,December,20,Wednesday,Workingday,Clear,0.24,0.2273,0.41,0.2239,9,70,79,79,369,79,2,2,1,221,1,728,164550,2,79
2011-12-28,spring,2011,December,21,Wednesday,Workingday,Clear,0.22,0.2273,0.44,0.1343,7,63,70,70,369,70,2,2,1,221,1,728,125445,2,70
2011-12-28,spring,2011,December,22,Wednesday,Workingday,Clear,0.22,0.2424,0.44,0.1045,2,31,33,33,369,33,2,1,1,211,1,728,95612,2,33
2011-12-28,spring,2011,December,23,Wednesday,Workingday,Clear,0.22,0.2121,0.44,0.2537,3,36,39,39,369,39,2,1,1,211,1,728,63941,2,39
2011-12-29,spring,2011,December,0,Thursday,Workingday,Mist,0.22,0.2273,0.47,0.194,4,24,28,28,368,28,2,1,1,211,1,726,39130,2,28
2011-12-29,spring,2011,December,1,Thursday,Workingday,Clear,0.22,0.2121,0.47,0.2239,0,15,15,15,368,15,2,1,1,211,1,724,24164,2,15
2011-12-29,spring,2011,December,2,Thursday,Workingday,Clear,0.2,0.2273,0.51,0.1045,0,3,3,3,368,3,2,1,1,211,1,715,16352,2,3
2011-12-29,spring,2011,December,3,Thursday,Workingday,Clear,0.2,0.197,0.55,0.194,0,2,2,2,368,2,2,1,1,211,1,697,8174,2,2
2011-12-29,spring,2011,December,4,Thursday,Workingday,Clear,0.2,0.2121,0.55,0.1642,1,2,3,3,368,3,2,1,1,211,1,697,4428,2,3
2011-12-29,spring,2011,December,5,Thursday,Workingday,Clear,0.2,0.2273,0.55,0.1045,0,10,10,10,368,10,2,1,1,211,1,717,14261,2,10
2011-12-29,spring,2011,December,6,Thursday,Workingday,Clear,0.2,0.2576,0.59,0.0,2,39,41,41,368,41,2,2,1,221,1,725,55132,2,41
2011-12-29,spring,2011,December,7,Thursday,Workingday,Clear,0.18,0.2121,0.64,0.0896,2,104,106,106,368,106,2,2,1,221,1,727,154171,2,106
2011-12-29,spring,2011,December,8,Thursday,Workingday,Mist,0.2,0.2576,0.64,0.0,3,207,210,210,368,210,2,3,1,231,1,727,261001,2,210
2011-12-29,spring,2011,December,9,Thursday,Workingday,Mist,0.2,0.2121,0.64,0.1343,15,155,170,170,368,170,2,3,1,231,1,727,159438,2,170
2011-12-29,spring,2011,December,10,Thursday,Workingday,Mist,0.22,0.2273,0.64,0.1642,13,97,110,110,368,110,2,2,1,221,1,727,126257,2,110
2011-12-29,spring,2011,December,11,Thursday,Workingday,Mist,0.24,0.2576,0.6,0.0896,23,99,122,122,368,122,2,2,1,221,1,727,151320,2,122
2011-12-29,spring,2011,December,12,Thursday,Workingday,Mist,0.26,0.2727,0.56,0.1045,12,118,130,130,368,130,2,2,1,221,1,728,184414,2,130
2011-12-29,spring,2011,December,13,Thursday,Workingday,Mist,0.28,0.2879,0.52,0.1045,36,95,131,131,368,131,2,2,1,221,1,729,184919,2,131
2011-12-29,spring,2011,December,14,Thursday,Workingday,Mist,0.3,0.3333,0.52,0.0,30,112,142,142,368,142,2,2,1,221,1,729,175652,2,142
2011-12-29,spring,2011,December,15,Thursday,Workingday,Mist,0.3,0.3182,0.52,0.0896,27,150,177,177,368,177,2,3,1,231,1,729,183149,2,177
2011-12-29,spring,2011,December,16,Thursday,Workingday,Clear,0.3,0.303,0.52,0.1642,22,155,177,177,368,177,2,3,1,231,1,730,227748,2,177
2011-12-29,spring,2011,December,17,Thursday,Workingday,Clear,0.3,0.303,0.61,0.1642,14,226,240,240,368,240,2,3,1,231,1,730,336860,2,240
2011-12-29,spring,2011,December,18,Thursday,Workingday,Clear,0.3,0.303,0.56,0.1343,15,192,207,207,368,207,2,3,1,231,1,728,309772,2,207
2011-12-29,spring,2011,December,19,Thursday,Workingday,Clear,0.3,0.3182,0.56,0.1045,11,124,135,135,368,135,2,2,1,221,1,728,226789,2,135
2011-12-29,spring,2011,December,20,Thursday,Workingday,Clear,0.28,0.2879,0.65,0.1045,8,88,96,96,368,96,2,2,1,221,1,728,164550,2,96
2011-12-29,spring,2011,December,21,Thursday,Workingday,Mist,0.28,0.2879,0.61,0.1343,8,60,68,68,368,68,2,2,1,221,1,728,125445,2,68
2011-12-29,spring,2011,December,22,Thursday,Workingday,Clear,0.28,0.2879,0.65,0.1343,7,48,55,55,368,55,2,2,1,221,1,728,95612,2,55
2011-12-29,spring,2011,December,23,Thursday,Workingday,Clear,0.3,0.303,0.65,0.1642,1,44,45,45,368,45,2,2,1,221,1,728,63941,2,45
2011-12-30,spring,2011,December,0,Friday,Workingday,Clear,0.28,0.2879,0.7,0.1343,4,26,30,30,367,30,2,1,1,211,1,726,39130,2,30
2011-12-30,spring,2011,December,1,Friday,Workingday,Clear,0.26,0.2879,0.65,0.0896,9,11,20,20,367,20,2,1,1,211,1,724,24164,2,20
2011-12-30,spring,2011,December,2,Friday,Workingday,Clear,0.24,0.2576,0.7,0.1045,2,10,12,12,367,12,2,1,1,211,1,715,16352,2,12
2011-12-30,spring,2011,December,3,Friday,Workingday,Clear,0.24,0.2576,0.7,0.1045,0,6,6,6,367,6,2,1,1,211,1,697,8174,2,6
2011-12-30,spring,2011,December,4,Friday,Workingday,Clear,0.24,0.2576,0.7,0.0896,0,2,2,2,367,2,2,1,1,211,1,697,4428,2,2
2011-12-30,spring,2011,December,5,Friday,Workingday,Clear,0.22,0.2576,0.75,0.0896,0,10,10,10,367,10,2,1,1,211,1,717,14261,2,10
2011-12-30,spring,2011,December,6,Friday,Workingday,Clear,0.24,0.2576,0.7,0.0896,1,31,32,32,367,32,2,1,1,211,1,725,55132,2,32
2011-12-30,spring,2011,December,7,Friday,Workingday,Clear,0.24,0.2576,0.75,0.0896,3,92,95,95,367,95,2,2,1,221,1,727,154171,2,95
2011-12-30,spring,2011,December,8,Friday,Workingday,Mist,0.24,0.2576,0.75,0.0896,12,193,205,205,367,205,2,3,1,231,1,727,261001,2,205
2011-12-30,spring,2011,December,9,Friday,Workingday,Clear,0.26,0.303,0.75,0.0,19,175,194,194,367,194,2,3,1,231,1,727,159438,2,194
2011-12-30,spring,2011,December,10,Friday,Workingday,Clear,0.3,0.2879,0.65,0.2537,10,108,118,118,367,118,2,2,1,221,1,727,126257,2,118
2011-12-30,spring,2011,December,11,Friday,Workingday,Clear,0.32,0.3182,0.66,0.194,45,126,171,171,367,171,2,3,1,231,1,727,151320,2,171
2011-12-30,spring,2011,December,12,Friday,Workingday,Clear,0.32,0.3333,0.57,0.1343,38,159,197,197,367,197,2,3,1,231,1,728,184414,2,197
2011-12-30,spring,2011,December,13,Friday,Workingday,Mist,0.36,0.3485,0.53,0.1343,53,154,207,207,367,207,2,3,2,232,1,729,184919,2,207
2011-12-30,spring,2011,December,14,Friday,Workingday,Mist,0.4,0.4091,0.47,0.0896,67,178,245,245,367,245,2,3,2,232,1,729,175652,2,245
2011-12-30,spring,2011,December,15,Friday,Workingday,Clear,0.42,0.4242,0.44,0.0,56,236,292,292,367,292,2,4,2,242,1,729,183149,2,292
2011-12-30,spring,2011,December,16,Friday,Workingday,Clear,0.42,0.4242,0.47,0.194,36,247,283,283,367,283,2,4,2,242,1,730,227748,2,283
2011-12-30,spring,2011,December,17,Friday,Workingday,Clear,0.38,0.3939,0.54,0.1642,54,188,242,242,367,242,2,3,2,232,1,730,336860,2,242
2011-12-30,spring,2011,December,18,Friday,Workingday,Clear,0.36,0.3485,0.62,0.1343,19,163,182,182,367,182,2,3,2,232,1,728,309772,2,182
2011-12-30,spring,2011,December,19,Friday,Workingday,Mist,0.34,0.303,0.49,0.4179,16,96,112,112,367,112,2,2,1,221,1,728,226789,2,112
2011-12-30,spring,2011,December,20,Friday,Workingday,Mist,0.34,0.3485,0.66,0.1045,16,75,91,91,367,91,2,2,2,222,1,728,164550,2,91
2011-12-30,spring,2011,December,21,Friday,Workingday,Mist,0.36,0.3636,0.66,0.1045,11,84,95,95,367,95,2,2,2,222,1,728,125445,2,95
2011-12-30,spring,2011,December,22,Friday,Workingday,Mist,0.34,0.3333,0.71,0.1642,7,78,85,85,367,85,2,2,1,221,1,728,95612,2,85
2011-12-30,spring,2011,December,23,Friday,Workingday,Mist,0.36,0.3333,0.66,0.2537,13,60,73,73,367,73,2,2,1,221,1,728,63941,2,73
2011-12-31,spring,2011,December,0,Saturday,Holiday,Mist,0.38,0.3939,0.62,0.3284,7,37,44,44,366,44,2,2,2,222,1,726,39130,2,44
2011-12-31,spring,2011,December,1,Saturday,Holiday,Mist,0.4,0.4091,0.62,0.2836,4,31,35,35,366,35,2,1,2,212,1,724,24164,2,35
2011-12-31,spring,2011,December,2,Saturday,Holiday,Mist,0.4,0.4091,0.62,0.2836,1,27,28,28,366,28,2,1,2,212,1,715,16352,2,28
2011-12-31,spring,2011,December,3,Saturday,Holiday,Mist,0.4,0.4091,0.62,0.2836,1,17,18,18,366,18,2,1,2,212,1,697,8174,2,18
2011-12-31,spring,2011,December,4,Saturday,Holiday,Clear,0.38,0.3939,0.71,0.2239,1,9,10,10,366,10,2,1,2,212,1,697,4428,2,10
2011-12-31,spring,2011,December,5,Saturday,Holiday,Mist,0.36,0.3485,0.76,0.2239,1,0,1,1,366,1,2,1,2,212,1,717,14261,2,1
2011-12-31,spring,2011,December,6,Saturday,Holiday,Mist,0.4,0.4091,0.71,0.0896,1,5,6,6,366,6,2,1,2,212,0,725,55132,2,6
2011-12-31,spring,2011,December,7,Saturday,Holiday,Light Snow,0.38,0.3939,0.76,0.0,6,13,19,19,366,19,2,1,2,212,0,727,154171,2,19
2011-12-31,spring,2011,December,8,Saturday,Holiday,Clear,0.34,0.3333,0.81,0.1343,7,42,49,49,366,49,2,2,1,221,1,727,261001,2,49
2011-12-31,spring,2011,December,9,Saturday,Holiday,Clear,0.38,0.3939,0.76,0.0,18,72,90,90,366,90,2,2,2,222,0,727,159438,2,90
2011-12-31,spring,2011,December,10,Saturday,Holiday,Clear,0.4,0.4091,0.76,0.1642,20,108,128,128,366,128,2,2,2,222,0,727,126257,2,128
2011-12-31,spring,2011,December,11,Saturday,Holiday,Clear,0.42,0.4242,0.71,0.1642,65,152,217,217,366,217,2,3,2,232,0,727,151320,2,217
2011-12-31,spring,2011,December,12,Saturday,Holiday,Clear,0.52,0.5,0.39,0.2985,93,180,273,273,366,273,2,3,3,233,2,728,184414,2,273
2011-12-31,spring,2011,December,13,Saturday,Holiday,Clear,0.5,0.4848,0.42,0.4925,108,205,313,313,366,313,2,4,2,242,2,729,184919,2,313
2011-12-31,spring,2011,December,14,Saturday,Holiday,Clear,0.46,0.4545,0.51,0.3284,115,185,300,300,366,300,2,4,2,242,2,729,175652,2,300
2011-12-31,spring,2011,December,15,Saturday,Holiday,Clear,0.46,0.4545,0.47,0.4925,89,164,253,253,366,253,2,3,2,232,2,729,183149,2,253
2011-12-31,spring,2011,December,16,Saturday,Holiday,Clear,0.44,0.4394,0.51,0.3881,52,143,195,195,366,195,2,3,2,232,1,730,227748,2,195
2011-12-31,spring,2011,December,17,Saturday,Holiday,Clear,0.42,0.4242,0.54,0.194,28,101,129,129,366,129,2,2,2,222,1,730,336860,2,129
2011-12-31,spring,2011,December,18,Saturday,Holiday,Clear,0.42,0.4242,0.54,0.1343,13,80,93,93,366,93,2,2,2,222,1,728,309772,2,93
2011-12-31,spring,2011,December,19,Saturday,Holiday,Clear,0.42,0.4242,0.54,0.2239,19,73,92,92,366,92,2,2,2,222,1,728,226789,2,92
2011-12-31,spring,2011,December,20,Saturday,Holiday,Clear,0.42,0.4242,0.54,0.2239,8,63,71,71,366,71,2,2,2,222,1,728,164550,2,71
2011-12-31,spring,2011,December,21,Saturday,Holiday,Clear,0.4,0.4091,0.58,0.194,2,50,52,52,366,52,2,2,2,222,1,728,125445,2,52
2011-12-31,spring,2011,December,22,Saturday,Holiday,Clear,0.38,0.3939,0.62,0.1343,2,36,38,38,366,38,2,1,2,212,1,728,95612,2,38
2011-12-31,spring,2011,December,23,Saturday,Holiday,Clear,0.36,0.3788,0.66,0.0,4,27,31,31,366,31,2,1,2,212,1,728,63941,2,31
2012-01-01,spring,2012,January,0,Sunday,Holiday,Clear,0.36,0.3788,0.66,0.0,5,43,48,48,365,48,2,2,2,222,1,726,39130,2,48
2012-01-01,spring,2012,January,1,Sunday,Holiday,Clear,0.36,0.3485,0.66,0.1343,15,78,93,93,365,93,2,2,2,222,1,724,24164,2,93
2012-01-01,spring,2012,January,2,Sunday,Holiday,Clear,0.32,0.3485,0.76,0.0,16,59,75,75,365,75,2,2,2,222,1,715,16352,2,75
2012-01-01,spring,2012,January,3,Sunday,Holiday,Clear,0.3,0.3333,0.81,0.0,11,41,52,52,365,52,2,2,1,221,1,697,8174,2,52
2012-01-01,spring,2012,January,4,Sunday,Holiday,Clear,0.28,0.303,0.81,0.0896,0,8,8,8,365,8,2,1,1,211,1,697,4428,2,8
2012-01-01,spring,2012,January,5,Sunday,Holiday,Clear,0.28,0.2879,0.81,0.1045,0,5,5,5,365,5,2,1,1,211,1,717,14261,2,5
2012-01-01,spring,2012,January,6,Sunday,Holiday,Clear,0.26,0.2727,0.93,0.1343,1,1,2,2,365,2,2,1,1,211,1,725,55132,2,2
2012-01-01,spring,2012,January,7,Sunday,Holiday,Clear,0.26,0.2576,0.93,0.1642,1,6,7,7,365,7,2,1,1,211,1,727,154171,2,7
2012-01-01,spring,2012,January,8,Sunday,Holiday,Clear,0.26,0.2727,0.87,0.1045,4,10,14,14,365,14,2,1,1,211,1,727,261001,2,14
2012-01-01,spring,2012,January,9,Sunday,Holiday,Clear,0.26,0.2727,0.93,0.1045,13,27,40,40,365,40,2,1,1,211,1,727,159438,2,40
2012-01-01,spring,2012,January,10,Sunday,Holiday,Clear,0.3,0.3182,0.81,0.1045,18,52,70,70,365,70,2,2,1,221,1,727,126257,2,70
2012-01-01,spring,2012,January,11,Sunday,Holiday,Clear,0.34,0.3333,0.76,0.1343,40,98,138,138,365,138,2,2,1,221,1,727,151320,2,138
2012-01-01,spring,2012,January,12,Sunday,Holiday,Clear,0.4,0.4091,0.62,0.2836,58,143,201,201,365,201,2,3,2,232,1,728,184414,2,201
2012-01-01,spring,2012,January,13,Sunday,Holiday,Clear,0.42,0.4242,0.58,0.2836,82,141,223,223,365,223,2,3,2,232,1,729,184919,2,223
2012-01-01,spring,2012,January,14,Sunday,Holiday,Clear,0.44,0.4394,0.54,0.2985,120,147,267,267,365,267,2,3,2,232,2,729,175652,2,267
2012-01-01,spring,2012,January,15,Sunday,Holiday,Clear,0.46,0.4545,0.51,0.2985,101,164,265,265,365,265,2,3,2,232,2,729,183149,2,265
2012-01-01,spring,2012,January,16,Sunday,Holiday,Mist,0.44,0.4394,0.54,0.2985,68,147,215,215,365,215,2,3,2,232,1,730,227748,2,215
2012-01-01,spring,2012,January,17,Sunday,Holiday,Mist,0.48,0.4697,0.48,0.1642,36,75,111,111,365,111,2,2,2,222,1,730,336860,2,111
2012-01-01,spring,2012,January,18,Sunday,Holiday,Light Snow,0.46,0.4545,0.59,0.2537,25,81,106,106,365,106,2,2,2,222,1,728,309772,2,106
2012-01-01,spring,2012,January,19,Sunday,Holiday,Light Snow,0.42,0.4242,0.67,0.3881,20,85,105,105,365,105,2,2,2,222,1,728,226789,2,105
2012-01-01,spring,2012,January,20,Sunday,Holiday,Mist,0.44,0.4394,0.62,0.2985,25,58,83,83,365,83,2,2,2,222,1,728,164550,2,83
2012-01-01,spring,2012,January,21,Sunday,Holiday,Mist,0.44,0.4394,0.67,0.2537,10,61,71,71,365,71,2,2,2,222,1,728,125445,2,71
2012-01-01,spring,2012,January,22,Sunday,Holiday,Clear,0.46,0.4545,0.55,0.4179,13,53,66,66,365,66,2,2,2,222,1,728,95612,2,66
2012-01-01,spring,2012,January,23,Sunday,Holiday,Clear,0.44,0.4394,0.51,0.2985,4,25,29,29,365,29,2,1,2,212,1,728,63941,2,29
2012-01-02,spring,2012,January,0,Monday,Holiday,Clear,0.4,0.4091,0.4,0.4627,8,31,39,39,364,39,3,1,2,312,1,726,39130,3,39
2012-01-02,spring,2012,January,1,Monday,Holiday,Clear,0.36,0.3333,0.43,0.4179,1,11,12,12,364,12,3,1,1,311,1,724,24164,3,12
2012-01-02,spring,2012,January,2,Monday,Holiday,Clear,0.36,0.3182,0.34,0.4478,1,6,7,7,364,7,3,1,1,311,1,715,16352,3,7
2012-01-02,spring,2012,January,4,Monday,Holiday,Clear,0.28,0.2576,0.45,0.3284,0,4,4,4,364,4,3,1,1,311,1,697,4428,3,4
2012-01-02,spring,2012,January,5,Monday,Holiday,Clear,0.28,0.2576,0.45,0.3284,1,3,4,4,364,4,3,1,1,311,1,717,14261,3,4
2012-01-02,spring,2012,January,6,Monday,Holiday,Clear,0.26,0.2273,0.41,0.3881,0,14,14,14,364,14,3,1,1,311,1,725,55132,3,14
2012-01-02,spring,2012,January,7,Monday,Holiday,Clear,0.24,0.2121,0.32,0.3881,0,16,16,16,364,16,3,1,1,311,1,727,154171,3,16
2012-01-02,spring,2012,January,8,Monday,Holiday,Clear,0.24,0.2273,0.35,0.2537,2,51,53,53,364,53,3,2,1,321,1,727,261001,3,53
2012-01-02,spring,2012,January,9,Monday,Holiday,Clear,0.24,0.2576,0.35,0.0,15,53,68,68,364,68,3,2,1,321,1,727,159438,3,68
2012-01-02,spring,2012,January,10,Monday,Holiday,Clear,0.26,0.2424,0.35,0.2836,20,89,109,109,364,109,3,2,1,321,1,727,126257,3,109
2012-01-02,spring,2012,January,11,Monday,Holiday,Clear,0.26,0.2121,0.35,0.4925,33,142,175,175,364,175,3,3,1,331,1,727,151320,3,175
2012-01-02,spring,2012,January,12,Monday,Holiday,Clear,0.28,0.2727,0.36,0.2537,41,161,202,202,364,202,3,3,1,331,1,728,184414,3,202
2012-01-02,spring,2012,January,13,Monday,Holiday,Clear,0.3,0.2727,0.36,0.2985,26,150,176,176,364,176,3,3,1,331,1,729,184919,3,176
2012-01-02,spring,2012,January,14,Monday,Holiday,Clear,0.3,0.2727,0.36,0.4179,10,141,151,151,364,151,3,3,1,331,1,729,175652,3,151
2012-01-02,spring,2012,January,15,Monday,Holiday,Clear,0.28,0.2424,0.38,0.4478,29,139,168,168,364,168,3,3,1,331,1,729,183149,3,168
2012-01-02,spring,2012,January,16,Monday,Holiday,Clear,0.26,0.2273,0.35,0.4179,10,144,154,154,364,154,3,3,1,331,1,730,227748,3,154
2012-01-02,spring,2012,January,17,Monday,Holiday,Clear,0.26,0.2273,0.35,0.3881,17,136,153,153,364,153,3,3,1,331,1,730,336860,3,153
2012-01-02,spring,2012,January,18,Monday,Holiday,Clear,0.26,0.2424,0.33,0.2537,13,113,126,126,364,126,3,2,1,321,1,728,309772,3,126
2012-01-02,spring,2012,January,19,Monday,Holiday,Clear,0.24,0.2273,0.38,0.2239,4,89,93,93,364,93,3,2,1,321,1,728,226789,3,93
2012-01-02,spring,2012,January,20,Monday,Holiday,Clear,0.24,0.2273,0.41,0.2239,5,83,88,88,364,88,3,2,1,321,1,728,164550,3,88
2012-01-02,spring,2012,January,21,Monday,Holiday,Mist,0.24,0.2121,0.41,0.3284,3,63,66,66,364,66,3,2,1,321,1,728,125445,3,66
2012-01-02,spring,2012,January,22,Monday,Holiday,Mist,0.22,0.2121,0.44,0.2836,3,36,39,39,364,39,3,1,1,311,1,728,95612,3,39
2012-01-02,spring,2012,January,23,Monday,Holiday,Clear,0.22,0.2121,0.44,0.2537,2,32,34,34,364,34,3,1,1,311,1,728,63941,3,34
2012-01-03,spring,2012,January,0,Tuesday,Workingday,Clear,0.2,0.197,0.51,0.2537,0,13,13,13,363,13,3,1,1,311,1,726,39130,3,13
2012-01-03,spring,2012,January,1,Tuesday,Workingday,Clear,0.18,0.1818,0.55,0.2239,1,5,6,6,363,6,3,1,1,311,1,724,24164,3,6
2012-01-03,spring,2012,January,2,Tuesday,Workingday,Clear,0.18,0.1667,0.51,0.2537,0,3,3,3,363,3,3,1,1,311,1,715,16352,3,3
2012-01-03,spring,2012,January,3,Tuesday,Workingday,Clear,0.16,0.1364,0.55,0.2836,0,2,2,2,363,2,3,1,1,311,1,697,8174,3,2
2012-01-03,spring,2012,January,4,Tuesday,Workingday,Clear,0.16,0.1515,0.55,0.2537,0,5,5,5,363,5,3,1,1,311,1,697,4428,3,5
2012-01-03,spring,2012,January,5,Tuesday,Workingday,Clear,0.14,0.1364,0.54,0.194,0,12,12,12,363,12,3,1,1,311,1,717,14261,3,12
2012-01-03,spring,2012,January,6,Tuesday,Workingday,Clear,0.14,0.1212,0.59,0.2836,4,81,85,85,363,85,3,2,1,321,1,725,55132,3,85
2012-01-03,spring,2012,January,7,Tuesday,Workingday,Clear,0.14,0.1212,0.59,0.2537,2,168,170,170,363,170,3,3,1,331,1,727,154171,3,170
2012-01-03,spring,2012,January,8,Tuesday,Workingday,Clear,0.16,0.1364,0.55,0.2836,5,349,354,354,363,354,3,4,1,341,1,727,261001,3,354
2012-01-03,spring,2012,January,9,Tuesday,Workingday,Clear,0.16,0.1364,0.5,0.2836,8,145,153,153,363,153,3,3,1,331,1,727,159438,3,153
2012-01-03,spring,2012,January,10,Tuesday,Workingday,Clear,0.16,0.1212,0.47,0.4627,5,55,60,60,363,60,3,2,1,321,1,727,126257,3,60
2012-01-03,spring,2012,January,11,Tuesday,Workingday,Clear,0.18,0.1364,0.37,0.5224,12,63,75,75,363,75,3,2,1,321,1,727,151320,3,75
2012-01-03,spring,2012,January,12,Tuesday,Workingday,Clear,0.18,0.1364,0.37,0.5224,4,70,74,74,363,74,3,2,1,321,1,728,184414,3,74
2012-01-03,spring,2012,January,13,Tuesday,Workingday,Clear,0.18,0.1212,0.34,0.6567,5,68,73,73,363,73,3,2,1,321,1,729,184919,3,73
2012-01-03,spring,2012,January,14,Tuesday,Workingday,Clear,0.16,0.1212,0.43,0.5224,7,72,79,79,363,79,3,2,1,321,1,729,175652,3,79
2012-01-03,spring,2012,January,15,Tuesday,Workingday,Clear,0.16,0.1212,0.37,0.4179,9,68,77,77,363,77,3,2,1,321,1,729,183149,3,77
2012-01-03,spring,2012,January,16,Tuesday,Workingday,Clear,0.14,0.0909,0.39,0.5821,7,129,136,136,363,136,3,2,1,321,1,730,227748,3,136
2012-01-03,spring,2012,January,17,Tuesday,Workingday,Clear,0.14,0.1061,0.26,0.4627,4,241,245,245,363,245,3,3,1,331,1,730,336860,3,245
2012-01-03,spring,2012,January,18,Tuesday,Workingday,Clear,0.14,0.0909,0.26,0.5224,10,214,224,224,363,224,3,3,1,331,1,728,309772,3,224
2012-01-03,spring,2012,January,19,Tuesday,Workingday,Clear,0.12,0.0909,0.28,0.4179,4,152,156,156,363,156,3,3,1,331,1,728,226789,3,156
2012-01-03,spring,2012,January,20,Tuesday,Workingday,Clear,0.12,0.1212,0.33,0.2537,0,115,115,115,363,115,3,2,1,321,1,728,164550,3,115
2012-01-03,spring,2012,January,21,Tuesday,Workingday,Clear,0.1,0.1061,0.36,0.2239,2,66,68,68,363,68,3,2,1,321,1,728,125445,3,68
2012-01-03,spring,2012,January,22,Tuesday,Workingday,Clear,0.1,0.1061,0.46,0.2537,0,33,33,33,363,33,3,1,1,311,1,728,95612,3,33
2012-01-03,spring,2012,January,23,Tuesday,Workingday,Clear,0.1,0.0758,0.46,0.3881,0,18,18,18,363,18,3,1,1,311,1,728,63941,3,18
2012-01-04,spring,2012,January,0,Wednesday,Workingday,Clear,0.08,0.0606,0.42,0.3284,0,9,9,9,362,9,3,1,1,311,1,726,39130,3,9
2012-01-04,spring,2012,January,1,Wednesday,Workingday,Clear,0.04,0.0303,0.38,0.2985,0,3,3,3,362,3,3,1,1,311,1,724,24164,3,3
2012-01-04,spring,2012,January,2,Wednesday,Workingday,Clear,0.02,0.0152,0.34,0.2836,0,1,1,1,362,1,3,1,1,311,1,715,16352,3,1
2012-01-04,spring,2012,January,3,Wednesday,Workingday,Clear,0.02,0.0152,0.34,0.2836,0,1,1,1,362,1,3,1,1,311,1,697,8174,3,1
2012-01-04,spring,2012,January,4,Wednesday,Workingday,Clear,0.02,0.0455,0.41,0.194,0,2,2,2,362,2,3,1,1,311,1,697,4428,3,2
2012-01-04,spring,2012,January,5,Wednesday,Workingday,Clear,0.02,0.0455,0.41,0.194,0,14,14,14,362,14,3,1,1,311,1,717,14261,3,14
2012-01-04,spring,2012,January,6,Wednesday,Workingday,Clear,0.02,0.0455,0.41,0.1642,0,59,59,59,362,59,3,2,1,321,1,725,55132,3,59
2012-01-04,spring,2012,January,7,Wednesday,Workingday,Clear,0.02,0.0455,0.44,0.194,1,151,152,152,362,152,3,3,1,331,1,727,154171,3,152
2012-01-04,spring,2012,January,8,Wednesday,Workingday,Clear,0.02,0.0606,0.44,0.1343,5,310,315,315,362,315,3,4,1,341,1,727,261001,3,315
2012-01-04,spring,2012,January,9,Wednesday,Workingday,Clear,0.04,0.0606,0.45,0.1343,7,173,180,180,362,180,3,3,1,331,1,727,159438,3,180
2012-01-04,spring,2012,January,10,Wednesday,Workingday,Clear,0.06,0.1061,0.45,0.0,7,57,64,64,362,64,3,2,1,321,1,727,126257,3,64
2012-01-04,spring,2012,January,11,Wednesday,Workingday,Mist,0.08,0.1212,0.42,0.0896,6,40,46,46,362,46,3,2,1,321,1,727,151320,3,46
2012-01-04,spring,2012,January,12,Wednesday,Workingday,Mist,0.1,0.1061,0.46,0.194,9,75,84,84,362,84,3,2,1,321,1,728,184414,3,84
2012-01-04,spring,2012,January,13,Wednesday,Workingday,Mist,0.14,0.1212,0.43,0.2537,9,82,91,91,362,91,3,2,1,321,1,729,184919,3,91
2012-01-04,spring,2012,January,14,Wednesday,Workingday,Mist,0.14,0.1212,0.46,0.2537,6,69,75,75,362,75,3,2,1,321,1,729,175652,3,75
2012-01-04,spring,2012,January,15,Wednesday,Workingday,Mist,0.18,0.1515,0.37,0.3284,9,81,90,90,362,90,3,2,1,321,1,729,183149,3,90
2012-01-04,spring,2012,January,16,Wednesday,Workingday,Mist,0.18,0.1667,0.4,0.2836,8,123,131,131,362,131,3,2,1,321,1,730,227748,3,131
2012-01-04,spring,2012,January,17,Wednesday,Workingday,Mist,0.2,0.197,0.4,0.194,9,272,281,281,362,281,3,3,1,331,1,730,336860,3,281
2012-01-04,spring,2012,January,18,Wednesday,Workingday,Mist,0.2,0.2121,0.37,0.1343,9,280,289,289,362,289,3,4,1,341,1,728,309772,3,289
2012-01-04,spring,2012,January,19,Wednesday,Workingday,Mist,0.2,0.2273,0.4,0.1045,2,182,184,184,362,184,3,3,1,331,1,728,226789,3,184
2012-01-04,spring,2012,January,20,Wednesday,Workingday,Mist,0.2,0.197,0.4,0.194,2,121,123,123,362,123,3,2,1,321,1,728,164550,3,123
2012-01-04,spring,2012,January,21,Wednesday,Workingday,Mist,0.2,0.2576,0.44,0.0,2,88,90,90,362,90,3,2,1,321,1,728,125445,3,90
2012-01-04,spring,2012,January,22,Wednesday,Workingday,Mist,0.2,0.2273,0.47,0.0896,4,48,52,52,362,52,3,2,1,321,1,728,95612,3,52
2012-01-04,spring,2012,January,23,Wednesday,Workingday,Mist,0.2,0.2273,0.44,0.1045,0,32,32,32,362,32,3,1,1,311,1,728,63941,3,32
2012-01-05,spring,2012,January,0,Thursday,Workingday,Mist,0.22,0.2273,0.47,0.194,1,13,14,14,361,14,3,1,1,311,1,726,39130,3,14
2012-01-05,spring,2012,January,1,Thursday,Workingday,Clear,0.2,0.2273,0.51,0.0896,0,5,5,5,361,5,3,1,1,311,1,724,24164,3,5
2012-01-05,spring,2012,January,2,Thursday,Workingday,Clear,0.2,0.2273,0.51,0.0896,0,4,4,4,361,4,3,1,1,311,1,715,16352,3,4
2012-01-05,spring,2012,January,3,Thursday,Workingday,Clear,0.2,0.2576,0.61,0.0,0,4,4,4,361,4,3,1,1,311,1,697,8174,3,4
2012-01-05,spring,2012,January,4,Thursday,Workingday,Mist,0.2,0.2273,0.59,0.0896,0,5,5,5,361,5,3,1,1,311,1,697,4428,3,5
2012-01-05,spring,2012,January,5,Thursday,Workingday,Mist,0.2,0.2273,0.59,0.0896,0,26,26,26,361,26,3,1,1,311,1,717,14261,3,26
2012-01-05,spring,2012,January,6,Thursday,Workingday,Mist,0.2,0.2121,0.75,0.1343,0,78,78,78,361,78,3,2,1,321,1,725,55132,3,78
2012-01-05,spring,2012,January,7,Thursday,Workingday,Mist,0.2,0.2273,0.69,0.0896,3,212,215,215,361,215,3,3,1,331,1,727,154171,3,215
2012-01-05,spring,2012,January,8,Thursday,Workingday,Mist,0.2,0.2576,0.75,0.0,11,377,388,388,361,388,3,4,1,341,1,727,261001,3,388
2012-01-05,spring,2012,January,9,Thursday,Workingday,Mist,0.22,0.2727,0.69,0.0,7,220,227,227,361,227,3,3,1,331,1,727,159438,3,227
2012-01-05,spring,2012,January,10,Thursday,Workingday,Mist,0.24,0.2576,0.52,0.0896,5,81,86,86,361,86,3,2,1,321,1,727,126257,3,86
2012-01-05,spring,2012,January,11,Thursday,Workingday,Clear,0.3,0.3333,0.49,0.0,6,78,84,84,361,84,3,2,1,321,1,727,151320,3,84
2012-01-05,spring,2012,January,12,Thursday,Workingday,Clear,0.3,0.2879,0.49,0.2537,6,114,120,120,361,120,3,2,1,321,1,728,184414,3,120
2012-01-05,spring,2012,January,13,Thursday,Workingday,Clear,0.34,0.303,0.42,0.2985,6,112,118,118,361,118,3,2,1,321,1,729,184919,3,118
2012-01-05,spring,2012,January,14,Thursday,Workingday,Clear,0.34,0.3182,0.39,0.2836,13,104,117,117,361,117,3,2,1,321,1,729,175652,3,117
2012-01-05,spring,2012,January,15,Thursday,Workingday,Clear,0.36,0.3333,0.34,0.2836,6,113,119,119,361,119,3,2,1,321,1,729,183149,3,119
2012-01-05,spring,2012,January,16,Thursday,Workingday,Clear,0.36,0.3333,0.34,0.2836,19,178,197,197,361,197,3,3,1,331,1,730,227748,3,197
2012-01-05,spring,2012,January,17,Thursday,Workingday,Mist,0.36,0.3485,0.34,0.194,19,393,412,412,361,412,3,4,2,342,1,730,336860,3,412
2012-01-05,spring,2012,January,18,Thursday,Workingday,Clear,0.34,0.3333,0.36,0.1642,9,374,383,383,361,383,3,4,1,341,1,728,309772,3,383
2012-01-05,spring,2012,January,19,Thursday,Workingday,Clear,0.34,0.3485,0.34,0.0896,10,255,265,265,361,265,3,3,2,332,1,728,226789,3,265
2012-01-05,spring,2012,January,20,Thursday,Workingday,Clear,0.3,0.3333,0.49,0.0,5,172,177,177,361,177,3,3,1,331,1,728,164550,3,177
2012-01-05,spring,2012,January,21,Thursday,Workingday,Clear,0.26,0.2727,0.6,0.1343,9,88,97,97,361,97,3,2,1,321,1,728,125445,3,97
2012-01-05,spring,2012,January,22,Thursday,Workingday,Clear,0.26,0.2576,0.6,0.1642,1,70,71,71,361,71,3,2,1,321,1,728,95612,3,71
2012-01-05,spring,2012,January,23,Thursday,Workingday,Clear,0.24,0.2576,0.7,0.1045,4,56,60,60,361,60,3,2,1,321,1,728,63941,3,60
2012-01-06,spring,2012,January,0,Friday,Workingday,Clear,0.22,0.2576,0.75,0.0896,1,24,25,25,360,25,3,1,1,311,1,726,39130,3,25
2012-01-06,spring,2012,January,1,Friday,Workingday,Clear,0.22,0.2727,0.75,0.0,2,6,8,8,360,8,3,1,1,311,1,724,24164,3,8
2012-01-06,spring,2012,January,2,Friday,Workingday,Clear,0.22,0.2273,0.69,0.1642,2,3,5,5,360,5,3,1,1,311,1,715,16352,3,5
2012-01-06,spring,2012,January,3,Friday,Workingday,Clear,0.22,0.2424,0.69,0.1045,1,3,4,4,360,4,3,1,1,311,1,697,8174,3,4
2012-01-06,spring,2012,January,4,Friday,Workingday,Clear,0.22,0.2273,0.69,0.1343,0,3,3,3,360,3,3,1,1,311,1,697,4428,3,3
2012-01-06,spring,2012,January,5,Friday,Workingday,Mist,0.2,0.2121,0.8,0.1343,0,13,13,13,360,13,3,1,1,311,1,717,14261,3,13
2012-01-06,spring,2012,January,6,Friday,Workingday,Mist,0.22,0.2424,0.73,0.1045,1,69,70,70,360,70,3,2,1,321,1,725,55132,3,70
2012-01-06,spring,2012,January,7,Friday,Workingday,Mist,0.24,0.2879,0.65,0.0,4,201,205,205,360,205,3,3,1,331,1,727,154171,3,205
2012-01-06,spring,2012,January,8,Friday,Workingday,Clear,0.24,0.2424,0.7,0.1343,11,436,447,447,360,447,3,4,1,341,1,727,261001,3,447
2012-01-06,spring,2012,January,9,Friday,Workingday,Clear,0.24,0.2424,0.7,0.1642,4,237,241,241,360,241,3,3,1,331,1,727,159438,3,241
2012-01-06,spring,2012,January,10,Friday,Workingday,Clear,0.26,0.2576,0.65,0.194,14,102,116,116,360,116,3,2,1,321,1,727,126257,3,116
2012-01-06,spring,2012,January,11,Friday,Workingday,Clear,0.3,0.303,0.56,0.1642,8,130,138,138,360,138,3,2,1,321,1,727,151320,3,138
2012-01-06,spring,2012,January,12,Friday,Workingday,Clear,0.36,0.3333,0.5,0.2537,23,168,191,191,360,191,3,3,1,331,1,728,184414,3,191
2012-01-06,spring,2012,January,13,Friday,Workingday,Clear,0.4,0.4091,0.43,0.2836,16,188,204,204,360,204,3,3,2,332,1,729,184919,3,204
2012-01-06,spring,2012,January,14,Friday,Workingday,Clear,0.46,0.4545,0.36,0.194,26,152,178,178,360,178,3,3,2,332,1,729,175652,3,178
2012-01-06,spring,2012,January,15,Friday,Workingday,Clear,0.52,0.5,0.27,0.2537,44,178,222,222,360,222,3,3,3,333,2,729,183149,3,222
2012-01-06,spring,2012,January,16,Friday,Workingday,Clear,0.52,0.5,0.27,0.2836,35,259,294,294,360,294,3,4,3,343,2,730,227748,3,294
2012-01-06,spring,2012,January,17,Friday,Workingday,Clear,0.46,0.4545,0.36,0.2239,20,456,476,476,360,476,3,4,2,342,2,730,336860,3,476
2012-01-06,spring,2012,January,18,Friday,Workingday,Clear,0.5,0.4848,0.29,0.2537,28,391,419,419,360,419,3,4,2,342,2,728,309772,3,419
2012-01-06,spring,2012,January,19,Friday,Workingday,Clear,0.46,0.4545,0.33,0.2836,11,261,272,272,360,272,3,3,2,332,1,728,226789,3,272
2012-01-06,spring,2012,January,20,Friday,Workingday,Clear,0.42,0.4242,0.41,0.194,14,163,177,177,360,177,3,3,2,332,1,728,164550,3,177
2012-01-06,spring,2012,January,21,Friday,Workingday,Clear,0.4,0.4091,0.43,0.2239,17,137,154,154,360,154,3,3,2,332,1,728,125445,3,154
2012-01-06,spring,2012,January,22,Friday,Workingday,Clear,0.36,0.3485,0.5,0.194,12,123,135,135,360,135,3,2,2,322,1,728,95612,3,135
2012-01-06,spring,2012,January,23,Friday,Workingday,Clear,0.36,0.3788,0.5,0.0,13,88,101,101,360,101,3,2,2,322,1,728,63941,3,101
2012-01-07,spring,2012,January,0,Saturday,Holiday,Clear,0.36,0.3485,0.5,0.1642,2,77,79,79,359,79,3,2,2,322,1,726,39130,3,79
2012-01-07,spring,2012,January,1,Saturday,Holiday,Clear,0.38,0.3939,0.46,0.1642,6,56,62,62,359,62,3,2,2,322,1,724,24164,3,62
2012-01-07,spring,2012,January,2,Saturday,Holiday,Clear,0.36,0.3636,0.5,0.1045,2,36,38,38,359,38,3,1,2,312,1,715,16352,3,38
2012-01-07,spring,2012,January,3,Saturday,Holiday,Clear,0.32,0.3333,0.57,0.1045,1,19,20,20,359,20,3,1,1,311,1,697,8174,3,20
2012-01-07,spring,2012,January,4,Saturday,Holiday,Clear,0.32,0.3333,0.57,0.0896,1,9,10,10,359,10,3,1,1,311,1,697,4428,3,10
2012-01-07,spring,2012,January,5,Saturday,Holiday,Clear,0.26,0.2727,0.75,0.1045,2,7,9,9,359,9,3,1,1,311,1,717,14261,3,9
2012-01-07,spring,2012,January,6,Saturday,Holiday,Clear,0.26,0.2727,0.75,0.1045,0,7,7,7,359,7,3,1,1,311,1,725,55132,3,7
2012-01-07,spring,2012,January,7,Saturday,Holiday,Clear,0.22,0.2273,0.87,0.194,0,20,20,20,359,20,3,1,1,311,1,727,154171,3,20
2012-01-07,spring,2012,January,8,Saturday,Holiday,Clear,0.24,0.2576,0.75,0.1045,0,64,64,64,359,64,3,2,1,321,1,727,261001,3,64
2012-01-07,spring,2012,January,9,Saturday,Holiday,Clear,0.22,0.2273,0.8,0.1343,14,116,130,130,359,130,3,2,1,321,1,727,159438,3,130
2012-01-07,spring,2012,January,10,Saturday,Holiday,Clear,0.28,0.303,0.75,0.0896,43,160,203,203,359,203,3,3,1,331,1,727,126257,3,203
2012-01-07,spring,2012,January,11,Saturday,Holiday,Clear,0.34,0.3182,0.57,0.2239,74,250,324,324,359,324,3,4,1,341,1,727,151320,3,324
2012-01-07,spring,2012,January,12,Saturday,Holiday,Clear,0.4,0.4091,0.43,0.2239,100,276,376,376,359,376,3,4,2,342,2,728,184414,3,376
2012-01-07,spring,2012,January,13,Saturday,Holiday,Clear,0.44,0.4394,0.44,0.194,149,296,445,445,359,445,3,4,2,342,2,729,184919,3,445
2012-01-07,spring,2012,January,14,Saturday,Holiday,Clear,0.5,0.4848,0.42,0.2836,156,356,512,512,359,512,3,4,2,342,2,729,175652,3,512
2012-01-07,spring,2012,January,15,Saturday,Holiday,Clear,0.58,0.5455,0.37,0.2985,132,317,449,449,359,449,3,4,3,343,2,729,183149,3,449
2012-01-07,spring,2012,January,16,Saturday,Holiday,Mist,0.56,0.5303,0.37,0.2836,133,268,401,401,359,401,3,4,3,343,2,730,227748,3,401
2012-01-07,spring,2012,January,17,Saturday,Holiday,Mist,0.54,0.5152,0.43,0.1343,87,235,322,322,359,322,3,4,3,343,2,730,336860,3,322
2012-01-07,spring,2012,January,18,Saturday,Holiday,Clear,0.54,0.5152,0.45,0.1343,49,248,297,297,359,297,3,4,3,343,2,728,309772,3,297
2012-01-07,spring,2012,January,19,Saturday,Holiday,Clear,0.52,0.5,0.42,0.1045,44,171,215,215,359,215,3,3,3,333,2,728,226789,3,215
2012-01-07,spring,2012,January,20,Saturday,Holiday,Clear,0.5,0.4848,0.39,0.2537,21,149,170,170,359,170,3,3,2,332,1,728,164550,3,170
2012-01-07,spring,2012,January,21,Saturday,Holiday,Clear,0.44,0.4394,0.44,0.2239,22,118,140,140,359,140,3,2,2,322,1,728,125445,3,140
2012-01-07,spring,2012,January,22,Saturday,Holiday,Clear,0.44,0.4394,0.38,0.2537,16,93,109,109,359,109,3,2,2,322,1,728,95612,3,109
2012-01-07,spring,2012,January,23,Saturday,Holiday,Clear,0.42,0.4242,0.38,0.2239,16,103,119,119,359,119,3,2,2,322,1,728,63941,3,119
2012-01-08,spring,2012,January,0,Sunday,Holiday,Clear,0.38,0.3939,0.4,0.2836,14,77,91,91,358,91,3,2,2,322,1,726,39130,3,91
2012-01-08,spring,2012,January,1,Sunday,Holiday,Clear,0.34,0.3333,0.42,0.194,10,62,72,72,358,72,3,2,1,321,1,724,24164,3,72
2012-01-08,spring,2012,January,2,Sunday,Holiday,Clear,0.36,0.3333,0.37,0.2836,10,57,67,67,358,67,3,2,1,321,1,715,16352,3,67
2012-01-08,spring,2012,January,3,Sunday,Holiday,Clear,0.34,0.3333,0.42,0.1343,6,26,32,32,358,32,3,1,1,311,1,697,8174,3,32
2012-01-08,spring,2012,January,4,Sunday,Holiday,Clear,0.32,0.303,0.49,0.2537,2,4,6,6,358,6,3,1,1,311,1,697,4428,3,6
2012-01-08,spring,2012,January,5,Sunday,Holiday,Mist,0.32,0.3333,0.49,0.1045,0,2,2,2,358,2,3,1,1,311,1,717,14261,3,2
2012-01-08,spring,2012,January,6,Sunday,Holiday,Mist,0.3,0.3333,0.52,0.0,0,2,2,2,358,2,3,1,1,311,1,725,55132,3,2
2012-01-08,spring,2012,January,7,Sunday,Holiday,Mist,0.3,0.3333,0.52,0.0,1,23,24,24,358,24,3,1,1,311,1,727,154171,3,24
2012-01-08,spring,2012,January,8,Sunday,Holiday,Clear,0.3,0.303,0.52,0.1343,4,53,57,57,358,57,3,2,1,321,1,727,261001,3,57
2012-01-08,spring,2012,January,9,Sunday,Holiday,Clear,0.32,0.3333,0.53,0.1343,23,102,125,125,358,125,3,2,1,321,1,727,159438,3,125
2012-01-08,spring,2012,January,10,Sunday,Holiday,Clear,0.34,0.3333,0.49,0.1642,27,181,208,208,358,208,3,3,1,331,1,727,126257,3,208
2012-01-08,spring,2012,January,11,Sunday,Holiday,Clear,0.36,0.3485,0.46,0.2239,55,201,256,256,358,256,3,3,2,332,1,727,151320,3,256
2012-01-08,spring,2012,January,12,Sunday,Holiday,Clear,0.38,0.3939,0.43,0.2239,78,273,351,351,358,351,3,4,2,342,1,728,184414,3,351
2012-01-08,spring,2012,January,13,Sunday,Holiday,Clear,0.4,0.4091,0.37,0.2985,77,266,343,343,358,343,3,4,2,342,2,729,184919,3,343
2012-01-08,spring,2012,January,14,Sunday,Holiday,Clear,0.4,0.4091,0.4,0.194,75,253,328,328,358,328,3,4,2,342,1,729,175652,3,328
2012-01-08,spring,2012,January,15,Sunday,Holiday,Clear,0.4,0.4091,0.37,0.2836,89,241,330,330,358,330,3,4,2,342,2,729,183149,3,330
2012-01-08,spring,2012,January,16,Sunday,Holiday,Clear,0.4,0.4091,0.37,0.2985,58,256,314,314,358,314,3,4,2,342,1,730,227748,3,314
2012-01-08,spring,2012,January,17,Sunday,Holiday,Clear,0.38,0.3939,0.4,0.2239,22,197,219,219,358,219,3,3,2,332,1,730,336860,3,219
2012-01-08,spring,2012,January,18,Sunday,Holiday,Clear,0.34,0.3182,0.46,0.2239,19,162,181,181,358,181,3,3,1,331,1,728,309772,3,181
2012-01-08,spring,2012,January,19,Sunday,Holiday,Clear,0.32,0.3182,0.49,0.194,8,104,112,112,358,112,3,2,1,321,1,728,226789,3,112
2012-01-08,spring,2012,January,20,Sunday,Holiday,Clear,0.3,0.303,0.52,0.1642,7,119,126,126,358,126,3,2,1,321,1,728,164550,3,126
2012-01-08,spring,2012,January,21,Sunday,Holiday,Clear,0.28,0.2727,0.56,0.2239,10,81,91,91,358,91,3,2,1,321,1,728,125445,3,91
2012-01-08,spring,2012,January,22,Sunday,Holiday,Clear,0.26,0.2727,0.6,0.1045,4,54,58,58,358,58,3,2,1,321,1,728,95612,3,58
2012-01-08,spring,2012,January,23,Sunday,Holiday,Clear,0.26,0.2424,0.56,0.2537,0,30,30,30,358,30,3,1,1,311,1,728,63941,3,30
2012-01-09,spring,2012,January,0,Monday,Workingday,Clear,0.24,0.2273,0.6,0.2239,3,12,15,15,357,15,3,1,1,311,1,726,39130,3,15
2012-01-09,spring,2012,January,1,Monday,Workingday,Clear,0.24,0.2424,0.6,0.1343,1,4,5,5,357,5,3,1,1,311,1,724,24164,3,5
2012-01-09,spring,2012,January,2,Monday,Workingday,Clear,0.24,0.2424,0.56,0.1343,2,3,5,5,357,5,3,1,1,311,1,715,16352,3,5
2012-01-09,spring,2012,January,3,Monday,Workingday,Clear,0.24,0.2424,0.52,0.1642,0,3,3,3,357,3,3,1,1,311,1,697,8174,3,3
2012-01-09,spring,2012,January,4,Monday,Workingday,Clear,0.22,0.2424,0.64,0.1045,0,4,4,4,357,4,3,1,1,311,1,697,4428,3,4
2012-01-09,spring,2012,January,5,Monday,Workingday,Mist,0.2,0.2273,0.64,0.0896,0,21,21,21,357,21,3,1,1,311,1,717,14261,3,21
2012-01-09,spring,2012,January,6,Monday,Workingday,Mist,0.22,0.2273,0.6,0.1343,3,85,88,88,357,88,3,2,1,321,1,725,55132,3,88
2012-01-09,spring,2012,January,7,Monday,Workingday,Mist,0.22,0.2424,0.6,0.1045,1,239,240,240,357,240,3,3,1,331,1,727,154171,3,240
2012-01-09,spring,2012,January,8,Monday,Workingday,Mist,0.22,0.2576,0.55,0.0896,13,407,420,420,357,420,3,4,1,341,1,727,261001,3,420
2012-01-09,spring,2012,January,9,Monday,Workingday,Mist,0.22,0.2727,0.64,0.0,9,188,197,197,357,197,3,3,1,331,1,727,159438,3,197
2012-01-09,spring,2012,January,10,Monday,Workingday,Clear,0.24,0.2879,0.6,0.0,13,95,108,108,357,108,3,2,1,321,1,727,126257,3,108
2012-01-09,spring,2012,January,11,Monday,Workingday,Mist,0.26,0.2879,0.56,0.0896,6,82,88,88,357,88,3,2,1,321,1,727,151320,3,88
2012-01-09,spring,2012,January,12,Monday,Workingday,Mist,0.26,0.2727,0.56,0.1045,10,93,103,103,357,103,3,2,1,321,1,728,184414,3,103
2012-01-09,spring,2012,January,13,Monday,Workingday,Mist,0.26,0.2727,0.56,0.1045,3,77,80,80,357,80,3,2,1,321,1,729,184919,3,80
2012-01-09,spring,2012,January,14,Monday,Workingday,Light Snow,0.22,0.2273,0.75,0.1642,5,45,50,50,357,50,3,2,1,321,1,729,175652,3,50
2012-01-09,spring,2012,January,15,Monday,Workingday,Light Snow,0.22,0.2273,0.75,0.1642,5,64,69,69,357,69,3,2,1,321,1,729,183149,3,69
2012-01-09,spring,2012,January,16,Monday,Workingday,Light Snow,0.22,0.2576,0.87,0.0896,3,46,49,49,357,49,3,2,1,321,1,730,227748,3,49
2012-01-09,spring,2012,January,17,Monday,Workingday,Light Snow,0.22,0.2727,0.87,0.0,5,147,152,152,357,152,3,3,1,331,1,730,336860,3,152
2012-01-09,spring,2012,January,18,Monday,Workingday,Heavy Rain,0.2,0.2273,0.86,0.0896,6,158,164,164,357,164,3,3,1,331,1,728,309772,3,164
2012-01-09,spring,2012,January,19,Monday,Workingday,Light Snow,0.2,0.2273,0.93,0.0896,3,187,190,190,357,190,3,3,1,331,1,728,226789,3,190
2012-01-09,spring,2012,January,20,Monday,Workingday,Mist,0.2,0.2273,0.86,0.0896,5,127,132,132,357,132,3,2,1,321,1,728,164550,3,132
2012-01-09,spring,2012,January,21,Monday,Workingday,Mist,0.2,0.2576,0.93,0.0,1,78,79,79,357,79,3,2,1,321,1,728,125445,3,79
2012-01-09,spring,2012,January,22,Monday,Workingday,Mist,0.2,0.2273,0.92,0.1045,8,54,62,62,357,62,3,2,1,321,1,728,95612,3,62
2012-01-09,spring,2012,January,23,Monday,Workingday,Mist,0.22,0.2424,0.87,0.1045,1,51,52,52,357,52,3,2,1,321,1,728,63941,3,52
2012-01-10,spring,2012,January,0,Tuesday,Workingday,Mist,0.22,0.2424,0.87,0.1045,0,14,14,14,356,14,3,1,1,311,1,726,39130,3,14
2012-01-10,spring,2012,January,1,Tuesday,Workingday,Mist,0.22,0.2424,0.93,0.1045,2,3,5,5,356,5,3,1,1,311,1,724,24164,3,5
2012-01-10,spring,2012,January,2,Tuesday,Workingday,Mist,0.22,0.2273,0.87,0.1642,2,2,4,4,356,4,3,1,1,311,1,715,16352,3,4
2012-01-10,spring,2012,January,4,Tuesday,Workingday,Mist,0.2,0.2121,0.86,0.1642,0,4,4,4,356,4,3,1,1,311,1,697,4428,3,4
2012-01-10,spring,2012,January,5,Tuesday,Workingday,Clear,0.4,0.4091,0.47,0.2239,0,23,23,23,356,23,3,1,2,312,1,717,14261,3,23
2012-01-10,spring,2012,January,6,Tuesday,Workingday,Mist,0.18,0.1818,0.93,0.194,0,79,79,79,356,79,3,2,1,321,1,725,55132,3,79
2012-01-10,spring,2012,January,7,Tuesday,Workingday,Mist,0.18,0.197,0.93,0.1642,3,219,222,222,356,222,3,3,1,331,1,727,154171,3,222
2012-01-10,spring,2012,January,8,Tuesday,Workingday,Mist,0.18,0.197,0.93,0.1642,6,465,471,471,356,471,3,4,1,341,1,727,261001,3,471
2012-01-10,spring,2012,January,9,Tuesday,Workingday,Mist,0.18,0.197,0.93,0.1642,11,184,195,195,356,195,3,3,1,331,1,727,159438,3,195
2012-01-10,spring,2012,January,10,Tuesday,Workingday,Mist,0.18,0.197,0.93,0.1642,3,80,83,83,356,83,3,2,1,321,1,727,126257,3,83
2012-01-10,spring,2012,January,11,Tuesday,Workingday,Clear,0.42,0.4242,0.38,0.2985,8,93,101,101,356,101,3,2,2,322,1,727,151320,3,101
2012-01-10,spring,2012,January,12,Tuesday,Workingday,Clear,0.42,0.4242,0.38,0.2985,13,127,140,140,356,140,3,2,2,322,1,728,184414,3,140
2012-01-10,spring,2012,January,13,Tuesday,Workingday,Clear,0.42,0.4242,0.38,0.2985,15,163,178,178,356,178,3,3,2,332,1,729,184919,3,178
2012-01-10,spring,2012,January,14,Tuesday,Workingday,Clear,0.42,0.4242,0.38,0.2985,10,96,106,106,356,106,3,2,2,322,1,729,175652,3,106
2012-01-10,spring,2012,January,15,Tuesday,Workingday,Clear,0.42,0.4242,0.38,0.2985,17,119,136,136,356,136,3,2,2,322,1,729,183149,3,136
2012-01-10,spring,2012,January,16,Tuesday,Workingday,Clear,0.42,0.4242,0.38,0.3582,15,225,240,240,356,240,3,3,2,332,1,730,227748,3,240
2012-01-10,spring,2012,January,17,Tuesday,Workingday,Clear,0.42,0.4242,0.38,0.2537,14,446,460,460,356,460,3,4,2,342,2,730,336860,3,460
2012-01-10,spring,2012,January,18,Tuesday,Workingday,Clear,0.4,0.4091,0.4,0.1045,13,372,385,385,356,385,3,4,2,342,1,728,309772,3,385
2012-01-10,spring,2012,January,19,Tuesday,Workingday,Clear,0.38,0.3939,0.46,0.1045,11,270,281,281,356,281,3,3,2,332,1,728,226789,3,281
2012-01-10,spring,2012,January,20,Tuesday,Workingday,Clear,0.34,0.3485,0.53,0.1045,10,190,200,200,356,200,3,3,2,332,1,728,164550,3,200
2012-01-10,spring,2012,January,21,Tuesday,Workingday,Clear,0.32,0.3333,0.66,0.0896,7,109,116,116,356,116,3,2,1,321,1,728,125445,3,116
2012-01-10,spring,2012,January,22,Tuesday,Workingday,Clear,0.3,0.303,0.7,0.0896,10,104,114,114,356,114,3,2,1,321,1,728,95612,3,114
2012-01-10,spring,2012,January,23,Tuesday,Workingday,Clear,0.26,0.2727,0.81,0.1045,3,38,41,41,356,41,3,2,1,321,1,728,63941,3,41
2012-01-11,spring,2012,January,0,Wednesday,Workingday,Clear,0.26,0.303,0.81,0.0,2,26,28,28,355,28,3,1,1,311,1,726,39130,3,28
2012-01-11,spring,2012,January,1,Wednesday,Workingday,Clear,0.24,0.2576,0.87,0.0896,1,6,7,7,355,7,3,1,1,311,1,724,24164,3,7
2012-01-11,spring,2012,January,2,Wednesday,Workingday,Clear,0.2,0.2121,0.85,0.1642,0,5,5,5,355,5,3,1,1,311,1,715,16352,3,5
2012-01-11,spring,2012,January,3,Wednesday,Workingday,Clear,0.22,0.2727,0.8,0.0,0,4,4,4,355,4,3,1,1,311,1,697,8174,3,4
2012-01-11,spring,2012,January,4,Wednesday,Workingday,Clear,0.2,0.2121,0.8,0.1343,0,2,2,2,355,2,3,1,1,311,1,697,4428,3,2
2012-01-11,spring,2012,January,5,Wednesday,Workingday,Clear,0.2,0.2121,0.8,0.1343,0,22,22,22,355,22,3,1,1,311,1,717,14261,3,22
2012-01-11,spring,2012,January,6,Wednesday,Workingday,Clear,0.2,0.2121,0.86,0.1343,2,72,74,74,355,74,3,2,1,321,1,725,55132,3,74
2012-01-11,spring,2012,January,7,Wednesday,Workingday,Clear,0.2,0.2121,0.8,0.1343,9,247,256,256,355,256,3,3,1,331,1,727,154171,3,256
2012-01-11,spring,2012,January,8,Wednesday,Workingday,Clear,0.2,0.2273,0.82,0.1045,11,488,499,499,355,499,3,4,1,341,1,727,261001,3,499
2012-01-11,spring,2012,January,9,Wednesday,Workingday,Mist,0.2,0.2121,0.86,0.1343,7,218,225,225,355,225,3,3,1,331,1,727,159438,3,225
2012-01-11,spring,2012,January,10,Wednesday,Workingday,Mist,0.24,0.2424,0.87,0.1343,13,84,97,97,355,97,3,2,1,321,1,727,126257,3,97
2012-01-11,spring,2012,January,11,Wednesday,Workingday,Mist,0.26,0.2879,0.87,0.0896,9,90,99,99,355,99,3,2,1,321,1,727,151320,3,99
2012-01-11,spring,2012,January,12,Wednesday,Workingday,Light Snow,0.3,0.3333,0.81,0.0,4,51,55,55,355,55,3,2,1,321,1,728,184414,3,55
2012-01-11,spring,2012,January,13,Wednesday,Workingday,Light Snow,0.32,0.3485,0.76,0.0,8,57,65,65,355,65,3,2,2,322,1,729,184919,3,65
2012-01-11,spring,2012,January,14,Wednesday,Workingday,Light Snow,0.32,0.3333,0.81,0.1045,3,70,73,73,355,73,3,2,1,321,1,729,175652,3,73
2012-01-11,spring,2012,January,15,Wednesday,Workingday,Mist,0.34,0.3485,0.87,0.0896,6,73,79,79,355,79,3,2,2,322,0,729,183149,3,79
2012-01-11,spring,2012,January,16,Wednesday,Workingday,Mist,0.34,0.3182,0.87,0.2537,6,112,118,118,355,118,3,2,1,321,1,730,227748,3,118
2012-01-11,spring,2012,January,17,Wednesday,Workingday,Light Snow,0.34,0.3182,0.87,0.2239,6,128,134,134,355,134,3,2,1,321,1,730,336860,3,134
2012-01-11,spring,2012,January,18,Wednesday,Workingday,Light Snow,0.34,0.3333,0.87,0.194,2,96,98,98,355,98,3,2,1,321,1,728,309772,3,98
2012-01-11,spring,2012,January,19,Wednesday,Workingday,Light Snow,0.32,0.303,0.93,0.2239,1,92,93,93,355,93,3,2,1,321,1,728,226789,3,93
2012-01-11,spring,2012,January,20,Wednesday,Workingday,Light Snow,0.32,0.3182,0.93,0.1642,2,55,57,57,355,57,3,2,1,321,1,728,164550,3,57
2012-01-11,spring,2012,January,21,Wednesday,Workingday,Light Snow,0.34,0.3182,0.87,0.2239,0,29,29,29,355,29,3,1,1,311,1,728,125445,3,29
2012-01-11,spring,2012,January,22,Wednesday,Workingday,Light Snow,0.34,0.3333,0.87,0.194,0,49,49,49,355,49,3,2,1,321,1,728,95612,3,49
2012-01-11,spring,2012,January,23,Wednesday,Workingday,Light Snow,0.34,0.3182,0.87,0.2239,0,9,9,9,355,9,3,1,1,311,1,728,63941,3,9
2012-01-12,spring,2012,January,0,Thursday,Workingday,Light Snow,0.34,0.3333,0.93,0.194,0,3,3,3,354,3,3,1,1,311,1,726,39130,3,3
2012-01-12,spring,2012,January,1,Thursday,Workingday,Light Snow,0.36,0.3485,0.93,0.194,0,3,3,3,354,3,3,1,2,312,0,724,24164,3,3
2012-01-12,spring,2012,January,2,Thursday,Workingday,Light Snow,0.36,0.3485,0.93,0.2537,1,1,2,2,354,2,3,1,2,312,1,715,16352,3,2
2012-01-12,spring,2012,January,3,Thursday,Workingday,Light Snow,0.36,0.3485,0.93,0.2537,0,3,3,3,354,3,3,1,2,312,1,697,8174,3,3
2012-01-12,spring,2012,January,4,Thursday,Workingday,Light Snow,0.36,0.3485,0.93,0.194,0,2,2,2,354,2,3,1,2,312,0,697,4428,3,2
2012-01-12,spring,2012,January,5,Thursday,Workingday,Light Snow,0.34,0.3485,0.93,0.0896,0,16,16,16,354,16,3,1,2,312,0,717,14261,3,16
2012-01-12,spring,2012,January,6,Thursday,Workingday,Light Snow,0.36,0.3485,0.93,0.1343,1,88,89,89,354,89,3,2,2,322,0,725,55132,3,89
2012-01-12,spring,2012,January,7,Thursday,Workingday,Mist,0.34,0.3182,0.87,0.2836,2,218,220,220,354,220,3,3,1,331,1,727,154171,3,220
2012-01-12,spring,2012,January,8,Thursday,Workingday,Clear,0.32,0.3182,0.81,0.194,11,497,508,508,354,508,3,4,1,341,1,727,261001,3,508
2012-01-12,spring,2012,January,9,Thursday,Workingday,Clear,0.32,0.3333,0.81,0.1045,10,220,230,230,354,230,3,3,1,331,1,727,159438,3,230
2012-01-12,spring,2012,January,10,Thursday,Workingday,Clear,0.34,0.3485,0.81,0.1045,6,84,90,90,354,90,3,2,2,322,1,727,126257,3,90
2012-01-12,spring,2012,January,11,Thursday,Workingday,Mist,0.34,0.3485,0.81,0.1045,18,101,119,119,354,119,3,2,2,322,1,727,151320,3,119
2012-01-12,spring,2012,January,12,Thursday,Workingday,Mist,0.34,0.3485,0.81,0.1045,14,130,144,144,354,144,3,3,2,332,1,728,184414,3,144
2012-01-12,spring,2012,January,13,Thursday,Workingday,Clear,0.42,0.4242,0.77,0.1642,13,170,183,183,354,183,3,3,2,332,0,729,184919,3,183
2012-01-12,spring,2012,January,14,Thursday,Workingday,Clear,0.42,0.4242,0.77,0.1642,24,132,156,156,354,156,3,3,2,332,0,729,175652,3,156
2012-01-12,spring,2012,January,15,Thursday,Workingday,Clear,0.44,0.4394,0.72,0.1343,32,156,188,188,354,188,3,3,2,332,0,729,183149,3,188
2012-01-12,spring,2012,January,16,Thursday,Workingday,Clear,0.46,0.4545,0.67,0.194,33,248,281,281,354,281,3,3,2,332,0,730,227748,3,281
2012-01-12,spring,2012,January,17,Thursday,Workingday,Clear,0.46,0.4545,0.63,0.1642,23,472,495,495,354,495,3,4,2,342,2,730,336860,3,495
2012-01-12,spring,2012,January,18,Thursday,Workingday,Clear,0.44,0.4394,0.67,0.194,22,399,421,421,354,421,3,4,2,342,0,728,309772,3,421
2012-01-12,spring,2012,January,19,Thursday,Workingday,Mist,0.42,0.4242,0.71,0.1642,17,313,330,330,354,330,3,4,2,342,0,728,226789,3,330
2012-01-12,spring,2012,January,20,Thursday,Workingday,Mist,0.42,0.4242,0.71,0.194,11,229,240,240,354,240,3,3,2,332,0,728,164550,3,240
2012-01-12,spring,2012,January,21,Thursday,Workingday,Clear,0.44,0.4394,0.67,0.1343,12,162,174,174,354,174,3,3,2,332,0,728,125445,3,174
2012-01-12,spring,2012,January,22,Thursday,Workingday,Clear,0.38,0.3939,0.76,0.2985,12,121,133,133,354,133,3,2,2,322,1,728,95612,3,133
2012-01-12,spring,2012,January,23,Thursday,Workingday,Clear,0.4,0.4091,0.76,0.3284,7,60,67,67,354,67,3,2,2,322,1,728,63941,3,67
2012-01-13,spring,2012,January,0,Friday,Workingday,Mist,0.4,0.4091,0.71,0.2836,4,38,42,42,353,42,3,2,2,322,1,726,39130,3,42
2012-01-13,spring,2012,January,1,Friday,Workingday,Mist,0.38,0.3939,0.76,0.2985,0,12,12,12,353,12,3,1,2,312,1,724,24164,3,12
2012-01-13,spring,2012,January,2,Friday,Workingday,Clear,0.4,0.4091,0.76,0.3582,1,13,14,14,353,14,3,1,2,312,1,715,16352,3,14
2012-01-13,spring,2012,January,3,Friday,Workingday,Clear,0.36,0.3333,0.87,0.2537,3,4,7,7,353,7,3,1,1,311,1,697,8174,3,7
2012-01-13,spring,2012,January,4,Friday,Workingday,Light Snow,0.32,0.2879,0.7,0.4925,1,2,3,3,353,3,3,1,1,311,1,697,4428,3,3
2012-01-13,spring,2012,January,5,Friday,Workingday,Mist,0.3,0.2424,0.7,0.5522,0,21,21,21,353,21,3,1,1,311,1,717,14261,3,21
2012-01-13,spring,2012,January,6,Friday,Workingday,Mist,0.26,0.2576,0.75,0.2239,2,71,73,73,353,73,3,2,1,321,1,725,55132,3,73
2012-01-13,spring,2012,January,7,Friday,Workingday,Clear,0.26,0.2576,0.6,0.2239,3,174,177,177,353,177,3,3,1,331,1,727,154171,3,177
2012-01-13,spring,2012,January,8,Friday,Workingday,Clear,0.24,0.2121,0.52,0.3582,11,408,419,419,353,419,3,4,1,341,1,727,261001,3,419
2012-01-13,spring,2012,January,9,Friday,Workingday,Clear,0.22,0.197,0.47,0.3881,10,204,214,214,353,214,3,3,1,331,1,727,159438,3,214
2012-01-13,spring,2012,January,10,Friday,Workingday,Clear,0.24,0.197,0.44,0.4478,2,101,103,103,353,103,3,2,1,321,1,727,126257,3,103
2012-01-13,spring,2012,January,11,Friday,Workingday,Clear,0.24,0.1818,0.38,0.6119,12,102,114,114,353,114,3,2,1,321,1,727,151320,3,114
2012-01-13,spring,2012,January,12,Friday,Workingday,Clear,0.24,0.197,0.38,0.4925,14,140,154,154,353,154,3,3,1,331,1,728,184414,3,154
2012-01-13,spring,2012,January,13,Friday,Workingday,Clear,0.26,0.2121,0.33,0.5224,14,140,154,154,353,154,3,3,1,331,1,729,184919,3,154
2012-01-13,spring,2012,January,14,Friday,Workingday,Clear,0.26,0.2121,0.33,0.5522,10,119,129,129,353,129,3,2,1,321,1,729,175652,3,129
2012-01-13,spring,2012,January,15,Friday,Workingday,Clear,0.26,0.2121,0.33,0.5821,15,123,138,138,353,138,3,2,1,321,1,729,183149,3,138
2012-01-13,spring,2012,January,16,Friday,Workingday,Clear,0.28,0.2424,0.3,0.4627,18,215,233,233,353,233,3,3,1,331,1,730,227748,3,233
2012-01-13,spring,2012,January,17,Friday,Workingday,Clear,0.28,0.2424,0.33,0.4179,15,317,332,332,353,332,3,4,1,341,1,730,336860,3,332
2012-01-13,spring,2012,January,18,Friday,Workingday,Clear,0.26,0.2273,0.38,0.2985,7,294,301,301,353,301,3,4,1,341,1,728,309772,3,301
2012-01-13,spring,2012,January,19,Friday,Workingday,Clear,0.26,0.2424,0.38,0.2836,7,199,206,206,353,206,3,3,1,331,1,728,226789,3,206
2012-01-13,spring,2012,January,20,Friday,Workingday,Clear,0.24,0.2424,0.41,0.1642,6,130,136,136,353,136,3,2,1,321,1,728,164550,3,136
2012-01-13,spring,2012,January,21,Friday,Workingday,Clear,0.24,0.2121,0.41,0.2836,7,95,102,102,353,102,3,2,1,321,1,728,125445,3,102
2012-01-13,spring,2012,January,22,Friday,Workingday,Clear,0.2,0.1818,0.47,0.3284,7,58,65,65,353,65,3,2,1,321,1,728,95612,3,65
2012-01-13,spring,2012,January,23,Friday,Workingday,Clear,0.18,0.1818,0.47,0.194,5,60,65,65,353,65,3,2,1,321,1,728,63941,3,65
2012-01-14,spring,2012,January,0,Saturday,Holiday,Clear,0.16,0.1818,0.47,0.1045,2,42,44,44,352,44,3,2,1,321,1,726,39130,3,44
2012-01-14,spring,2012,January,1,Saturday,Holiday,Clear,0.16,0.1515,0.47,0.194,6,44,50,50,352,50,3,2,1,321,1,724,24164,3,50
2012-01-14,spring,2012,January,2,Saturday,Holiday,Clear,0.16,0.1667,0.47,0.1642,6,32,38,38,352,38,3,1,1,311,1,715,16352,3,38
2012-01-14,spring,2012,January,3,Saturday,Holiday,Clear,0.14,0.1667,0.54,0.1045,6,14,20,20,352,20,3,1,1,311,1,697,8174,3,20
2012-01-14,spring,2012,January,4,Saturday,Holiday,Clear,0.14,0.1515,0.5,0.1343,0,3,3,3,352,3,3,1,1,311,1,697,4428,3,3
2012-01-14,spring,2012,January,5,Saturday,Holiday,Clear,0.14,0.1515,0.5,0.1343,0,4,4,4,352,4,3,1,1,311,1,717,14261,3,4
2012-01-14,spring,2012,January,6,Saturday,Holiday,Clear,0.14,0.1515,0.5,0.0,0,5,5,5,352,5,3,1,1,311,1,725,55132,3,5
2012-01-14,spring,2012,January,7,Saturday,Holiday,Clear,0.14,0.1515,0.5,0.1343,0,24,24,24,352,24,3,1,1,311,1,727,154171,3,24
2012-01-14,spring,2012,January,8,Saturday,Holiday,Clear,0.12,0.1515,0.54,0.1045,3,89,92,92,352,92,3,2,1,321,1,727,261001,3,92
2012-01-14,spring,2012,January,9,Saturday,Holiday,Clear,0.14,0.1667,0.5,0.1045,3,78,81,81,352,81,3,2,1,321,1,727,159438,3,81
2012-01-14,spring,2012,January,10,Saturday,Holiday,Clear,0.16,0.2273,0.47,0.0,14,135,149,149,352,149,3,3,1,331,1,727,126257,3,149
2012-01-14,spring,2012,January,11,Saturday,Holiday,Clear,0.2,0.197,0.4,0.194,28,150,178,178,352,178,3,3,1,331,1,727,151320,3,178
2012-01-14,spring,2012,January,12,Saturday,Holiday,Clear,0.22,0.2121,0.41,0.2537,30,189,219,219,352,219,3,3,1,331,1,728,184414,3,219
2012-01-14,spring,2012,January,13,Saturday,Holiday,Clear,0.22,0.2121,0.44,0.2836,38,182,220,220,352,220,3,3,1,331,1,729,184919,3,220
2012-01-14,spring,2012,January,14,Saturday,Holiday,Clear,0.24,0.2121,0.41,0.2985,52,179,231,231,352,231,3,3,1,331,1,729,175652,3,231
2012-01-14,spring,2012,January,15,Saturday,Holiday,Clear,0.24,0.2121,0.38,0.2985,49,177,226,226,352,226,3,3,1,331,1,729,183149,3,226
2012-01-14,spring,2012,January,16,Saturday,Holiday,Clear,0.24,0.2273,0.38,0.2239,28,178,206,206,352,206,3,3,1,331,1,730,227748,3,206
2012-01-14,spring,2012,January,17,Saturday,Holiday,Clear,0.24,0.2273,0.41,0.2537,15,129,144,144,352,144,3,3,1,331,1,730,336860,3,144
2012-01-14,spring,2012,January,18,Saturday,Holiday,Clear,0.22,0.2273,0.41,0.194,21,122,143,143,352,143,3,3,1,331,1,728,309772,3,143
2012-01-14,spring,2012,January,19,Saturday,Holiday,Clear,0.2,0.197,0.47,0.2239,12,90,102,102,352,102,3,2,1,321,1,728,226789,3,102
2012-01-14,spring,2012,January,20,Saturday,Holiday,Clear,0.2,0.197,0.44,0.2537,8,95,103,103,352,103,3,2,1,321,1,728,164550,3,103
2012-01-14,spring,2012,January,21,Saturday,Holiday,Clear,0.18,0.1667,0.43,0.2537,3,66,69,69,352,69,3,2,1,321,1,728,125445,3,69
2012-01-14,spring,2012,January,22,Saturday,Holiday,Clear,0.16,0.1364,0.47,0.3582,4,62,66,66,352,66,3,2,1,321,1,728,95612,3,66
2012-01-14,spring,2012,January,23,Saturday,Holiday,Clear,0.16,0.1515,0.47,0.2239,5,71,76,76,352,76,3,2,1,321,1,728,63941,3,76
2012-01-15,spring,2012,January,0,Sunday,Holiday,Clear,0.16,0.1364,0.47,0.3284,9,50,59,59,351,59,3,2,1,321,1,726,39130,3,59
2012-01-15,spring,2012,January,1,Sunday,Holiday,Mist,0.16,0.1364,0.47,0.2985,2,40,42,42,351,42,3,2,1,321,1,724,24164,3,42
2012-01-15,spring,2012,January,2,Sunday,Holiday,Mist,0.16,0.1364,0.47,0.2836,5,38,43,43,351,43,3,2,1,321,1,715,16352,3,43
2012-01-15,spring,2012,January,3,Sunday,Holiday,Mist,0.16,0.1364,0.48,0.3881,1,24,25,25,351,25,3,1,1,311,1,697,8174,3,25
2012-01-15,spring,2012,January,4,Sunday,Holiday,Mist,0.16,0.1364,0.47,0.3881,1,5,6,6,351,6,3,1,1,311,1,697,4428,3,6
2012-01-15,spring,2012,January,5,Sunday,Holiday,Mist,0.16,0.1364,0.47,0.3284,0,5,5,5,351,5,3,1,1,311,1,717,14261,3,5
2012-01-15,spring,2012,January,6,Sunday,Holiday,Mist,0.14,0.1212,0.5,0.2836,1,7,8,8,351,8,3,1,1,311,1,725,55132,3,8
2012-01-15,spring,2012,January,7,Sunday,Holiday,Clear,0.12,0.1212,0.54,0.2836,3,14,17,17,351,17,3,1,1,311,1,727,154171,3,17
2012-01-15,spring,2012,January,8,Sunday,Holiday,Clear,0.12,0.1212,0.54,0.2239,2,34,36,36,351,36,3,1,1,311,1,727,261001,3,36
2012-01-15,spring,2012,January,9,Sunday,Holiday,Clear,0.12,0.1364,0.54,0.194,10,80,90,90,351,90,3,2,1,321,1,727,159438,3,90
2012-01-15,spring,2012,January,10,Sunday,Holiday,Clear,0.14,0.1212,0.54,0.2836,11,115,126,126,351,126,3,2,1,321,1,727,126257,3,126
2012-01-15,spring,2012,January,11,Sunday,Holiday,Clear,0.16,0.1515,0.47,0.2239,21,144,165,165,351,165,3,3,1,331,1,727,151320,3,165
2012-01-15,spring,2012,January,12,Sunday,Holiday,Clear,0.18,0.1667,0.4,0.2985,42,192,234,234,351,234,3,3,1,331,1,728,184414,3,234
2012-01-15,spring,2012,January,13,Sunday,Holiday,Clear,0.2,0.1818,0.34,0.2836,40,184,224,224,351,224,3,3,1,331,1,729,184919,3,224
2012-01-15,spring,2012,January,14,Sunday,Holiday,Clear,0.2,0.1818,0.32,0.3582,25,163,188,188,351,188,3,3,1,331,1,729,175652,3,188
2012-01-15,spring,2012,January,15,Sunday,Holiday,Clear,0.22,0.2273,0.27,0.194,33,173,206,206,351,206,3,3,1,331,1,729,183149,3,206
2012-01-15,spring,2012,January,16,Sunday,Holiday,Clear,0.22,0.2121,0.29,0.2985,31,174,205,205,351,205,3,3,1,331,1,730,227748,3,205
2012-01-15,spring,2012,January,17,Sunday,Holiday,Clear,0.22,0.2121,0.25,0.2537,15,131,146,146,351,146,3,3,1,331,1,730,336860,3,146
2012-01-15,spring,2012,January,18,Sunday,Holiday,Clear,0.18,0.1818,0.29,0.2239,7,113,120,120,351,120,3,2,1,321,1,728,309772,3,120
2012-01-15,spring,2012,January,19,Sunday,Holiday,Clear,0.16,0.1667,0.37,0.1642,9,101,110,110,351,110,3,2,1,321,1,728,226789,3,110
2012-01-15,spring,2012,January,20,Sunday,Holiday,Clear,0.16,0.1818,0.37,0.1045,10,85,95,95,351,95,3,2,1,321,1,728,164550,3,95
2012-01-15,spring,2012,January,21,Sunday,Holiday,Clear,0.16,0.1667,0.4,0.1642,1,71,72,72,351,72,3,2,1,321,1,728,125445,3,72
2012-01-15,spring,2012,January,22,Sunday,Holiday,Clear,0.18,0.2121,0.37,0.0896,2,58,60,60,351,60,3,2,1,321,1,728,95612,3,60
2012-01-15,spring,2012,January,23,Sunday,Holiday,Clear,0.16,0.197,0.43,0.0896,3,26,29,29,351,29,3,1,1,311,1,728,63941,3,29
2012-01-16,spring,2012,January,0,Monday,Holiday,Clear,0.14,0.1515,0.46,0.1343,2,23,25,25,350,25,3,1,1,311,1,726,39130,3,25
2012-01-16,spring,2012,January,1,Monday,Holiday,Clear,0.14,0.1667,0.43,0.1045,2,18,20,20,350,20,3,1,1,311,1,724,24164,3,20
2012-01-16,spring,2012,January,2,Monday,Holiday,Clear,0.14,0.2121,0.46,0.0,3,14,17,17,350,17,3,1,1,311,1,715,16352,3,17
2012-01-16,spring,2012,January,3,Monday,Holiday,Clear,0.12,0.197,0.5,0.0,0,3,3,3,350,3,3,1,1,311,1,697,8174,3,3
2012-01-16,spring,2012,January,4,Monday,Holiday,Clear,0.12,0.1515,0.58,0.1045,2,6,8,8,350,8,3,1,1,311,1,697,4428,3,8
2012-01-16,spring,2012,January,5,Monday,Holiday,Clear,0.12,0.1667,0.54,0.0896,1,5,6,6,350,6,3,1,1,311,1,717,14261,3,6
2012-01-16,spring,2012,January,6,Monday,Holiday,Clear,0.1,0.1364,0.54,0.0896,0,13,13,13,350,13,3,1,1,311,1,725,55132,3,13
2012-01-16,spring,2012,January,7,Monday,Holiday,Clear,0.1,0.1364,0.54,0.1045,5,28,33,33,350,33,3,1,1,311,1,727,154171,3,33
2012-01-16,spring,2012,January,8,Monday,Holiday,Clear,0.1,0.1212,0.58,0.1642,3,75,78,78,350,78,3,2,1,321,1,727,261001,3,78
2012-01-16,spring,2012,January,9,Monday,Holiday,Clear,0.1,0.1212,0.58,0.1642,7,89,96,96,350,96,3,2,1,321,1,727,159438,3,96
2012-01-16,spring,2012,January,10,Monday,Holiday,Mist,0.14,0.1364,0.59,0.194,19,107,126,126,350,126,3,2,1,321,1,727,126257,3,126
2012-01-16,spring,2012,January,11,Monday,Holiday,Clear,0.16,0.1515,0.59,0.2537,21,158,179,179,350,179,3,3,1,331,1,727,151320,3,179
2012-01-16,spring,2012,January,12,Monday,Holiday,Clear,0.2,0.1818,0.55,0.3284,20,165,185,185,350,185,3,3,1,331,1,728,184414,3,185
2012-01-16,spring,2012,January,13,Monday,Holiday,Mist,0.24,0.197,0.41,0.4179,26,202,228,228,350,228,3,3,1,331,1,729,184919,3,228
2012-01-16,spring,2012,January,14,Monday,Holiday,Clear,0.24,0.2121,0.44,0.3881,23,158,181,181,350,181,3,3,1,331,1,729,175652,3,181
2012-01-16,spring,2012,January,15,Monday,Holiday,Clear,0.26,0.2121,0.44,0.4478,17,175,192,192,350,192,3,3,1,331,1,729,183149,3,192
2012-01-16,spring,2012,January,16,Monday,Holiday,Clear,0.26,0.2273,0.44,0.3582,22,158,180,180,350,180,3,3,1,331,1,730,227748,3,180
2012-01-16,spring,2012,January,17,Monday,Holiday,Clear,0.26,0.2273,0.48,0.3284,19,174,193,193,350,193,3,3,1,331,1,730,336860,3,193
2012-01-16,spring,2012,January,18,Monday,Holiday,Clear,0.26,0.2273,0.52,0.3284,6,175,181,181,350,181,3,3,1,331,1,728,309772,3,181
2012-01-16,spring,2012,January,19,Monday,Holiday,Clear,0.26,0.2424,0.56,0.2836,10,134,144,144,350,144,3,3,1,331,1,728,226789,3,144
2012-01-16,spring,2012,January,20,Monday,Holiday,Clear,0.26,0.2424,0.6,0.2836,2,88,90,90,350,90,3,2,1,321,1,728,164550,3,90
2012-01-16,spring,2012,January,21,Monday,Holiday,Clear,0.28,0.2576,0.52,0.3284,3,46,49,49,350,49,3,2,1,321,1,728,125445,3,49
2012-01-16,spring,2012,January,22,Monday,Holiday,Mist,0.3,0.2727,0.49,0.3582,4,39,43,43,350,43,3,2,1,321,1,728,95612,3,43
2012-01-16,spring,2012,January,23,Monday,Holiday,Light Snow,0.26,0.2273,0.7,0.2985,0,28,28,28,350,28,3,1,1,311,1,728,63941,3,28
2012-01-17,spring,2012,January,0,Tuesday,Workingday,Mist,0.26,0.2273,0.7,0.3284,0,12,12,12,349,12,3,1,1,311,1,726,39130,3,12
2012-01-17,spring,2012,January,1,Tuesday,Workingday,Mist,0.28,0.2576,0.65,0.3582,0,2,2,2,349,2,3,1,1,311,1,724,24164,3,2
2012-01-17,spring,2012,January,2,Tuesday,Workingday,Light Snow,0.28,0.2727,0.75,0.2537,0,12,12,12,349,12,3,1,1,311,1,715,16352,3,12
2012-01-17,spring,2012,January,4,Tuesday,Workingday,Light Snow,0.32,0.303,0.66,0.3284,0,2,2,2,349,2,3,1,1,311,1,697,4428,3,2
2012-01-17,spring,2012,January,5,Tuesday,Workingday,Light Snow,0.32,0.303,0.66,0.3284,0,13,13,13,349,13,3,1,1,311,1,717,14261,3,13
2012-01-17,spring,2012,January,6,Tuesday,Workingday,Light Snow,0.3,0.2879,0.75,0.2537,0,57,57,57,349,57,3,2,1,321,1,725,55132,3,57
2012-01-17,spring,2012,January,7,Tuesday,Workingday,Light Snow,0.3,0.2879,0.81,0.2239,5,121,126,126,349,126,3,2,1,321,1,727,154171,3,126
2012-01-17,spring,2012,January,8,Tuesday,Workingday,Light Snow,0.3,0.2879,0.81,0.2836,3,90,93,93,349,93,3,2,1,321,1,727,261001,3,93
2012-01-17,spring,2012,January,9,Tuesday,Workingday,Light Snow,0.32,0.303,0.81,0.2537,7,61,68,68,349,68,3,2,1,321,1,727,159438,3,68
2012-01-17,spring,2012,January,10,Tuesday,Workingday,Light Snow,0.3,0.2879,0.87,0.2537,1,61,62,62,349,62,3,2,1,321,1,727,126257,3,62
2012-01-17,spring,2012,January,11,Tuesday,Workingday,Mist,0.34,0.3485,0.87,0.1045,2,73,75,75,349,75,3,2,2,322,0,727,151320,3,75
2012-01-17,spring,2012,January,12,Tuesday,Workingday,Mist,0.32,0.303,0.87,0.2836,3,83,86,86,349,86,3,2,1,321,1,728,184414,3,86
2012-01-17,spring,2012,January,13,Tuesday,Workingday,Mist,0.38,0.3939,0.76,0.3284,8,95,103,103,349,103,3,2,2,322,1,729,184919,3,103
2012-01-17,spring,2012,January,14,Tuesday,Workingday,Clear,0.44,0.4394,0.62,0.4925,12,120,132,132,349,132,3,2,2,322,1,729,175652,3,132
2012-01-17,spring,2012,January,15,Tuesday,Workingday,Clear,0.44,0.4394,0.62,0.4925,6,123,129,129,349,129,3,2,2,322,1,729,183149,3,129
2012-01-17,spring,2012,January,16,Tuesday,Workingday,Clear,0.46,0.4545,0.63,0.5522,14,205,219,219,349,219,3,3,2,332,1,730,227748,3,219
2012-01-17,spring,2012,January,17,Tuesday,Workingday,Clear,0.46,0.4545,0.63,0.4478,20,442,462,462,349,462,3,4,2,342,2,730,336860,3,462
2012-01-17,spring,2012,January,18,Tuesday,Workingday,Clear,0.46,0.4545,0.63,0.4478,12,451,463,463,349,463,3,4,2,342,2,728,309772,3,463
2012-01-17,spring,2012,January,19,Tuesday,Workingday,Clear,0.46,0.4545,0.63,0.4179,11,297,308,308,349,308,3,4,2,342,1,728,226789,3,308
2012-01-17,spring,2012,January,20,Tuesday,Workingday,Clear,0.46,0.4545,0.63,0.3582,11,169,180,180,349,180,3,3,2,332,1,728,164550,3,180
2012-01-17,spring,2012,January,21,Tuesday,Workingday,Clear,0.46,0.4545,0.67,0.4627,6,174,180,180,349,180,3,3,2,332,1,728,125445,3,180
2012-01-17,spring,2012,January,22,Tuesday,Workingday,Clear,0.46,0.4545,0.72,0.3881,5,85,90,90,349,90,3,2,2,322,1,728,95612,3,90
2012-01-17,spring,2012,January,23,Tuesday,Workingday,Clear,0.46,0.4545,0.72,0.3881,1,60,61,61,349,61,3,2,2,322,1,728,63941,3,61
2012-01-18,spring,2012,January,0,Wednesday,Workingday,Mist,0.46,0.4545,0.77,0.3284,3,14,17,17,348,17,3,1,2,312,0,726,39130,3,17
2012-01-18,spring,2012,January,1,Wednesday,Workingday,Mist,0.46,0.4545,0.77,0.3284,0,10,10,10,348,10,3,1,2,312,0,724,24164,3,10
2012-01-18,spring,2012,January,2,Wednesday,Workingday,Mist,0.44,0.4394,0.51,0.4925,1,1,2,2,348,2,3,1,2,312,1,715,16352,3,2
2012-01-18,spring,2012,January,3,Wednesday,Workingday,Mist,0.44,0.4394,0.51,0.4925,1,3,4,4,348,4,3,1,2,312,1,697,8174,3,4
2012-01-18,spring,2012,January,4,Wednesday,Workingday,Clear,0.34,0.2879,0.46,0.5224,0,1,1,1,348,1,3,1,1,311,1,697,4428,3,1
2012-01-18,spring,2012,January,5,Wednesday,Workingday,Clear,0.34,0.2879,0.46,0.5224,0,29,29,29,348,29,3,1,1,311,1,717,14261,3,29
2012-01-18,spring,2012,January,6,Wednesday,Workingday,Clear,0.34,0.2879,0.36,0.5224,0,88,88,88,348,88,3,2,1,321,1,725,55132,3,88
2012-01-18,spring,2012,January,7,Wednesday,Workingday,Clear,0.32,0.2879,0.42,0.3582,1,262,263,263,348,263,3,3,1,331,1,727,154171,3,263
2012-01-18,spring,2012,January,8,Wednesday,Workingday,Clear,0.3,0.2727,0.52,0.4179,15,474,489,489,348,489,3,4,1,341,1,727,261001,3,489
2012-01-18,spring,2012,January,9,Wednesday,Workingday,Clear,0.28,0.2576,0.52,0.3284,6,196,202,202,348,202,3,3,1,331,1,727,159438,3,202
2012-01-18,spring,2012,January,10,Wednesday,Workingday,Clear,0.3,0.2727,0.42,0.4627,5,88,93,93,348,93,3,2,1,321,1,727,126257,3,93
2012-01-18,spring,2012,January,11,Wednesday,Workingday,Clear,0.3,0.2727,0.42,0.3881,4,110,114,114,348,114,3,2,1,321,1,727,151320,3,114
2012-01-18,spring,2012,January,12,Wednesday,Workingday,Clear,0.3,0.2576,0.39,0.4925,6,155,161,161,348,161,3,3,1,331,1,728,184414,3,161
2012-01-18,spring,2012,January,13,Wednesday,Workingday,Clear,0.3,0.2727,0.42,0.4627,6,124,130,130,348,130,3,2,1,321,1,729,184919,3,130
2012-01-18,spring,2012,January,14,Wednesday,Workingday,Clear,0.3,0.2727,0.33,0.3881,7,98,105,105,348,105,3,2,1,321,1,729,175652,3,105
2012-01-18,spring,2012,January,15,Wednesday,Workingday,Clear,0.3,0.2576,0.33,0.5224,8,122,130,130,348,130,3,2,1,321,1,729,183149,3,130
2012-01-18,spring,2012,January,16,Wednesday,Workingday,Clear,0.28,0.2273,0.3,0.5224,13,163,176,176,348,176,3,3,1,331,1,730,227748,3,176
2012-01-18,spring,2012,January,17,Wednesday,Workingday,Clear,0.26,0.2121,0.33,0.4478,8,338,346,346,348,346,3,4,1,341,1,730,336860,3,346
2012-01-18,spring,2012,January,18,Wednesday,Workingday,Clear,0.24,0.2121,0.32,0.3582,8,347,355,355,348,355,3,4,1,341,1,728,309772,3,355
2012-01-18,spring,2012,January,19,Wednesday,Workingday,Clear,0.22,0.197,0.37,0.3881,5,251,256,256,348,256,3,3,1,331,1,728,226789,3,256
2012-01-18,spring,2012,January,20,Wednesday,Workingday,Clear,0.22,0.2121,0.37,0.2537,1,164,165,165,348,165,3,3,1,331,1,728,164550,3,165
2012-01-18,spring,2012,January,21,Wednesday,Workingday,Clear,0.2,0.1667,0.4,0.4179,5,119,124,124,348,124,3,2,1,321,1,728,125445,3,124
2012-01-18,spring,2012,January,22,Wednesday,Workingday,Clear,0.18,0.1667,0.47,0.2537,4,74,78,78,348,78,3,2,1,321,1,728,95612,3,78
2012-01-18,spring,2012,January,23,Wednesday,Workingday,Clear,0.16,0.1364,0.47,0.2985,2,36,38,38,348,38,3,1,1,311,1,728,63941,3,38
2012-01-19,spring,2012,January,0,Thursday,Workingday,Clear,0.14,0.1364,0.5,0.194,0,16,16,16,347,16,3,1,1,311,1,726,39130,3,16
2012-01-19,spring,2012,January,1,Thursday,Workingday,Clear,0.14,0.1515,0.5,0.1642,0,5,5,5,347,5,3,1,1,311,1,724,24164,3,5
2012-01-19,spring,2012,January,2,Thursday,Workingday,Clear,0.14,0.1515,0.5,0.1343,0,3,3,3,347,3,3,1,1,311,1,715,16352,3,3
2012-01-19,spring,2012,January,3,Thursday,Workingday,Clear,0.12,0.1515,0.54,0.1045,0,4,4,4,347,4,3,1,1,311,1,697,8174,3,4
2012-01-19,spring,2012,January,4,Thursday,Workingday,Clear,0.12,0.1515,0.54,0.1045,0,1,1,1,347,1,3,1,1,311,1,697,4428,3,1
2012-01-19,spring,2012,January,5,Thursday,Workingday,Clear,0.12,0.1212,0.55,0.2537,0,19,19,19,347,19,3,1,1,311,1,717,14261,3,19
2012-01-19,spring,2012,January,6,Thursday,Workingday,Clear,0.12,0.1364,0.54,0.1642,0,86,86,86,347,86,3,2,1,321,1,725,55132,3,86
2012-01-19,spring,2012,January,7,Thursday,Workingday,Clear,0.12,0.1667,0.54,0.0896,2,204,206,206,347,206,3,3,1,331,1,727,154171,3,206
2012-01-19,spring,2012,January,8,Thursday,Workingday,Clear,0.12,0.1515,0.54,0.1045,9,414,423,423,347,423,3,4,1,341,1,727,261001,3,423
2012-01-19,spring,2012,January,9,Thursday,Workingday,Clear,0.12,0.197,0.54,0.0,6,204,210,210,347,210,3,3,1,331,1,727,159438,3,210
2012-01-19,spring,2012,January,10,Thursday,Workingday,Clear,0.14,0.2121,0.59,0.0,10,98,108,108,347,108,3,2,1,321,1,727,126257,3,108
2012-01-19,spring,2012,January,11,Thursday,Workingday,Clear,0.16,0.1667,0.55,0.1642,6,93,99,99,347,99,3,2,1,321,1,727,151320,3,99
2012-01-19,spring,2012,January,12,Thursday,Workingday,Clear,0.2,0.197,0.51,0.194,5,106,111,111,347,111,3,2,1,321,1,728,184414,3,111
2012-01-19,spring,2012,January,13,Thursday,Workingday,Clear,0.22,0.2121,0.47,0.2836,6,118,124,124,347,124,3,2,1,321,1,729,184919,3,124
2012-01-19,spring,2012,January,14,Thursday,Workingday,Clear,0.24,0.2273,0.44,0.194,15,104,119,119,347,119,3,2,1,321,1,729,175652,3,119
2012-01-19,spring,2012,January,15,Thursday,Workingday,Clear,0.26,0.2273,0.44,0.2985,9,118,127,127,347,127,3,2,1,321,1,729,183149,3,127
2012-01-19,spring,2012,January,16,Thursday,Workingday,Clear,0.26,0.2273,0.41,0.3284,8,185,193,193,347,193,3,3,1,331,1,730,227748,3,193
2012-01-19,spring,2012,January,17,Thursday,Workingday,Mist,0.26,0.2273,0.44,0.3284,21,364,385,385,347,385,3,4,1,341,1,730,336860,3,385
2012-01-19,spring,2012,January,18,Thursday,Workingday,Mist,0.26,0.2273,0.44,0.3284,16,345,361,361,347,361,3,4,1,341,1,728,309772,3,361
2012-01-19,spring,2012,January,19,Thursday,Workingday,Mist,0.26,0.2273,0.48,0.2985,5,229,234,234,347,234,3,3,1,331,1,728,226789,3,234
2012-01-19,spring,2012,January,20,Thursday,Workingday,Clear,0.26,0.2121,0.52,0.4478,7,184,191,191,347,191,3,3,1,331,1,728,164550,3,191
2012-01-19,spring,2012,January,21,Thursday,Workingday,Clear,0.26,0.2273,0.44,0.3582,4,117,121,121,347,121,3,2,1,321,1,728,125445,3,121
2012-01-19,spring,2012,January,22,Thursday,Workingday,Mist,0.26,0.2273,0.44,0.4179,0,90,90,90,347,90,3,2,1,321,1,728,95612,3,90
2012-01-19,spring,2012,January,23,Thursday,Workingday,Clear,0.26,0.2273,0.48,0.3284,1,55,56,56,347,56,3,2,1,321,1,728,63941,3,56
2012-01-20,spring,2012,January,0,Friday,Workingday,Mist,0.26,0.2273,0.48,0.2985,3,24,27,27,346,27,3,1,1,311,1,726,39130,3,27
2012-01-20,spring,2012,January,1,Friday,Workingday,Clear,0.26,0.2727,0.48,0.1343,0,15,15,15,346,15,3,1,1,311,1,724,24164,3,15
2012-01-20,spring,2012,January,2,Friday,Workingday,Clear,0.26,0.2727,0.48,0.1343,0,11,11,11,346,11,3,1,1,311,1,715,16352,3,11
2012-01-20,spring,2012,January,3,Friday,Workingday,Clear,0.24,0.2576,0.52,0.1045,0,4,4,4,346,4,3,1,1,311,1,697,8174,3,4
2012-01-20,spring,2012,January,4,Friday,Workingday,Clear,0.22,0.2424,0.6,0.1045,0,3,3,3,346,3,3,1,1,311,1,697,4428,3,3
2012-01-20,spring,2012,January,5,Friday,Workingday,Clear,0.22,0.2424,0.6,0.1045,0,19,19,19,346,19,3,1,1,311,1,717,14261,3,19
2012-01-20,spring,2012,January,6,Friday,Workingday,Clear,0.24,0.2121,0.6,0.2836,0,68,68,68,346,68,3,2,1,321,1,725,55132,3,68
2012-01-20,spring,2012,January,7,Friday,Workingday,Clear,0.22,0.2121,0.69,0.2239,2,183,185,185,346,185,3,3,1,331,1,727,154171,3,185
2012-01-20,spring,2012,January,8,Friday,Workingday,Clear,0.22,0.2121,0.64,0.2537,4,421,425,425,346,425,3,4,1,341,1,727,261001,3,425
2012-01-20,spring,2012,January,9,Friday,Workingday,Clear,0.22,0.197,0.47,0.3881,21,242,263,263,346,263,3,3,1,331,1,727,159438,3,263
2012-01-20,spring,2012,January,10,Friday,Workingday,Mist,0.22,0.2121,0.44,0.2836,1,96,97,97,346,97,3,2,1,321,1,727,126257,3,97
2012-01-20,spring,2012,January,11,Friday,Workingday,Mist,0.2,0.1818,0.32,0.3582,6,117,123,123,346,123,3,2,1,321,1,727,151320,3,123
2012-01-20,spring,2012,January,12,Friday,Workingday,Mist,0.2,0.1818,0.34,0.3284,5,119,124,124,346,124,3,2,1,321,1,728,184414,3,124
2012-01-20,spring,2012,January,13,Friday,Workingday,Clear,0.22,0.2121,0.32,0.2985,12,144,156,156,346,156,3,3,1,331,1,729,184919,3,156
2012-01-20,spring,2012,January,14,Friday,Workingday,Mist,0.22,0.2121,0.35,0.2985,8,107,115,115,346,115,3,2,1,321,1,729,175652,3,115
2012-01-20,spring,2012,January,15,Friday,Workingday,Mist,0.22,0.2273,0.35,0.194,12,144,156,156,346,156,3,3,1,331,1,729,183149,3,156
2012-01-20,spring,2012,January,16,Friday,Workingday,Mist,0.2,0.2121,0.37,0.1642,11,163,174,174,346,174,3,3,1,331,1,730,227748,3,174
2012-01-20,spring,2012,January,17,Friday,Workingday,Mist,0.22,0.2576,0.32,0.0896,9,340,349,349,346,349,3,4,1,341,1,730,336860,3,349
2012-01-20,spring,2012,January,18,Friday,Workingday,Mist,0.2,0.2273,0.34,0.0896,5,296,301,301,346,301,3,4,1,341,1,728,309772,3,301
2012-01-20,spring,2012,January,19,Friday,Workingday,Mist,0.2,0.2273,0.37,0.1045,6,186,192,192,346,192,3,3,1,331,1,728,226789,3,192
2012-01-20,spring,2012,January,20,Friday,Workingday,Mist,0.2,0.2273,0.34,0.0896,1,141,142,142,346,142,3,2,1,321,1,728,164550,3,142
2012-01-20,spring,2012,January,21,Friday,Workingday,Mist,0.2,0.2273,0.37,0.0896,5,99,104,104,346,104,3,2,1,321,1,728,125445,3,104
2012-01-20,spring,2012,January,22,Friday,Workingday,Mist,0.2,0.197,0.37,0.2239,1,71,72,72,346,72,3,2,1,321,1,728,95612,3,72
2012-01-20,spring,2012,January,23,Friday,Workingday,Light Snow,0.16,0.1515,0.64,0.2239,3,35,38,38,346,38,3,1,1,311,1,728,63941,3,38
2012-01-21,spring,2012,January,0,Saturday,Holiday,Light Snow,0.16,0.1515,0.64,0.2239,0,24,24,24,345,24,3,1,1,311,1,726,39130,3,24
2012-01-21,spring,2012,January,1,Saturday,Holiday,Heavy Rain,0.14,0.1364,0.86,0.194,1,22,23,23,345,23,3,1,1,311,1,724,24164,3,23
2012-01-21,spring,2012,January,2,Saturday,Holiday,Light Snow,0.14,0.2121,0.86,0.0,1,25,26,26,345,26,3,1,1,311,1,715,16352,3,26
2012-01-21,spring,2012,January,3,Saturday,Holiday,Light Snow,0.14,0.1818,0.93,0.0896,0,13,13,13,345,13,3,1,1,311,1,697,8174,3,13
2012-01-21,spring,2012,January,4,Saturday,Holiday,Light Snow,0.16,0.197,0.86,0.0896,0,1,1,1,345,1,3,1,1,311,1,697,4428,3,1
2012-01-21,spring,2012,January,5,Saturday,Holiday,Light Snow,0.16,0.1818,0.86,0.1045,0,2,2,2,345,2,3,1,1,311,1,717,14261,3,2
2012-01-21,spring,2012,January,6,Saturday,Holiday,Light Snow,0.16,0.1667,0.93,0.1642,0,1,1,1,345,1,3,1,1,311,1,725,55132,3,1
2012-01-21,spring,2012,January,7,Saturday,Holiday,Light Snow,0.16,0.1667,0.93,0.1642,3,10,13,13,345,13,3,1,1,311,1,727,154171,3,13
2012-01-21,spring,2012,January,8,Saturday,Holiday,Mist,0.16,0.1515,0.93,0.2537,3,22,25,25,345,25,3,1,1,311,1,727,261001,3,25
2012-01-21,spring,2012,January,9,Saturday,Holiday,Mist,0.16,0.1515,0.93,0.2537,2,40,42,42,345,42,3,2,1,321,1,727,159438,3,42
2012-01-21,spring,2012,January,10,Saturday,Holiday,Light Snow,0.16,0.1515,0.93,0.2537,0,45,45,45,345,45,3,2,1,321,1,727,126257,3,45
2012-01-21,spring,2012,January,11,Saturday,Holiday,Mist,0.18,0.2121,0.86,0.1045,1,62,63,63,345,63,3,2,1,321,1,727,151320,3,63
2012-01-21,spring,2012,January,12,Saturday,Holiday,Mist,0.2,0.2121,0.8,0.1642,5,62,67,67,345,67,3,2,1,321,1,728,184414,3,67
2012-01-21,spring,2012,January,13,Saturday,Holiday,Mist,0.2,0.197,0.8,0.2537,10,66,76,76,345,76,3,2,1,321,1,729,184919,3,76
2012-01-21,spring,2012,January,14,Saturday,Holiday,Light Snow,0.2,0.197,0.8,0.194,6,89,95,95,345,95,3,2,1,321,1,729,175652,3,95
2012-01-21,spring,2012,January,15,Saturday,Holiday,Light Snow,0.2,0.197,0.8,0.194,6,113,119,119,345,119,3,2,1,321,1,729,183149,3,119
2012-01-21,spring,2012,January,16,Saturday,Holiday,Mist,0.2,0.1818,0.8,0.2985,5,113,118,118,345,118,3,2,1,321,1,730,227748,3,118
2012-01-21,spring,2012,January,17,Saturday,Holiday,Mist,0.2,0.1818,0.8,0.3881,7,99,106,106,345,106,3,2,1,321,1,730,336860,3,106
2012-01-21,spring,2012,January,18,Saturday,Holiday,Mist,0.2,0.1818,0.75,0.3881,3,107,110,110,345,110,3,2,1,321,1,728,309772,3,110
2012-01-21,spring,2012,January,19,Saturday,Holiday,Mist,0.18,0.1515,0.8,0.3881,0,85,85,85,345,85,3,2,1,321,1,728,226789,3,85
2012-01-21,spring,2012,January,20,Saturday,Holiday,Mist,0.18,0.1667,0.8,0.2985,5,62,67,67,345,67,3,2,1,321,1,728,164550,3,67
2012-01-21,spring,2012,January,21,Saturday,Holiday,Clear,0.18,0.1515,0.74,0.3284,5,64,69,69,345,69,3,2,1,321,1,728,125445,3,69
2012-01-21,spring,2012,January,22,Saturday,Holiday,Mist,0.18,0.1667,0.74,0.2985,3,56,59,59,345,59,3,2,1,321,1,728,95612,3,59
2012-01-21,spring,2012,January,23,Saturday,Holiday,Mist,0.16,0.1515,0.8,0.2537,1,51,52,52,345,52,3,2,1,321,1,728,63941,3,52
2012-01-22,spring,2012,January,0,Sunday,Holiday,Clear,0.16,0.1364,0.8,0.2985,1,51,52,52,344,52,3,2,1,321,1,726,39130,3,52
2012-01-22,spring,2012,January,1,Sunday,Holiday,Mist,0.18,0.1667,0.74,0.2985,1,49,50,50,344,50,3,2,1,321,1,724,24164,3,50
2012-01-22,spring,2012,January,2,Sunday,Holiday,Mist,0.18,0.1667,0.74,0.2836,1,46,47,47,344,47,3,2,1,321,1,715,16352,3,47
2012-01-22,spring,2012,January,3,Sunday,Holiday,Mist,0.18,0.1667,0.69,0.2836,1,20,21,21,344,21,3,1,1,311,1,697,8174,3,21
2012-01-22,spring,2012,January,4,Sunday,Holiday,Light Snow,0.16,0.1364,0.8,0.2836,1,1,2,2,344,2,3,1,1,311,1,697,4428,3,2
2012-01-22,spring,2012,January,5,Sunday,Holiday,Light Snow,0.16,0.1515,0.74,0.2239,1,2,3,3,344,3,3,1,1,311,1,717,14261,3,3
2012-01-22,spring,2012,January,6,Sunday,Holiday,Mist,0.16,0.1515,0.74,0.2239,0,4,4,4,344,4,3,1,1,311,1,725,55132,3,4
2012-01-22,spring,2012,January,7,Sunday,Holiday,Mist,0.16,0.1515,0.74,0.2239,2,11,13,13,344,13,3,1,1,311,1,727,154171,3,13
2012-01-22,spring,2012,January,8,Sunday,Holiday,Mist,0.16,0.1515,0.74,0.2239,3,29,32,32,344,32,3,1,1,311,1,727,261001,3,32
2012-01-22,spring,2012,January,9,Sunday,Holiday,Mist,0.16,0.1515,0.74,0.2239,9,54,63,63,344,63,3,2,1,321,1,727,159438,3,63
2012-01-22,spring,2012,January,10,Sunday,Holiday,Mist,0.16,0.1364,0.74,0.2836,9,120,129,129,344,129,3,2,1,321,1,727,126257,3,129
2012-01-22,spring,2012,January,11,Sunday,Holiday,Light Snow,0.16,0.1515,0.8,0.2537,18,115,133,133,344,133,3,2,1,321,1,727,151320,3,133
2012-01-22,spring,2012,January,12,Sunday,Holiday,Mist,0.16,0.1515,0.8,0.2239,24,161,185,185,344,185,3,3,1,331,1,728,184414,3,185
2012-01-22,spring,2012,January,13,Sunday,Holiday,Mist,0.16,0.1818,0.8,0.1343,24,175,199,199,344,199,3,3,1,331,1,729,184919,3,199
2012-01-22,spring,2012,January,14,Sunday,Holiday,Mist,0.16,0.1667,0.8,0.1642,19,163,182,182,344,182,3,3,1,331,1,729,175652,3,182
2012-01-22,spring,2012,January,15,Sunday,Holiday,Mist,0.16,0.1515,0.8,0.194,27,149,176,176,344,176,3,3,1,331,1,729,183149,3,176
2012-01-22,spring,2012,January,16,Sunday,Holiday,Mist,0.16,0.1515,0.8,0.194,12,143,155,155,344,155,3,3,1,331,1,730,227748,3,155
2012-01-22,spring,2012,January,17,Sunday,Holiday,Mist,0.16,0.1818,0.8,0.1045,8,100,108,108,344,108,3,2,1,321,1,730,336860,3,108
2012-01-22,spring,2012,January,18,Sunday,Holiday,Light Snow,0.16,0.1818,0.86,0.1045,11,110,121,121,344,121,3,2,1,321,1,728,309772,3,121
2012-01-22,spring,2012,January,19,Sunday,Holiday,Light Snow,0.16,0.1818,0.86,0.1045,9,80,89,89,344,89,3,2,1,321,1,728,226789,3,89
2012-01-22,spring,2012,January,20,Sunday,Holiday,Light Snow,0.16,0.1667,0.86,0.1642,5,69,74,74,344,74,3,2,1,321,1,728,164550,3,74
2012-01-22,spring,2012,January,21,Sunday,Holiday,Light Snow,0.16,0.1818,0.86,0.1045,8,36,44,44,344,44,3,2,1,321,1,728,125445,3,44
2012-01-22,spring,2012,January,22,Sunday,Holiday,Mist,0.16,0.197,0.93,0.0896,0,58,58,58,344,58,3,2,1,321,1,728,95612,3,58
2012-01-22,spring,2012,January,23,Sunday,Holiday,Mist,0.16,0.1818,0.93,0.1045,2,35,37,37,344,37,3,1,1,311,1,728,63941,3,37
2012-01-23,spring,2012,January,0,Monday,Workingday,Mist,0.18,0.2424,0.86,0.0,2,17,19,19,343,19,3,1,1,311,1,726,39130,3,19
2012-01-23,spring,2012,January,1,Monday,Workingday,Mist,0.18,0.2121,0.86,0.1045,0,4,4,4,343,4,3,1,1,311,1,724,24164,3,4
2012-01-23,spring,2012,January,2,Monday,Workingday,Mist,0.18,0.2121,0.86,0.1045,0,2,2,2,343,2,3,1,1,311,1,715,16352,3,2
2012-01-23,spring,2012,January,3,Monday,Workingday,Mist,0.18,0.2424,0.86,0.0,0,1,1,1,343,1,3,1,1,311,1,697,8174,3,1
2012-01-23,spring,2012,January,4,Monday,Workingday,Mist,0.2,0.2576,0.8,0.0,0,1,1,1,343,1,3,1,1,311,1,697,4428,3,1
2012-01-23,spring,2012,January,5,Monday,Workingday,Mist,0.2,0.2576,0.86,0.0,0,19,19,19,343,19,3,1,1,311,1,717,14261,3,19
2012-01-23,spring,2012,January,6,Monday,Workingday,Mist,0.2,0.2576,0.86,0.0,6,36,42,42,343,42,3,2,1,321,1,725,55132,3,42
2012-01-23,spring,2012,January,7,Monday,Workingday,Light Snow,0.2,0.2576,0.86,0.0,8,114,122,122,343,122,3,2,1,321,1,727,154171,3,122
2012-01-23,spring,2012,January,8,Monday,Workingday,Light Snow,0.2,0.2121,0.86,0.1343,5,267,272,272,343,272,3,3,1,331,1,727,261001,3,272
2012-01-23,spring,2012,January,9,Monday,Workingday,Mist,0.2,0.2273,0.86,0.0896,13,198,211,211,343,211,3,3,1,331,1,727,159438,3,211
2012-01-23,spring,2012,January,10,Monday,Workingday,Mist,0.2,0.2576,0.93,0.0,10,139,149,149,343,149,3,3,1,331,1,727,126257,3,149
2012-01-23,spring,2012,January,11,Monday,Workingday,Mist,0.2,0.2273,0.93,0.0896,5,57,62,62,343,62,3,2,1,321,1,727,151320,3,62
2012-01-23,spring,2012,January,12,Monday,Workingday,Mist,0.22,0.2727,0.93,0.0,10,52,62,62,343,62,3,2,1,321,1,728,184414,3,62
2012-01-23,spring,2012,January,13,Monday,Workingday,Light Snow,0.22,0.2576,0.93,0.0896,5,32,37,37,343,37,3,1,1,311,1,729,184919,3,37
2012-01-23,spring,2012,January,14,Monday,Workingday,Light Snow,0.22,0.2273,0.93,0.194,13,48,61,61,343,61,3,2,1,321,1,729,175652,3,61
2012-01-23,spring,2012,January,15,Monday,Workingday,Mist,0.22,0.2121,1.0,0.2239,10,64,74,74,343,74,3,2,1,321,1,729,183149,3,74
2012-01-23,spring,2012,January,16,Monday,Workingday,Mist,0.24,0.2424,0.93,0.1642,14,108,122,122,343,122,3,2,1,321,1,730,227748,3,122
2012-01-23,spring,2012,January,17,Monday,Workingday,Mist,0.24,0.2576,0.96,0.1045,6,270,276,276,343,276,3,3,1,331,1,730,336860,3,276
2012-01-23,spring,2012,January,18,Monday,Workingday,Mist,0.24,0.2424,0.93,0.1343,7,275,282,282,343,282,3,4,1,341,1,728,309772,3,282
2012-01-23,spring,2012,January,19,Monday,Workingday,Mist,0.26,0.2576,0.93,0.1642,9,211,220,220,343,220,3,3,1,331,1,728,226789,3,220
2012-01-23,spring,2012,January,20,Monday,Workingday,Mist,0.26,0.2576,1.0,0.1642,8,161,169,169,343,169,3,3,1,331,1,728,164550,3,169
2012-01-23,spring,2012,January,21,Monday,Workingday,Mist,0.26,0.2424,1.0,0.2836,8,112,120,120,343,120,3,2,1,321,1,728,125445,3,120
2012-01-23,spring,2012,January,22,Monday,Workingday,Mist,0.26,0.2424,1.0,0.2836,4,64,68,68,343,68,3,2,1,321,1,728,95612,3,68
2012-01-23,spring,2012,January,23,Monday,Workingday,Mist,0.28,0.2576,0.93,0.3284,2,35,37,37,343,37,3,1,1,311,1,728,63941,3,37
2012-01-24,spring,2012,January,0,Tuesday,Workingday,Mist,0.3,0.2879,1.0,0.2836,6,19,25,25,342,25,3,1,1,311,1,726,39130,3,25
2012-01-24,spring,2012,January,1,Tuesday,Workingday,Mist,0.32,0.303,0.93,0.2537,2,7,9,9,342,9,3,1,1,311,1,724,24164,3,9
2012-01-24,spring,2012,January,2,Tuesday,Workingday,Mist,0.32,0.303,0.93,0.2239,2,6,8,8,342,8,3,1,1,311,1,715,16352,3,8
2012-01-24,spring,2012,January,3,Tuesday,Workingday,Mist,0.32,0.3333,0.93,0.1343,0,3,3,3,342,3,3,1,1,311,0,697,8174,3,3
2012-01-24,spring,2012,January,4,Tuesday,Workingday,Mist,0.3,0.3182,1.0,0.0896,0,2,2,2,342,2,3,1,1,311,0,697,4428,3,2
2012-01-24,spring,2012,January,5,Tuesday,Workingday,Mist,0.3,0.3182,1.0,0.0896,0,26,26,26,342,26,3,1,1,311,0,717,14261,3,26
2012-01-24,spring,2012,January,6,Tuesday,Workingday,Mist,0.32,0.3182,0.93,0.194,1,88,89,89,342,89,3,2,1,321,1,725,55132,3,89
2012-01-24,spring,2012,January,7,Tuesday,Workingday,Mist,0.32,0.3333,0.93,0.1343,11,221,232,232,342,232,3,3,1,331,0,727,154171,3,232
2012-01-24,spring,2012,January,8,Tuesday,Workingday,Mist,0.32,0.3333,0.93,0.1343,11,479,490,490,342,490,3,4,1,341,0,727,261001,3,490
2012-01-24,spring,2012,January,9,Tuesday,Workingday,Mist,0.32,0.3333,0.87,0.0896,11,244,255,255,342,255,3,3,1,331,1,727,159438,3,255
2012-01-24,spring,2012,January,10,Tuesday,Workingday,Clear,0.32,0.3333,0.93,0.0896,23,93,116,116,342,116,3,2,1,321,0,727,126257,3,116
2012-01-24,spring,2012,January,11,Tuesday,Workingday,Clear,0.34,0.3333,0.87,0.1343,30,123,153,153,342,153,3,3,1,331,1,727,151320,3,153
2012-01-24,spring,2012,January,12,Tuesday,Workingday,Clear,0.34,0.3333,0.87,0.1642,25,150,175,175,342,175,3,3,1,331,1,728,184414,3,175
2012-01-24,spring,2012,January,13,Tuesday,Workingday,Clear,0.34,0.3333,0.87,0.1642,33,170,203,203,342,203,3,3,1,331,1,729,184919,3,203
2012-01-24,spring,2012,January,14,Tuesday,Workingday,Clear,0.36,0.3485,0.81,0.2239,35,138,173,173,342,173,3,3,2,332,1,729,175652,3,173
2012-01-24,spring,2012,January,15,Tuesday,Workingday,Mist,0.4,0.4091,0.71,0.1642,52,156,208,208,342,208,3,3,2,332,0,729,183149,3,208
2012-01-24,spring,2012,January,16,Tuesday,Workingday,Clear,0.4,0.4091,0.71,0.1343,35,243,278,278,342,278,3,3,2,332,0,730,227748,3,278
2012-01-24,spring,2012,January,17,Tuesday,Workingday,Clear,0.42,0.4242,0.67,0.0896,41,474,515,515,342,515,3,4,2,342,2,730,336860,3,515
2012-01-24,spring,2012,January,18,Tuesday,Workingday,Clear,0.4,0.4091,0.62,0.0896,32,391,423,423,342,423,3,4,2,342,1,728,309772,3,423
2012-01-24,spring,2012,January,19,Tuesday,Workingday,Clear,0.44,0.4394,0.51,0.0896,20,311,331,331,342,331,3,4,2,342,1,728,226789,3,331
2012-01-24,spring,2012,January,20,Tuesday,Workingday,Clear,0.32,0.3485,0.76,0.0,18,211,229,229,342,229,3,3,2,332,1,728,164550,3,229
2012-01-24,spring,2012,January,21,Tuesday,Workingday,Clear,0.36,0.3788,0.71,0.0,18,154,172,172,342,172,3,3,2,332,0,728,125445,3,172
2012-01-24,spring,2012,January,22,Tuesday,Workingday,Clear,0.32,0.3485,0.81,0.0,14,111,125,125,342,125,3,2,2,322,0,728,95612,3,125
2012-01-24,spring,2012,January,23,Tuesday,Workingday,Clear,0.32,0.3485,0.76,0.0,19,80,99,99,342,99,3,2,2,322,1,728,63941,3,99
2012-01-25,spring,2012,January,0,Wednesday,Workingday,Clear,0.26,0.303,0.93,0.0,6,25,31,31,341,31,3,1,1,311,0,726,39130,3,31
2012-01-25,spring,2012,January,1,Wednesday,Workingday,Clear,0.3,0.2879,0.7,0.2239,4,9,13,13,341,13,3,1,1,311,1,724,24164,3,13
2012-01-25,spring,2012,January,2,Wednesday,Workingday,Clear,0.28,0.2727,0.7,0.194,3,3,6,6,341,6,3,1,1,311,1,715,16352,3,6
2012-01-25,spring,2012,January,3,Wednesday,Workingday,Clear,0.26,0.2576,0.75,0.194,0,1,1,1,341,1,3,1,1,311,1,697,8174,3,1
2012-01-25,spring,2012,January,4,Wednesday,Workingday,Clear,0.26,0.2424,0.7,0.2836,0,4,4,4,341,4,3,1,1,311,1,697,4428,3,4
2012-01-25,spring,2012,January,5,Wednesday,Workingday,Clear,0.26,0.2424,0.7,0.2836,0,33,33,33,341,33,3,1,1,311,1,717,14261,3,33
2012-01-25,spring,2012,January,6,Wednesday,Workingday,Clear,0.24,0.2273,0.73,0.2239,1,87,88,88,341,88,3,2,1,321,1,725,55132,3,88
2012-01-25,spring,2012,January,7,Wednesday,Workingday,Clear,0.24,0.2273,0.75,0.2239,14,243,257,257,341,257,3,3,1,331,1,727,154171,3,257
2012-01-25,spring,2012,January,8,Wednesday,Workingday,Clear,0.24,0.2273,0.7,0.2537,18,495,513,513,341,513,3,4,1,341,1,727,261001,3,513
2012-01-25,spring,2012,January,9,Wednesday,Workingday,Clear,0.24,0.2273,0.7,0.2537,18,218,236,236,341,236,3,3,1,331,1,727,159438,3,236
2012-01-25,spring,2012,January,10,Wednesday,Workingday,Mist,0.26,0.2273,0.7,0.3284,30,111,141,141,341,141,3,2,1,321,1,727,126257,3,141
2012-01-25,spring,2012,January,11,Wednesday,Workingday,Mist,0.3,0.2727,0.61,0.2985,52,105,157,157,341,157,3,3,1,331,1,727,151320,3,157
2012-01-25,spring,2012,January,12,Wednesday,Workingday,Clear,0.32,0.3333,0.53,0.1343,46,147,193,193,341,193,3,3,1,331,1,728,184414,3,193
2012-01-25,spring,2012,January,13,Wednesday,Workingday,Clear,0.34,0.3333,0.49,0.1343,63,149,212,212,341,212,3,3,1,331,1,729,184919,3,212
2012-01-25,spring,2012,January,14,Wednesday,Workingday,Clear,0.34,0.3485,0.49,0.0896,53,107,160,160,341,160,3,3,2,332,1,729,175652,3,160
2012-01-25,spring,2012,January,15,Wednesday,Workingday,Clear,0.36,0.3788,0.46,0.0,30,125,155,155,341,155,3,3,2,332,1,729,183149,3,155
2012-01-25,spring,2012,January,16,Wednesday,Workingday,Clear,0.34,0.3333,0.53,0.1642,29,217,246,246,341,246,3,3,1,331,1,730,227748,3,246
2012-01-25,spring,2012,January,17,Wednesday,Workingday,Clear,0.36,0.3485,0.53,0.1642,27,443,470,470,341,470,3,4,2,342,1,730,336860,3,470
2012-01-25,spring,2012,January,18,Wednesday,Workingday,Clear,0.32,0.3333,0.66,0.1343,24,415,439,439,341,439,3,4,1,341,1,728,309772,3,439
2012-01-25,spring,2012,January,19,Wednesday,Workingday,Mist,0.34,0.3636,0.53,0.0,5,311,316,316,341,316,3,4,2,342,1,728,226789,3,316
2012-01-25,spring,2012,January,20,Wednesday,Workingday,Clear,0.32,0.3182,0.61,0.194,10,225,235,235,341,235,3,3,1,331,1,728,164550,3,235
2012-01-25,spring,2012,January,21,Wednesday,Workingday,Clear,0.3,0.3333,0.65,0.0,19,166,185,185,341,185,3,3,1,331,1,728,125445,3,185
2012-01-25,spring,2012,January,22,Wednesday,Workingday,Clear,0.3,0.3182,0.65,0.0896,12,101,113,113,341,113,3,2,1,321,1,728,95612,3,113
2012-01-25,spring,2012,January,23,Wednesday,Workingday,Mist,0.28,0.3182,0.65,0.0,3,63,66,66,341,66,3,2,1,321,1,728,63941,3,66
2012-01-26,spring,2012,January,0,Thursday,Workingday,Mist,0.28,0.2879,0.75,0.1045,3,22,25,25,340,25,3,1,1,311,1,726,39130,3,25
2012-01-26,spring,2012,January,1,Thursday,Workingday,Mist,0.28,0.3182,0.75,0.0,5,16,21,21,340,21,3,1,1,311,1,724,24164,3,21
2012-01-26,spring,2012,January,2,Thursday,Workingday,Mist,0.28,0.2727,0.75,0.1642,1,6,7,7,340,7,3,1,1,311,1,715,16352,3,7
2012-01-26,spring,2012,January,3,Thursday,Workingday,Mist,0.28,0.303,0.75,0.0896,1,5,6,6,340,6,3,1,1,311,1,697,8174,3,6
2012-01-26,spring,2012,January,4,Thursday,Workingday,Clear,0.28,0.3182,0.75,0.0,0,3,3,3,340,3,3,1,1,311,1,697,4428,3,3
2012-01-26,spring,2012,January,5,Thursday,Workingday,Mist,0.3,0.3182,0.75,0.1045,0,28,28,28,340,28,3,1,1,311,1,717,14261,3,28
2012-01-26,spring,2012,January,6,Thursday,Workingday,Mist,0.28,0.3182,0.81,0.0,0,88,88,88,340,88,3,2,1,321,1,725,55132,3,88
2012-01-26,spring,2012,January,7,Thursday,Workingday,Mist,0.28,0.303,0.81,0.0896,11,228,239,239,340,239,3,3,1,331,1,727,154171,3,239
2012-01-26,spring,2012,January,8,Thursday,Workingday,Mist,0.28,0.303,0.81,0.0896,16,514,530,530,340,530,3,4,1,341,1,727,261001,3,530
2012-01-26,spring,2012,January,9,Thursday,Workingday,Mist,0.3,0.3333,0.81,0.0,18,256,274,274,340,274,3,3,1,331,1,727,159438,3,274
2012-01-26,spring,2012,January,10,Thursday,Workingday,Mist,0.3,0.303,0.81,0.1343,16,92,108,108,340,108,3,2,1,321,1,727,126257,3,108
2012-01-26,spring,2012,January,11,Thursday,Workingday,Mist,0.3,0.3182,0.87,0.1045,11,100,111,111,340,111,3,2,1,321,1,727,151320,3,111
2012-01-26,spring,2012,January,12,Thursday,Workingday,Mist,0.34,0.3333,0.81,0.1343,29,136,165,165,340,165,3,3,1,331,1,728,184414,3,165
2012-01-26,spring,2012,January,13,Thursday,Workingday,Mist,0.38,0.3939,0.71,0.0,17,156,173,173,340,173,3,3,2,332,0,729,184919,3,173
2012-01-26,spring,2012,January,14,Thursday,Workingday,Mist,0.4,0.4091,0.71,0.1045,16,112,128,128,340,128,3,2,2,322,0,729,175652,3,128
2012-01-26,spring,2012,January,15,Thursday,Workingday,Mist,0.42,0.4242,0.71,0.1045,22,142,164,164,340,164,3,3,2,332,0,729,183149,3,164
2012-01-26,spring,2012,January,16,Thursday,Workingday,Mist,0.4,0.4091,0.71,0.0896,15,209,224,224,340,224,3,3,2,332,0,730,227748,3,224
2012-01-26,spring,2012,January,17,Thursday,Workingday,Mist,0.42,0.4242,0.71,0.0,16,397,413,413,340,413,3,4,2,342,0,730,336860,3,413
2012-01-26,spring,2012,January,18,Thursday,Workingday,Mist,0.42,0.4242,0.71,0.0,12,394,406,406,340,406,3,4,2,342,0,728,309772,3,406
2012-01-26,spring,2012,January,19,Thursday,Workingday,Mist,0.4,0.4091,0.76,0.1045,11,302,313,313,340,313,3,4,2,342,0,728,226789,3,313
2012-01-26,spring,2012,January,20,Thursday,Workingday,Mist,0.4,0.4091,0.82,0.1343,8,216,224,224,340,224,3,3,2,332,0,728,164550,3,224
2012-01-26,spring,2012,January,21,Thursday,Workingday,Mist,0.4,0.4091,0.76,0.1045,8,184,192,192,340,192,3,3,2,332,0,728,125445,3,192
2012-01-26,spring,2012,January,22,Thursday,Workingday,Clear,0.38,0.3939,0.82,0.1045,3,139,142,142,340,142,3,2,2,322,0,728,95612,3,142
2012-01-26,spring,2012,January,23,Thursday,Workingday,Mist,0.4,0.4091,0.82,0.0,5,86,91,91,340,91,3,2,2,322,0,728,63941,3,91
2012-01-27,spring,2012,January,0,Friday,Workingday,Mist,0.4,0.4091,0.82,0.2537,6,32,38,38,339,38,3,1,2,312,0,726,39130,3,38
2012-01-27,spring,2012,January,1,Friday,Workingday,Mist,0.4,0.4091,0.87,0.2239,6,23,29,29,339,29,3,1,2,312,0,724,24164,3,29
2012-01-27,spring,2012,January,2,Friday,Workingday,Clear,0.42,0.4242,0.94,0.1343,2,11,13,13,339,13,3,1,2,312,0,715,16352,3,13
2012-01-27,spring,2012,January,3,Friday,Workingday,Mist,0.42,0.4242,0.94,0.2836,3,5,8,8,339,8,3,1,2,312,0,697,8174,3,8
2012-01-27,spring,2012,January,4,Friday,Workingday,Mist,0.4,0.4091,1.0,0.2985,1,3,4,4,339,4,3,1,2,312,0,697,4428,3,4
2012-01-27,spring,2012,January,5,Friday,Workingday,Mist,0.42,0.4242,0.94,0.3284,0,24,24,24,339,24,3,1,2,312,0,717,14261,3,24
2012-01-27,spring,2012,January,6,Friday,Workingday,Mist,0.42,0.4242,1.0,0.3284,0,72,72,72,339,72,3,2,2,322,0,725,55132,3,72
2012-01-27,spring,2012,January,7,Friday,Workingday,Mist,0.42,0.4242,1.0,0.2985,6,128,134,134,339,134,3,2,2,322,0,727,154171,3,134
2012-01-27,spring,2012,January,8,Friday,Workingday,Light Snow,0.5,0.4848,0.88,0.2836,14,206,220,220,339,220,3,3,2,332,0,727,261001,3,220
2012-01-27,spring,2012,January,9,Friday,Workingday,Light Snow,0.5,0.4848,0.88,0.2836,6,101,107,107,339,107,3,2,2,322,0,727,159438,3,107
2012-01-27,spring,2012,January,10,Friday,Workingday,Light Snow,0.48,0.4697,1.0,0.1642,9,117,126,126,339,126,3,2,2,322,0,727,126257,3,126
2012-01-27,spring,2012,January,11,Friday,Workingday,Mist,0.48,0.4697,0.94,0.1343,10,95,105,105,339,105,3,2,2,322,0,727,151320,3,105
2012-01-27,spring,2012,January,12,Friday,Workingday,Mist,0.5,0.4848,0.88,0.1642,25,155,180,180,339,180,3,3,2,332,0,728,184414,3,180
2012-01-27,spring,2012,January,13,Friday,Workingday,Clear,0.5,0.4848,0.59,0.4627,26,175,201,201,339,201,3,3,2,332,1,729,184919,3,201
2012-01-27,spring,2012,January,14,Friday,Workingday,Clear,0.5,0.4848,0.55,0.5522,23,153,176,176,339,176,3,3,2,332,1,729,175652,3,176
2012-01-27,spring,2012,January,15,Friday,Workingday,Clear,0.48,0.4697,0.51,0.3284,27,170,197,197,339,197,3,3,2,332,1,729,183149,3,197
2012-01-27,spring,2012,January,16,Friday,Workingday,Clear,0.44,0.4394,0.51,0.5522,26,241,267,267,339,267,3,3,2,332,1,730,227748,3,267
2012-01-27,spring,2012,January,17,Friday,Workingday,Clear,0.42,0.4242,0.5,0.5821,16,406,422,422,339,422,3,4,2,342,1,730,336860,3,422
2012-01-27,spring,2012,January,18,Friday,Workingday,Clear,0.4,0.4091,0.5,0.4925,20,363,383,383,339,383,3,4,2,342,1,728,309772,3,383
2012-01-27,spring,2012,January,19,Friday,Workingday,Clear,0.36,0.3333,0.5,0.3881,10,241,251,251,339,251,3,3,1,331,1,728,226789,3,251
2012-01-27,spring,2012,January,20,Friday,Workingday,Clear,0.34,0.303,0.53,0.3582,6,153,159,159,339,159,3,3,1,331,1,728,164550,3,159
2012-01-27,spring,2012,January,21,Friday,Workingday,Clear,0.34,0.2879,0.53,0.5224,8,127,135,135,339,135,3,2,1,321,1,728,125445,3,135
2012-01-27,spring,2012,January,22,Friday,Workingday,Clear,0.34,0.303,0.49,0.3881,11,108,119,119,339,119,3,2,1,321,1,728,95612,3,119
2012-01-27,spring,2012,January,23,Friday,Workingday,Clear,0.32,0.2879,0.49,0.4179,8,78,86,86,339,86,3,2,1,321,1,728,63941,3,86
2012-01-28,spring,2012,January,0,Saturday,Holiday,Clear,0.3,0.2879,0.52,0.2836,1,68,69,69,338,69,3,2,1,321,1,726,39130,3,69
2012-01-28,spring,2012,January,1,Saturday,Holiday,Clear,0.3,0.303,0.52,0.1642,1,57,58,58,338,58,3,2,1,321,1,724,24164,3,58
2012-01-28,spring,2012,January,2,Saturday,Holiday,Clear,0.26,0.303,0.6,0.0,3,38,41,41,338,41,3,2,1,321,1,715,16352,3,41
2012-01-28,spring,2012,January,3,Saturday,Holiday,Clear,0.26,0.2879,0.6,0.0896,1,16,17,17,338,17,3,1,1,311,1,697,8174,3,17
2012-01-28,spring,2012,January,4,Saturday,Holiday,Clear,0.26,0.2576,0.6,0.1642,0,8,8,8,338,8,3,1,1,311,1,697,4428,3,8
2012-01-28,spring,2012,January,5,Saturday,Holiday,Clear,0.24,0.2576,0.75,0.0896,0,10,10,10,338,10,3,1,1,311,1,717,14261,3,10
2012-01-28,spring,2012,January,6,Saturday,Holiday,Clear,0.24,0.2879,0.7,0.0,3,12,15,15,338,15,3,1,1,311,1,725,55132,3,15
2012-01-28,spring,2012,January,7,Saturday,Holiday,Clear,0.22,0.2727,0.75,0.0,3,28,31,31,338,31,3,1,1,311,1,727,154171,3,31
2012-01-28,spring,2012,January,8,Saturday,Holiday,Clear,0.2,0.2273,0.8,0.0896,9,82,91,91,338,91,3,2,1,321,1,727,261001,3,91
2012-01-28,spring,2012,January,9,Saturday,Holiday,Clear,0.22,0.2727,0.8,0.0,13,145,158,158,338,158,3,3,1,331,1,727,159438,3,158
2012-01-28,spring,2012,January,10,Saturday,Holiday,Clear,0.26,0.2727,0.7,0.1343,27,164,191,191,338,191,3,3,1,331,1,727,126257,3,191
2012-01-28,spring,2012,January,11,Saturday,Holiday,Clear,0.3,0.303,0.56,0.1343,55,241,296,296,338,296,3,4,1,341,1,727,151320,3,296
2012-01-28,spring,2012,January,12,Saturday,Holiday,Clear,0.3,0.2879,0.61,0.2836,70,244,314,314,338,314,3,4,1,341,1,728,184414,3,314
2012-01-28,spring,2012,January,13,Saturday,Holiday,Clear,0.34,0.3182,0.57,0.2537,80,293,373,373,338,373,3,4,1,341,1,729,184919,3,373
2012-01-28,spring,2012,January,14,Saturday,Holiday,Clear,0.38,0.3939,0.5,0.3881,123,239,362,362,338,362,3,4,2,342,2,729,175652,3,362
2012-01-28,spring,2012,January,15,Saturday,Holiday,Clear,0.4,0.4091,0.47,0.3284,90,320,410,410,338,410,3,4,2,342,2,729,183149,3,410
2012-01-28,spring,2012,January,16,Saturday,Holiday,Clear,0.42,0.4242,0.44,0.3582,131,276,407,407,338,407,3,4,2,342,2,730,227748,3,407
2012-01-28,spring,2012,January,17,Saturday,Holiday,Clear,0.42,0.4242,0.44,0.3881,57,233,290,290,338,290,3,4,2,342,1,730,336860,3,290
2012-01-28,spring,2012,January,18,Saturday,Holiday,Clear,0.42,0.4242,0.41,0.2239,40,201,241,241,338,241,3,3,2,332,1,728,309772,3,241
2012-01-28,spring,2012,January,19,Saturday,Holiday,Mist,0.42,0.4242,0.41,0.5522,33,173,206,206,338,206,3,3,2,332,1,728,226789,3,206
2012-01-28,spring,2012,January,20,Saturday,Holiday,Clear,0.4,0.4091,0.35,0.3881,5,115,120,120,338,120,3,2,2,322,1,728,164550,3,120
2012-01-28,spring,2012,January,21,Saturday,Holiday,Clear,0.36,0.3333,0.29,0.3582,18,109,127,127,338,127,3,2,1,321,1,728,125445,3,127
2012-01-28,spring,2012,January,22,Saturday,Holiday,Clear,0.34,0.3333,0.34,0.194,6,97,103,103,338,103,3,2,1,321,1,728,95612,3,103
2012-01-28,spring,2012,January,23,Saturday,Holiday,Clear,0.32,0.3182,0.31,0.194,6,79,85,85,338,85,3,2,1,321,1,728,63941,3,85
2012-01-29,spring,2012,January,0,Sunday,Holiday,Clear,0.3,0.2879,0.33,0.2239,15,81,96,96,337,96,3,2,1,321,1,726,39130,3,96
2012-01-29,spring,2012,January,1,Sunday,Holiday,Clear,0.3,0.2727,0.28,0.3582,5,68,73,73,337,73,3,2,1,321,1,724,24164,3,73
2012-01-29,spring,2012,January,2,Sunday,Holiday,Clear,0.28,0.2576,0.26,0.3284,3,48,51,51,337,51,3,2,1,321,1,715,16352,3,51
2012-01-29,spring,2012,January,3,Sunday,Holiday,Clear,0.26,0.2576,0.28,0.194,4,17,21,21,337,21,3,1,1,311,1,697,8174,3,21
2012-01-29,spring,2012,January,4,Sunday,Holiday,Clear,0.24,0.2576,0.3,0.0,0,5,5,5,337,5,3,1,1,311,1,697,4428,3,5
2012-01-29,spring,2012,January,5,Sunday,Holiday,Clear,0.2,0.2121,0.51,0.1343,1,6,7,7,337,7,3,1,1,311,1,717,14261,3,7
2012-01-29,spring,2012,January,6,Sunday,Holiday,Clear,0.2,0.2273,0.4,0.1045,1,4,5,5,337,5,3,1,1,311,1,725,55132,3,5
2012-01-29,spring,2012,January,7,Sunday,Holiday,Clear,0.2,0.2121,0.37,0.1343,0,12,12,12,337,12,3,1,1,311,1,727,154171,3,12
2012-01-29,spring,2012,January,8,Sunday,Holiday,Clear,0.18,0.197,0.4,0.1343,9,61,70,70,337,70,3,2,1,321,1,727,261001,3,70
2012-01-29,spring,2012,January,9,Sunday,Holiday,Clear,0.18,0.197,0.43,0.1343,13,98,111,111,337,111,3,2,1,321,1,727,159438,3,111
2012-01-29,spring,2012,January,10,Sunday,Holiday,Clear,0.24,0.2424,0.35,0.1343,38,153,191,191,337,191,3,3,1,331,1,727,126257,3,191
2012-01-29,spring,2012,January,11,Sunday,Holiday,Clear,0.28,0.2727,0.28,0.2239,57,198,255,255,337,255,3,3,1,331,1,727,151320,3,255
2012-01-29,spring,2012,January,12,Sunday,Holiday,Clear,0.32,0.303,0.26,0.2239,73,215,288,288,337,288,3,4,1,341,1,728,184414,3,288
2012-01-29,spring,2012,January,13,Sunday,Holiday,Clear,0.32,0.303,0.26,0.2239,78,238,316,316,337,316,3,4,1,341,1,729,184919,3,316
2012-01-29,spring,2012,January,14,Sunday,Holiday,Clear,0.32,0.303,0.26,0.2537,51,229,280,280,337,280,3,3,1,331,1,729,175652,3,280
2012-01-29,spring,2012,January,15,Sunday,Holiday,Clear,0.36,0.3333,0.25,0.2836,68,242,310,310,337,310,3,4,1,341,1,729,183149,3,310
2012-01-29,spring,2012,January,16,Sunday,Holiday,Clear,0.36,0.3333,0.21,0.4179,54,268,322,322,337,322,3,4,1,341,1,730,227748,3,322
2012-01-29,spring,2012,January,17,Sunday,Holiday,Clear,0.36,0.3333,0.21,0.4179,33,201,234,234,337,234,3,3,1,331,1,730,336860,3,234
2012-01-29,spring,2012,January,18,Sunday,Holiday,Clear,0.34,0.303,0.23,0.3582,17,151,168,168,337,168,3,3,1,331,1,728,309772,3,168
2012-01-29,spring,2012,January,19,Sunday,Holiday,Clear,0.32,0.303,0.29,0.2537,14,145,159,159,337,159,3,3,1,331,1,728,226789,3,159
2012-01-29,spring,2012,January,20,Sunday,Holiday,Clear,0.3,0.2879,0.39,0.2239,13,98,111,111,337,111,3,2,1,321,1,728,164550,3,111
2012-01-29,spring,2012,January,21,Sunday,Holiday,Clear,0.3,0.2879,0.33,0.2836,0,69,69,69,337,69,3,2,1,321,1,728,125445,3,69
2012-01-29,spring,2012,January,22,Sunday,Holiday,Clear,0.32,0.2879,0.26,0.3881,7,57,64,64,337,64,3,2,1,321,1,728,95612,3,64
2012-01-29,spring,2012,January,23,Sunday,Holiday,Clear,0.3,0.2727,0.33,0.3284,4,21,25,25,337,25,3,1,1,311,1,728,63941,3,25
2012-01-30,spring,2012,January,0,Monday,Workingday,Mist,0.32,0.2879,0.26,0.4179,0,10,10,10,336,10,3,1,1,311,1,726,39130,3,10
2012-01-30,spring,2012,January,1,Monday,Workingday,Clear,0.26,0.2273,0.6,0.3582,0,9,9,9,336,9,3,1,1,311,1,724,24164,3,9
2012-01-30,spring,2012,January,2,Monday,Workingday,Clear,0.24,0.2121,0.48,0.3582,1,6,7,7,336,7,3,1,1,311,1,715,16352,3,7
2012-01-30,spring,2012,January,3,Monday,Workingday,Clear,0.24,0.2273,0.48,0.194,0,4,4,4,336,4,3,1,1,311,1,697,8174,3,4
2012-01-30,spring,2012,January,4,Monday,Workingday,Clear,0.2,0.2121,0.51,0.1343,0,5,5,5,336,5,3,1,1,311,1,697,4428,3,5
2012-01-30,spring,2012,January,5,Monday,Workingday,Clear,0.2,0.2121,0.51,0.1343,0,26,26,26,336,26,3,1,1,311,1,717,14261,3,26
2012-01-30,spring,2012,January,6,Monday,Workingday,Clear,0.22,0.2121,0.44,0.2537,0,80,80,80,336,80,3,2,1,321,1,725,55132,3,80
2012-01-30,spring,2012,January,7,Monday,Workingday,Clear,0.22,0.2121,0.44,0.2836,4,221,225,225,336,225,3,3,1,331,1,727,154171,3,225
2012-01-30,spring,2012,January,8,Monday,Workingday,Clear,0.2,0.197,0.47,0.2239,12,481,493,493,336,493,3,4,1,341,1,727,261001,3,493
2012-01-30,spring,2012,January,9,Monday,Workingday,Clear,0.2,0.197,0.47,0.2239,5,193,198,198,336,198,3,3,1,331,1,727,159438,3,198
2012-01-30,spring,2012,January,10,Monday,Workingday,Clear,0.22,0.2121,0.41,0.2836,3,82,85,85,336,85,3,2,1,321,1,727,126257,3,85
2012-01-30,spring,2012,January,11,Monday,Workingday,Clear,0.26,0.2576,0.38,0.0,6,93,99,99,336,99,3,2,1,321,1,727,151320,3,99
2012-01-30,spring,2012,January,12,Monday,Workingday,Clear,0.26,0.2273,0.35,0.3881,5,129,134,134,336,134,3,2,1,321,1,728,184414,3,134
2012-01-30,spring,2012,January,13,Monday,Workingday,Clear,0.3,0.2879,0.31,0.194,15,117,132,132,336,132,3,2,1,321,1,729,184919,3,132
2012-01-30,spring,2012,January,14,Monday,Workingday,Clear,0.32,0.3333,0.24,0.1343,15,100,115,115,336,115,3,2,1,321,1,729,175652,3,115
2012-01-30,spring,2012,January,15,Monday,Workingday,Clear,0.32,0.3182,0.24,0.194,7,131,138,138,336,138,3,2,1,321,1,729,183149,3,138
2012-01-30,spring,2012,January,16,Monday,Workingday,Clear,0.34,0.3333,0.25,0.194,11,210,221,221,336,221,3,3,1,331,1,730,227748,3,221
2012-01-30,spring,2012,January,17,Monday,Workingday,Clear,0.36,0.3485,0.21,0.194,16,422,438,438,336,438,3,4,2,342,1,730,336860,3,438
2012-01-30,spring,2012,January,18,Monday,Workingday,Clear,0.34,0.3333,0.23,0.1642,11,399,410,410,336,410,3,4,1,341,1,728,309772,3,410
2012-01-30,spring,2012,January,19,Monday,Workingday,Clear,0.3,0.3182,0.45,0.1045,8,298,306,306,336,306,3,4,1,341,1,728,226789,3,306
2012-01-30,spring,2012,January,20,Monday,Workingday,Clear,0.3,0.303,0.39,0.1642,2,179,181,181,336,181,3,3,1,331,1,728,164550,3,181
2012-01-30,spring,2012,January,21,Monday,Workingday,Clear,0.3,0.303,0.42,0.1642,3,159,162,162,336,162,3,3,1,331,1,728,125445,3,162
2012-01-30,spring,2012,January,22,Monday,Workingday,Clear,0.28,0.2727,0.48,0.2239,2,92,94,94,336,94,3,2,1,321,1,728,95612,3,94
2012-01-30,spring,2012,January,23,Monday,Workingday,Clear,0.26,0.2576,0.6,0.194,0,52,52,52,336,52,3,2,1,321,1,728,63941,3,52
2012-01-31,spring,2012,January,0,Tuesday,Workingday,Clear,0.28,0.2727,0.52,0.2537,0,15,15,15,335,15,3,1,1,311,1,726,39130,3,15
2012-01-31,spring,2012,January,1,Tuesday,Workingday,Clear,0.3,0.2727,0.42,0.2985,1,7,8,8,335,8,3,1,1,311,1,724,24164,3,8
2012-01-31,spring,2012,January,2,Tuesday,Workingday,Clear,0.3,0.2879,0.42,0.2239,0,2,2,2,335,2,3,1,1,311,1,715,16352,3,2
2012-01-31,spring,2012,January,3,Tuesday,Workingday,Clear,0.3,0.2879,0.45,0.2239,0,2,2,2,335,2,3,1,1,311,1,697,8174,3,2
2012-01-31,spring,2012,January,4,Tuesday,Workingday,Clear,0.3,0.2879,0.49,0.194,0,1,1,1,335,1,3,1,1,311,1,697,4428,3,1
2012-01-31,spring,2012,January,5,Tuesday,Workingday,Clear,0.3,0.2879,0.49,0.194,0,22,22,22,335,22,3,1,1,311,1,717,14261,3,22
2012-01-31,spring,2012,January,6,Tuesday,Workingday,Clear,0.28,0.2727,0.52,0.1642,0,104,104,104,335,104,3,2,1,321,1,725,55132,3,104
2012-01-31,spring,2012,January,7,Tuesday,Workingday,Clear,0.26,0.2576,0.6,0.194,6,273,279,279,335,279,3,3,1,331,1,727,154171,3,279
2012-01-31,spring,2012,January,8,Tuesday,Workingday,Clear,0.26,0.2727,0.6,0.1045,14,498,512,512,335,512,3,4,1,341,1,727,261001,3,512
2012-01-31,spring,2012,January,9,Tuesday,Workingday,Clear,0.3,0.2879,0.52,0.194,30,231,261,261,335,261,3,3,1,331,1,727,159438,3,261
2012-01-31,spring,2012,January,10,Tuesday,Workingday,Mist,0.32,0.3182,0.57,0.194,34,110,144,144,335,144,3,3,1,331,1,727,126257,3,144
2012-01-31,spring,2012,January,11,Tuesday,Workingday,Clear,0.4,0.4091,0.37,0.2836,14,125,139,139,335,139,3,2,2,322,1,727,151320,3,139
2012-01-31,spring,2012,January,12,Tuesday,Workingday,Clear,0.4,0.4091,0.43,0.2985,13,181,194,194,335,194,3,3,2,332,1,728,184414,3,194
2012-01-31,spring,2012,January,13,Tuesday,Workingday,Clear,0.46,0.4545,0.36,0.2239,27,171,198,198,335,198,3,3,2,332,1,729,184919,3,198
2012-01-31,spring,2012,January,14,Tuesday,Workingday,Clear,0.5,0.4848,0.29,0.3284,18,142,160,160,335,160,3,3,2,332,1,729,175652,3,160
2012-01-31,spring,2012,January,15,Tuesday,Workingday,Clear,0.54,0.5152,0.26,0.4478,27,150,177,177,335,177,3,3,3,333,2,729,183149,3,177
2012-01-31,spring,2012,January,16,Tuesday,Workingday,Clear,0.54,0.5152,0.26,0.4478,30,277,307,307,335,307,3,4,3,343,2,730,227748,3,307
2012-01-31,spring,2012,January,17,Tuesday,Workingday,Clear,0.54,0.5152,0.26,0.4179,41,518,559,559,335,559,3,4,3,343,2,730,336860,3,559
2012-01-31,spring,2012,January,18,Tuesday,Workingday,Clear,0.54,0.5152,0.24,0.3582,16,486,502,502,335,502,3,4,3,343,2,728,309772,3,502
2012-01-31,spring,2012,January,19,Tuesday,Workingday,Clear,0.5,0.4848,0.29,0.2836,22,306,328,328,335,328,3,4,2,342,2,728,226789,3,328
2012-01-31,spring,2012,January,20,Tuesday,Workingday,Clear,0.4,0.4091,0.58,0.1045,15,223,238,238,335,238,3,3,2,332,1,728,164550,3,238
2012-01-31,spring,2012,January,21,Tuesday,Workingday,Clear,0.46,0.4545,0.33,0.2985,3,162,165,165,335,165,3,3,2,332,1,728,125445,3,165
2012-01-31,spring,2012,January,22,Tuesday,Workingday,Clear,0.44,0.4394,0.35,0.2985,11,118,129,129,335,129,3,2,2,322,1,728,95612,3,129
2012-01-31,spring,2012,January,23,Tuesday,Workingday,Clear,0.44,0.4394,0.38,0.2537,2,61,63,63,335,63,3,2,2,322,1,728,63941,3,63
2012-02-01,spring,2012,February,0,Wednesday,Workingday,Clear,0.44,0.4394,0.38,0.2836,0,31,31,31,334,31,3,1,2,312,1,726,39130,3,31
2012-02-01,spring,2012,February,1,Wednesday,Workingday,Clear,0.44,0.4394,0.41,0.2836,0,4,4,4,334,4,3,1,2,312,1,724,24164,3,4
2012-02-01,spring,2012,February,2,Wednesday,Workingday,Clear,0.44,0.4394,0.44,0.2836,1,6,7,7,334,7,3,1,2,312,1,715,16352,3,7
2012-02-01,spring,2012,February,3,Wednesday,Workingday,Clear,0.44,0.4394,0.44,0.194,0,3,3,3,334,3,3,1,2,312,1,697,8174,3,3
2012-02-01,spring,2012,February,4,Wednesday,Workingday,Clear,0.4,0.4091,0.5,0.1642,0,1,1,1,334,1,3,1,2,312,1,697,4428,3,1
2012-02-01,spring,2012,February,5,Wednesday,Workingday,Clear,0.4,0.4091,0.5,0.1642,0,18,18,18,334,18,3,1,2,312,1,717,14261,3,18
2012-02-01,spring,2012,February,6,Wednesday,Workingday,Light Snow,0.4,0.4091,0.54,0.1642,0,67,67,67,334,67,3,2,2,322,1,725,55132,3,67
2012-02-01,spring,2012,February,7,Wednesday,Workingday,Light Snow,0.38,0.3939,0.62,0.0896,7,201,208,208,334,208,3,3,2,332,1,727,154171,3,208
2012-02-01,spring,2012,February,8,Wednesday,Workingday,Light Snow,0.36,0.3636,0.73,0.1045,15,505,520,520,334,520,3,4,2,342,1,727,261001,3,520
2012-02-01,spring,2012,February,9,Wednesday,Workingday,Mist,0.36,0.3485,0.71,0.194,9,267,276,276,334,276,3,3,2,332,1,727,159438,3,276
2012-02-01,spring,2012,February,10,Wednesday,Workingday,Clear,0.4,0.4091,0.62,0.1343,9,124,133,133,334,133,3,2,2,322,1,727,126257,3,133
2012-02-01,spring,2012,February,11,Wednesday,Workingday,Clear,0.4,0.4091,0.58,0.1642,27,116,143,143,334,143,3,3,2,332,1,727,151320,3,143
2012-02-01,spring,2012,February,12,Wednesday,Workingday,Clear,0.44,0.4394,0.54,0.1045,26,153,179,179,334,179,3,3,2,332,1,728,184414,3,179
2012-02-01,spring,2012,February,13,Wednesday,Workingday,Clear,0.46,0.4545,0.47,0.2239,12,174,186,186,334,186,3,3,2,332,1,729,184919,3,186
2012-02-01,spring,2012,February,14,Wednesday,Workingday,Clear,0.62,0.6212,0.33,0.2239,33,159,192,192,334,192,3,3,3,333,2,729,175652,3,192
2012-02-01,spring,2012,February,15,Wednesday,Workingday,Clear,0.6,0.6212,0.35,0.2836,25,169,194,194,334,194,3,3,3,333,2,729,183149,3,194
2012-02-01,spring,2012,February,16,Wednesday,Workingday,Clear,0.6,0.6212,0.4,0.2239,22,261,283,283,334,283,3,4,3,343,2,730,227748,3,283
2012-02-01,spring,2012,February,17,Wednesday,Workingday,Clear,0.58,0.5455,0.43,0.194,31,508,539,539,334,539,3,4,3,343,2,730,336860,3,539
2012-02-01,spring,2012,February,18,Wednesday,Workingday,Clear,0.56,0.5303,0.46,0.1642,12,514,526,526,334,526,3,4,3,343,2,728,309772,3,526
2012-02-01,spring,2012,February,19,Wednesday,Workingday,Clear,0.54,0.5152,0.52,0.2836,20,315,335,335,334,335,3,4,3,343,2,728,226789,3,335
2012-02-01,spring,2012,February,20,Wednesday,Workingday,Clear,0.52,0.5,0.52,0.1642,10,254,264,264,334,264,3,3,3,333,0,728,164550,3,264
2012-02-01,spring,2012,February,21,Wednesday,Workingday,Clear,0.52,0.5,0.52,0.1642,16,217,233,233,334,233,3,3,3,333,0,728,125445,3,233
2012-02-01,spring,2012,February,22,Wednesday,Workingday,Clear,0.5,0.4848,0.55,0.194,7,133,140,140,334,140,3,2,2,322,0,728,95612,3,140
2012-02-01,spring,2012,February,23,Wednesday,Workingday,Clear,0.46,0.4545,0.63,0.0896,22,75,97,97,334,97,3,2,2,322,0,728,63941,3,97
2012-02-02,spring,2012,February,0,Thursday,Workingday,Clear,0.46,0.4545,0.59,0.1343,7,24,31,31,333,31,3,1,2,312,0,726,39130,3,31
2012-02-02,spring,2012,February,1,Thursday,Workingday,Mist,0.46,0.4545,0.55,0.0,3,14,17,17,333,17,3,1,2,312,0,724,24164,3,17
2012-02-02,spring,2012,February,2,Thursday,Workingday,Mist,0.42,0.4242,0.67,0.1343,2,7,9,9,333,9,3,1,2,312,0,715,16352,3,9
2012-02-02,spring,2012,February,3,Thursday,Workingday,Mist,0.42,0.4242,0.67,0.1343,0,2,2,2,333,2,3,1,2,312,0,697,8174,3,2
2012-02-02,spring,2012,February,4,Thursday,Workingday,Light Snow,0.4,0.4091,0.82,0.0896,0,1,1,1,333,1,3,1,2,312,0,697,4428,3,1
2012-02-02,spring,2012,February,5,Thursday,Workingday,Light Snow,0.4,0.4091,0.82,0.0,0,19,19,19,333,19,3,1,2,312,0,717,14261,3,19
2012-02-02,spring,2012,February,6,Thursday,Workingday,Light Snow,0.36,0.3788,0.9,0.0,1,73,74,74,333,74,3,2,2,322,0,725,55132,3,74
2012-02-02,spring,2012,February,7,Thursday,Workingday,Light Snow,0.36,0.3788,0.93,0.0,4,201,205,205,333,205,3,3,2,332,0,727,154171,3,205
2012-02-02,spring,2012,February,8,Thursday,Workingday,Light Snow,0.4,0.4091,0.87,0.0,9,436,445,445,333,445,3,4,2,342,0,727,261001,3,445
2012-02-02,spring,2012,February,9,Thursday,Workingday,Light Snow,0.38,0.3939,0.87,0.0,15,213,228,228,333,228,3,3,2,332,0,727,159438,3,228
2012-02-02,spring,2012,February,10,Thursday,Workingday,Light Snow,0.42,0.4242,0.77,0.1045,6,72,78,78,333,78,3,2,2,322,0,727,126257,3,78
2012-02-02,spring,2012,February,11,Thursday,Workingday,Light Snow,0.4,0.4091,0.82,0.2537,6,99,105,105,333,105,3,2,2,322,0,727,151320,3,105
2012-02-02,spring,2012,February,12,Thursday,Workingday,Clear,0.42,0.4242,0.82,0.0,8,140,148,148,333,148,3,3,2,332,0,728,184414,3,148
2012-02-02,spring,2012,February,13,Thursday,Workingday,Mist,0.42,0.4242,0.77,0.0,13,124,137,137,333,137,3,2,2,322,0,729,184919,3,137
2012-02-02,spring,2012,February,14,Thursday,Workingday,Clear,0.4,0.4091,0.76,0.1045,12,129,141,141,333,141,3,2,2,322,0,729,175652,3,141
2012-02-02,spring,2012,February,15,Thursday,Workingday,Clear,0.46,0.4545,0.67,0.1642,24,150,174,174,333,174,3,3,2,332,0,729,183149,3,174
2012-02-02,spring,2012,February,16,Thursday,Workingday,Clear,0.46,0.4545,0.55,0.2836,18,211,229,229,333,229,3,3,2,332,1,730,227748,3,229
2012-02-02,spring,2012,February,17,Thursday,Workingday,Clear,0.42,0.4242,0.54,0.4925,13,437,450,450,333,450,3,4,2,342,1,730,336860,3,450
2012-02-02,spring,2012,February,18,Thursday,Workingday,Clear,0.4,0.4091,0.43,0.4627,17,393,410,410,333,410,3,4,2,342,1,728,309772,3,410
2012-02-02,spring,2012,February,19,Thursday,Workingday,Clear,0.38,0.3939,0.43,0.5224,16,311,327,327,333,327,3,4,2,342,1,728,226789,3,327
2012-02-02,spring,2012,February,20,Thursday,Workingday,Clear,0.36,0.3182,0.46,0.5224,9,204,213,213,333,213,3,3,1,331,1,728,164550,3,213
2012-02-02,spring,2012,February,21,Thursday,Workingday,Clear,0.34,0.303,0.46,0.4179,4,144,148,148,333,148,3,3,1,331,1,728,125445,3,148
2012-02-02,spring,2012,February,22,Thursday,Workingday,Clear,0.32,0.2879,0.49,0.4179,3,106,109,109,333,109,3,2,1,321,1,728,95612,3,109
2012-02-02,spring,2012,February,23,Thursday,Workingday,Clear,0.32,0.303,0.49,0.2537,0,61,61,61,333,61,3,2,1,321,1,728,63941,3,61
2012-02-03,spring,2012,February,0,Friday,Workingday,Clear,0.32,0.2879,0.53,0.3881,1,37,38,38,332,38,3,1,1,311,1,726,39130,3,38
2012-02-03,spring,2012,February,1,Friday,Workingday,Clear,0.3,0.2727,0.56,0.3284,3,19,22,22,332,22,3,1,1,311,1,724,24164,3,22
2012-02-03,spring,2012,February,2,Friday,Workingday,Clear,0.3,0.2879,0.52,0.2239,0,6,6,6,332,6,3,1,1,311,1,715,16352,3,6
2012-02-03,spring,2012,February,3,Friday,Workingday,Clear,0.28,0.2576,0.56,0.2985,0,4,4,4,332,4,3,1,1,311,1,697,8174,3,4
2012-02-03,spring,2012,February,4,Friday,Workingday,Clear,0.26,0.2576,0.6,0.2239,0,2,2,2,332,2,3,1,1,311,1,697,4428,3,2
2012-02-03,spring,2012,February,5,Friday,Workingday,Clear,0.26,0.2576,0.6,0.2239,0,17,17,17,332,17,3,1,1,311,1,717,14261,3,17
2012-02-03,spring,2012,February,6,Friday,Workingday,Clear,0.24,0.2424,0.65,0.1642,0,88,88,88,332,88,3,2,1,321,1,725,55132,3,88
2012-02-03,spring,2012,February,7,Friday,Workingday,Clear,0.24,0.2273,0.65,0.2239,10,216,226,226,332,226,3,3,1,331,1,727,154171,3,226
2012-02-03,spring,2012,February,8,Friday,Workingday,Clear,0.24,0.2273,0.65,0.2239,12,429,441,441,332,441,3,4,1,341,1,727,261001,3,441
2012-02-03,spring,2012,February,9,Friday,Workingday,Clear,0.24,0.2273,0.65,0.194,18,252,270,270,332,270,3,3,1,331,1,727,159438,3,270
2012-02-03,spring,2012,February,10,Friday,Workingday,Clear,0.28,0.2576,0.56,0.2836,15,114,129,129,332,129,3,2,1,321,1,727,126257,3,129
2012-02-03,spring,2012,February,11,Friday,Workingday,Clear,0.32,0.303,0.53,0.2985,15,149,164,164,332,164,3,3,1,331,1,727,151320,3,164
2012-02-03,spring,2012,February,12,Friday,Workingday,Clear,0.34,0.3333,0.46,0.1343,25,191,216,216,332,216,3,3,1,331,1,728,184414,3,216
2012-02-03,spring,2012,February,13,Friday,Workingday,Clear,0.36,0.3636,0.46,0.0,25,173,198,198,332,198,3,3,2,332,1,729,184919,3,198
2012-02-03,spring,2012,February,14,Friday,Workingday,Clear,0.36,0.3485,0.46,0.2239,22,148,170,170,332,170,3,3,2,332,1,729,175652,3,170
2012-02-03,spring,2012,February,15,Friday,Workingday,Clear,0.38,0.3939,0.4,0.0,48,168,216,216,332,216,3,3,2,332,1,729,183149,3,216
2012-02-03,spring,2012,February,16,Friday,Workingday,Clear,0.4,0.4091,0.37,0.1045,36,275,311,311,332,311,3,4,2,342,1,730,227748,3,311
2012-02-03,spring,2012,February,17,Friday,Workingday,Clear,0.4,0.4091,0.37,0.0896,30,458,488,488,332,488,3,4,2,342,2,730,336860,3,488
2012-02-03,spring,2012,February,18,Friday,Workingday,Clear,0.38,0.3939,0.4,0.1343,17,368,385,385,332,385,3,4,2,342,1,728,309772,3,385
2012-02-03,spring,2012,February,19,Friday,Workingday,Clear,0.34,0.3485,0.49,0.1045,11,256,267,267,332,267,3,3,2,332,1,728,226789,3,267
2012-02-03,spring,2012,February,20,Friday,Workingday,Clear,0.34,0.3485,0.49,0.1045,8,155,163,163,332,163,3,3,2,332,1,728,164550,3,163
2012-02-03,spring,2012,February,21,Friday,Workingday,Clear,0.34,0.3485,0.49,0.1045,8,126,134,134,332,134,3,2,2,322,1,728,125445,3,134
2012-02-03,spring,2012,February,22,Friday,Workingday,Clear,0.34,0.3485,0.49,0.1045,3,116,119,119,332,119,3,2,2,322,1,728,95612,3,119
2012-02-03,spring,2012,February,23,Friday,Workingday,Clear,0.26,0.2727,0.7,0.1045,3,74,77,77,332,77,3,2,1,321,1,728,63941,3,77
2012-02-04,spring,2012,February,0,Saturday,Holiday,Clear,0.26,0.2727,0.7,0.1045,10,76,86,86,331,86,3,2,1,321,1,726,39130,3,86
2012-02-04,spring,2012,February,1,Saturday,Holiday,Clear,0.26,0.2727,0.7,0.1045,0,43,43,43,331,43,3,2,1,321,1,724,24164,3,43
2012-02-04,spring,2012,February,2,Saturday,Holiday,Clear,0.24,0.2576,0.7,0.0896,6,38,44,44,331,44,3,2,1,321,1,715,16352,3,44
2012-02-04,spring,2012,February,3,Saturday,Holiday,Clear,0.24,0.2879,0.75,0.0,1,17,18,18,331,18,3,1,1,311,1,697,8174,3,18
2012-02-04,spring,2012,February,4,Saturday,Holiday,Clear,0.24,0.2576,0.81,0.0896,1,5,6,6,331,6,3,1,1,311,1,697,4428,3,6
2012-02-04,spring,2012,February,5,Saturday,Holiday,Clear,0.24,0.2576,0.81,0.0896,1,3,4,4,331,4,3,1,1,311,1,717,14261,3,4
2012-02-04,spring,2012,February,6,Saturday,Holiday,Clear,0.22,0.2273,0.87,0.1343,1,4,5,5,331,5,3,1,1,311,1,725,55132,3,5
2012-02-04,spring,2012,February,7,Saturday,Holiday,Mist,0.24,0.2424,0.87,0.1343,1,27,28,28,331,28,3,1,1,311,1,727,154171,3,28
2012-02-04,spring,2012,February,8,Saturday,Holiday,Clear,0.24,0.2879,0.87,0.0,4,86,90,90,331,90,3,2,1,321,1,727,261001,3,90
2012-02-04,spring,2012,February,9,Saturday,Holiday,Clear,0.24,0.2424,0.81,0.1343,16,141,157,157,331,157,3,3,1,331,1,727,159438,3,157
2012-02-04,spring,2012,February,10,Saturday,Holiday,Clear,0.24,0.2576,0.87,0.1045,31,193,224,224,331,224,3,3,1,331,1,727,126257,3,224
2012-02-04,spring,2012,February,11,Saturday,Holiday,Clear,0.3,0.3333,0.7,0.0,46,224,270,270,331,270,3,3,1,331,1,727,151320,3,270
2012-02-04,spring,2012,February,12,Saturday,Holiday,Mist,0.3,0.3182,0.7,0.0896,40,260,300,300,331,300,3,4,1,341,1,728,184414,3,300
2012-02-04,spring,2012,February,13,Saturday,Holiday,Mist,0.3,0.2879,0.7,0.194,58,244,302,302,331,302,3,4,1,341,1,729,184919,3,302
2012-02-04,spring,2012,February,14,Saturday,Holiday,Mist,0.32,0.303,0.66,0.2239,47,229,276,276,331,276,3,3,1,331,1,729,175652,3,276
2012-02-04,spring,2012,February,15,Saturday,Holiday,Mist,0.32,0.303,0.66,0.2239,61,244,305,305,331,305,3,4,1,341,1,729,183149,3,305
2012-02-04,spring,2012,February,16,Saturday,Holiday,Mist,0.34,0.3333,0.61,0.1642,20,123,143,143,331,143,3,3,1,331,1,730,227748,3,143
2012-02-04,spring,2012,February,17,Saturday,Holiday,Light Snow,0.3,0.2879,0.7,0.194,13,54,67,67,331,67,3,2,1,321,1,730,336860,3,67
2012-02-04,spring,2012,February,18,Saturday,Holiday,Light Snow,0.28,0.2727,0.75,0.1642,6,58,64,64,331,64,3,2,1,321,1,728,309772,3,64
2012-02-04,spring,2012,February,19,Saturday,Holiday,Light Snow,0.26,0.2727,0.87,0.1343,5,75,80,80,331,80,3,2,1,321,1,728,226789,3,80
2012-02-04,spring,2012,February,20,Saturday,Holiday,Light Snow,0.24,0.2273,0.93,0.194,4,73,77,77,331,77,3,2,1,321,1,728,164550,3,77
2012-02-04,spring,2012,February,21,Saturday,Holiday,Light Snow,0.24,0.2424,0.93,0.1343,4,74,78,78,331,78,3,2,1,321,1,728,125445,3,78
2012-02-04,spring,2012,February,22,Saturday,Holiday,Mist,0.24,0.2576,0.87,0.0896,4,91,95,95,331,95,3,2,1,321,1,728,95612,3,95
2012-02-04,spring,2012,February,23,Saturday,Holiday,Mist,0.24,0.2424,0.87,0.1343,4,66,70,70,331,70,3,2,1,321,1,728,63941,3,70
2012-02-05,spring,2012,February,0,Sunday,Holiday,Mist,0.24,0.2424,0.87,0.1343,3,58,61,61,330,61,3,2,1,321,1,726,39130,3,61
2012-02-05,spring,2012,February,1,Sunday,Holiday,Mist,0.24,0.2576,0.93,0.1045,5,46,51,51,330,51,3,2,1,321,1,724,24164,3,51
2012-02-05,spring,2012,February,2,Sunday,Holiday,Mist,0.24,0.2576,0.93,0.1045,4,59,63,63,330,63,3,2,1,321,1,715,16352,3,63
2012-02-05,spring,2012,February,3,Sunday,Holiday,Light Snow,0.24,0.2576,0.87,0.0896,4,13,17,17,330,17,3,1,1,311,1,697,8174,3,17
2012-02-05,spring,2012,February,4,Sunday,Holiday,Mist,0.24,0.2424,0.87,0.1343,0,9,9,9,330,9,3,1,1,311,1,697,4428,3,9
2012-02-05,spring,2012,February,5,Sunday,Holiday,Light Snow,0.26,0.2576,0.81,0.194,0,4,4,4,330,4,3,1,1,311,1,717,14261,3,4
2012-02-05,spring,2012,February,6,Sunday,Holiday,Mist,0.26,0.2424,0.7,0.2537,0,4,4,4,330,4,3,1,1,311,1,725,55132,3,4
2012-02-05,spring,2012,February,7,Sunday,Holiday,Mist,0.24,0.2424,0.75,0.1642,0,16,16,16,330,16,3,1,1,311,1,727,154171,3,16
2012-02-05,spring,2012,February,8,Sunday,Holiday,Mist,0.24,0.2424,0.75,0.1642,4,58,62,62,330,62,3,2,1,321,1,727,261001,3,62
2012-02-05,spring,2012,February,9,Sunday,Holiday,Mist,0.24,0.2273,0.7,0.2239,9,83,92,92,330,92,3,2,1,321,1,727,159438,3,92
2012-02-05,spring,2012,February,10,Sunday,Holiday,Mist,0.26,0.2424,0.65,0.2836,10,138,148,148,330,148,3,3,1,331,1,727,126257,3,148
2012-02-05,spring,2012,February,11,Sunday,Holiday,Mist,0.26,0.2576,0.7,0.194,22,160,182,182,330,182,3,3,1,331,1,727,151320,3,182
2012-02-05,spring,2012,February,12,Sunday,Holiday,Mist,0.26,0.2576,0.65,0.194,25,223,248,248,330,248,3,3,1,331,1,728,184414,3,248
2012-02-05,spring,2012,February,13,Sunday,Holiday,Mist,0.28,0.2727,0.61,0.1642,33,241,274,274,330,274,3,3,1,331,1,729,184919,3,274
2012-02-05,spring,2012,February,14,Sunday,Holiday,Clear,0.3,0.303,0.61,0.1642,40,203,243,243,330,243,3,3,1,331,1,729,175652,3,243
2012-02-05,spring,2012,February,15,Sunday,Holiday,Mist,0.3,0.2879,0.56,0.2537,55,217,272,272,330,272,3,3,1,331,1,729,183149,3,272
2012-02-05,spring,2012,February,16,Sunday,Holiday,Clear,0.3,0.2879,0.56,0.2239,35,261,296,296,330,296,3,4,1,341,1,730,227748,3,296
2012-02-05,spring,2012,February,17,Sunday,Holiday,Clear,0.32,0.3182,0.53,0.1642,31,275,306,306,330,306,3,4,1,341,1,730,336860,3,306
2012-02-05,spring,2012,February,18,Sunday,Holiday,Clear,0.3,0.2879,0.52,0.2537,10,171,181,181,330,181,3,3,1,331,1,728,309772,3,181
2012-02-05,spring,2012,February,19,Sunday,Holiday,Clear,0.3,0.2879,0.52,0.2239,6,63,69,69,330,69,3,2,1,321,1,728,226789,3,69
2012-02-05,spring,2012,February,20,Sunday,Holiday,Clear,0.28,0.2727,0.56,0.194,3,47,50,50,330,50,3,2,1,321,1,728,164550,3,50
2012-02-05,spring,2012,February,21,Sunday,Holiday,Clear,0.28,0.2879,0.56,0.1045,6,60,66,66,330,66,3,2,1,321,1,728,125445,3,66
2012-02-05,spring,2012,February,22,Sunday,Holiday,Clear,0.26,0.2727,0.6,0.1045,9,182,191,191,330,191,3,3,1,331,1,728,95612,3,191
2012-02-05,spring,2012,February,23,Sunday,Holiday,Clear,0.24,0.2424,0.7,0.1343,4,38,42,42,330,42,3,2,1,321,1,728,63941,3,42
2012-02-06,spring,2012,February,0,Monday,Workingday,Clear,0.24,0.2424,0.65,0.1343,7,14,21,21,329,21,3,1,1,311,1,726,39130,3,21
2012-02-06,spring,2012,February,1,Monday,Workingday,Clear,0.22,0.2576,0.75,0.0896,0,6,6,6,329,6,3,1,1,311,1,724,24164,3,6
2012-02-06,spring,2012,February,2,Monday,Workingday,Clear,0.22,0.2727,0.75,0.0,0,3,3,3,329,3,3,1,1,311,1,715,16352,3,3
2012-02-06,spring,2012,February,4,Monday,Workingday,Clear,0.18,0.2121,0.8,0.1045,0,2,2,2,329,2,3,1,1,311,1,697,4428,3,2
2012-02-06,spring,2012,February,5,Monday,Workingday,Clear,0.18,0.2121,0.8,0.1045,0,17,17,17,329,17,3,1,1,311,1,717,14261,3,17
2012-02-06,spring,2012,February,6,Monday,Workingday,Clear,0.16,0.1818,0.86,0.1045,0,72,72,72,329,72,3,2,1,321,1,725,55132,3,72
2012-02-06,spring,2012,February,7,Monday,Workingday,Clear,0.16,0.1818,0.86,0.1045,5,229,234,234,329,234,3,3,1,331,1,727,154171,3,234
2012-02-06,spring,2012,February,8,Monday,Workingday,Clear,0.16,0.1818,0.86,0.1343,10,434,444,444,329,444,3,4,1,341,1,727,261001,3,444
2012-02-06,spring,2012,February,9,Monday,Workingday,Clear,0.18,0.2121,0.8,0.1045,8,269,277,277,329,277,3,3,1,331,1,727,159438,3,277
2012-02-06,spring,2012,February,10,Monday,Workingday,Clear,0.22,0.2424,0.75,0.1045,20,96,116,116,329,116,3,2,1,321,1,727,126257,3,116
2012-02-06,spring,2012,February,11,Monday,Workingday,Clear,0.26,0.2727,0.7,0.1343,12,104,116,116,329,116,3,2,1,321,1,727,151320,3,116
2012-02-06,spring,2012,February,12,Monday,Workingday,Clear,0.32,0.3182,0.61,0.1642,19,131,150,150,329,150,3,3,1,331,1,728,184414,3,150
2012-02-06,spring,2012,February,13,Monday,Workingday,Clear,0.38,0.3939,0.4,0.2239,17,124,141,141,329,141,3,2,2,322,1,729,184919,3,141
2012-02-06,spring,2012,February,14,Monday,Workingday,Clear,0.4,0.4091,0.35,0.1642,14,126,140,140,329,140,3,2,2,322,1,729,175652,3,140
2012-02-06,spring,2012,February,15,Monday,Workingday,Clear,0.42,0.4242,0.32,0.2836,25,146,171,171,329,171,3,3,2,332,1,729,183149,3,171
2012-02-06,spring,2012,February,16,Monday,Workingday,Clear,0.4,0.4091,0.43,0.2537,13,215,228,228,329,228,3,3,2,332,1,730,227748,3,228
2012-02-06,spring,2012,February,17,Monday,Workingday,Clear,0.4,0.4091,0.43,0.2537,13,417,430,430,329,430,3,4,2,342,1,730,336860,3,430
2012-02-06,spring,2012,February,18,Monday,Workingday,Clear,0.38,0.3939,0.43,0.2239,11,426,437,437,329,437,3,4,2,342,1,728,309772,3,437
2012-02-06,spring,2012,February,19,Monday,Workingday,Clear,0.36,0.3333,0.43,0.2537,7,284,291,291,329,291,3,4,1,341,1,728,226789,3,291
2012-02-06,spring,2012,February,20,Monday,Workingday,Clear,0.34,0.3333,0.46,0.1642,7,194,201,201,329,201,3,3,1,331,1,728,164550,3,201
2012-02-06,spring,2012,February,21,Monday,Workingday,Clear,0.32,0.3182,0.57,0.1642,11,143,154,154,329,154,3,3,1,331,1,728,125445,3,154
2012-02-06,spring,2012,February,22,Monday,Workingday,Clear,0.3,0.303,0.65,0.1343,4,83,87,87,329,87,3,2,1,321,1,728,95612,3,87
2012-02-06,spring,2012,February,23,Monday,Workingday,Clear,0.3,0.303,0.65,0.1343,3,43,46,46,329,46,3,2,1,321,1,728,63941,3,46
2012-02-07,spring,2012,February,0,Tuesday,Workingday,Clear,0.3,0.2879,0.7,0.194,1,22,23,23,328,23,3,1,1,311,1,726,39130,3,23
2012-02-07,spring,2012,February,1,Tuesday,Workingday,Clear,0.28,0.2879,0.61,0.1343,8,6,14,14,328,14,3,1,1,311,1,724,24164,3,14
2012-02-07,spring,2012,February,2,Tuesday,Workingday,Clear,0.3,0.3333,0.61,0.0,0,4,4,4,328,4,3,1,1,311,1,715,16352,3,4
2012-02-07,spring,2012,February,3,Tuesday,Workingday,Mist,0.3,0.3333,0.7,0.0,1,1,2,2,328,2,3,1,1,311,1,697,8174,3,2
2012-02-07,spring,2012,February,4,Tuesday,Workingday,Mist,0.3,0.3333,0.7,0.0,0,3,3,3,328,3,3,1,1,311,1,697,4428,3,3
2012-02-07,spring,2012,February,5,Tuesday,Workingday,Clear,0.32,0.3333,0.49,0.0896,0,15,15,15,328,15,3,1,1,311,1,717,14261,3,15
2012-02-07,spring,2012,February,6,Tuesday,Workingday,Clear,0.32,0.303,0.45,0.2985,2,98,100,100,328,100,3,2,1,321,1,725,55132,3,100
2012-02-07,spring,2012,February,7,Tuesday,Workingday,Clear,0.32,0.3485,0.45,0.0,6,293,299,299,328,299,3,4,2,342,1,727,154171,3,299
2012-02-07,spring,2012,February,8,Tuesday,Workingday,Clear,0.3,0.3182,0.49,0.0,7,522,529,529,328,529,3,4,1,341,1,727,261001,3,529
2012-02-07,spring,2012,February,9,Tuesday,Workingday,Clear,0.32,0.3333,0.49,0.0,11,278,289,289,328,289,3,4,1,341,1,727,159438,3,289
2012-02-07,spring,2012,February,10,Tuesday,Workingday,Clear,0.34,0.3333,0.46,0.1642,12,104,116,116,328,116,3,2,1,321,1,727,126257,3,116
2012-02-07,spring,2012,February,11,Tuesday,Workingday,Clear,0.36,0.3485,0.46,0.194,9,120,129,129,328,129,3,2,2,322,1,727,151320,3,129
2012-02-07,spring,2012,February,12,Tuesday,Workingday,Clear,0.4,0.4091,0.4,0.3284,9,163,172,172,328,172,3,3,2,332,1,728,184414,3,172
2012-02-07,spring,2012,February,13,Tuesday,Workingday,Clear,0.44,0.4394,0.38,0.2537,15,169,184,184,328,184,3,3,2,332,1,729,184919,3,184
2012-02-07,spring,2012,February,14,Tuesday,Workingday,Clear,0.44,0.4394,0.38,0.2537,11,127,138,138,328,138,3,2,2,322,1,729,175652,3,138
2012-02-07,spring,2012,February,15,Tuesday,Workingday,Clear,0.44,0.4394,0.38,0.194,13,133,146,146,328,146,3,3,2,332,1,729,183149,3,146
2012-02-07,spring,2012,February,16,Tuesday,Workingday,Clear,0.44,0.4394,0.35,0.2537,19,257,276,276,328,276,3,3,2,332,1,730,227748,3,276
2012-02-07,spring,2012,February,17,Tuesday,Workingday,Clear,0.44,0.4394,0.35,0.194,15,494,509,509,328,509,3,4,2,342,2,730,336860,3,509
2012-02-07,spring,2012,February,18,Tuesday,Workingday,Clear,0.42,0.4242,0.38,0.194,10,508,518,518,328,518,3,4,2,342,2,728,309772,3,518
2012-02-07,spring,2012,February,19,Tuesday,Workingday,Clear,0.38,0.3939,0.43,0.2239,11,327,338,338,328,338,3,4,2,342,1,728,226789,3,338
2012-02-07,spring,2012,February,20,Tuesday,Workingday,Clear,0.36,0.3485,0.5,0.1343,6,206,212,212,328,212,3,3,2,332,1,728,164550,3,212
2012-02-07,spring,2012,February,21,Tuesday,Workingday,Clear,0.34,0.3485,0.61,0.1045,20,170,190,190,328,190,3,3,2,332,1,728,125445,3,190
2012-02-07,spring,2012,February,22,Tuesday,Workingday,Clear,0.32,0.3182,0.57,0.194,11,107,118,118,328,118,3,2,1,321,1,728,95612,3,118
2012-02-07,spring,2012,February,23,Tuesday,Workingday,Clear,0.32,0.3333,0.57,0.1343,2,49,51,51,328,51,3,2,1,321,1,728,63941,3,51
2012-02-08,spring,2012,February,0,Wednesday,Workingday,Clear,0.3,0.2879,0.56,0.2239,2,21,23,23,327,23,3,1,1,311,1,726,39130,3,23
2012-02-08,spring,2012,February,1,Wednesday,Workingday,Clear,0.28,0.2727,0.61,0.1642,1,9,10,10,327,10,3,1,1,311,1,724,24164,3,10
2012-02-08,spring,2012,February,2,Wednesday,Workingday,Clear,0.26,0.303,0.65,0.0,0,1,1,1,327,1,3,1,1,311,1,715,16352,3,1
2012-02-08,spring,2012,February,3,Wednesday,Workingday,Clear,0.26,0.303,0.65,0.0,0,1,1,1,327,1,3,1,1,311,1,697,8174,3,1
2012-02-08,spring,2012,February,4,Wednesday,Workingday,Clear,0.24,0.2576,0.7,0.0896,0,1,1,1,327,1,3,1,1,311,1,697,4428,3,1
2012-02-08,spring,2012,February,5,Wednesday,Workingday,Clear,0.24,0.2576,0.7,0.0896,0,20,20,20,327,20,3,1,1,311,1,717,14261,3,20
2012-02-08,spring,2012,February,6,Wednesday,Workingday,Mist,0.24,0.2879,0.7,0.0,3,95,98,98,327,98,3,2,1,321,1,725,55132,3,98
2012-02-08,spring,2012,February,7,Wednesday,Workingday,Mist,0.24,0.2576,0.7,0.1045,5,276,281,281,327,281,3,3,1,331,1,727,154171,3,281
2012-02-08,spring,2012,February,8,Wednesday,Workingday,Mist,0.24,0.2273,0.7,0.2239,13,495,508,508,327,508,3,4,1,341,1,727,261001,3,508
2012-02-08,spring,2012,February,9,Wednesday,Workingday,Mist,0.24,0.2576,0.7,0.1642,8,245,253,253,327,253,3,3,1,331,1,727,159438,3,253
2012-02-08,spring,2012,February,10,Wednesday,Workingday,Mist,0.26,0.2576,0.7,0.2239,1,107,108,108,327,108,3,2,1,321,1,727,126257,3,108
2012-02-08,spring,2012,February,11,Wednesday,Workingday,Mist,0.26,0.2576,0.65,0.2239,5,97,102,102,327,102,3,2,1,321,1,727,151320,3,102
2012-02-08,spring,2012,February,12,Wednesday,Workingday,Mist,0.28,0.2576,0.65,0.2836,14,124,138,138,327,138,3,2,1,321,1,728,184414,3,138
2012-02-08,spring,2012,February,13,Wednesday,Workingday,Mist,0.28,0.2879,0.61,0.1045,15,111,126,126,327,126,3,2,1,321,1,729,184919,3,126
2012-02-08,spring,2012,February,14,Wednesday,Workingday,Mist,0.3,0.303,0.56,0.1642,8,100,108,108,327,108,3,2,1,321,1,729,175652,3,108
2012-02-08,spring,2012,February,15,Wednesday,Workingday,Light Snow,0.3,0.3182,0.61,0.1045,5,49,54,54,327,54,3,2,1,321,1,729,183149,3,54
2012-02-08,spring,2012,February,16,Wednesday,Workingday,Light Snow,0.26,0.2727,0.81,0.1045,2,73,75,75,327,75,3,2,1,321,1,730,227748,3,75
2012-02-08,spring,2012,February,17,Wednesday,Workingday,Light Snow,0.24,0.2576,0.87,0.1045,8,147,155,155,327,155,3,3,1,331,1,730,336860,3,155
2012-02-08,spring,2012,February,18,Wednesday,Workingday,Light Snow,0.24,0.2576,0.87,0.1045,4,163,167,167,327,167,3,3,1,331,1,728,309772,3,167
2012-02-08,spring,2012,February,19,Wednesday,Workingday,Light Snow,0.24,0.2576,0.87,0.1045,3,158,161,161,327,161,3,3,1,331,1,728,226789,3,161
2012-02-08,spring,2012,February,20,Wednesday,Workingday,Light Snow,0.24,0.2424,0.87,0.1343,3,122,125,125,327,125,3,2,1,321,1,728,164550,3,125
2012-02-08,spring,2012,February,21,Wednesday,Workingday,Light Snow,0.24,0.2273,0.87,0.194,3,126,129,129,327,129,3,2,1,321,1,728,125445,3,129
2012-02-08,spring,2012,February,22,Wednesday,Workingday,Mist,0.24,0.2424,0.87,0.1343,3,95,98,98,327,98,3,2,1,321,1,728,95612,3,98
2012-02-08,spring,2012,February,23,Wednesday,Workingday,Mist,0.24,0.2424,0.87,0.1642,3,57,60,60,327,60,3,2,1,321,1,728,63941,3,60
2012-02-09,spring,2012,February,0,Thursday,Workingday,Mist,0.24,0.2424,0.87,0.1642,3,23,26,26,326,26,3,1,1,311,1,726,39130,3,26
2012-02-09,spring,2012,February,1,Thursday,Workingday,Mist,0.24,0.2424,0.87,0.1343,2,10,12,12,326,12,3,1,1,311,1,724,24164,3,12
2012-02-09,spring,2012,February,2,Thursday,Workingday,Clear,0.22,0.2273,0.8,0.1343,0,2,2,2,326,2,3,1,1,311,1,715,16352,3,2
2012-02-09,spring,2012,February,3,Thursday,Workingday,Clear,0.22,0.2121,0.8,0.2836,0,4,4,4,326,4,3,1,1,311,1,697,8174,3,4
2012-02-09,spring,2012,February,4,Thursday,Workingday,Mist,0.22,0.197,0.75,0.4478,0,1,1,1,326,1,3,1,1,311,1,697,4428,3,1
2012-02-09,spring,2012,February,5,Thursday,Workingday,Clear,0.2,0.1818,0.75,0.2836,0,18,18,18,326,18,3,1,1,311,1,717,14261,3,18
2012-02-09,spring,2012,February,6,Thursday,Workingday,Clear,0.2,0.1818,0.75,0.2836,1,75,76,76,326,76,3,2,1,321,1,725,55132,3,76
2012-02-09,spring,2012,February,7,Thursday,Workingday,Clear,0.2,0.197,0.69,0.2537,4,263,267,267,326,267,3,3,1,331,1,727,154171,3,267
2012-02-09,spring,2012,February,8,Thursday,Workingday,Clear,0.2,0.197,0.64,0.2537,11,473,484,484,326,484,3,4,1,341,1,727,261001,3,484
2012-02-09,spring,2012,February,9,Thursday,Workingday,Clear,0.2,0.197,0.59,0.2239,9,229,238,238,326,238,3,3,1,331,1,727,159438,3,238
2012-02-09,spring,2012,February,10,Thursday,Workingday,Clear,0.22,0.2121,0.51,0.2239,7,90,97,97,326,97,3,2,1,321,1,727,126257,3,97
2012-02-09,spring,2012,February,11,Thursday,Workingday,Clear,0.24,0.2273,0.52,0.2239,4,95,99,99,326,99,3,2,1,321,1,727,151320,3,99
2012-02-09,spring,2012,February,12,Thursday,Workingday,Clear,0.26,0.2273,0.48,0.3284,10,148,158,158,326,158,3,3,1,331,1,728,184414,3,158
2012-02-09,spring,2012,February,13,Thursday,Workingday,Clear,0.3,0.2727,0.42,0.3284,10,144,154,154,326,154,3,3,1,331,1,729,184919,3,154
2012-02-09,spring,2012,February,14,Thursday,Workingday,Clear,0.32,0.303,0.39,0.2985,18,126,144,144,326,144,3,3,1,331,1,729,175652,3,144
2012-02-09,spring,2012,February,15,Thursday,Workingday,Clear,0.32,0.303,0.36,0.2985,14,120,134,134,326,134,3,2,1,321,1,729,183149,3,134
2012-02-09,spring,2012,February,16,Thursday,Workingday,Clear,0.34,0.3333,0.36,0.0,15,223,238,238,326,238,3,3,1,331,1,730,227748,3,238
2012-02-09,spring,2012,February,17,Thursday,Workingday,Clear,0.34,0.3333,0.34,0.1343,12,387,399,399,326,399,3,4,1,341,1,730,336860,3,399
2012-02-09,spring,2012,February,18,Thursday,Workingday,Clear,0.34,0.3333,0.31,0.1642,13,404,417,417,326,417,3,4,1,341,1,728,309772,3,417
2012-02-09,spring,2012,February,19,Thursday,Workingday,Clear,0.32,0.3333,0.33,0.1045,8,287,295,295,326,295,3,4,1,341,1,728,226789,3,295
2012-02-09,spring,2012,February,20,Thursday,Workingday,Clear,0.32,0.3485,0.36,0.0,2,197,199,199,326,199,3,3,2,332,1,728,164550,3,199
2012-02-09,spring,2012,February,21,Thursday,Workingday,Clear,0.3,0.3182,0.52,0.0896,8,169,177,177,326,177,3,3,1,331,1,728,125445,3,177
2012-02-09,spring,2012,February,22,Thursday,Workingday,Mist,0.3,0.3333,0.56,0.0,3,104,107,107,326,107,3,2,1,321,1,728,95612,3,107
2012-02-09,spring,2012,February,23,Thursday,Workingday,Mist,0.3,0.3333,0.52,0.0,9,75,84,84,326,84,3,2,1,321,1,728,63941,3,84
2012-02-10,spring,2012,February,0,Friday,Workingday,Mist,0.28,0.303,0.65,0.0896,4,39,43,43,325,43,3,2,1,321,1,726,39130,3,43
2012-02-10,spring,2012,February,1,Friday,Workingday,Mist,0.28,0.303,0.61,0.0896,2,11,13,13,325,13,3,1,1,311,1,724,24164,3,13
2012-02-10,spring,2012,February,2,Friday,Workingday,Clear,0.26,0.2879,0.52,0.0896,7,9,16,16,325,16,3,1,1,311,1,715,16352,3,16
2012-02-10,spring,2012,February,3,Friday,Workingday,Clear,0.26,0.2879,0.56,0.0896,0,5,5,5,325,5,3,1,1,311,1,697,8174,3,5
2012-02-10,spring,2012,February,4,Friday,Workingday,Clear,0.26,0.2879,0.56,0.0896,0,2,2,2,325,2,3,1,1,311,1,697,4428,3,2
2012-02-10,spring,2012,February,5,Friday,Workingday,Clear,0.24,0.2273,0.52,0.2239,0,17,17,17,325,17,3,1,1,311,1,717,14261,3,17
2012-02-10,spring,2012,February,6,Friday,Workingday,Clear,0.2,0.197,0.59,0.194,3,61,64,64,325,64,3,2,1,321,1,725,55132,3,64
2012-02-10,spring,2012,February,7,Friday,Workingday,Clear,0.2,0.2121,0.59,0.1642,5,225,230,230,325,230,3,3,1,331,1,727,154171,3,230
2012-02-10,spring,2012,February,8,Friday,Workingday,Clear,0.2,0.2121,0.59,0.1642,1,447,448,448,325,448,3,4,1,341,1,727,261001,3,448
2012-02-10,spring,2012,February,9,Friday,Workingday,Clear,0.22,0.2273,0.55,0.1642,10,265,275,275,325,275,3,3,1,331,1,727,159438,3,275
2012-02-10,spring,2012,February,10,Friday,Workingday,Mist,0.26,0.2727,0.48,0.1343,5,119,124,124,325,124,3,2,1,321,1,727,126257,3,124
2012-02-10,spring,2012,February,11,Friday,Workingday,Mist,0.28,0.2879,0.45,0.1045,19,134,153,153,325,153,3,3,1,331,1,727,151320,3,153
2012-02-10,spring,2012,February,12,Friday,Workingday,Mist,0.3,0.303,0.42,0.1343,8,168,176,176,325,176,3,3,1,331,1,728,184414,3,176
2012-02-10,spring,2012,February,13,Friday,Workingday,Mist,0.3,0.3182,0.42,0.0896,22,170,192,192,325,192,3,3,1,331,1,729,184919,3,192
2012-02-10,spring,2012,February,14,Friday,Workingday,Mist,0.32,0.3333,0.39,0.0896,8,138,146,146,325,146,3,3,1,331,1,729,175652,3,146
2012-02-10,spring,2012,February,15,Friday,Workingday,Mist,0.32,0.3333,0.45,0.1343,27,164,191,191,325,191,3,3,1,331,1,729,183149,3,191
2012-02-10,spring,2012,February,16,Friday,Workingday,Mist,0.34,0.3182,0.42,0.2537,28,240,268,268,325,268,3,3,1,331,1,730,227748,3,268
2012-02-10,spring,2012,February,17,Friday,Workingday,Mist,0.34,0.3333,0.42,0.194,15,381,396,396,325,396,3,4,1,341,1,730,336860,3,396
2012-02-10,spring,2012,February,18,Friday,Workingday,Light Snow,0.3,0.303,0.61,0.1343,14,345,359,359,325,359,3,4,1,341,1,728,309772,3,359
2012-02-10,spring,2012,February,19,Friday,Workingday,Mist,0.32,0.3485,0.57,0.0,16,246,262,262,325,262,3,3,2,332,1,728,226789,3,262
2012-02-10,spring,2012,February,20,Friday,Workingday,Mist,0.32,0.3485,0.57,0.0,7,144,151,151,325,151,3,3,2,332,1,728,164550,3,151
2012-02-10,spring,2012,February,21,Friday,Workingday,Mist,0.32,0.3333,0.66,0.0896,14,108,122,122,325,122,3,2,1,321,1,728,125445,3,122
2012-02-10,spring,2012,February,22,Friday,Workingday,Mist,0.32,0.3485,0.66,0.0,11,102,113,113,325,113,3,2,2,322,1,728,95612,3,113
2012-02-10,spring,2012,February,23,Friday,Workingday,Mist,0.3,0.3182,0.7,0.0896,1,64,65,65,325,65,3,2,1,321,1,728,63941,3,65
2012-02-11,spring,2012,February,0,Saturday,Holiday,Mist,0.3,0.303,0.7,0.1343,3,50,53,53,324,53,3,2,1,321,1,726,39130,3,53
2012-02-11,spring,2012,February,1,Saturday,Holiday,Light Snow,0.28,0.2879,0.81,0.1343,2,43,45,45,324,45,3,2,1,321,1,724,24164,3,45
2012-02-11,spring,2012,February,2,Saturday,Holiday,Light Snow,0.26,0.2576,0.81,0.194,2,24,26,26,324,26,3,1,1,311,1,715,16352,3,26
2012-02-11,spring,2012,February,3,Saturday,Holiday,Light Snow,0.24,0.2273,0.87,0.2239,0,9,9,9,324,9,3,1,1,311,1,697,8174,3,9
2012-02-11,spring,2012,February,4,Saturday,Holiday,Light Snow,0.24,0.2273,0.87,0.2239,0,4,4,4,324,4,3,1,1,311,1,697,4428,3,4
2012-02-11,spring,2012,February,5,Saturday,Holiday,Light Snow,0.22,0.2273,0.93,0.1642,0,2,2,2,324,2,3,1,1,311,1,717,14261,3,2
2012-02-11,spring,2012,February,6,Saturday,Holiday,Light Snow,0.22,0.2273,0.93,0.1343,1,8,9,9,324,9,3,1,1,311,1,725,55132,3,9
2012-02-11,spring,2012,February,7,Saturday,Holiday,Light Snow,0.22,0.2273,0.93,0.1343,0,19,19,19,324,19,3,1,1,311,1,727,154171,3,19
2012-02-11,spring,2012,February,8,Saturday,Holiday,Light Snow,0.22,0.2273,0.93,0.1343,1,77,78,78,324,78,3,2,1,321,1,727,261001,3,78
2012-02-11,spring,2012,February,9,Saturday,Holiday,Light Snow,0.22,0.2424,0.93,0.1045,5,85,90,90,324,90,3,2,1,321,1,727,159438,3,90
2012-02-11,spring,2012,February,10,Saturday,Holiday,Light Snow,0.22,0.2424,0.93,0.1045,23,143,166,166,324,166,3,3,1,331,1,727,126257,3,166
2012-02-11,spring,2012,February,11,Saturday,Holiday,Mist,0.24,0.2576,0.81,0.1045,26,157,183,183,324,183,3,3,1,331,1,727,151320,3,183
2012-02-11,spring,2012,February,12,Saturday,Holiday,Mist,0.26,0.2576,0.81,0.1642,25,196,221,221,324,221,3,3,1,331,1,728,184414,3,221
2012-02-11,spring,2012,February,13,Saturday,Holiday,Mist,0.26,0.2424,0.81,0.2836,18,217,235,235,324,235,3,3,1,331,1,729,184919,3,235
2012-02-11,spring,2012,February,14,Saturday,Holiday,Mist,0.26,0.2424,0.81,0.2537,38,205,243,243,324,243,3,3,1,331,1,729,175652,3,243
2012-02-11,spring,2012,February,15,Saturday,Holiday,Mist,0.3,0.2727,0.61,0.2985,12,112,124,124,324,124,3,2,1,321,1,729,183149,3,124
2012-02-11,spring,2012,February,16,Saturday,Holiday,Light Snow,0.22,0.197,0.75,0.4179,12,134,146,146,324,146,3,3,1,331,1,730,227748,3,146
2012-02-11,spring,2012,February,17,Saturday,Holiday,Light Snow,0.22,0.1818,0.69,0.4627,13,131,144,144,324,144,3,3,1,331,1,730,336860,3,144
2012-02-11,spring,2012,February,18,Saturday,Holiday,Mist,0.22,0.1818,0.47,0.6567,3,105,108,108,324,108,3,2,1,321,1,728,309772,3,108
2012-02-11,spring,2012,February,19,Saturday,Holiday,Mist,0.2,0.1515,0.4,0.5522,2,85,87,87,324,87,3,2,1,321,1,728,226789,3,87
2012-02-11,spring,2012,February,20,Saturday,Holiday,Mist,0.16,0.1212,0.43,0.5522,1,62,63,63,324,63,3,2,1,321,1,728,164550,3,63
2012-02-11,spring,2012,February,21,Saturday,Holiday,Clear,0.14,0.0758,0.43,0.6418,5,43,48,48,324,48,3,2,1,321,1,728,125445,3,48
2012-02-11,spring,2012,February,22,Saturday,Holiday,Mist,0.14,0.1061,0.39,0.3881,0,46,46,46,324,46,3,2,1,321,1,728,95612,3,46
2012-02-11,spring,2012,February,23,Saturday,Holiday,Light Snow,0.12,0.0758,0.5,0.4925,0,20,20,20,324,20,3,1,1,311,1,728,63941,3,20
2012-02-12,spring,2012,February,0,Sunday,Holiday,Light Snow,0.1,0.0758,0.68,0.3881,0,21,21,21,323,21,3,1,1,311,1,726,39130,3,21
2012-02-12,spring,2012,February,1,Sunday,Holiday,Light Snow,0.08,0.0455,0.79,0.4627,0,24,24,24,323,24,3,1,1,311,1,724,24164,3,24
2012-02-12,spring,2012,February,2,Sunday,Holiday,Mist,0.1,0.0606,0.58,0.5821,1,26,27,27,323,27,3,1,1,311,1,715,16352,3,27
2012-02-12,spring,2012,February,3,Sunday,Holiday,Mist,0.1,0.0455,0.46,0.6866,0,14,14,14,323,14,3,1,1,311,1,697,8174,3,14
2012-02-12,spring,2012,February,4,Sunday,Holiday,Mist,0.1,0.0455,0.46,0.7164,0,1,1,1,323,1,3,1,1,311,1,697,4428,3,1
2012-02-12,spring,2012,February,5,Sunday,Holiday,Clear,0.1,0.0758,0.49,0.3881,0,3,3,3,323,3,3,1,1,311,1,717,14261,3,3
2012-02-12,spring,2012,February,6,Sunday,Holiday,Clear,0.1,0.0758,0.49,0.3881,0,2,2,2,323,2,3,1,1,311,1,725,55132,3,2
2012-02-12,spring,2012,February,7,Sunday,Holiday,Clear,0.08,0.0909,0.53,0.194,0,18,18,18,323,18,3,1,1,311,1,727,154171,3,18
2012-02-12,spring,2012,February,8,Sunday,Holiday,Clear,0.08,0.0758,0.53,0.2537,0,26,26,26,323,26,3,1,1,311,1,727,261001,3,26
2012-02-12,spring,2012,February,9,Sunday,Holiday,Clear,0.1,0.0909,0.49,0.2985,3,60,63,63,323,63,3,2,1,321,1,727,159438,3,63
2012-02-12,spring,2012,February,10,Sunday,Holiday,Clear,0.12,0.1061,0.42,0.3582,8,83,91,91,323,91,3,2,1,321,1,727,126257,3,91
2012-02-12,spring,2012,February,11,Sunday,Holiday,Clear,0.12,0.1061,0.42,0.2985,3,121,124,124,323,124,3,2,1,321,1,727,151320,3,124
2012-02-12,spring,2012,February,12,Sunday,Holiday,Clear,0.14,0.0758,0.39,0.6418,7,133,140,140,323,140,3,2,1,321,1,728,184414,3,140
2012-02-12,spring,2012,February,13,Sunday,Holiday,Clear,0.16,0.1212,0.4,0.4478,10,128,138,138,323,138,3,2,1,321,1,729,184919,3,138
2012-02-12,spring,2012,February,14,Sunday,Holiday,Clear,0.16,0.1212,0.4,0.5224,9,102,111,111,323,111,3,2,1,321,1,729,175652,3,111
2012-02-12,spring,2012,February,15,Sunday,Holiday,Clear,0.16,0.1212,0.4,0.5522,5,150,155,155,323,155,3,3,1,331,1,729,183149,3,155
2012-02-12,spring,2012,February,16,Sunday,Holiday,Clear,0.2,0.1667,0.34,0.4627,16,148,164,164,323,164,3,3,1,331,1,730,227748,3,164
2012-02-12,spring,2012,February,17,Sunday,Holiday,Clear,0.18,0.1515,0.37,0.4179,4,83,87,87,323,87,3,2,1,321,1,730,336860,3,87
2012-02-12,spring,2012,February,18,Sunday,Holiday,Clear,0.16,0.1212,0.4,0.4627,4,92,96,96,323,96,3,2,1,321,1,728,309772,3,96
2012-02-12,spring,2012,February,19,Sunday,Holiday,Clear,0.16,0.1364,0.4,0.2836,2,78,80,80,323,80,3,2,1,321,1,728,226789,3,80
2012-02-12,spring,2012,February,20,Sunday,Holiday,Clear,0.14,0.1212,0.42,0.3284,1,56,57,57,323,57,3,2,1,321,1,728,164550,3,57
2012-02-12,spring,2012,February,21,Sunday,Holiday,Clear,0.14,0.1212,0.43,0.2985,0,36,36,36,323,36,3,1,1,311,1,728,125445,3,36
2012-02-12,spring,2012,February,22,Sunday,Holiday,Clear,0.14,0.1515,0.43,0.1642,0,28,28,28,323,28,3,1,1,311,1,728,95612,3,28
2012-02-12,spring,2012,February,23,Sunday,Holiday,Clear,0.14,0.1364,0.43,0.2239,0,23,23,23,323,23,3,1,1,311,1,728,63941,3,23
2012-02-13,spring,2012,February,0,Monday,Workingday,Clear,0.14,0.1364,0.46,0.2239,0,9,9,9,322,9,3,1,1,311,1,726,39130,3,9
2012-02-13,spring,2012,February,1,Monday,Workingday,Clear,0.12,0.1212,0.5,0.2239,0,6,6,6,322,6,3,1,1,311,1,724,24164,3,6
2012-02-13,spring,2012,February,2,Monday,Workingday,Clear,0.14,0.1364,0.46,0.194,0,4,4,4,322,4,3,1,1,311,1,715,16352,3,4
2012-02-13,spring,2012,February,3,Monday,Workingday,Clear,0.12,0.1515,0.54,0.1045,0,1,1,1,322,1,3,1,1,311,1,697,8174,3,1
2012-02-13,spring,2012,February,4,Monday,Workingday,Clear,0.12,0.1667,0.54,0.0896,0,2,2,2,322,2,3,1,1,311,1,697,4428,3,2
2012-02-13,spring,2012,February,5,Monday,Workingday,Clear,0.1,0.1212,0.58,0.1343,0,17,17,17,322,17,3,1,1,311,1,717,14261,3,17
2012-02-13,spring,2012,February,6,Monday,Workingday,Clear,0.1,0.1061,0.54,0.2239,1,71,72,72,322,72,3,2,1,321,1,725,55132,3,72
2012-02-13,spring,2012,February,7,Monday,Workingday,Clear,0.1,0.1061,0.54,0.194,1,194,195,195,322,195,3,3,1,331,1,727,154171,3,195
2012-02-13,spring,2012,February,8,Monday,Workingday,Clear,0.1,0.1212,0.54,0.1343,4,413,417,417,322,417,3,4,1,341,1,727,261001,3,417
2012-02-13,spring,2012,February,9,Monday,Workingday,Clear,0.12,0.1364,0.5,0.194,7,198,205,205,322,205,3,3,1,331,1,727,159438,3,205
2012-02-13,spring,2012,February,10,Monday,Workingday,Clear,0.14,0.1515,0.5,0.1343,1,70,71,71,322,71,3,2,1,321,1,727,126257,3,71
2012-02-13,spring,2012,February,11,Monday,Workingday,Clear,0.22,0.2273,0.37,0.194,5,85,90,90,322,90,3,2,1,321,1,727,151320,3,90
2012-02-13,spring,2012,February,12,Monday,Workingday,Clear,0.28,0.2576,0.28,0.3284,7,111,118,118,322,118,3,2,1,321,1,728,184414,3,118
2012-02-13,spring,2012,February,13,Monday,Workingday,Clear,0.32,0.303,0.22,0.2239,11,129,140,140,322,140,3,2,1,321,1,729,184919,3,140
2012-02-13,spring,2012,February,14,Monday,Workingday,Clear,0.34,0.3485,0.23,0.1045,10,125,135,135,322,135,3,2,2,322,1,729,175652,3,135
2012-02-13,spring,2012,February,15,Monday,Workingday,Clear,0.36,0.3485,0.27,0.1343,10,145,155,155,322,155,3,3,2,332,1,729,183149,3,155
2012-02-13,spring,2012,February,16,Monday,Workingday,Clear,0.36,0.3485,0.23,0.194,5,206,211,211,322,211,3,3,2,332,1,730,227748,3,211
2012-02-13,spring,2012,February,17,Monday,Workingday,Clear,0.36,0.3485,0.23,0.194,8,399,407,407,322,407,3,4,2,342,1,730,336860,3,407
2012-02-13,spring,2012,February,18,Monday,Workingday,Clear,0.34,0.3182,0.25,0.2537,6,399,405,405,322,405,3,4,1,341,1,728,309772,3,405
2012-02-13,spring,2012,February,19,Monday,Workingday,Clear,0.34,0.3333,0.25,0.1343,7,256,263,263,322,263,3,3,1,331,1,728,226789,3,263
2012-02-13,spring,2012,February,20,Monday,Workingday,Clear,0.3,0.303,0.42,0.1642,4,210,214,214,322,214,3,3,1,331,1,728,164550,3,214
2012-02-13,spring,2012,February,21,Monday,Workingday,Clear,0.28,0.2879,0.45,0.1343,2,145,147,147,322,147,3,3,1,331,1,728,125445,3,147
2012-02-13,spring,2012,February,22,Monday,Workingday,Clear,0.26,0.2727,0.56,0.1045,3,99,102,102,322,102,3,2,1,321,1,728,95612,3,102
2012-02-13,spring,2012,February,23,Monday,Workingday,Clear,0.28,0.3182,0.41,0.0,2,34,36,36,322,36,3,1,1,311,1,728,63941,3,36
2012-02-14,spring,2012,February,0,Tuesday,Workingday,Mist,0.26,0.303,0.6,0.0,0,14,14,14,321,14,3,1,1,311,1,726,39130,3,14
2012-02-14,spring,2012,February,1,Tuesday,Workingday,Mist,0.26,0.303,0.56,0.0,0,6,6,6,321,6,3,1,1,311,1,724,24164,3,6
2012-02-14,spring,2012,February,2,Tuesday,Workingday,Mist,0.28,0.3182,0.41,0.0,0,3,3,3,321,3,3,1,1,311,1,715,16352,3,3
2012-02-14,spring,2012,February,3,Tuesday,Workingday,Mist,0.26,0.303,0.52,0.0,0,3,3,3,321,3,3,1,1,311,1,697,8174,3,3
2012-02-14,spring,2012,February,4,Tuesday,Workingday,Mist,0.26,0.2727,0.65,0.1045,0,2,2,2,321,2,3,1,1,311,1,697,4428,3,2
2012-02-14,spring,2012,February,5,Tuesday,Workingday,Mist,0.26,0.2727,0.65,0.1045,2,20,22,22,321,22,3,1,1,311,1,717,14261,3,22
2012-02-14,spring,2012,February,6,Tuesday,Workingday,Mist,0.26,0.303,0.56,0.0,1,89,90,90,321,90,3,2,1,321,1,725,55132,3,90
2012-02-14,spring,2012,February,7,Tuesday,Workingday,Mist,0.24,0.2576,0.6,0.0896,4,276,280,280,321,280,3,3,1,331,1,727,154171,3,280
2012-02-14,spring,2012,February,8,Tuesday,Workingday,Mist,0.24,0.2879,0.7,0.0,3,510,513,513,321,513,3,4,1,341,1,727,261001,3,513
2012-02-14,spring,2012,February,9,Tuesday,Workingday,Mist,0.26,0.2879,0.56,0.0896,6,256,262,262,321,262,3,3,1,331,1,727,159438,3,262
2012-02-14,spring,2012,February,10,Tuesday,Workingday,Mist,0.26,0.2727,0.6,0.1343,8,90,98,98,321,98,3,2,1,321,1,727,126257,3,98
2012-02-14,spring,2012,February,11,Tuesday,Workingday,Mist,0.3,0.303,0.45,0.1642,5,107,112,112,321,112,3,2,1,321,1,727,151320,3,112
2012-02-14,spring,2012,February,12,Tuesday,Workingday,Mist,0.3,0.2879,0.52,0.2239,10,162,172,172,321,172,3,3,1,331,1,728,184414,3,172
2012-02-14,spring,2012,February,13,Tuesday,Workingday,Mist,0.36,0.3333,0.4,0.2537,6,167,173,173,321,173,3,3,1,331,1,729,184919,3,173
2012-02-14,spring,2012,February,14,Tuesday,Workingday,Clear,0.4,0.4091,0.4,0.2239,13,111,124,124,321,124,3,2,2,322,1,729,175652,3,124
2012-02-14,spring,2012,February,15,Tuesday,Workingday,Mist,0.42,0.4242,0.38,0.4478,7,138,145,145,321,145,3,3,2,332,1,729,183149,3,145
2012-02-14,spring,2012,February,16,Tuesday,Workingday,Clear,0.42,0.4242,0.35,0.2985,15,251,266,266,321,266,3,3,2,332,1,730,227748,3,266
2012-02-14,spring,2012,February,17,Tuesday,Workingday,Clear,0.42,0.4242,0.38,0.3582,19,504,523,523,321,523,3,4,2,342,2,730,336860,3,523
2012-02-14,spring,2012,February,18,Tuesday,Workingday,Mist,0.38,0.3939,0.46,0.2985,8,398,406,406,321,406,3,4,2,342,1,728,309772,3,406
2012-02-14,spring,2012,February,19,Tuesday,Workingday,Mist,0.36,0.3485,0.5,0.1642,11,270,281,281,321,281,3,3,2,332,1,728,226789,3,281
2012-02-14,spring,2012,February,20,Tuesday,Workingday,Mist,0.38,0.3939,0.46,0.1343,6,178,184,184,321,184,3,3,2,332,1,728,164550,3,184
2012-02-14,spring,2012,February,21,Tuesday,Workingday,Mist,0.36,0.3636,0.5,0.1045,4,105,109,109,321,109,3,2,2,322,1,728,125445,3,109
2012-02-14,spring,2012,February,22,Tuesday,Workingday,Mist,0.36,0.3636,0.5,0.1045,5,72,77,77,321,77,3,2,2,322,1,728,95612,3,77
2012-02-14,spring,2012,February,23,Tuesday,Workingday,Mist,0.36,0.3636,0.5,0.0896,2,55,57,57,321,57,3,2,2,322,1,728,63941,3,57
2012-02-15,spring,2012,February,0,Wednesday,Workingday,Clear,0.32,0.3485,0.57,0.0,0,22,22,22,320,22,3,1,2,312,1,726,39130,3,22
2012-02-15,spring,2012,February,1,Wednesday,Workingday,Clear,0.34,0.3636,0.53,0.0,0,5,5,5,320,5,3,1,2,312,1,724,24164,3,5
2012-02-15,spring,2012,February,2,Wednesday,Workingday,Clear,0.3,0.3333,0.61,0.0,0,4,4,4,320,4,3,1,1,311,1,715,16352,3,4
2012-02-15,spring,2012,February,3,Wednesday,Workingday,Clear,0.28,0.3182,0.75,0.0,0,3,3,3,320,3,3,1,1,311,1,697,8174,3,3
2012-02-15,spring,2012,February,4,Wednesday,Workingday,Clear,0.28,0.2879,0.7,0.1045,0,1,1,1,320,1,3,1,1,311,1,697,4428,3,1
2012-02-15,spring,2012,February,5,Wednesday,Workingday,Clear,0.28,0.2879,0.7,0.1045,0,25,25,25,320,25,3,1,1,311,1,717,14261,3,25
2012-02-15,spring,2012,February,6,Wednesday,Workingday,Clear,0.3,0.303,0.61,0.1343,3,92,95,95,320,95,3,2,1,321,1,725,55132,3,95
2012-02-15,spring,2012,February,7,Wednesday,Workingday,Mist,0.3,0.2879,0.65,0.194,3,318,321,321,320,321,3,4,1,341,1,727,154171,3,321
2012-02-15,spring,2012,February,8,Wednesday,Workingday,Clear,0.32,0.2879,0.61,0.3582,7,508,515,515,320,515,3,4,1,341,1,727,261001,3,515
2012-02-15,spring,2012,February,9,Wednesday,Workingday,Clear,0.32,0.303,0.61,0.3284,5,226,231,231,320,231,3,3,1,331,1,727,159438,3,231
2012-02-15,spring,2012,February,10,Wednesday,Workingday,Clear,0.34,0.303,0.57,0.2985,12,108,120,120,320,120,3,2,1,321,1,727,126257,3,120
2012-02-15,spring,2012,February,11,Wednesday,Workingday,Clear,0.36,0.3333,0.53,0.2836,13,125,138,138,320,138,3,2,1,321,1,727,151320,3,138
2012-02-15,spring,2012,February,12,Wednesday,Workingday,Clear,0.38,0.3939,0.46,0.3881,11,152,163,163,320,163,3,3,2,332,1,728,184414,3,163
2012-02-15,spring,2012,February,13,Wednesday,Workingday,Clear,0.4,0.4091,0.43,0.2836,11,159,170,170,320,170,3,3,2,332,1,729,184919,3,170
2012-02-15,spring,2012,February,14,Wednesday,Workingday,Clear,0.42,0.4242,0.41,0.3582,6,128,134,134,320,134,3,2,2,322,1,729,175652,3,134
2012-02-15,spring,2012,February,15,Wednesday,Workingday,Clear,0.42,0.4242,0.41,0.2239,7,164,171,171,320,171,3,3,2,332,1,729,183149,3,171
2012-02-15,spring,2012,February,16,Wednesday,Workingday,Clear,0.42,0.4242,0.38,0.194,9,222,231,231,320,231,3,3,2,332,1,730,227748,3,231
2012-02-15,spring,2012,February,17,Wednesday,Workingday,Clear,0.42,0.4242,0.38,0.194,17,470,487,487,320,487,3,4,2,342,2,730,336860,3,487
2012-02-15,spring,2012,February,18,Wednesday,Workingday,Clear,0.4,0.4091,0.4,0.2239,9,459,468,468,320,468,3,4,2,342,1,728,309772,3,468
2012-02-15,spring,2012,February,19,Wednesday,Workingday,Clear,0.38,0.3939,0.43,0.1642,9,302,311,311,320,311,3,4,2,342,1,728,226789,3,311
2012-02-15,spring,2012,February,20,Wednesday,Workingday,Clear,0.36,0.3485,0.46,0.1642,4,207,211,211,320,211,3,3,2,332,1,728,164550,3,211
2012-02-15,spring,2012,February,21,Wednesday,Workingday,Clear,0.34,0.3333,0.53,0.1642,8,170,178,178,320,178,3,3,1,331,1,728,125445,3,178
2012-02-15,spring,2012,February,22,Wednesday,Workingday,Clear,0.34,0.3485,0.49,0.1045,3,104,107,107,320,107,3,2,2,322,1,728,95612,3,107
2012-02-15,spring,2012,February,23,Wednesday,Workingday,Clear,0.34,0.3485,0.53,0.0896,4,54,58,58,320,58,3,2,2,322,1,728,63941,3,58
2012-02-16,spring,2012,February,0,Thursday,Workingday,Mist,0.3,0.303,0.7,0.1343,1,22,23,23,319,23,3,1,1,311,1,726,39130,3,23
2012-02-16,spring,2012,February,1,Thursday,Workingday,Mist,0.3,0.3333,0.7,0.0,0,5,5,5,319,5,3,1,1,311,1,724,24164,3,5
2012-02-16,spring,2012,February,2,Thursday,Workingday,Mist,0.3,0.3182,0.7,0.0896,1,6,7,7,319,7,3,1,1,311,1,715,16352,3,7
2012-02-16,spring,2012,February,3,Thursday,Workingday,Mist,0.3,0.3333,0.61,0.0,0,1,1,1,319,1,3,1,1,311,1,697,8174,3,1
2012-02-16,spring,2012,February,4,Thursday,Workingday,Light Snow,0.3,0.3182,0.7,0.0896,0,3,3,3,319,3,3,1,1,311,1,697,4428,3,3
2012-02-16,spring,2012,February,5,Thursday,Workingday,Mist,0.3,0.3333,0.7,0.0,0,20,20,20,319,20,3,1,1,311,1,717,14261,3,20
2012-02-16,spring,2012,February,6,Thursday,Workingday,Mist,0.3,0.3182,0.7,0.0896,4,83,87,87,319,87,3,2,1,321,1,725,55132,3,87
2012-02-16,spring,2012,February,7,Thursday,Workingday,Mist,0.3,0.303,0.7,0.1343,3,285,288,288,319,288,3,4,1,341,1,727,154171,3,288
2012-02-16,spring,2012,February,8,Thursday,Workingday,Mist,0.3,0.3182,0.7,0.0896,9,489,498,498,319,498,3,4,1,341,1,727,261001,3,498
2012-02-16,spring,2012,February,9,Thursday,Workingday,Mist,0.3,0.303,0.7,0.1642,3,199,202,202,319,202,3,3,1,331,1,727,159438,3,202
2012-02-16,spring,2012,February,10,Thursday,Workingday,Light Snow,0.32,0.3333,0.7,0.1343,2,42,44,44,319,44,3,2,1,321,1,727,126257,3,44
2012-02-16,spring,2012,February,11,Thursday,Workingday,Light Snow,0.32,0.3333,0.7,0.1045,2,69,71,71,319,71,3,2,1,321,1,727,151320,3,71
2012-02-16,spring,2012,February,12,Thursday,Workingday,Light Snow,0.32,0.3333,0.76,0.0896,1,44,45,45,319,45,3,2,1,321,1,728,184414,3,45
2012-02-16,spring,2012,February,13,Thursday,Workingday,Light Snow,0.34,0.3182,0.71,0.2537,2,62,64,64,319,64,3,2,1,321,1,729,184919,3,64
2012-02-16,spring,2012,February,14,Thursday,Workingday,Light Snow,0.32,0.3182,0.81,0.194,1,30,31,31,319,31,3,1,1,311,1,729,175652,3,31
2012-02-16,spring,2012,February,15,Thursday,Workingday,Light Snow,0.34,0.3636,0.76,0.0,3,50,53,53,319,53,3,2,2,322,0,729,183149,3,53
2012-02-16,spring,2012,February,16,Thursday,Workingday,Light Snow,0.34,0.3636,0.81,0.0,8,110,118,118,319,118,3,2,2,322,0,730,227748,3,118
2012-02-16,spring,2012,February,17,Thursday,Workingday,Light Snow,0.34,0.3636,0.87,0.0,8,281,289,289,319,289,3,4,2,342,0,730,336860,3,289
2012-02-16,spring,2012,February,18,Thursday,Workingday,Light Snow,0.34,0.3333,0.87,0.1343,8,345,353,353,319,353,3,4,1,341,1,728,309772,3,353
2012-02-16,spring,2012,February,19,Thursday,Workingday,Mist,0.32,0.3182,0.87,0.1642,4,254,258,258,319,258,3,3,1,331,1,728,226789,3,258
2012-02-16,spring,2012,February,20,Thursday,Workingday,Mist,0.32,0.3333,0.87,0.1343,5,211,216,216,319,216,3,3,1,331,1,728,164550,3,216
2012-02-16,spring,2012,February,21,Thursday,Workingday,Mist,0.34,0.3485,0.81,0.1045,3,142,145,145,319,145,3,3,2,332,1,728,125445,3,145
2012-02-16,spring,2012,February,22,Thursday,Workingday,Mist,0.32,0.3485,0.81,0.0,3,108,111,111,319,111,3,2,2,322,0,728,95612,3,111
2012-02-16,spring,2012,February,23,Thursday,Workingday,Clear,0.32,0.3333,0.81,0.0896,3,70,73,73,319,73,3,2,1,321,1,728,63941,3,73
2012-02-17,spring,2012,February,0,Friday,Workingday,Mist,0.3,0.3333,0.87,0.0,2,32,34,34,318,34,3,1,1,311,0,726,39130,3,34
2012-02-17,spring,2012,February,1,Friday,Workingday,Mist,0.3,0.3333,0.93,0.0,2,16,18,18,318,18,3,1,1,311,0,724,24164,3,18
2012-02-17,spring,2012,February,2,Friday,Workingday,Mist,0.3,0.3182,0.93,0.1045,1,11,12,12,318,12,3,1,1,311,1,715,16352,3,12
2012-02-17,spring,2012,February,3,Friday,Workingday,Mist,0.28,0.2879,0.93,0.1045,0,1,1,1,318,1,3,1,1,311,1,697,8174,3,1
2012-02-17,spring,2012,February,4,Friday,Workingday,Mist,0.28,0.2727,0.93,0.194,0,1,1,1,318,1,3,1,1,311,1,697,4428,3,1
2012-02-17,spring,2012,February,5,Friday,Workingday,Mist,0.28,0.2727,0.93,0.1642,0,16,16,16,318,16,3,1,1,311,1,717,14261,3,16
2012-02-17,spring,2012,February,6,Friday,Workingday,Mist,0.28,0.2879,0.96,0.1343,1,70,71,71,318,71,3,2,1,321,1,725,55132,3,71
2012-02-17,spring,2012,February,7,Friday,Workingday,Mist,0.28,0.2879,0.93,0.1045,4,222,226,226,318,226,3,3,1,331,1,727,154171,3,226
2012-02-17,spring,2012,February,8,Friday,Workingday,Mist,0.26,0.303,1.0,0.0,4,516,520,520,318,520,3,4,1,341,0,727,261001,3,520
2012-02-17,spring,2012,February,9,Friday,Workingday,Mist,0.26,0.303,1.0,0.0,8,275,283,283,318,283,3,4,1,341,0,727,159438,3,283
2012-02-17,spring,2012,February,10,Friday,Workingday,Clear,0.34,0.3182,0.71,0.2836,13,103,116,116,318,116,3,2,1,321,1,727,126257,3,116
2012-02-17,spring,2012,February,11,Friday,Workingday,Clear,0.36,0.3333,0.62,0.4179,9,133,142,142,318,142,3,2,1,321,1,727,151320,3,142
2012-02-17,spring,2012,February,12,Friday,Workingday,Clear,0.38,0.3939,0.46,0.3881,21,177,198,198,318,198,3,3,2,332,1,728,184414,3,198
2012-02-17,spring,2012,February,13,Friday,Workingday,Clear,0.4,0.4091,0.43,0.3582,34,171,205,205,318,205,3,3,2,332,1,729,184919,3,205
2012-02-17,spring,2012,February,14,Friday,Workingday,Clear,0.4,0.4091,0.37,0.3582,33,137,170,170,318,170,3,3,2,332,1,729,175652,3,170
2012-02-17,spring,2012,February,15,Friday,Workingday,Clear,0.42,0.4242,0.35,0.4179,41,180,221,221,318,221,3,3,2,332,1,729,183149,3,221
2012-02-17,spring,2012,February,16,Friday,Workingday,Clear,0.42,0.4242,0.32,0.2985,56,251,307,307,318,307,3,4,2,342,1,730,227748,3,307
2012-02-17,spring,2012,February,17,Friday,Workingday,Clear,0.42,0.4242,0.32,0.3284,36,429,465,465,318,465,3,4,2,342,2,730,336860,3,465
2012-02-17,spring,2012,February,18,Friday,Workingday,Clear,0.4,0.4091,0.35,0.2537,15,362,377,377,318,377,3,4,2,342,1,728,309772,3,377
2012-02-17,spring,2012,February,19,Friday,Workingday,Clear,0.38,0.3939,0.37,0.2239,16,266,282,282,318,282,3,4,2,342,1,728,226789,3,282
2012-02-17,spring,2012,February,20,Friday,Workingday,Clear,0.4,0.4091,0.35,0.194,13,158,171,171,318,171,3,3,2,332,1,728,164550,3,171
2012-02-17,spring,2012,February,21,Friday,Workingday,Clear,0.38,0.3939,0.37,0.194,15,114,129,129,318,129,3,2,2,322,1,728,125445,3,129
2012-02-17,spring,2012,February,22,Friday,Workingday,Clear,0.36,0.3485,0.4,0.2239,15,92,107,107,318,107,3,2,2,322,1,728,95612,3,107
2012-02-17,spring,2012,February,23,Friday,Workingday,Clear,0.36,0.3485,0.4,0.194,10,72,82,82,318,82,3,2,2,322,1,728,63941,3,82
2012-02-18,spring,2012,February,0,Saturday,Holiday,Clear,0.34,0.3333,0.42,0.1642,5,81,86,86,317,86,3,2,1,321,1,726,39130,3,86
2012-02-18,spring,2012,February,1,Saturday,Holiday,Clear,0.32,0.3182,0.49,0.1642,7,38,45,45,317,45,3,2,1,321,1,724,24164,3,45
2012-02-18,spring,2012,February,2,Saturday,Holiday,Clear,0.3,0.2879,0.61,0.2537,6,39,45,45,317,45,3,2,1,321,1,715,16352,3,45
2012-02-18,spring,2012,February,3,Saturday,Holiday,Clear,0.28,0.2879,0.65,0.1045,3,15,18,18,317,18,3,1,1,311,1,697,8174,3,18
2012-02-18,spring,2012,February,4,Saturday,Holiday,Clear,0.26,0.303,0.7,0.0,3,4,7,7,317,7,3,1,1,311,1,697,4428,3,7
2012-02-18,spring,2012,February,5,Saturday,Holiday,Clear,0.24,0.2576,0.7,0.0896,0,1,1,1,317,1,3,1,1,311,1,717,14261,3,1
2012-02-18,spring,2012,February,6,Saturday,Holiday,Clear,0.24,0.2879,0.7,0.0,1,8,9,9,317,9,3,1,1,311,1,725,55132,3,9
2012-02-18,spring,2012,February,7,Saturday,Holiday,Clear,0.24,0.2879,0.7,0.0,8,33,41,41,317,41,3,2,1,321,1,727,154171,3,41
2012-02-18,spring,2012,February,8,Saturday,Holiday,Clear,0.22,0.2727,0.87,0.0,10,92,102,102,317,102,3,2,1,321,1,727,261001,3,102
2012-02-18,spring,2012,February,9,Saturday,Holiday,Clear,0.22,0.2424,0.8,0.1045,22,116,138,138,317,138,3,2,1,321,1,727,159438,3,138
2012-02-18,spring,2012,February,10,Saturday,Holiday,Clear,0.26,0.2727,0.81,0.1045,48,157,205,205,317,205,3,3,1,331,1,727,126257,3,205
2012-02-18,spring,2012,February,11,Saturday,Holiday,Clear,0.32,0.3333,0.57,0.1343,102,184,286,286,317,286,3,4,1,341,1,727,151320,3,286
2012-02-18,spring,2012,February,12,Saturday,Holiday,Clear,0.36,0.3485,0.43,0.194,128,241,369,369,317,369,3,4,2,342,2,728,184414,3,369
2012-02-18,spring,2012,February,13,Saturday,Holiday,Clear,0.4,0.4091,0.43,0.2836,165,219,384,384,317,384,3,4,2,342,2,729,184919,3,384
2012-02-18,spring,2012,February,14,Saturday,Holiday,Clear,0.44,0.4394,0.35,0.3582,183,244,427,427,317,427,3,4,2,342,2,729,175652,3,427
2012-02-18,spring,2012,February,15,Saturday,Holiday,Clear,0.42,0.4242,0.41,0.2537,229,270,499,499,317,499,3,4,2,342,2,729,183149,3,499
2012-02-18,spring,2012,February,16,Saturday,Holiday,Clear,0.44,0.4394,0.44,0.3284,186,218,404,404,317,404,3,4,2,342,2,730,227748,3,404
2012-02-18,spring,2012,February,17,Saturday,Holiday,Clear,0.48,0.4697,0.36,0.2836,142,222,364,364,317,364,3,4,2,342,2,730,336860,3,364
2012-02-18,spring,2012,February,18,Saturday,Holiday,Clear,0.46,0.4545,0.38,0.2985,70,176,246,246,317,246,3,3,2,332,2,728,309772,3,246
2012-02-18,spring,2012,February,19,Saturday,Holiday,Clear,0.44,0.4394,0.44,0.1642,38,150,188,188,317,188,3,3,2,332,1,728,226789,3,188
2012-02-18,spring,2012,February,20,Saturday,Holiday,Clear,0.44,0.4394,0.44,0.1642,25,123,148,148,317,148,3,3,2,332,1,728,164550,3,148
2012-02-18,spring,2012,February,21,Saturday,Holiday,Clear,0.44,0.4394,0.33,0.2985,25,89,114,114,317,114,3,2,2,322,1,728,125445,3,114
2012-02-18,spring,2012,February,22,Saturday,Holiday,Clear,0.4,0.4091,0.4,0.4478,17,101,118,118,317,118,3,2,2,322,1,728,95612,3,118
2012-02-18,spring,2012,February,23,Saturday,Holiday,Mist,0.36,0.3333,0.4,0.3881,12,62,74,74,317,74,3,2,1,321,1,728,63941,3,74
2012-02-19,spring,2012,February,0,Sunday,Holiday,Mist,0.34,0.303,0.39,0.3582,9,65,74,74,316,74,3,2,1,321,1,726,39130,3,74
2012-02-19,spring,2012,February,1,Sunday,Holiday,Mist,0.32,0.303,0.39,0.2537,10,62,72,72,316,72,3,2,1,321,1,724,24164,3,72
2012-02-19,spring,2012,February,2,Sunday,Holiday,Mist,0.3,0.2879,0.36,0.2836,3,45,48,48,316,48,3,2,1,321,1,715,16352,3,48
2012-02-19,spring,2012,February,3,Sunday,Holiday,Mist,0.3,0.2879,0.36,0.2239,3,12,15,15,316,15,3,1,1,311,1,697,8174,3,15
2012-02-19,spring,2012,February,4,Sunday,Holiday,Mist,0.28,0.2576,0.41,0.3881,0,3,3,3,316,3,3,1,1,311,1,697,4428,3,3
2012-02-19,spring,2012,February,5,Sunday,Holiday,Mist,0.26,0.2273,0.48,0.2985,1,1,2,2,316,2,3,1,1,311,1,717,14261,3,2
2012-02-19,spring,2012,February,6,Sunday,Holiday,Clear,0.24,0.2121,0.52,0.3284,0,5,5,5,316,5,3,1,1,311,1,725,55132,3,5
2012-02-19,spring,2012,February,7,Sunday,Holiday,Mist,0.24,0.2121,0.52,0.2836,2,12,14,14,316,14,3,1,1,311,1,727,154171,3,14
2012-02-19,spring,2012,February,8,Sunday,Holiday,Mist,0.24,0.2273,0.56,0.194,8,48,56,56,316,56,3,2,1,321,1,727,261001,3,56
2012-02-19,spring,2012,February,9,Sunday,Holiday,Mist,0.24,0.2273,0.56,0.2537,20,73,93,93,316,93,3,2,1,321,1,727,159438,3,93
2012-02-19,spring,2012,February,10,Sunday,Holiday,Mist,0.26,0.2424,0.52,0.2537,49,142,191,191,316,191,3,3,1,331,1,727,126257,3,191
2012-02-19,spring,2012,February,11,Sunday,Holiday,Mist,0.26,0.2273,0.56,0.3284,82,144,226,226,316,226,3,3,1,331,1,727,151320,3,226
2012-02-19,spring,2012,February,12,Sunday,Holiday,Mist,0.28,0.2727,0.52,0.2537,71,184,255,255,316,255,3,3,1,331,1,728,184414,3,255
2012-02-19,spring,2012,February,13,Sunday,Holiday,Clear,0.3,0.303,0.49,0.1642,64,197,261,261,316,261,3,3,1,331,1,729,184919,3,261
2012-02-19,spring,2012,February,14,Sunday,Holiday,Mist,0.32,0.3182,0.45,0.194,48,189,237,237,316,237,3,3,1,331,1,729,175652,3,237
2012-02-19,spring,2012,February,15,Sunday,Holiday,Mist,0.3,0.2879,0.49,0.194,85,168,253,253,316,253,3,3,1,331,1,729,183149,3,253
2012-02-19,spring,2012,February,16,Sunday,Holiday,Mist,0.32,0.303,0.45,0.2836,62,150,212,212,316,212,3,3,1,331,1,730,227748,3,212
2012-02-19,spring,2012,February,17,Sunday,Holiday,Mist,0.3,0.2879,0.49,0.2537,22,135,157,157,316,157,3,3,1,331,1,730,336860,3,157
2012-02-19,spring,2012,February,18,Sunday,Holiday,Mist,0.3,0.2727,0.49,0.3284,23,144,167,167,316,167,3,3,1,331,1,728,309772,3,167
2012-02-19,spring,2012,February,19,Sunday,Holiday,Mist,0.3,0.2879,0.52,0.2537,18,101,119,119,316,119,3,2,1,321,1,728,226789,3,119
2012-02-19,spring,2012,February,20,Sunday,Holiday,Mist,0.3,0.2879,0.52,0.2836,22,81,103,103,316,103,3,2,1,321,1,728,164550,3,103
2012-02-19,spring,2012,February,21,Sunday,Holiday,Light Snow,0.26,0.2576,0.65,0.1642,3,33,36,36,316,36,3,1,1,311,1,728,125445,3,36
2012-02-19,spring,2012,February,22,Sunday,Holiday,Light Snow,0.24,0.2576,0.75,0.0896,8,47,55,55,316,55,3,2,1,321,1,728,95612,3,55
2012-02-19,spring,2012,February,23,Sunday,Holiday,Mist,0.22,0.2273,0.93,0.1642,5,30,35,35,316,35,3,1,1,311,1,728,63941,3,35
2012-02-20,spring,2012,February,0,Monday,Holiday,Mist,0.24,0.2576,0.87,0.0896,5,36,41,41,315,41,3,2,1,321,1,726,39130,3,41
2012-02-20,spring,2012,February,1,Monday,Holiday,Mist,0.24,0.2576,0.87,0.0896,3,12,15,15,315,15,3,1,1,311,1,724,24164,3,15
2012-02-20,spring,2012,February,2,Monday,Holiday,Mist,0.24,0.2576,0.87,0.0896,1,19,20,20,315,20,3,1,1,311,1,715,16352,3,20
2012-02-20,spring,2012,February,3,Monday,Holiday,Mist,0.24,0.2273,0.81,0.194,0,8,8,8,315,8,3,1,1,311,1,697,8174,3,8
2012-02-20,spring,2012,February,5,Monday,Holiday,Mist,0.24,0.2121,0.6,0.3582,0,6,6,6,315,6,3,1,1,311,1,717,14261,3,6
2012-02-20,spring,2012,February,6,Monday,Holiday,Clear,0.24,0.197,0.52,0.4179,1,9,10,10,315,10,3,1,1,311,1,725,55132,3,10
2012-02-20,spring,2012,February,7,Monday,Holiday,Mist,0.22,0.197,0.55,0.3284,2,42,44,44,315,44,3,2,1,321,1,727,154171,3,44
2012-02-20,spring,2012,February,8,Monday,Holiday,Clear,0.2,0.1818,0.59,0.3582,9,111,120,120,315,120,3,2,1,321,1,727,261001,3,120
2012-02-20,spring,2012,February,9,Monday,Holiday,Clear,0.2,0.1818,0.59,0.3582,12,98,110,110,315,110,3,2,1,321,1,727,159438,3,110
2012-02-20,spring,2012,February,10,Monday,Holiday,Clear,0.22,0.197,0.55,0.4478,30,113,143,143,315,143,3,3,1,331,1,727,126257,3,143
2012-02-20,spring,2012,February,11,Monday,Holiday,Clear,0.26,0.2273,0.48,0.3582,45,163,208,208,315,208,3,3,1,331,1,727,151320,3,208
2012-02-20,spring,2012,February,12,Monday,Holiday,Clear,0.28,0.2727,0.45,0.2239,65,216,281,281,315,281,3,3,1,331,1,728,184414,3,281
2012-02-20,spring,2012,February,13,Monday,Holiday,Clear,0.3,0.2879,0.42,0.2836,66,246,312,312,315,312,3,4,1,341,1,729,184919,3,312
2012-02-20,spring,2012,February,14,Monday,Holiday,Clear,0.32,0.3182,0.36,0.194,57,206,263,263,315,263,3,3,1,331,1,729,175652,3,263
2012-02-20,spring,2012,February,15,Monday,Holiday,Clear,0.34,0.3182,0.34,0.2239,54,235,289,289,315,289,3,4,1,341,1,729,183149,3,289
2012-02-20,spring,2012,February,16,Monday,Holiday,Clear,0.36,0.3788,0.29,0.1045,64,216,280,280,315,280,3,3,2,332,1,730,227748,3,280
2012-02-20,spring,2012,February,17,Monday,Holiday,Clear,0.38,0.3939,0.27,0.2537,27,226,253,253,315,253,3,3,2,332,1,730,336860,3,253
2012-02-20,spring,2012,February,18,Monday,Holiday,Clear,0.34,0.3182,0.34,0.2239,27,215,242,242,315,242,3,3,1,331,1,728,309772,3,242
2012-02-20,spring,2012,February,19,Monday,Holiday,Clear,0.34,0.3182,0.34,0.2239,8,164,172,172,315,172,3,3,1,331,1,728,226789,3,172
2012-02-20,spring,2012,February,20,Monday,Holiday,Clear,0.34,0.3333,0.34,0.194,9,117,126,126,315,126,3,2,1,321,1,728,164550,3,126
2012-02-20,spring,2012,February,21,Monday,Holiday,Clear,0.3,0.303,0.39,0.1642,8,90,98,98,315,98,3,2,1,321,1,728,125445,3,98
2012-02-20,spring,2012,February,22,Monday,Holiday,Clear,0.3,0.3182,0.45,0.0896,9,53,62,62,315,62,3,2,1,321,1,728,95612,3,62
2012-02-20,spring,2012,February,23,Monday,Holiday,Clear,0.3,0.3333,0.39,0.0,0,26,26,26,315,26,3,1,1,311,1,728,63941,3,26
2012-02-21,spring,2012,February,0,Tuesday,Workingday,Clear,0.26,0.303,0.65,0.0,1,11,12,12,314,12,3,1,1,311,1,726,39130,3,12
2012-02-21,spring,2012,February,1,Tuesday,Workingday,Clear,0.26,0.303,0.56,0.0,0,7,7,7,314,7,3,1,1,311,1,724,24164,3,7
2012-02-21,spring,2012,February,2,Tuesday,Workingday,Clear,0.24,0.2879,0.6,0.0,0,3,3,3,314,3,3,1,1,311,1,715,16352,3,3
2012-02-21,spring,2012,February,4,Tuesday,Workingday,Clear,0.22,0.2727,0.64,0.0,0,2,2,2,314,2,3,1,1,311,1,697,4428,3,2
2012-02-21,spring,2012,February,5,Tuesday,Workingday,Clear,0.2,0.2576,0.69,0.0,0,15,15,15,314,15,3,1,1,311,1,717,14261,3,15
2012-02-21,spring,2012,February,6,Tuesday,Workingday,Clear,0.2,0.2576,0.75,0.0,3,83,86,86,314,86,3,2,1,321,1,725,55132,3,86
2012-02-21,spring,2012,February,7,Tuesday,Workingday,Clear,0.22,0.2727,0.64,0.0,6,273,279,279,314,279,3,3,1,331,1,727,154171,3,279
2012-02-21,spring,2012,February,8,Tuesday,Workingday,Clear,0.2,0.2273,0.69,0.0896,5,459,464,464,314,464,3,4,1,341,1,727,261001,3,464
2012-02-21,spring,2012,February,9,Tuesday,Workingday,Clear,0.2,0.2273,0.75,0.1045,6,211,217,217,314,217,3,3,1,331,1,727,159438,3,217
2012-02-21,spring,2012,February,10,Tuesday,Workingday,Clear,0.24,0.2273,0.7,0.194,8,77,85,85,314,85,3,2,1,321,1,727,126257,3,85
2012-02-21,spring,2012,February,11,Tuesday,Workingday,Mist,0.26,0.2424,0.7,0.2836,5,81,86,86,314,86,3,2,1,321,1,727,151320,3,86
2012-02-21,spring,2012,February,12,Tuesday,Workingday,Mist,0.3,0.2727,0.56,0.3881,16,147,163,163,314,163,3,3,1,331,1,728,184414,3,163
2012-02-21,spring,2012,February,13,Tuesday,Workingday,Clear,0.34,0.303,0.49,0.4179,8,123,131,131,314,131,3,2,1,321,1,729,184919,3,131
2012-02-21,spring,2012,February,14,Tuesday,Workingday,Mist,0.32,0.2879,0.53,0.3881,16,108,124,124,314,124,3,2,1,321,1,729,175652,3,124
2012-02-21,spring,2012,February,15,Tuesday,Workingday,Clear,0.34,0.303,0.49,0.4179,23,137,160,160,314,160,3,3,1,331,1,729,183149,3,160
2012-02-21,spring,2012,February,16,Tuesday,Workingday,Clear,0.36,0.3333,0.46,0.4179,14,240,254,254,314,254,3,3,1,331,1,730,227748,3,254
2012-02-21,spring,2012,February,17,Tuesday,Workingday,Clear,0.38,0.3939,0.4,0.4478,21,411,432,432,314,432,3,4,2,342,1,730,336860,3,432
2012-02-21,spring,2012,February,18,Tuesday,Workingday,Clear,0.38,0.3939,0.4,0.4478,11,414,425,425,314,425,3,4,2,342,1,728,309772,3,425
2012-02-21,spring,2012,February,19,Tuesday,Workingday,Clear,0.36,0.3333,0.46,0.2985,5,299,304,304,314,304,3,4,1,341,1,728,226789,3,304
2012-02-21,spring,2012,February,20,Tuesday,Workingday,Clear,0.34,0.3182,0.53,0.2537,4,223,227,227,314,227,3,3,1,331,1,728,164550,3,227
2012-02-21,spring,2012,February,21,Tuesday,Workingday,Clear,0.34,0.3333,0.61,0.1642,7,147,154,154,314,154,3,3,1,331,1,728,125445,3,154
2012-02-21,spring,2012,February,22,Tuesday,Workingday,Mist,0.34,0.3333,0.71,0.194,3,97,100,100,314,100,3,2,1,321,1,728,95612,3,100
2012-02-21,spring,2012,February,23,Tuesday,Workingday,Clear,0.32,0.303,0.66,0.2239,1,46,47,47,314,47,3,2,1,321,1,728,63941,3,47
2012-02-22,spring,2012,February,0,Wednesday,Workingday,Clear,0.32,0.303,0.66,0.2239,5,19,24,24,313,24,3,1,1,311,1,726,39130,3,24
2012-02-22,spring,2012,February,1,Wednesday,Workingday,Clear,0.32,0.3333,0.7,0.1343,3,4,7,7,313,7,3,1,1,311,1,724,24164,3,7
2012-02-22,spring,2012,February,2,Wednesday,Workingday,Clear,0.34,0.3182,0.66,0.2836,1,5,6,6,313,6,3,1,1,311,1,715,16352,3,6
2012-02-22,spring,2012,February,3,Wednesday,Workingday,Mist,0.34,0.3182,0.71,0.2239,1,3,4,4,313,4,3,1,1,311,1,697,8174,3,4
2012-02-22,spring,2012,February,4,Wednesday,Workingday,Clear,0.34,0.3333,0.71,0.1642,0,2,2,2,313,2,3,1,1,311,1,697,4428,3,2
2012-02-22,spring,2012,February,5,Wednesday,Workingday,Clear,0.32,0.3333,0.7,0.1045,1,29,30,30,313,30,3,1,1,311,1,717,14261,3,30
2012-02-22,spring,2012,February,6,Wednesday,Workingday,Clear,0.32,0.3182,0.76,0.1642,5,85,90,90,313,90,3,2,1,321,1,725,55132,3,90
2012-02-22,spring,2012,February,7,Wednesday,Workingday,Clear,0.32,0.3333,0.76,0.0896,10,292,302,302,313,302,3,4,1,341,1,727,154171,3,302
2012-02-22,spring,2012,February,8,Wednesday,Workingday,Clear,0.3,0.3182,0.75,0.0896,9,567,576,576,313,576,3,4,1,341,1,727,261001,3,576
2012-02-22,spring,2012,February,9,Wednesday,Workingday,Clear,0.32,0.3333,0.7,0.0896,11,241,252,252,313,252,3,3,1,331,1,727,159438,3,252
2012-02-22,spring,2012,February,10,Wednesday,Workingday,Clear,0.34,0.3485,0.71,0.0896,17,122,139,139,313,139,3,2,2,322,1,727,126257,3,139
2012-02-22,spring,2012,February,11,Wednesday,Workingday,Clear,0.36,0.3485,0.66,0.1642,22,149,171,171,313,171,3,3,2,332,1,727,151320,3,171
2012-02-22,spring,2012,February,12,Wednesday,Workingday,Clear,0.4,0.4091,0.62,0.2836,21,186,207,207,313,207,3,3,2,332,1,728,184414,3,207
2012-02-22,spring,2012,February,13,Wednesday,Workingday,Clear,0.42,0.4242,0.54,0.2985,15,175,190,190,313,190,3,3,2,332,1,729,184919,3,190
2012-02-22,spring,2012,February,14,Wednesday,Workingday,Clear,0.44,0.4394,0.54,0.3284,35,142,177,177,313,177,3,3,2,332,1,729,175652,3,177
2012-02-22,spring,2012,February,15,Wednesday,Workingday,Clear,0.5,0.4848,0.31,0.4179,34,161,195,195,313,195,3,3,2,332,1,729,183149,3,195
2012-02-22,spring,2012,February,16,Wednesday,Workingday,Clear,0.52,0.5,0.29,0.4627,30,268,298,298,313,298,3,4,3,343,2,730,227748,3,298
2012-02-22,spring,2012,February,17,Wednesday,Workingday,Clear,0.52,0.5,0.32,0.3881,43,486,529,529,313,529,3,4,3,343,2,730,336860,3,529
2012-02-22,spring,2012,February,18,Wednesday,Workingday,Mist,0.48,0.4697,0.41,0.3284,42,483,525,525,313,525,3,4,2,342,2,728,309772,3,525
2012-02-22,spring,2012,February,19,Wednesday,Workingday,Mist,0.46,0.4545,0.44,0.2836,22,305,327,327,313,327,3,4,2,342,1,728,226789,3,327
2012-02-22,spring,2012,February,20,Wednesday,Workingday,Mist,0.44,0.4394,0.47,0.194,25,249,274,274,313,274,3,3,2,332,1,728,164550,3,274
2012-02-22,spring,2012,February,21,Wednesday,Workingday,Mist,0.48,0.4697,0.33,0.2836,19,220,239,239,313,239,3,3,2,332,1,728,125445,3,239
2012-02-22,spring,2012,February,22,Wednesday,Workingday,Mist,0.44,0.4394,0.47,0.2537,18,129,147,147,313,147,3,3,2,332,1,728,95612,3,147
2012-02-22,spring,2012,February,23,Wednesday,Workingday,Mist,0.46,0.4545,0.41,0.2836,5,57,62,62,313,62,3,2,2,322,1,728,63941,3,62
2012-02-23,spring,2012,February,0,Thursday,Workingday,Mist,0.44,0.4394,0.47,0.2537,12,30,42,42,312,42,3,2,2,322,1,726,39130,3,42
2012-02-23,spring,2012,February,1,Thursday,Workingday,Mist,0.44,0.4394,0.58,0.2836,3,12,15,15,312,15,3,1,2,312,1,724,24164,3,15
2012-02-23,spring,2012,February,2,Thursday,Workingday,Mist,0.44,0.4394,0.62,0.2239,5,4,9,9,312,9,3,1,2,312,1,715,16352,3,9
2012-02-23,spring,2012,February,3,Thursday,Workingday,Light Snow,0.44,0.4394,0.67,0.194,2,4,6,6,312,6,3,1,2,312,0,697,8174,3,6
2012-02-23,spring,2012,February,4,Thursday,Workingday,Clear,0.4,0.4091,0.76,0.2239,0,1,1,1,312,1,3,1,2,312,1,697,4428,3,1
2012-02-23,spring,2012,February,5,Thursday,Workingday,Clear,0.4,0.4091,0.76,0.2239,2,30,32,32,312,32,3,1,2,312,1,717,14261,3,32
2012-02-23,spring,2012,February,6,Thursday,Workingday,Clear,0.36,0.3485,0.87,0.194,3,88,91,91,312,91,3,2,2,322,1,725,55132,3,91
2012-02-23,spring,2012,February,7,Thursday,Workingday,Clear,0.36,0.3485,0.81,0.2239,9,317,326,326,312,326,3,4,2,342,1,727,154171,3,326
2012-02-23,spring,2012,February,8,Thursday,Workingday,Clear,0.34,0.3333,0.87,0.194,11,549,560,560,312,560,3,4,1,341,1,727,261001,3,560
2012-02-23,spring,2012,February,9,Thursday,Workingday,Clear,0.36,0.3333,0.81,0.2537,14,228,242,242,312,242,3,3,1,331,1,727,159438,3,242
2012-02-23,spring,2012,February,10,Thursday,Workingday,Clear,0.42,0.4242,0.67,0.194,41,107,148,148,312,148,3,3,2,332,1,727,126257,3,148
2012-02-23,spring,2012,February,11,Thursday,Workingday,Clear,0.48,0.4697,0.48,0.2836,54,128,182,182,312,182,3,3,2,332,1,727,151320,3,182
2012-02-23,spring,2012,February,12,Thursday,Workingday,Clear,0.5,0.4848,0.42,0.2537,25,199,224,224,312,224,3,3,2,332,1,728,184414,3,224
2012-02-23,spring,2012,February,13,Thursday,Workingday,Clear,0.52,0.5,0.39,0.194,30,188,218,218,312,218,3,3,3,333,2,729,184919,3,218
2012-02-23,spring,2012,February,14,Thursday,Workingday,Clear,0.54,0.5152,0.37,0.2537,36,156,192,192,312,192,3,3,3,333,2,729,175652,3,192
2012-02-23,spring,2012,February,15,Thursday,Workingday,Clear,0.54,0.5152,0.33,0.1343,46,171,217,217,312,217,3,3,3,333,2,729,183149,3,217
2012-02-23,spring,2012,February,16,Thursday,Workingday,Clear,0.56,0.5303,0.32,0.0,45,298,343,343,312,343,3,4,3,343,2,730,227748,3,343
2012-02-23,spring,2012,February,17,Thursday,Workingday,Clear,0.54,0.5152,0.32,0.1642,49,561,610,610,312,610,3,4,3,343,2,730,336860,3,610
2012-02-23,spring,2012,February,18,Thursday,Workingday,Clear,0.54,0.5152,0.37,0.1343,36,486,522,522,312,522,3,4,3,343,2,728,309772,3,522
2012-02-23,spring,2012,February,19,Thursday,Workingday,Clear,0.5,0.4848,0.39,0.0896,20,349,369,369,312,369,3,4,2,342,2,728,226789,3,369
2012-02-23,spring,2012,February,20,Thursday,Workingday,Clear,0.46,0.4545,0.44,0.1343,23,246,269,269,312,269,3,3,2,332,1,728,164550,3,269
2012-02-23,spring,2012,February,21,Thursday,Workingday,Clear,0.44,0.4394,0.51,0.2239,17,205,222,222,312,222,3,3,2,332,1,728,125445,3,222
2012-02-23,spring,2012,February,22,Thursday,Workingday,Clear,0.44,0.4394,0.54,0.2537,19,118,137,137,312,137,3,2,2,322,1,728,95612,3,137
2012-02-23,spring,2012,February,23,Thursday,Workingday,Clear,0.44,0.4394,0.54,0.0,14,71,85,85,312,85,3,2,2,322,0,728,63941,3,85
2012-02-24,spring,2012,February,0,Friday,Workingday,Mist,0.44,0.4394,0.58,0.0896,12,34,46,46,311,46,3,2,2,322,0,726,39130,3,46
2012-02-24,spring,2012,February,1,Friday,Workingday,Clear,0.44,0.4394,0.62,0.194,3,15,18,18,311,18,3,1,2,312,1,724,24164,3,18
2012-02-24,spring,2012,February,2,Friday,Workingday,Light Snow,0.42,0.4242,0.77,0.2836,1,4,5,5,311,5,3,1,2,312,1,715,16352,3,5
2012-02-24,spring,2012,February,3,Friday,Workingday,Clear,0.42,0.4242,0.82,0.1343,0,5,5,5,311,5,3,1,2,312,0,697,8174,3,5
2012-02-24,spring,2012,February,4,Friday,Workingday,Clear,0.4,0.4091,0.87,0.1343,0,2,2,2,311,2,3,1,2,312,0,697,4428,3,2
2012-02-24,spring,2012,February,5,Friday,Workingday,Mist,0.4,0.4091,0.87,0.194,1,25,26,26,311,26,3,1,2,312,0,717,14261,3,26
2012-02-24,spring,2012,February,6,Friday,Workingday,Mist,0.4,0.4091,0.87,0.1642,2,80,82,82,311,82,3,2,2,322,0,725,55132,3,82
2012-02-24,spring,2012,February,7,Friday,Workingday,Mist,0.4,0.4091,0.76,0.2239,7,265,272,272,311,272,3,3,2,332,1,727,154171,3,272
2012-02-24,spring,2012,February,8,Friday,Workingday,Mist,0.38,0.3939,0.76,0.3284,17,452,469,469,311,469,3,4,2,342,1,727,261001,3,469
2012-02-24,spring,2012,February,9,Friday,Workingday,Light Snow,0.36,0.3333,0.81,0.2537,15,229,244,244,311,244,3,3,1,331,1,727,159438,3,244
2012-02-24,spring,2012,February,10,Friday,Workingday,Light Snow,0.36,0.3485,0.81,0.1642,22,119,141,141,311,141,3,2,2,322,1,727,126257,3,141
2012-02-24,spring,2012,February,11,Friday,Workingday,Mist,0.36,0.3636,0.81,0.1045,27,136,163,163,311,163,3,3,2,332,0,727,151320,3,163
2012-02-24,spring,2012,February,12,Friday,Workingday,Mist,0.4,0.4091,0.76,0.1343,27,201,228,228,311,228,3,3,2,332,0,728,184414,3,228
2012-02-24,spring,2012,February,13,Friday,Workingday,Mist,0.42,0.4242,0.71,0.1045,30,153,183,183,311,183,3,3,2,332,0,729,184919,3,183
2012-02-24,spring,2012,February,14,Friday,Workingday,Mist,0.46,0.4545,0.67,0.1045,5,26,31,31,311,31,3,1,2,312,0,729,175652,3,31
2012-02-24,spring,2012,February,15,Friday,Workingday,Light Snow,0.4,0.4091,0.87,0.194,11,83,94,94,311,94,3,2,2,322,0,729,183149,3,94
2012-02-24,spring,2012,February,16,Friday,Workingday,Light Snow,0.4,0.4091,0.87,0.194,12,166,178,178,311,178,3,3,2,332,0,730,227748,3,178
2012-02-24,spring,2012,February,17,Friday,Workingday,Light Snow,0.42,0.4242,0.94,0.1045,14,242,256,256,311,256,3,3,2,332,0,730,336860,3,256
2012-02-24,spring,2012,February,18,Friday,Workingday,Mist,0.42,0.4242,0.94,0.0,11,289,300,300,311,300,3,4,2,342,0,728,309772,3,300
2012-02-24,spring,2012,February,19,Friday,Workingday,Mist,0.44,0.4394,0.88,0.1045,6,227,233,233,311,233,3,3,2,332,0,728,226789,3,233
2012-02-24,spring,2012,February,20,Friday,Workingday,Clear,0.44,0.4394,0.62,0.4179,8,159,167,167,311,167,3,3,2,332,1,728,164550,3,167
2012-02-24,spring,2012,February,21,Friday,Workingday,Clear,0.42,0.4242,0.35,0.806,1,151,152,152,311,152,3,3,2,332,1,728,125445,3,152
2012-02-24,spring,2012,February,22,Friday,Workingday,Clear,0.4,0.4091,0.37,0.5821,4,102,106,106,311,106,3,2,2,322,1,728,95612,3,106
2012-02-24,spring,2012,February,23,Friday,Workingday,Clear,0.38,0.3939,0.37,0.6866,10,76,86,86,311,86,3,2,2,322,1,728,63941,3,86
2012-02-25,spring,2012,February,0,Saturday,Holiday,Clear,0.36,0.3333,0.43,0.3881,5,56,61,61,310,61,3,2,1,321,1,726,39130,3,61
2012-02-25,spring,2012,February,1,Saturday,Holiday,Clear,0.34,0.303,0.42,0.3582,4,42,46,46,310,46,3,2,1,321,1,724,24164,3,46
2012-02-25,spring,2012,February,2,Saturday,Holiday,Clear,0.32,0.303,0.45,0.2537,1,37,38,38,310,38,3,1,1,311,1,715,16352,3,38
2012-02-25,spring,2012,February,3,Saturday,Holiday,Clear,0.3,0.2727,0.45,0.2985,0,7,7,7,310,7,3,1,1,311,1,697,8174,3,7
2012-02-25,spring,2012,February,4,Saturday,Holiday,Clear,0.3,0.2727,0.42,0.3284,0,2,2,2,310,2,3,1,1,311,1,697,4428,3,2
2012-02-25,spring,2012,February,5,Saturday,Holiday,Mist,0.3,0.2727,0.42,0.2985,0,3,3,3,310,3,3,1,1,311,1,717,14261,3,3
2012-02-25,spring,2012,February,6,Saturday,Holiday,Mist,0.3,0.2727,0.42,0.2985,1,12,13,13,310,13,3,1,1,311,1,725,55132,3,13
2012-02-25,spring,2012,February,7,Saturday,Holiday,Clear,0.28,0.2424,0.45,0.4478,3,20,23,23,310,23,3,1,1,311,1,727,154171,3,23
2012-02-25,spring,2012,February,8,Saturday,Holiday,Clear,0.26,0.2273,0.48,0.2985,3,90,93,93,310,93,3,2,1,321,1,727,261001,3,93
2012-02-25,spring,2012,February,9,Saturday,Holiday,Light Snow,0.22,0.197,0.75,0.3284,15,107,122,122,310,122,3,2,1,321,1,727,159438,3,122
2012-02-25,spring,2012,February,10,Saturday,Holiday,Clear,0.26,0.2273,0.6,0.3582,24,159,183,183,310,183,3,3,1,331,1,727,126257,3,183
2012-02-25,spring,2012,February,11,Saturday,Holiday,Clear,0.3,0.2576,0.39,0.6119,23,187,210,210,310,210,3,3,1,331,1,727,151320,3,210
2012-02-25,spring,2012,February,12,Saturday,Holiday,Clear,0.32,0.2727,0.29,0.6567,41,217,258,258,310,258,3,3,1,331,1,728,184414,3,258
2012-02-25,spring,2012,February,13,Saturday,Holiday,Clear,0.32,0.2879,0.31,0.4925,48,178,226,226,310,226,3,3,1,331,1,729,184919,3,226
2012-02-25,spring,2012,February,14,Saturday,Holiday,Clear,0.32,0.2727,0.29,0.5522,35,181,216,216,310,216,3,3,1,331,1,729,175652,3,216
2012-02-25,spring,2012,February,15,Saturday,Holiday,Clear,0.32,0.2879,0.29,0.4179,21,211,232,232,310,232,3,3,1,331,1,729,183149,3,232
2012-02-25,spring,2012,February,16,Saturday,Holiday,Clear,0.32,0.2727,0.26,0.5821,32,163,195,195,310,195,3,3,1,331,1,730,227748,3,195
2012-02-25,spring,2012,February,17,Saturday,Holiday,Clear,0.3,0.2727,0.33,0.3582,16,143,159,159,310,159,3,3,1,331,1,730,336860,3,159
2012-02-25,spring,2012,February,18,Saturday,Holiday,Clear,0.3,0.2576,0.28,0.5821,7,126,133,133,310,133,3,2,1,321,1,728,309772,3,133
2012-02-25,spring,2012,February,19,Saturday,Holiday,Clear,0.26,0.2121,0.33,0.4478,12,137,149,149,310,149,3,3,1,331,1,728,226789,3,149
2012-02-25,spring,2012,February,20,Saturday,Holiday,Clear,0.26,0.2121,0.3,0.5522,10,95,105,105,310,105,3,2,1,321,1,728,164550,3,105
2012-02-25,spring,2012,February,21,Saturday,Holiday,Clear,0.24,0.2121,0.35,0.3284,5,80,85,85,310,85,3,2,1,321,1,728,125445,3,85
2012-02-25,spring,2012,February,22,Saturday,Holiday,Clear,0.24,0.197,0.38,0.4627,4,78,82,82,310,82,3,2,1,321,1,728,95612,3,82
2012-02-25,spring,2012,February,23,Saturday,Holiday,Clear,0.24,0.197,0.41,0.4179,7,84,91,91,310,91,3,2,1,321,1,728,63941,3,91
2012-02-26,spring,2012,February,0,Sunday,Holiday,Clear,0.24,0.2121,0.41,0.3582,7,63,70,70,309,70,3,2,1,321,1,726,39130,3,70
2012-02-26,spring,2012,February,1,Sunday,Holiday,Clear,0.24,0.2121,0.44,0.3284,5,50,55,55,309,55,3,2,1,321,1,724,24164,3,55
2012-02-26,spring,2012,February,2,Sunday,Holiday,Clear,0.24,0.2121,0.44,0.3284,5,37,42,42,309,42,3,2,1,321,1,715,16352,3,42
2012-02-26,spring,2012,February,3,Sunday,Holiday,Clear,0.24,0.2273,0.41,0.194,0,21,21,21,309,21,3,1,1,311,1,697,8174,3,21
2012-02-26,spring,2012,February,4,Sunday,Holiday,Clear,0.24,0.2273,0.41,0.194,1,5,6,6,309,6,3,1,1,311,1,697,4428,3,6
2012-02-26,spring,2012,February,5,Sunday,Holiday,Clear,0.22,0.2121,0.44,0.2239,0,5,5,5,309,5,3,1,1,311,1,717,14261,3,5
2012-02-26,spring,2012,February,6,Sunday,Holiday,Clear,0.22,0.197,0.44,0.3284,0,2,2,2,309,2,3,1,1,311,1,725,55132,3,2
2012-02-26,spring,2012,February,7,Sunday,Holiday,Clear,0.2,0.1818,0.51,0.2985,2,20,22,22,309,22,3,1,1,311,1,727,154171,3,22
2012-02-26,spring,2012,February,8,Sunday,Holiday,Clear,0.2,0.197,0.51,0.2537,2,57,59,59,309,59,3,2,1,321,1,727,261001,3,59
2012-02-26,spring,2012,February,9,Sunday,Holiday,Clear,0.22,0.2121,0.47,0.2239,11,76,87,87,309,87,3,2,1,321,1,727,159438,3,87
2012-02-26,spring,2012,February,10,Sunday,Holiday,Clear,0.26,0.2576,0.41,0.1642,27,161,188,188,309,188,3,3,1,331,1,727,126257,3,188
2012-02-26,spring,2012,February,11,Sunday,Holiday,Clear,0.28,0.2576,0.41,0.2836,43,184,227,227,309,227,3,3,1,331,1,727,151320,3,227
2012-02-26,spring,2012,February,12,Sunday,Holiday,Clear,0.3,0.303,0.39,0.1343,49,256,305,305,309,305,3,4,1,341,1,728,184414,3,305
2012-02-26,spring,2012,February,13,Sunday,Holiday,Clear,0.32,0.3333,0.36,0.0,58,267,325,325,309,325,3,4,1,341,1,729,184919,3,325
2012-02-26,spring,2012,February,14,Sunday,Holiday,Clear,0.34,0.3485,0.31,0.0,68,263,331,331,309,331,3,4,2,342,1,729,175652,3,331
2012-02-26,spring,2012,February,15,Sunday,Holiday,Clear,0.36,0.3485,0.29,0.0,72,281,353,353,309,353,3,4,2,342,1,729,183149,3,353
2012-02-26,spring,2012,February,16,Sunday,Holiday,Clear,0.36,0.3333,0.32,0.2537,64,275,339,339,309,339,3,4,1,341,1,730,227748,3,339
2012-02-26,spring,2012,February,17,Sunday,Holiday,Clear,0.36,0.3485,0.32,0.2239,46,241,287,287,309,287,3,4,2,342,1,730,336860,3,287
2012-02-26,spring,2012,February,18,Sunday,Holiday,Clear,0.34,0.3182,0.36,0.2836,17,199,216,216,309,216,3,3,1,331,1,728,309772,3,216
2012-02-26,spring,2012,February,19,Sunday,Holiday,Clear,0.34,0.3333,0.34,0.1642,13,130,143,143,309,143,3,3,1,331,1,728,226789,3,143
2012-02-26,spring,2012,February,20,Sunday,Holiday,Clear,0.32,0.3182,0.42,0.1642,9,79,88,88,309,88,3,2,1,321,1,728,164550,3,88
2012-02-26,spring,2012,February,21,Sunday,Holiday,Clear,0.3,0.303,0.45,0.1343,8,75,83,83,309,83,3,2,1,321,1,728,125445,3,83
2012-02-26,spring,2012,February,22,Sunday,Holiday,Clear,0.3,0.2879,0.42,0.2239,3,68,71,71,309,71,3,2,1,321,1,728,95612,3,71
2012-02-26,spring,2012,February,23,Sunday,Holiday,Clear,0.26,0.2576,0.56,0.1642,5,59,64,64,309,64,3,2,1,321,1,728,63941,3,64
2012-02-27,spring,2012,February,0,Monday,Workingday,Clear,0.26,0.2424,0.6,0.2537,2,27,29,29,308,29,3,1,1,311,1,726,39130,3,29
2012-02-27,spring,2012,February,1,Monday,Workingday,Clear,0.26,0.2576,0.65,0.2239,0,6,6,6,308,6,3,1,1,311,1,724,24164,3,6
2012-02-27,spring,2012,February,2,Monday,Workingday,Clear,0.26,0.2273,0.7,0.2985,0,4,4,4,308,4,3,1,1,311,1,715,16352,3,4
2012-02-27,spring,2012,February,3,Monday,Workingday,Clear,0.24,0.2424,0.75,0.1642,0,2,2,2,308,2,3,1,1,311,1,697,8174,3,2
2012-02-27,spring,2012,February,4,Monday,Workingday,Clear,0.22,0.2273,0.8,0.1343,0,1,1,1,308,1,3,1,1,311,1,697,4428,3,1
2012-02-27,spring,2012,February,5,Monday,Workingday,Clear,0.22,0.2273,0.8,0.1343,0,16,16,16,308,16,3,1,1,311,1,717,14261,3,16
2012-02-27,spring,2012,February,6,Monday,Workingday,Clear,0.24,0.2273,0.7,0.2537,1,89,90,90,308,90,3,2,1,321,1,725,55132,3,90
2012-02-27,spring,2012,February,7,Monday,Workingday,Clear,0.24,0.2273,0.6,0.2239,2,278,280,280,308,280,3,3,1,331,1,727,154171,3,280
2012-02-27,spring,2012,February,8,Monday,Workingday,Clear,0.24,0.2424,0.6,0.0,14,514,528,528,308,528,3,4,1,341,1,727,261001,3,528
2012-02-27,spring,2012,February,9,Monday,Workingday,Clear,0.26,0.2576,0.6,0.194,11,219,230,230,308,230,3,3,1,331,1,727,159438,3,230
2012-02-27,spring,2012,February,10,Monday,Workingday,Clear,0.32,0.303,0.45,0.2537,16,88,104,104,308,104,3,2,1,321,1,727,126257,3,104
2012-02-27,spring,2012,February,11,Monday,Workingday,Clear,0.36,0.3333,0.43,0.2537,11,92,103,103,308,103,3,2,1,321,1,727,151320,3,103
2012-02-27,spring,2012,February,12,Monday,Workingday,Clear,0.4,0.4091,0.37,0.2985,13,164,177,177,308,177,3,3,2,332,1,728,184414,3,177
2012-02-27,spring,2012,February,13,Monday,Workingday,Clear,0.4,0.4091,0.43,0.2836,23,159,182,182,308,182,3,3,2,332,1,729,184919,3,182
2012-02-27,spring,2012,February,14,Monday,Workingday,Clear,0.46,0.4545,0.36,0.2836,24,134,158,158,308,158,3,3,2,332,1,729,175652,3,158
2012-02-27,spring,2012,February,15,Monday,Workingday,Clear,0.52,0.5,0.25,0.4179,24,150,174,174,308,174,3,3,3,333,2,729,183149,3,174
2012-02-27,spring,2012,February,16,Monday,Workingday,Clear,0.54,0.5152,0.26,0.4478,20,266,286,286,308,286,3,4,3,343,2,730,227748,3,286
2012-02-27,spring,2012,February,17,Monday,Workingday,Clear,0.54,0.5152,0.24,0.4478,26,503,529,529,308,529,3,4,3,343,2,730,336860,3,529
2012-02-27,spring,2012,February,18,Monday,Workingday,Clear,0.52,0.5,0.27,0.4179,10,517,527,527,308,527,3,4,3,343,2,728,309772,3,527
2012-02-27,spring,2012,February,19,Monday,Workingday,Clear,0.5,0.4848,0.29,0.3881,16,318,334,334,308,334,3,4,2,342,2,728,226789,3,334
2012-02-27,spring,2012,February,20,Monday,Workingday,Clear,0.48,0.4697,0.33,0.3582,11,208,219,219,308,219,3,3,2,332,1,728,164550,3,219
2012-02-27,spring,2012,February,21,Monday,Workingday,Clear,0.46,0.4545,0.36,0.2836,14,181,195,195,308,195,3,3,2,332,1,728,125445,3,195
2012-02-27,spring,2012,February,22,Monday,Workingday,Clear,0.44,0.4394,0.44,0.2537,9,83,92,92,308,92,3,2,2,322,1,728,95612,3,92
2012-02-27,spring,2012,February,23,Monday,Workingday,Clear,0.42,0.4242,0.5,0.1642,6,50,56,56,308,56,3,2,2,322,1,728,63941,3,56
2012-02-28,spring,2012,February,0,Tuesday,Workingday,Clear,0.42,0.4242,0.54,0.1343,0,10,10,10,307,10,3,1,2,312,1,726,39130,3,10
2012-02-28,spring,2012,February,1,Tuesday,Workingday,Clear,0.38,0.3939,0.62,0.1642,0,6,6,6,307,6,3,1,2,312,1,724,24164,3,6
2012-02-28,spring,2012,February,2,Tuesday,Workingday,Clear,0.4,0.4091,0.54,0.1045,1,2,3,3,307,3,3,1,2,312,1,715,16352,3,3
2012-02-28,spring,2012,February,3,Tuesday,Workingday,Clear,0.4,0.4091,0.32,0.3582,0,6,6,6,307,6,3,1,2,312,1,697,8174,3,6
2012-02-28,spring,2012,February,4,Tuesday,Workingday,Clear,0.32,0.2879,0.42,0.3582,0,2,2,2,307,2,3,1,1,311,1,697,4428,3,2
2012-02-28,spring,2012,February,5,Tuesday,Workingday,Clear,0.32,0.2879,0.42,0.3582,1,20,21,21,307,21,3,1,1,311,1,717,14261,3,21
2012-02-28,spring,2012,February,6,Tuesday,Workingday,Clear,0.3,0.2727,0.45,0.3284,1,100,101,101,307,101,3,2,1,321,1,725,55132,3,101
2012-02-28,spring,2012,February,7,Tuesday,Workingday,Clear,0.28,0.2576,0.45,0.2985,12,313,325,325,307,325,3,4,1,341,1,727,154171,3,325
2012-02-28,spring,2012,February,8,Tuesday,Workingday,Clear,0.26,0.2424,0.48,0.2836,16,543,559,559,307,559,3,4,1,341,1,727,261001,3,559
2012-02-28,spring,2012,February,9,Tuesday,Workingday,Clear,0.28,0.2576,0.45,0.3582,7,225,232,232,307,232,3,3,1,331,1,727,159438,3,232
2012-02-28,spring,2012,February,10,Tuesday,Workingday,Clear,0.3,0.2727,0.42,0.2985,14,118,132,132,307,132,3,2,1,321,1,727,126257,3,132
2012-02-28,spring,2012,February,11,Tuesday,Workingday,Clear,0.34,0.3182,0.36,0.2537,8,155,163,163,307,163,3,3,1,331,1,727,151320,3,163
2012-02-28,spring,2012,February,12,Tuesday,Workingday,Clear,0.36,0.3485,0.34,0.1343,19,164,183,183,307,183,3,3,2,332,1,728,184414,3,183
2012-02-28,spring,2012,February,13,Tuesday,Workingday,Clear,0.36,0.3636,0.32,0.1045,16,174,190,190,307,190,3,3,2,332,1,729,184919,3,190
2012-02-28,spring,2012,February,14,Tuesday,Workingday,Clear,0.4,0.4091,0.28,0.1045,13,121,134,134,307,134,3,2,2,322,1,729,175652,3,134
2012-02-28,spring,2012,February,15,Tuesday,Workingday,Clear,0.42,0.4242,0.26,0.0896,17,149,166,166,307,166,3,3,2,332,1,729,183149,3,166
2012-02-28,spring,2012,February,16,Tuesday,Workingday,Clear,0.42,0.4242,0.28,0.0896,17,270,287,287,307,287,3,4,2,342,1,730,227748,3,287
2012-02-28,spring,2012,February,17,Tuesday,Workingday,Clear,0.42,0.4242,0.26,0.0896,33,497,530,530,307,530,3,4,2,342,2,730,336860,3,530
2012-02-28,spring,2012,February,18,Tuesday,Workingday,Clear,0.42,0.4242,0.28,0.1642,17,432,449,449,307,449,3,4,2,342,2,728,309772,3,449
2012-02-28,spring,2012,February,19,Tuesday,Workingday,Clear,0.42,0.4242,0.26,0.0,15,291,306,306,307,306,3,4,2,342,1,728,226789,3,306
2012-02-28,spring,2012,February,20,Tuesday,Workingday,Clear,0.4,0.4091,0.3,0.1343,2,202,204,204,307,204,3,3,2,332,1,728,164550,3,204
2012-02-28,spring,2012,February,21,Tuesday,Workingday,Clear,0.34,0.3485,0.46,0.1045,10,178,188,188,307,188,3,3,2,332,1,728,125445,3,188
2012-02-28,spring,2012,February,22,Tuesday,Workingday,Clear,0.34,0.3485,0.46,0.1045,6,95,101,101,307,101,3,2,2,322,1,728,95612,3,101
2012-02-28,spring,2012,February,23,Tuesday,Workingday,Clear,0.32,0.303,0.53,0.2239,4,61,65,65,307,65,3,2,1,321,1,728,63941,3,65
2012-02-29,spring,2012,February,0,Wednesday,Workingday,Clear,0.32,0.3333,0.53,0.1045,2,30,32,32,306,32,3,1,1,311,1,726,39130,3,32
2012-02-29,spring,2012,February,1,Wednesday,Workingday,Clear,0.32,0.3333,0.49,0.1045,0,6,6,6,306,6,3,1,1,311,1,724,24164,3,6
2012-02-29,spring,2012,February,2,Wednesday,Workingday,Clear,0.3,0.2879,0.56,0.2239,0,4,4,4,306,4,3,1,1,311,1,715,16352,3,4
2012-02-29,spring,2012,February,3,Wednesday,Workingday,Clear,0.28,0.303,0.7,0.0896,0,2,2,2,306,2,3,1,1,311,1,697,8174,3,2
2012-02-29,spring,2012,February,5,Wednesday,Workingday,Clear,0.26,0.2879,0.75,0.0896,0,29,29,29,306,29,3,1,1,311,1,717,14261,3,29
2012-02-29,spring,2012,February,6,Wednesday,Workingday,Mist,0.28,0.303,0.75,0.0896,4,100,104,104,306,104,3,2,1,321,1,725,55132,3,104
2012-02-29,spring,2012,February,7,Wednesday,Workingday,Mist,0.26,0.2727,0.81,0.1343,11,242,253,253,306,253,3,3,1,331,1,727,154171,3,253
2012-02-29,spring,2012,February,8,Wednesday,Workingday,Mist,0.28,0.2879,0.75,0.1045,2,114,116,116,306,116,3,2,1,321,1,727,261001,3,116
2012-02-29,spring,2012,February,9,Wednesday,Workingday,Light Snow,0.3,0.303,0.81,0.1642,5,33,38,38,306,38,3,1,1,311,1,727,159438,3,38
2012-02-29,spring,2012,February,10,Wednesday,Workingday,Light Snow,0.3,0.303,0.81,0.1642,0,10,10,10,306,10,3,1,1,311,1,727,126257,3,10
2012-02-29,spring,2012,February,11,Wednesday,Workingday,Light Snow,0.3,0.2879,0.87,0.194,1,9,10,10,306,10,3,1,1,311,1,727,151320,3,10
2012-02-29,spring,2012,February,12,Wednesday,Workingday,Light Snow,0.32,0.303,0.93,0.3284,1,69,70,70,306,70,3,2,1,321,1,728,184414,3,70
2012-02-29,spring,2012,February,13,Wednesday,Workingday,Mist,0.36,0.3333,0.93,0.3582,4,72,76,76,306,76,3,2,1,321,1,729,184919,3,76
2012-02-29,spring,2012,February,14,Wednesday,Workingday,Mist,0.36,0.3333,0.93,0.3582,2,54,56,56,306,56,3,2,1,321,1,729,175652,3,56
2012-02-29,spring,2012,February,15,Wednesday,Workingday,Mist,0.4,0.4091,0.82,0.2836,3,87,90,90,306,90,3,2,2,322,1,729,183149,3,90
2012-02-29,spring,2012,February,16,Wednesday,Workingday,Light Snow,0.4,0.4091,0.82,0.2239,5,162,167,167,306,167,3,3,2,332,0,730,227748,3,167
2012-02-29,spring,2012,February,17,Wednesday,Workingday,Mist,0.4,0.4091,0.87,0.1642,7,246,253,253,306,253,3,3,2,332,0,730,336860,3,253
2012-02-29,spring,2012,February,18,Wednesday,Workingday,Light Snow,0.4,0.4091,0.87,0.0,11,181,192,192,306,192,3,3,2,332,0,728,309772,3,192
2012-02-29,spring,2012,February,19,Wednesday,Workingday,Mist,0.4,0.4091,0.87,0.1045,0,102,102,102,306,102,3,2,2,322,0,728,226789,3,102
2012-02-29,spring,2012,February,20,Wednesday,Workingday,Light Snow,0.42,0.4242,0.88,0.1642,2,95,97,97,306,97,3,2,2,322,0,728,164550,3,97
2012-02-29,spring,2012,February,21,Wednesday,Workingday,Light Snow,0.42,0.4242,0.88,0.1642,0,39,39,39,306,39,3,1,2,312,0,728,125445,3,39
2012-02-29,spring,2012,February,22,Wednesday,Workingday,Light Snow,0.42,0.4242,0.94,0.2537,2,53,55,55,306,55,3,2,2,322,0,728,95612,3,55
2012-02-29,spring,2012,February,23,Wednesday,Workingday,Light Snow,0.42,0.4242,0.94,0.2537,3,30,33,33,306,33,3,1,2,312,0,728,63941,3,33
2012-03-01,spring,2012,March,0,Thursday,Workingday,Mist,0.42,0.4242,0.94,0.0,1,10,11,11,305,11,3,1,2,312,0,726,39130,3,11
2012-03-01,spring,2012,March,1,Thursday,Workingday,Light Snow,0.46,0.4545,0.94,0.1045,0,12,12,12,305,12,3,1,2,312,0,724,24164,3,12
2012-03-01,spring,2012,March,2,Thursday,Workingday,Mist,0.46,0.4545,0.94,0.2836,0,6,6,6,305,6,3,1,2,312,0,715,16352,3,6
2012-03-01,spring,2012,March,3,Thursday,Workingday,Clear,0.46,0.4545,0.94,0.2239,0,3,3,3,305,3,3,1,2,312,0,697,8174,3,3
2012-03-01,spring,2012,March,4,Thursday,Workingday,Clear,0.48,0.4697,0.88,0.194,0,5,5,5,305,5,3,1,2,312,0,697,4428,3,5
2012-03-01,spring,2012,March,5,Thursday,Workingday,Clear,0.48,0.4697,0.88,0.1642,0,18,18,18,305,18,3,1,2,312,0,717,14261,3,18
2012-03-01,spring,2012,March,6,Thursday,Workingday,Mist,0.42,0.4242,0.94,0.0,2,107,109,109,305,109,3,2,2,322,0,725,55132,3,109
2012-03-01,spring,2012,March,7,Thursday,Workingday,Mist,0.44,0.4394,0.94,0.1343,8,296,304,304,305,304,3,4,2,342,0,727,154171,3,304
2012-03-01,spring,2012,March,8,Thursday,Workingday,Clear,0.42,0.4242,0.94,0.1343,15,579,594,594,305,594,3,4,2,342,0,727,261001,3,594
2012-03-01,spring,2012,March,9,Thursday,Workingday,Clear,0.46,0.4545,0.77,0.2537,5,281,286,286,305,286,3,4,2,342,0,727,159438,3,286
2012-03-01,spring,2012,March,10,Thursday,Workingday,Clear,0.52,0.5,0.55,0.1642,11,122,133,133,305,133,3,2,3,323,0,727,126257,3,133
2012-03-01,spring,2012,March,11,Thursday,Workingday,Clear,0.56,0.5303,0.43,0.194,19,149,168,168,305,168,3,3,3,333,0,727,151320,3,168
2012-03-01,spring,2012,March,12,Thursday,Workingday,Clear,0.56,0.5303,0.37,0.2239,16,204,220,220,305,220,3,3,3,333,2,728,184414,3,220
2012-03-01,spring,2012,March,13,Thursday,Workingday,Clear,0.58,0.5455,0.32,0.2537,24,187,211,211,305,211,3,3,3,333,2,729,184919,3,211
2012-03-01,spring,2012,March,14,Thursday,Workingday,Clear,0.58,0.5455,0.35,0.2239,37,174,211,211,305,211,3,3,3,333,2,729,175652,3,211
2012-03-01,spring,2012,March,15,Thursday,Workingday,Clear,0.6,0.6212,0.31,0.2537,31,192,223,223,305,223,3,3,3,333,2,729,183149,3,223
2012-03-01,spring,2012,March,16,Thursday,Workingday,Clear,0.58,0.5455,0.32,0.2985,38,323,361,361,305,361,3,4,3,343,2,730,227748,3,361
2012-03-01,spring,2012,March,17,Thursday,Workingday,Clear,0.56,0.5303,0.35,0.2985,49,551,600,600,305,600,3,4,3,343,2,730,336860,3,600
2012-03-01,spring,2012,March,18,Thursday,Workingday,Clear,0.54,0.5152,0.34,0.3582,27,498,525,525,305,525,3,4,3,343,2,728,309772,3,525
2012-03-01,spring,2012,March,19,Thursday,Workingday,Clear,0.48,0.4697,0.41,0.3284,11,317,328,328,305,328,3,4,2,342,1,728,226789,3,328
2012-03-01,spring,2012,March,20,Thursday,Workingday,Clear,0.44,0.4394,0.44,0.4179,12,242,254,254,305,254,3,3,2,332,1,728,164550,3,254
2012-03-01,spring,2012,March,21,Thursday,Workingday,Clear,0.42,0.4242,0.47,0.4627,7,190,197,197,305,197,3,3,2,332,1,728,125445,3,197
2012-03-01,spring,2012,March,22,Thursday,Workingday,Clear,0.38,0.3939,0.5,0.2537,3,123,126,126,305,126,3,2,2,322,1,728,95612,3,126
2012-03-01,spring,2012,March,23,Thursday,Workingday,Clear,0.36,0.3485,0.5,0.2239,9,76,85,85,305,85,3,2,2,322,1,728,63941,3,85
2012-03-02,spring,2012,March,0,Friday,Workingday,Clear,0.34,0.3333,0.53,0.1642,1,45,46,46,304,46,3,2,1,321,1,726,39130,3,46
2012-03-02,spring,2012,March,1,Friday,Workingday,Clear,0.34,0.3182,0.49,0.2239,2,18,20,20,304,20,3,1,1,311,1,724,24164,3,20
2012-03-02,spring,2012,March,2,Friday,Workingday,Clear,0.34,0.3182,0.53,0.2836,2,4,6,6,304,6,3,1,1,311,1,715,16352,3,6
2012-03-02,spring,2012,March,3,Friday,Workingday,Clear,0.32,0.3182,0.57,0.194,0,3,3,3,304,3,3,1,1,311,1,697,8174,3,3
2012-03-02,spring,2012,March,4,Friday,Workingday,Clear,0.32,0.3485,0.61,0.0,0,2,2,2,304,2,3,1,2,312,1,697,4428,3,2
2012-03-02,spring,2012,March,5,Friday,Workingday,Clear,0.3,0.3333,0.7,0.0,0,24,24,24,304,24,3,1,1,311,1,717,14261,3,24
2012-03-02,spring,2012,March,6,Friday,Workingday,Clear,0.3,0.3333,0.7,0.0,4,88,92,92,304,92,3,2,1,321,1,725,55132,3,92
2012-03-02,spring,2012,March,7,Friday,Workingday,Clear,0.3,0.3333,0.7,0.0,4,258,262,262,304,262,3,3,1,331,1,727,154171,3,262
2012-03-02,spring,2012,March,8,Friday,Workingday,Clear,0.28,0.303,0.75,0.0896,16,533,549,549,304,549,3,4,1,341,1,727,261001,3,549
2012-03-02,spring,2012,March,9,Friday,Workingday,Clear,0.3,0.3333,0.81,0.0,15,299,314,314,304,314,3,4,1,341,1,727,159438,3,314
2012-03-02,spring,2012,March,10,Friday,Workingday,Clear,0.36,0.3485,0.5,0.1642,14,118,132,132,304,132,3,2,2,322,1,727,126257,3,132
2012-03-02,spring,2012,March,11,Friday,Workingday,Clear,0.38,0.3939,0.46,0.194,40,154,194,194,304,194,3,3,2,332,1,727,151320,3,194
2012-03-02,spring,2012,March,12,Friday,Workingday,Clear,0.4,0.4091,0.43,0.1642,40,194,234,234,304,234,3,3,2,332,1,728,184414,3,234
2012-03-02,spring,2012,March,13,Friday,Workingday,Clear,0.42,0.4242,0.44,0.2239,31,191,222,222,304,222,3,3,2,332,1,729,184919,3,222
2012-03-02,spring,2012,March,14,Friday,Workingday,Mist,0.44,0.4394,0.44,0.2836,29,176,205,205,304,205,3,3,2,332,1,729,175652,3,205
2012-03-02,spring,2012,March,15,Friday,Workingday,Mist,0.42,0.4242,0.5,0.2985,5,73,78,78,304,78,3,2,2,322,1,729,183149,3,78
2012-03-02,spring,2012,March,16,Friday,Workingday,Light Snow,0.4,0.4091,0.58,0.2985,1,49,50,50,304,50,3,2,2,322,1,730,227748,3,50
2012-03-02,spring,2012,March,17,Friday,Workingday,Light Snow,0.36,0.3485,0.81,0.2239,5,123,128,128,304,128,3,2,2,322,1,730,336860,3,128
2012-03-02,spring,2012,March,18,Friday,Workingday,Light Snow,0.36,0.3485,0.87,0.194,6,154,160,160,304,160,3,3,2,332,1,728,309772,3,160
2012-03-02,spring,2012,March,19,Friday,Workingday,Light Snow,0.36,0.3485,0.87,0.194,12,162,174,174,304,174,3,3,2,332,1,728,226789,3,174
2012-03-02,spring,2012,March,20,Friday,Workingday,Mist,0.36,0.3485,0.87,0.194,7,93,100,100,304,100,3,2,2,322,1,728,164550,3,100
2012-03-02,spring,2012,March,21,Friday,Workingday,Light Snow,0.36,0.3636,0.87,0.0896,2,99,101,101,304,101,3,2,2,322,0,728,125445,3,101
2012-03-02,spring,2012,March,22,Friday,Workingday,Mist,0.36,0.3788,0.87,0.0,6,69,75,75,304,75,3,2,2,322,0,728,95612,3,75
2012-03-02,spring,2012,March,23,Friday,Workingday,Mist,0.36,0.3788,0.87,0.0,4,19,23,23,304,23,3,1,2,312,0,728,63941,3,23
2012-03-03,spring,2012,March,0,Saturday,Holiday,Light Snow,0.36,0.3636,0.93,0.0896,1,21,22,22,303,22,3,1,2,312,0,726,39130,3,22
2012-03-03,spring,2012,March,1,Saturday,Holiday,Light Snow,0.36,0.3788,0.93,0.0,0,44,44,44,303,44,3,2,2,322,0,724,24164,3,44
2012-03-03,spring,2012,March,2,Saturday,Holiday,Light Snow,0.36,0.3636,0.93,0.0896,4,34,38,38,303,38,3,1,2,312,0,715,16352,3,38
2012-03-03,spring,2012,March,3,Saturday,Holiday,Mist,0.36,0.3485,0.93,0.1642,1,20,21,21,303,21,3,1,2,312,0,697,8174,3,21
2012-03-03,spring,2012,March,4,Saturday,Holiday,Mist,0.36,0.3485,0.93,0.194,0,2,2,2,303,2,3,1,2,312,0,697,4428,3,2
2012-03-03,spring,2012,March,5,Saturday,Holiday,Mist,0.36,0.3636,0.93,0.0896,1,1,2,2,303,2,3,1,2,312,0,717,14261,3,2
2012-03-03,spring,2012,March,6,Saturday,Holiday,Mist,0.36,0.3636,0.93,0.0896,1,6,7,7,303,7,3,1,2,312,0,725,55132,3,7
2012-03-03,spring,2012,March,7,Saturday,Holiday,Mist,0.36,0.3485,0.93,0.1343,2,14,16,16,303,16,3,1,2,312,0,727,154171,3,16
2012-03-03,spring,2012,March,8,Saturday,Holiday,Light Snow,0.36,0.3788,0.93,0.0,2,46,48,48,303,48,3,2,2,322,0,727,261001,3,48
2012-03-03,spring,2012,March,9,Saturday,Holiday,Light Snow,0.38,0.3939,0.87,0.0896,7,87,94,94,303,94,3,2,2,322,0,727,159438,3,94
2012-03-03,spring,2012,March,10,Saturday,Holiday,Mist,0.4,0.4091,0.87,0.0,31,137,168,168,303,168,3,3,2,332,0,727,126257,3,168
2012-03-03,spring,2012,March,11,Saturday,Holiday,Mist,0.4,0.4091,0.87,0.0896,33,181,214,214,303,214,3,3,2,332,0,727,151320,3,214
2012-03-03,spring,2012,March,12,Saturday,Holiday,Mist,0.42,0.4242,0.67,0.2537,47,252,299,299,303,299,3,4,2,342,1,728,184414,3,299
2012-03-03,spring,2012,March,13,Saturday,Holiday,Clear,0.44,0.4394,0.51,0.2836,87,252,339,339,303,339,3,4,2,342,2,729,184919,3,339
2012-03-03,spring,2012,March,14,Saturday,Holiday,Mist,0.46,0.4545,0.44,0.3582,151,279,430,430,303,430,3,4,2,342,2,729,175652,3,430
2012-03-03,spring,2012,March,15,Saturday,Holiday,Clear,0.48,0.4697,0.29,0.2985,145,254,399,399,303,399,3,4,2,342,2,729,183149,3,399
2012-03-03,spring,2012,March,16,Saturday,Holiday,Clear,0.5,0.4848,0.27,0.2985,167,300,467,467,303,467,3,4,2,342,2,730,227748,3,467
2012-03-03,spring,2012,March,17,Saturday,Holiday,Clear,0.5,0.4848,0.23,0.3284,106,279,385,385,303,385,3,4,2,342,2,730,336860,3,385
2012-03-03,spring,2012,March,18,Saturday,Holiday,Clear,0.5,0.4848,0.25,0.2537,53,250,303,303,303,303,3,4,2,342,2,728,309772,3,303
2012-03-03,spring,2012,March,19,Saturday,Holiday,Clear,0.46,0.4545,0.33,0.1642,34,191,225,225,303,225,3,3,2,332,1,728,226789,3,225
2012-03-03,spring,2012,March,20,Saturday,Holiday,Clear,0.44,0.4394,0.3,0.1343,28,121,149,149,303,149,3,3,2,332,1,728,164550,3,149
2012-03-03,spring,2012,March,21,Saturday,Holiday,Clear,0.46,0.4545,0.19,0.3284,24,130,154,154,303,154,3,3,2,332,1,728,125445,3,154
2012-03-03,spring,2012,March,22,Saturday,Holiday,Clear,0.44,0.4394,0.21,0.1343,19,115,134,134,303,134,3,2,2,322,1,728,95612,3,134
2012-03-03,spring,2012,March,23,Saturday,Holiday,Clear,0.42,0.4242,0.24,0.0,12,94,106,106,303,106,3,2,2,322,1,728,63941,3,106
2012-03-04,spring,2012,March,0,Sunday,Holiday,Mist,0.4,0.4091,0.3,0.3582,5,67,72,72,302,72,3,2,2,322,1,726,39130,3,72
2012-03-04,spring,2012,March,1,Sunday,Holiday,Mist,0.38,0.3939,0.34,0.194,16,60,76,76,302,76,3,2,2,322,1,724,24164,3,76
2012-03-04,spring,2012,March,2,Sunday,Holiday,Mist,0.36,0.3485,0.4,0.1642,14,66,80,80,302,80,3,2,2,322,1,715,16352,3,80
2012-03-04,spring,2012,March,3,Sunday,Holiday,Mist,0.36,0.3485,0.43,0.1343,5,21,26,26,302,26,3,1,2,312,1,697,8174,3,26
2012-03-04,spring,2012,March,4,Sunday,Holiday,Mist,0.34,0.3333,0.46,0.194,3,11,14,14,302,14,3,1,1,311,1,697,4428,3,14
2012-03-04,spring,2012,March,5,Sunday,Holiday,Mist,0.34,0.3182,0.46,0.2239,0,5,5,5,302,5,3,1,1,311,1,717,14261,3,5
2012-03-04,spring,2012,March,6,Sunday,Holiday,Mist,0.3,0.2727,0.52,0.2985,0,5,5,5,302,5,3,1,1,311,1,725,55132,3,5
2012-03-04,spring,2012,March,7,Sunday,Holiday,Mist,0.3,0.2727,0.52,0.2985,2,21,23,23,302,23,3,1,1,311,1,727,154171,3,23
2012-03-04,spring,2012,March,8,Sunday,Holiday,Clear,0.3,0.2727,0.52,0.3284,12,54,66,66,302,66,3,2,1,321,1,727,261001,3,66
2012-03-04,spring,2012,March,9,Sunday,Holiday,Clear,0.3,0.2727,0.49,0.4478,14,104,118,118,302,118,3,2,1,321,1,727,159438,3,118
2012-03-04,spring,2012,March,10,Sunday,Holiday,Clear,0.3,0.2727,0.49,0.3284,31,161,192,192,302,192,3,3,1,331,1,727,126257,3,192
2012-03-04,spring,2012,March,11,Sunday,Holiday,Clear,0.32,0.2879,0.45,0.3881,64,192,256,256,302,256,3,3,1,331,1,727,151320,3,256
2012-03-04,spring,2012,March,12,Sunday,Holiday,Clear,0.34,0.303,0.42,0.3582,71,256,327,327,302,327,3,4,1,341,1,728,184414,3,327
2012-03-04,spring,2012,March,13,Sunday,Holiday,Clear,0.36,0.3333,0.37,0.3582,108,256,364,364,302,364,3,4,1,341,1,729,184919,3,364
2012-03-04,spring,2012,March,14,Sunday,Holiday,Clear,0.36,0.3333,0.34,0.3582,106,226,332,332,302,332,3,4,1,341,1,729,175652,3,332
2012-03-04,spring,2012,March,15,Sunday,Holiday,Clear,0.36,0.3182,0.32,0.5224,82,252,334,334,302,334,3,4,1,341,1,729,183149,3,334
2012-03-04,spring,2012,March,16,Sunday,Holiday,Clear,0.36,0.3182,0.29,0.4925,68,231,299,299,302,299,3,4,1,341,1,730,227748,3,299
2012-03-04,spring,2012,March,17,Sunday,Holiday,Clear,0.34,0.2879,0.31,0.5522,49,214,263,263,302,263,3,3,1,331,1,730,336860,3,263
2012-03-04,spring,2012,March,18,Sunday,Holiday,Clear,0.32,0.2727,0.33,0.6119,20,164,184,184,302,184,3,3,1,331,1,728,309772,3,184
2012-03-04,spring,2012,March,19,Sunday,Holiday,Clear,0.3,0.2576,0.36,0.4925,12,120,132,132,302,132,3,2,1,321,1,728,226789,3,132
2012-03-04,spring,2012,March,20,Sunday,Holiday,Clear,0.28,0.2727,0.38,0.2537,8,80,88,88,302,88,3,2,1,321,1,728,164550,3,88
2012-03-04,spring,2012,March,21,Sunday,Holiday,Clear,0.28,0.2727,0.36,0.2239,9,70,79,79,302,79,3,2,1,321,1,728,125445,3,79
2012-03-04,spring,2012,March,22,Sunday,Holiday,Clear,0.26,0.2424,0.41,0.2537,9,53,62,62,302,62,3,2,1,321,1,728,95612,3,62
2012-03-04,spring,2012,March,23,Sunday,Holiday,Clear,0.26,0.2576,0.41,0.194,2,24,26,26,302,26,3,1,1,311,1,728,63941,3,26
2012-03-05,spring,2012,March,0,Monday,Workingday,Clear,0.24,0.2273,0.44,0.194,2,15,17,17,301,17,3,1,1,311,1,726,39130,3,17
2012-03-05,spring,2012,March,1,Monday,Workingday,Clear,0.24,0.2424,0.48,0.1343,3,3,6,6,301,6,3,1,1,311,1,724,24164,3,6
2012-03-05,spring,2012,March,2,Monday,Workingday,Clear,0.24,0.2424,0.48,0.1343,1,3,4,4,301,4,3,1,1,311,1,715,16352,3,4
2012-03-05,spring,2012,March,3,Monday,Workingday,Clear,0.22,0.2273,0.51,0.1642,0,1,1,1,301,1,3,1,1,311,1,697,8174,3,1
2012-03-05,spring,2012,March,4,Monday,Workingday,Clear,0.2,0.2273,0.55,0.0896,0,1,1,1,301,1,3,1,1,311,1,697,4428,3,1
2012-03-05,spring,2012,March,5,Monday,Workingday,Clear,0.2,0.2273,0.55,0.0896,1,17,18,18,301,18,3,1,1,311,1,717,14261,3,18
2012-03-05,spring,2012,March,6,Monday,Workingday,Clear,0.18,0.197,0.59,0.1343,2,89,91,91,301,91,3,2,1,321,1,725,55132,3,91
2012-03-05,spring,2012,March,7,Monday,Workingday,Clear,0.18,0.197,0.59,0.1343,7,253,260,260,301,260,3,3,1,331,1,727,154171,3,260
2012-03-05,spring,2012,March,8,Monday,Workingday,Clear,0.2,0.2273,0.59,0.1045,13,415,428,428,301,428,3,4,1,341,1,727,261001,3,428
2012-03-05,spring,2012,March,9,Monday,Workingday,Mist,0.22,0.2576,0.6,0.0896,11,186,197,197,301,197,3,3,1,331,1,727,159438,3,197
2012-03-05,spring,2012,March,10,Monday,Workingday,Mist,0.24,0.2576,0.6,0.0,12,74,86,86,301,86,3,2,1,321,1,727,126257,3,86
2012-03-05,spring,2012,March,11,Monday,Workingday,Mist,0.26,0.2727,0.56,0.1343,17,86,103,103,301,103,3,2,1,321,1,727,151320,3,103
2012-03-05,spring,2012,March,12,Monday,Workingday,Mist,0.26,0.303,0.52,0.0,15,122,137,137,301,137,3,2,1,321,1,728,184414,3,137
2012-03-05,spring,2012,March,13,Monday,Workingday,Mist,0.26,0.2576,0.55,0.2985,11,109,120,120,301,120,3,2,1,321,1,729,184919,3,120
2012-03-05,spring,2012,March,14,Monday,Workingday,Mist,0.28,0.2576,0.57,0.3582,13,115,128,128,301,128,3,2,1,321,1,729,175652,3,128
2012-03-05,spring,2012,March,15,Monday,Workingday,Mist,0.3,0.2879,0.53,0.194,20,110,130,130,301,130,3,2,1,321,1,729,183149,3,130
2012-03-05,spring,2012,March,16,Monday,Workingday,Clear,0.3,0.2727,0.45,0.2985,30,180,210,210,301,210,3,3,1,331,1,730,227748,3,210
2012-03-05,spring,2012,March,17,Monday,Workingday,Light Snow,0.3,0.2727,0.45,0.2985,11,376,387,387,301,387,3,4,1,341,1,730,336860,3,387
2012-03-05,spring,2012,March,18,Monday,Workingday,Light Snow,0.28,0.2273,0.55,0.6567,12,363,375,375,301,375,3,4,1,341,1,728,309772,3,375
2012-03-05,spring,2012,March,19,Monday,Workingday,Clear,0.26,0.2576,0.53,0.2239,6,220,226,226,301,226,3,3,1,331,1,728,226789,3,226
2012-03-05,spring,2012,March,20,Monday,Workingday,Clear,0.26,0.2273,0.37,0.4627,8,171,179,179,301,179,3,3,1,331,1,728,164550,3,179
2012-03-05,spring,2012,March,21,Monday,Workingday,Clear,0.26,0.2273,0.37,0.3881,4,116,120,120,301,120,3,2,1,321,1,728,125445,3,120
2012-03-05,spring,2012,March,22,Monday,Workingday,Clear,0.24,0.2121,0.35,0.3284,2,76,78,78,301,78,3,2,1,321,1,728,95612,3,78
2012-03-05,spring,2012,March,23,Monday,Workingday,Clear,0.22,0.1818,0.37,0.5821,2,29,31,31,301,31,3,1,1,311,1,728,63941,3,31
2012-03-06,spring,2012,March,0,Tuesday,Workingday,Clear,0.22,0.2121,0.37,0.2985,0,8,8,8,300,8,3,1,1,311,1,726,39130,3,8
2012-03-06,spring,2012,March,1,Tuesday,Workingday,Clear,0.2,0.197,0.44,0.2537,0,6,6,6,300,6,3,1,1,311,1,724,24164,3,6
2012-03-06,spring,2012,March,2,Tuesday,Workingday,Clear,0.2,0.197,0.44,0.2239,0,4,4,4,300,4,3,1,1,311,1,715,16352,3,4
2012-03-06,spring,2012,March,3,Tuesday,Workingday,Clear,0.18,0.1667,0.51,0.2836,0,1,1,1,300,1,3,1,1,311,1,697,8174,3,1
2012-03-06,spring,2012,March,4,Tuesday,Workingday,Clear,0.18,0.1667,0.51,0.2985,0,3,3,3,300,3,3,1,1,311,1,697,4428,3,3
2012-03-06,spring,2012,March,5,Tuesday,Workingday,Clear,0.18,0.1818,0.51,0.2239,0,25,25,25,300,25,3,1,1,311,1,717,14261,3,25
2012-03-06,spring,2012,March,6,Tuesday,Workingday,Clear,0.18,0.2121,0.51,0.1045,3,99,102,102,300,102,3,2,1,321,1,725,55132,3,102
2012-03-06,spring,2012,March,7,Tuesday,Workingday,Clear,0.16,0.1818,0.55,0.1343,5,270,275,275,300,275,3,3,1,331,1,727,154171,3,275
2012-03-06,spring,2012,March,8,Tuesday,Workingday,Clear,0.16,0.1818,0.59,0.1045,14,487,501,501,300,501,3,4,1,341,1,727,261001,3,501
2012-03-06,spring,2012,March,9,Tuesday,Workingday,Clear,0.22,0.2727,0.47,0.0,11,222,233,233,300,233,3,3,1,331,1,727,159438,3,233
2012-03-06,spring,2012,March,10,Tuesday,Workingday,Clear,0.24,0.2576,0.44,0.0,16,113,129,129,300,129,3,2,1,321,1,727,126257,3,129
2012-03-06,spring,2012,March,11,Tuesday,Workingday,Clear,0.26,0.2576,0.41,0.1642,20,110,130,130,300,130,3,2,1,321,1,727,151320,3,130
2012-03-06,spring,2012,March,12,Tuesday,Workingday,Clear,0.26,0.2727,0.41,0.1045,9,129,138,138,300,138,3,2,1,321,1,728,184414,3,138
2012-03-06,spring,2012,March,13,Tuesday,Workingday,Clear,0.3,0.303,0.39,0.1343,16,148,164,164,300,164,3,3,1,331,1,729,184919,3,164
2012-03-06,spring,2012,March,14,Tuesday,Workingday,Clear,0.32,0.303,0.36,0.2239,20,116,136,136,300,136,3,2,1,321,1,729,175652,3,136
2012-03-06,spring,2012,March,15,Tuesday,Workingday,Clear,0.34,0.303,0.36,0.2985,24,142,166,166,300,166,3,3,1,331,1,729,183149,3,166
2012-03-06,spring,2012,March,16,Tuesday,Workingday,Clear,0.36,0.3333,0.32,0.2836,22,228,250,250,300,250,3,3,1,331,1,730,227748,3,250
2012-03-06,spring,2012,March,17,Tuesday,Workingday,Clear,0.36,0.3333,0.34,0.2836,21,425,446,446,300,446,3,4,1,341,1,730,336860,3,446
2012-03-06,spring,2012,March,18,Tuesday,Workingday,Clear,0.34,0.303,0.42,0.3284,15,442,457,457,300,457,3,4,1,341,1,728,309772,3,457
2012-03-06,spring,2012,March,19,Tuesday,Workingday,Clear,0.34,0.303,0.46,0.2985,9,278,287,287,300,287,3,4,1,341,1,728,226789,3,287
2012-03-06,spring,2012,March,20,Tuesday,Workingday,Clear,0.32,0.3182,0.49,0.194,3,184,187,187,300,187,3,3,1,331,1,728,164550,3,187
2012-03-06,spring,2012,March,21,Tuesday,Workingday,Clear,0.32,0.3182,0.49,0.194,5,143,148,148,300,148,3,3,1,331,1,728,125445,3,148
2012-03-06,spring,2012,March,22,Tuesday,Workingday,Clear,0.28,0.2727,0.56,0.1642,5,101,106,106,300,106,3,2,1,321,1,728,95612,3,106
2012-03-06,spring,2012,March,23,Tuesday,Workingday,Clear,0.28,0.2727,0.61,0.2239,3,51,54,54,300,54,3,2,1,321,1,728,63941,3,54
2012-03-07,spring,2012,March,0,Wednesday,Workingday,Clear,0.28,0.2576,0.65,0.2836,3,12,15,15,299,15,3,1,1,311,1,726,39130,3,15
2012-03-07,spring,2012,March,1,Wednesday,Workingday,Clear,0.3,0.2727,0.61,0.2985,1,4,5,5,299,5,3,1,1,311,1,724,24164,3,5
2012-03-07,spring,2012,March,2,Wednesday,Workingday,Clear,0.3,0.2879,0.56,0.2836,0,4,4,4,299,4,3,1,1,311,1,715,16352,3,4
2012-03-07,spring,2012,March,3,Wednesday,Workingday,Clear,0.3,0.2727,0.56,0.3582,1,2,3,3,299,3,3,1,1,311,1,697,8174,3,3
2012-03-07,spring,2012,March,4,Wednesday,Workingday,Clear,0.28,0.2576,0.61,0.3284,0,3,3,3,299,3,3,1,1,311,1,697,4428,3,3
2012-03-07,spring,2012,March,5,Wednesday,Workingday,Clear,0.28,0.2576,0.56,0.2985,0,18,18,18,299,18,3,1,1,311,1,717,14261,3,18
2012-03-07,spring,2012,March,6,Wednesday,Workingday,Clear,0.28,0.2576,0.61,0.3881,4,104,108,108,299,108,3,2,1,321,1,725,55132,3,108
2012-03-07,spring,2012,March,7,Wednesday,Workingday,Clear,0.26,0.2273,0.65,0.3881,12,332,344,344,299,344,3,4,1,341,1,727,154171,3,344
2012-03-07,spring,2012,March,8,Wednesday,Workingday,Clear,0.28,0.2576,0.61,0.2985,12,554,566,566,299,566,3,4,1,341,1,727,261001,3,566
2012-03-07,spring,2012,March,9,Wednesday,Workingday,Clear,0.3,0.2727,0.61,0.3284,12,252,264,264,299,264,3,3,1,331,1,727,159438,3,264
2012-03-07,spring,2012,March,10,Wednesday,Workingday,Clear,0.36,0.3333,0.5,0.2985,20,127,147,147,299,147,3,3,1,331,1,727,126257,3,147
2012-03-07,spring,2012,March,11,Wednesday,Workingday,Clear,0.42,0.4242,0.38,0.2985,33,128,161,161,299,161,3,3,2,332,1,727,151320,3,161
2012-03-07,spring,2012,March,12,Wednesday,Workingday,Clear,0.44,0.4394,0.38,0.3881,40,175,215,215,299,215,3,3,2,332,1,728,184414,3,215
2012-03-07,spring,2012,March,13,Wednesday,Workingday,Clear,0.5,0.4848,0.34,0.4179,26,179,205,205,299,205,3,3,2,332,1,729,184919,3,205
2012-03-07,spring,2012,March,14,Wednesday,Workingday,Clear,0.52,0.5,0.36,0.3284,38,137,175,175,299,175,3,3,3,333,2,729,175652,3,175
2012-03-07,spring,2012,March,15,Wednesday,Workingday,Clear,0.54,0.5152,0.37,0.4478,44,165,209,209,299,209,3,3,3,333,2,729,183149,3,209
2012-03-07,spring,2012,March,16,Wednesday,Workingday,Clear,0.56,0.5303,0.37,0.4179,34,254,288,288,299,288,3,4,3,343,2,730,227748,3,288
2012-03-07,spring,2012,March,17,Wednesday,Workingday,Clear,0.56,0.5303,0.43,0.4925,58,554,612,612,299,612,3,4,3,343,2,730,336860,3,612
2012-03-07,spring,2012,March,18,Wednesday,Workingday,Clear,0.56,0.5303,0.4,0.4627,35,509,544,544,299,544,3,4,3,343,2,728,309772,3,544
2012-03-07,spring,2012,March,19,Wednesday,Workingday,Clear,0.54,0.5152,0.42,0.3582,16,345,361,361,299,361,3,4,3,343,2,728,226789,3,361
2012-03-07,spring,2012,March,20,Wednesday,Workingday,Clear,0.5,0.4848,0.51,0.2537,18,242,260,260,299,260,3,3,2,332,1,728,164550,3,260
2012-03-07,spring,2012,March,21,Wednesday,Workingday,Clear,0.44,0.4394,0.62,0.2537,11,177,188,188,299,188,3,3,2,332,1,728,125445,3,188
2012-03-07,spring,2012,March,22,Wednesday,Workingday,Clear,0.46,0.4545,0.59,0.2985,10,149,159,159,299,159,3,3,2,332,1,728,95612,3,159
2012-03-07,spring,2012,March,23,Wednesday,Workingday,Clear,0.44,0.4394,0.62,0.3284,4,58,62,62,299,62,3,2,2,322,1,728,63941,3,62
2012-03-08,spring,2012,March,0,Thursday,Workingday,Clear,0.44,0.4394,0.62,0.3284,11,35,46,46,298,46,3,2,2,322,1,726,39130,3,46
2012-03-08,spring,2012,March,1,Thursday,Workingday,Clear,0.46,0.4545,0.63,0.3284,4,17,21,21,298,21,3,1,2,312,1,724,24164,3,21
2012-03-08,spring,2012,March,2,Thursday,Workingday,Clear,0.46,0.4545,0.63,0.3881,6,5,11,11,298,11,3,1,2,312,1,715,16352,3,11
2012-03-08,spring,2012,March,3,Thursday,Workingday,Clear,0.46,0.4545,0.63,0.3881,0,3,3,3,298,3,3,1,2,312,1,697,8174,3,3
2012-03-08,spring,2012,March,4,Thursday,Workingday,Clear,0.44,0.4394,0.72,0.2836,0,2,2,2,298,2,3,1,2,312,1,697,4428,3,2
2012-03-08,spring,2012,March,5,Thursday,Workingday,Clear,0.42,0.4242,0.77,0.2239,1,28,29,29,298,29,3,1,2,312,0,717,14261,3,29
2012-03-08,spring,2012,March,6,Thursday,Workingday,Clear,0.42,0.4242,0.77,0.2537,4,105,109,109,298,109,3,2,2,322,0,725,55132,3,109
2012-03-08,spring,2012,March,7,Thursday,Workingday,Clear,0.42,0.4242,0.77,0.3582,8,326,334,334,298,334,3,4,2,342,1,727,154171,3,334
2012-03-08,spring,2012,March,8,Thursday,Workingday,Clear,0.44,0.4394,0.77,0.3881,12,573,585,585,298,585,3,4,2,342,2,727,261001,3,585
2012-03-08,spring,2012,March,9,Thursday,Workingday,Clear,0.46,0.4545,0.72,0.4627,19,282,301,301,298,301,3,4,2,342,1,727,159438,3,301
2012-03-08,spring,2012,March,10,Thursday,Workingday,Clear,0.5,0.4848,0.68,0.4627,19,119,138,138,298,138,3,2,2,322,1,727,126257,3,138
2012-03-08,spring,2012,March,11,Thursday,Workingday,Mist,0.54,0.5152,0.6,0.4627,48,156,204,204,298,204,3,3,3,333,2,727,151320,3,204
2012-03-08,spring,2012,March,12,Thursday,Workingday,Mist,0.56,0.5303,0.6,0.4478,27,224,251,251,298,251,3,3,3,333,2,728,184414,3,251
2012-03-08,spring,2012,March,13,Thursday,Workingday,Mist,0.6,0.6212,0.49,0.6418,35,198,233,233,298,233,3,3,3,333,2,729,184919,3,233
2012-03-08,spring,2012,March,14,Thursday,Workingday,Mist,0.62,0.6212,0.43,0.6418,48,155,203,203,298,203,3,3,3,333,2,729,175652,3,203
2012-03-08,spring,2012,March,15,Thursday,Workingday,Clear,0.64,0.6212,0.38,0.6866,24,161,185,185,298,185,3,3,3,333,2,729,183149,3,185
2012-03-08,spring,2012,March,16,Thursday,Workingday,Mist,0.62,0.6212,0.41,0.6418,37,305,342,342,298,342,3,4,3,343,2,730,227748,3,342
2012-03-08,spring,2012,March,17,Thursday,Workingday,Clear,0.62,0.6212,0.38,0.6567,52,545,597,597,298,597,3,4,3,343,2,730,336860,3,597
2012-03-08,spring,2012,March,18,Thursday,Workingday,Mist,0.62,0.6212,0.38,0.5522,45,545,590,590,298,590,3,4,3,343,2,728,309772,3,590
2012-03-08,spring,2012,March,19,Thursday,Workingday,Mist,0.6,0.6212,0.4,0.4478,21,395,416,416,298,416,3,4,3,343,2,728,226789,3,416
2012-03-08,spring,2012,March,20,Thursday,Workingday,Mist,0.6,0.6212,0.43,0.3881,20,282,302,302,298,302,3,4,3,343,2,728,164550,3,302
2012-03-08,spring,2012,March,21,Thursday,Workingday,Clear,0.6,0.6212,0.43,0.3881,27,206,233,233,298,233,3,3,3,333,2,728,125445,3,233
2012-03-08,spring,2012,March,22,Thursday,Workingday,Clear,0.56,0.5303,0.49,0.3284,12,141,153,153,298,153,3,3,3,333,0,728,95612,3,153
2012-03-08,spring,2012,March,23,Thursday,Workingday,Mist,0.56,0.5303,0.49,0.4478,6,88,94,94,298,94,3,2,3,323,1,728,63941,3,94
2012-03-09,spring,2012,March,0,Friday,Workingday,Mist,0.58,0.5455,0.49,0.4627,3,51,54,54,297,54,3,2,3,323,1,726,39130,3,54
2012-03-09,spring,2012,March,1,Friday,Workingday,Light Snow,0.56,0.5303,0.52,0.4925,4,22,26,26,297,26,3,1,3,313,1,724,24164,3,26
2012-03-09,spring,2012,March,2,Friday,Workingday,Light Snow,0.48,0.4697,0.77,0.4179,2,9,11,11,297,11,3,1,2,312,0,715,16352,3,11
2012-03-09,spring,2012,March,3,Friday,Workingday,Clear,0.46,0.4545,0.77,0.5224,0,7,7,7,297,7,3,1,2,312,1,697,8174,3,7
2012-03-09,spring,2012,March,4,Friday,Workingday,Light Snow,0.4,0.4091,0.66,0.2836,0,1,1,1,297,1,3,1,2,312,1,697,4428,3,1
2012-03-09,spring,2012,March,5,Friday,Workingday,Light Snow,0.4,0.4091,0.66,0.2836,2,27,29,29,297,29,3,1,2,312,1,717,14261,3,29
2012-03-09,spring,2012,March,6,Friday,Workingday,Mist,0.4,0.4091,0.5,0.3582,2,83,85,85,297,85,3,2,2,322,1,725,55132,3,85
2012-03-09,spring,2012,March,7,Friday,Workingday,Mist,0.38,0.3939,0.4,0.2985,6,262,268,268,297,268,3,3,2,332,1,727,154171,3,268
2012-03-09,spring,2012,March,8,Friday,Workingday,Mist,0.34,0.2879,0.42,0.5224,17,484,501,501,297,501,3,4,1,341,1,727,261001,3,501
2012-03-09,spring,2012,March,9,Friday,Workingday,Mist,0.34,0.2879,0.42,0.5224,17,267,284,284,297,284,3,4,1,341,1,727,159438,3,284
2012-03-09,spring,2012,March,10,Friday,Workingday,Mist,0.34,0.2879,0.36,0.4925,14,145,159,159,297,159,3,3,1,331,1,727,126257,3,159
2012-03-09,spring,2012,March,11,Friday,Workingday,Mist,0.36,0.3333,0.34,0.3582,17,170,187,187,297,187,3,3,1,331,1,727,151320,3,187
2012-03-09,spring,2012,March,12,Friday,Workingday,Clear,0.36,0.3333,0.34,0.4179,27,174,201,201,297,201,3,3,1,331,1,728,184414,3,201
2012-03-09,spring,2012,March,13,Friday,Workingday,Mist,0.38,0.3939,0.29,0.3881,49,175,224,224,297,224,3,3,2,332,1,729,184919,3,224
2012-03-09,spring,2012,March,14,Friday,Workingday,Clear,0.42,0.4242,0.28,0.4627,49,129,178,178,297,178,3,3,2,332,1,729,175652,3,178
2012-03-09,spring,2012,March,15,Friday,Workingday,Clear,0.46,0.4545,0.24,0.2537,50,188,238,238,297,238,3,3,2,332,2,729,183149,3,238
2012-03-09,spring,2012,March,16,Friday,Workingday,Clear,0.48,0.4697,0.23,0.4179,51,292,343,343,297,343,3,4,2,342,2,730,227748,3,343
2012-03-09,spring,2012,March,17,Friday,Workingday,Clear,0.46,0.4545,0.24,0.3881,68,498,566,566,297,566,3,4,2,342,2,730,336860,3,566
2012-03-09,spring,2012,March,18,Friday,Workingday,Clear,0.44,0.4394,0.26,0.5224,30,440,470,470,297,470,3,4,2,342,2,728,309772,3,470
2012-03-09,spring,2012,March,19,Friday,Workingday,Clear,0.42,0.4242,0.28,0.6119,12,232,244,244,297,244,3,3,2,332,1,728,226789,3,244
2012-03-09,spring,2012,March,20,Friday,Workingday,Clear,0.38,0.3939,0.32,0.3582,3,156,159,159,297,159,3,3,2,332,1,728,164550,3,159
2012-03-09,spring,2012,March,21,Friday,Workingday,Clear,0.36,0.3333,0.34,0.3284,8,133,141,141,297,141,3,2,1,321,1,728,125445,3,141
2012-03-09,spring,2012,March,22,Friday,Workingday,Clear,0.34,0.2879,0.31,0.4925,7,100,107,107,297,107,3,2,1,321,1,728,95612,3,107
2012-03-09,spring,2012,March,23,Friday,Workingday,Clear,0.32,0.303,0.33,0.2985,9,77,86,86,297,86,3,2,1,321,1,728,63941,3,86
2012-03-10,spring,2012,March,0,Saturday,Holiday,Clear,0.3,0.2727,0.36,0.3582,9,68,77,77,296,77,3,2,1,321,1,726,39130,3,77
2012-03-10,spring,2012,March,1,Saturday,Holiday,Clear,0.3,0.2879,0.36,0.2537,1,50,51,51,296,51,3,2,1,321,1,724,24164,3,51
2012-03-10,spring,2012,March,2,Saturday,Holiday,Clear,0.26,0.2424,0.41,0.2537,12,30,42,42,296,42,3,2,1,321,1,715,16352,3,42
2012-03-10,spring,2012,March,3,Saturday,Holiday,Clear,0.26,0.2273,0.41,0.2985,0,16,16,16,296,16,3,1,1,311,1,697,8174,3,16
2012-03-10,spring,2012,March,4,Saturday,Holiday,Clear,0.24,0.2121,0.41,0.3582,1,3,4,4,296,4,3,1,1,311,1,697,4428,3,4
2012-03-10,spring,2012,March,5,Saturday,Holiday,Clear,0.22,0.2121,0.42,0.2836,3,7,10,10,296,10,3,1,1,311,1,717,14261,3,10
2012-03-10,spring,2012,March,6,Saturday,Holiday,Clear,0.22,0.2121,0.44,0.2836,1,11,12,12,296,12,3,1,1,311,1,725,55132,3,12
2012-03-10,spring,2012,March,7,Saturday,Holiday,Clear,0.22,0.2121,0.44,0.2537,4,36,40,40,296,40,3,1,1,311,1,727,154171,3,40
2012-03-10,spring,2012,March,8,Saturday,Holiday,Clear,0.22,0.2121,0.44,0.2985,15,96,111,111,296,111,3,2,1,321,1,727,261001,3,111
2012-03-10,spring,2012,March,9,Saturday,Holiday,Clear,0.24,0.2121,0.41,0.3284,21,127,148,148,296,148,3,3,1,331,1,727,159438,3,148
2012-03-10,spring,2012,March,10,Saturday,Holiday,Clear,0.26,0.2273,0.35,0.4179,47,176,223,223,296,223,3,3,1,331,1,727,126257,3,223
2012-03-10,spring,2012,March,11,Saturday,Holiday,Clear,0.3,0.2727,0.33,0.3284,56,218,274,274,296,274,3,3,1,331,1,727,151320,3,274
2012-03-10,spring,2012,March,12,Saturday,Holiday,Clear,0.3,0.2727,0.33,0.3284,88,241,329,329,296,329,3,4,1,341,1,728,184414,3,329
2012-03-10,spring,2012,March,13,Saturday,Holiday,Clear,0.32,0.303,0.29,0.2836,89,268,357,357,296,357,3,4,1,341,1,729,184919,3,357
2012-03-10,spring,2012,March,14,Saturday,Holiday,Clear,0.34,0.3182,0.27,0.2836,117,262,379,379,296,379,3,4,1,341,2,729,175652,3,379
2012-03-10,spring,2012,March,15,Saturday,Holiday,Clear,0.34,0.3636,0.25,0.0,132,274,406,406,296,406,3,4,2,342,2,729,183149,3,406
2012-03-10,spring,2012,March,16,Saturday,Holiday,Clear,0.36,0.3636,0.23,0.0,115,275,390,390,296,390,3,4,2,342,2,730,227748,3,390
2012-03-10,spring,2012,March,17,Saturday,Holiday,Clear,0.36,0.3788,0.23,0.0,104,250,354,354,296,354,3,4,2,342,2,730,336860,3,354
2012-03-10,spring,2012,March,18,Saturday,Holiday,Clear,0.36,0.3636,0.21,0.0896,67,230,297,297,296,297,3,4,2,342,1,728,309772,3,297
2012-03-10,spring,2012,March,19,Saturday,Holiday,Clear,0.34,0.3636,0.25,0.0,25,159,184,184,296,184,3,3,2,332,1,728,226789,3,184
2012-03-10,spring,2012,March,20,Saturday,Holiday,Clear,0.32,0.3333,0.33,0.1343,20,101,121,121,296,121,3,2,1,321,1,728,164550,3,121
2012-03-10,spring,2012,March,21,Saturday,Holiday,Clear,0.3,0.2879,0.39,0.2239,16,94,110,110,296,110,3,2,1,321,1,728,125445,3,110
2012-03-10,spring,2012,March,22,Saturday,Holiday,Clear,0.26,0.2576,0.44,0.1642,19,81,100,100,296,100,3,2,1,321,1,728,95612,3,100
2012-03-10,spring,2012,March,23,Saturday,Holiday,Clear,0.26,0.2576,0.41,0.194,6,77,83,83,296,83,3,2,1,321,1,728,63941,3,83
2012-03-11,spring,2012,March,0,Sunday,Holiday,Clear,0.26,0.2879,0.44,0.0896,7,62,69,69,295,69,3,2,1,321,1,726,39130,3,69
2012-03-11,spring,2012,March,1,Sunday,Holiday,Clear,0.24,0.2424,0.52,0.1642,4,57,61,61,295,61,3,2,1,321,1,724,24164,3,61
2012-03-11,spring,2012,March,3,Sunday,Holiday,Clear,0.24,0.2424,0.6,0.1343,15,51,66,66,295,66,3,2,1,321,1,697,8174,3,66
2012-03-11,spring,2012,March,4,Sunday,Holiday,Clear,0.24,0.2424,0.6,0.1343,7,15,22,22,295,22,3,1,1,311,1,697,4428,3,22
2012-03-11,spring,2012,March,5,Sunday,Holiday,Clear,0.24,0.2424,0.6,0.1642,2,5,7,7,295,7,3,1,1,311,1,717,14261,3,7
2012-03-11,spring,2012,March,6,Sunday,Holiday,Clear,0.24,0.2424,0.7,0.1642,2,8,10,10,295,10,3,1,1,311,1,725,55132,3,10
2012-03-11,spring,2012,March,7,Sunday,Holiday,Clear,0.22,0.2273,0.69,0.1343,2,15,17,17,295,17,3,1,1,311,1,727,154171,3,17
2012-03-11,spring,2012,March,8,Sunday,Holiday,Clear,0.22,0.2273,0.69,0.1343,4,68,72,72,295,72,3,2,1,321,1,727,261001,3,72
2012-03-11,spring,2012,March,9,Sunday,Holiday,Clear,0.26,0.2576,0.6,0.2239,20,70,90,90,295,90,3,2,1,321,1,727,159438,3,90
2012-03-11,spring,2012,March,10,Sunday,Holiday,Clear,0.32,0.303,0.49,0.2836,71,147,218,218,295,218,3,3,1,331,1,727,126257,3,218
2012-03-11,spring,2012,March,11,Sunday,Holiday,Clear,0.36,0.3333,0.43,0.2836,90,209,299,299,295,299,3,4,1,341,1,727,151320,3,299
2012-03-11,spring,2012,March,12,Sunday,Holiday,Clear,0.4,0.4091,0.37,0.2985,146,264,410,410,295,410,3,4,2,342,2,728,184414,3,410
2012-03-11,spring,2012,March,13,Sunday,Holiday,Clear,0.42,0.4242,0.41,0.2985,176,288,464,464,295,464,3,4,2,342,2,729,184919,3,464
2012-03-11,spring,2012,March,14,Sunday,Holiday,Clear,0.46,0.4545,0.31,0.2836,212,289,501,501,295,501,3,4,2,342,2,729,175652,3,501
2012-03-11,spring,2012,March,15,Sunday,Holiday,Clear,0.5,0.4848,0.29,0.2985,201,286,487,487,295,487,3,4,2,342,2,729,183149,3,487
2012-03-11,spring,2012,March,16,Sunday,Holiday,Clear,0.5,0.4848,0.31,0.3582,208,301,509,509,295,509,3,4,2,342,2,730,227748,3,509
2012-03-11,spring,2012,March,17,Sunday,Holiday,Clear,0.52,0.5,0.27,0.2985,199,299,498,498,295,498,3,4,3,343,2,730,336860,3,498
2012-03-11,spring,2012,March,18,Sunday,Holiday,Clear,0.52,0.5,0.29,0.2836,133,256,389,389,295,389,3,4,3,343,2,728,309772,3,389
2012-03-11,spring,2012,March,19,Sunday,Holiday,Clear,0.5,0.4848,0.31,0.2836,55,203,258,258,295,258,3,3,2,332,2,728,226789,3,258
2012-03-11,spring,2012,March,20,Sunday,Holiday,Clear,0.44,0.4394,0.47,0.2239,42,129,171,171,295,171,3,3,2,332,1,728,164550,3,171
2012-03-11,spring,2012,March,21,Sunday,Holiday,Clear,0.42,0.4242,0.54,0.2239,37,110,147,147,295,147,3,3,2,332,1,728,125445,3,147
2012-03-11,spring,2012,March,22,Sunday,Holiday,Clear,0.4,0.4091,0.54,0.194,13,81,94,94,295,94,3,2,2,322,1,728,95612,3,94
2012-03-11,spring,2012,March,23,Sunday,Holiday,Clear,0.4,0.4091,0.5,0.1642,12,40,52,52,295,52,3,2,2,322,1,728,63941,3,52
2012-03-12,spring,2012,March,0,Monday,Workingday,Clear,0.38,0.3939,0.54,0.194,4,20,24,24,294,24,3,1,2,312,1,726,39130,3,24
2012-03-12,spring,2012,March,1,Monday,Workingday,Clear,0.38,0.3939,0.5,0.1343,1,9,10,10,294,10,3,1,2,312,1,724,24164,3,10
2012-03-12,spring,2012,March,2,Monday,Workingday,Clear,0.38,0.3939,0.54,0.1045,4,5,9,9,294,9,3,1,2,312,1,715,16352,3,9
2012-03-12,spring,2012,March,3,Monday,Workingday,Clear,0.36,0.3485,0.5,0.1343,0,2,2,2,294,2,3,1,2,312,1,697,8174,3,2
2012-03-12,spring,2012,March,4,Monday,Workingday,Clear,0.34,0.3333,0.61,0.194,0,3,3,3,294,3,3,1,1,311,1,697,4428,3,3
2012-03-12,spring,2012,March,5,Monday,Workingday,Clear,0.34,0.3333,0.61,0.194,1,15,16,16,294,16,3,1,1,311,1,717,14261,3,16
2012-03-12,spring,2012,March,6,Monday,Workingday,Clear,0.34,0.3485,0.57,0.1045,2,86,88,88,294,88,3,2,2,322,1,725,55132,3,88
2012-03-12,spring,2012,March,7,Monday,Workingday,Clear,0.34,0.3485,0.53,0.1045,9,259,268,268,294,268,3,3,2,332,1,727,154171,3,268
2012-03-12,spring,2012,March,8,Monday,Workingday,Clear,0.34,0.3333,0.61,0.1343,17,547,564,564,294,564,3,4,1,341,1,727,261001,3,564
2012-03-12,spring,2012,March,9,Monday,Workingday,Clear,0.38,0.3939,0.54,0.1642,21,260,281,281,294,281,3,3,2,332,1,727,159438,3,281
2012-03-12,spring,2012,March,10,Monday,Workingday,Clear,0.4,0.4091,0.5,0.2239,39,98,137,137,294,137,3,2,2,322,1,727,126257,3,137
2012-03-12,spring,2012,March,11,Monday,Workingday,Clear,0.44,0.4394,0.44,0.2239,39,111,150,150,294,150,3,3,2,332,1,727,151320,3,150
2012-03-12,spring,2012,March,12,Monday,Workingday,Clear,0.48,0.4697,0.39,0.2239,59,162,221,221,294,221,3,3,2,332,2,728,184414,3,221
2012-03-12,spring,2012,March,13,Monday,Workingday,Mist,0.54,0.5152,0.32,0.2537,74,176,250,250,294,250,3,3,3,333,2,729,184919,3,250
2012-03-12,spring,2012,March,14,Monday,Workingday,Mist,0.58,0.5455,0.32,0.2836,76,145,221,221,294,221,3,3,3,333,2,729,175652,3,221
2012-03-12,spring,2012,March,15,Monday,Workingday,Clear,0.56,0.5303,0.4,0.1343,74,159,233,233,294,233,3,3,3,333,2,729,183149,3,233
2012-03-12,spring,2012,March,16,Monday,Workingday,Clear,0.62,0.6212,0.35,0.4478,77,255,332,332,294,332,3,4,3,343,2,730,227748,3,332
2012-03-12,spring,2012,March,17,Monday,Workingday,Mist,0.62,0.6212,0.38,0.4179,87,557,644,644,294,644,3,4,3,343,2,730,336860,3,644
2012-03-12,spring,2012,March,18,Monday,Workingday,Mist,0.6,0.6212,0.43,0.194,89,623,712,712,294,712,3,4,3,343,2,728,309772,3,712
2012-03-12,spring,2012,March,19,Monday,Workingday,Mist,0.56,0.5303,0.49,0.2239,67,379,446,446,294,446,3,4,3,343,2,728,226789,3,446
2012-03-12,spring,2012,March,20,Monday,Workingday,Mist,0.56,0.5303,0.49,0.2239,49,237,286,286,294,286,3,4,3,343,2,728,164550,3,286
2012-03-12,spring,2012,March,21,Monday,Workingday,Mist,0.54,0.5152,0.56,0.2239,22,183,205,205,294,205,3,3,3,333,0,728,125445,3,205
2012-03-12,spring,2012,March,22,Monday,Workingday,Mist,0.56,0.5303,0.56,0.2239,17,116,133,133,294,133,3,2,3,323,0,728,95612,3,133
2012-03-12,spring,2012,March,23,Monday,Workingday,Clear,0.56,0.5303,0.56,0.2239,10,53,63,63,294,63,3,2,3,323,0,728,63941,3,63
2012-03-13,spring,2012,March,0,Tuesday,Workingday,Mist,0.56,0.5303,0.52,0.194,5,21,26,26,293,26,3,1,3,313,0,726,39130,3,26
2012-03-13,spring,2012,March,1,Tuesday,Workingday,Mist,0.52,0.5,0.59,0.2239,2,14,16,16,293,16,3,1,3,313,0,724,24164,3,16
2012-03-13,spring,2012,March,2,Tuesday,Workingday,Light Snow,0.52,0.5,0.72,0.2985,0,1,1,1,293,1,3,1,3,313,0,715,16352,3,1
2012-03-13,spring,2012,March,3,Tuesday,Workingday,Light Snow,0.52,0.5,0.72,0.2985,0,2,2,2,293,2,3,1,3,313,0,697,8174,3,2
2012-03-13,spring,2012,March,4,Tuesday,Workingday,Mist,0.46,0.4545,0.82,0.194,0,1,1,1,293,1,3,1,2,312,0,697,4428,3,1
2012-03-13,spring,2012,March,5,Tuesday,Workingday,Mist,0.46,0.4545,0.82,0.194,0,24,24,24,293,24,3,1,2,312,0,717,14261,3,24
2012-03-13,spring,2012,March,6,Tuesday,Workingday,Light Snow,0.46,0.4545,0.82,0.194,5,108,113,113,293,113,3,2,2,322,0,725,55132,3,113
2012-03-13,spring,2012,March,7,Tuesday,Workingday,Mist,0.46,0.4545,0.82,0.2836,16,292,308,308,293,308,3,4,2,342,0,727,154171,3,308
2012-03-13,spring,2012,March,8,Tuesday,Workingday,Clear,0.46,0.4545,0.82,0.2836,22,571,593,593,293,593,3,4,2,342,2,727,261001,3,593
2012-03-13,spring,2012,March,9,Tuesday,Workingday,Clear,0.48,0.4697,0.82,0.2836,18,324,342,342,293,342,3,4,2,342,0,727,159438,3,342
2012-03-13,spring,2012,March,10,Tuesday,Workingday,Clear,0.52,0.5,0.77,0.2239,28,115,143,143,293,143,3,3,3,333,0,727,126257,3,143
2012-03-13,spring,2012,March,11,Tuesday,Workingday,Clear,0.54,0.5152,0.73,0.2836,64,155,219,219,293,219,3,3,3,333,0,727,151320,3,219
2012-03-13,spring,2012,March,12,Tuesday,Workingday,Clear,0.6,0.6061,0.6,0.2836,47,197,244,244,293,244,3,3,3,333,2,728,184414,3,244
2012-03-13,spring,2012,March,13,Tuesday,Workingday,Clear,0.6,0.6061,0.6,0.3881,53,180,233,233,293,233,3,3,3,333,2,729,184919,3,233
2012-03-13,spring,2012,March,14,Tuesday,Workingday,Clear,0.64,0.6212,0.53,0.3284,52,160,212,212,293,212,3,3,3,333,2,729,175652,3,212
2012-03-13,spring,2012,March,15,Tuesday,Workingday,Clear,0.7,0.6364,0.39,0.2239,68,196,264,264,293,264,3,3,4,334,2,729,183149,3,264
2012-03-13,spring,2012,March,16,Tuesday,Workingday,Clear,0.72,0.6515,0.34,0.3881,53,312,365,365,293,365,3,4,4,344,2,730,227748,3,365
2012-03-13,spring,2012,March,17,Tuesday,Workingday,Clear,0.7,0.6364,0.37,0.1045,62,614,676,676,293,676,3,4,4,344,2,730,336860,3,676
2012-03-13,spring,2012,March,18,Tuesday,Workingday,Clear,0.7,0.6364,0.34,0.2985,96,638,734,734,293,734,3,4,4,344,2,728,309772,3,734
2012-03-13,spring,2012,March,19,Tuesday,Workingday,Clear,0.64,0.6212,0.47,0.2239,50,429,479,479,293,479,3,4,3,343,2,728,226789,3,479
2012-03-13,spring,2012,March,20,Tuesday,Workingday,Clear,0.6,0.6212,0.49,0.1642,45,306,351,351,293,351,3,4,3,343,2,728,164550,3,351
2012-03-13,spring,2012,March,21,Tuesday,Workingday,Clear,0.58,0.5455,0.56,0.1045,44,200,244,244,293,244,3,3,3,333,0,728,125445,3,244
2012-03-13,spring,2012,March,22,Tuesday,Workingday,Clear,0.56,0.5303,0.6,0.0896,24,146,170,170,293,170,3,3,3,333,0,728,95612,3,170
2012-03-13,spring,2012,March,23,Tuesday,Workingday,Clear,0.56,0.5303,0.56,0.1343,8,79,87,87,293,87,3,2,3,323,0,728,63941,3,87
2012-03-14,spring,2012,March,0,Wednesday,Workingday,Clear,0.54,0.5152,0.6,0.1045,5,34,39,39,292,39,3,1,3,313,0,726,39130,3,39
2012-03-14,spring,2012,March,1,Wednesday,Workingday,Clear,0.52,0.5,0.63,0.0896,2,25,27,27,292,27,3,1,3,313,0,724,24164,3,27
2012-03-14,spring,2012,March,2,Wednesday,Workingday,Clear,0.5,0.4848,0.68,0.194,0,2,2,2,292,2,3,1,2,312,0,715,16352,3,2
2012-03-14,spring,2012,March,3,Wednesday,Workingday,Clear,0.48,0.4697,0.72,0.194,1,3,4,4,292,4,3,1,2,312,0,697,8174,3,4
2012-03-14,spring,2012,March,4,Wednesday,Workingday,Clear,0.48,0.4697,0.67,0.0896,1,4,5,5,292,5,3,1,2,312,0,697,4428,3,5
2012-03-14,spring,2012,March,5,Wednesday,Workingday,Clear,0.44,0.4394,0.82,0.1343,2,25,27,27,292,27,3,1,2,312,0,717,14261,3,27
2012-03-14,spring,2012,March,6,Wednesday,Workingday,Clear,0.44,0.4394,0.82,0.0896,1,120,121,121,292,121,3,2,2,322,0,725,55132,3,121
2012-03-14,spring,2012,March,7,Wednesday,Workingday,Clear,0.44,0.4394,0.82,0.1045,20,348,368,368,292,368,3,4,2,342,0,727,154171,3,368
2012-03-14,spring,2012,March,8,Wednesday,Workingday,Clear,0.44,0.4394,0.82,0.0,34,628,662,662,292,662,3,4,2,342,0,727,261001,3,662
2012-03-14,spring,2012,March,9,Wednesday,Workingday,Clear,0.52,0.5,0.68,0.0,26,325,351,351,292,351,3,4,3,343,0,727,159438,3,351
2012-03-14,spring,2012,March,10,Wednesday,Workingday,Clear,0.56,0.5303,0.56,0.1045,38,150,188,188,292,188,3,3,3,333,0,727,126257,3,188
2012-03-14,spring,2012,March,11,Wednesday,Workingday,Mist,0.62,0.6212,0.41,0.1642,65,155,220,220,292,220,3,3,3,333,2,727,151320,3,220
2012-03-14,spring,2012,March,12,Wednesday,Workingday,Mist,0.64,0.6212,0.29,0.0,55,212,267,267,292,267,3,3,3,333,2,728,184414,3,267
2012-03-14,spring,2012,March,13,Wednesday,Workingday,Clear,0.66,0.6212,0.27,0.2239,57,197,254,254,292,254,3,3,3,333,2,729,184919,3,254
2012-03-14,spring,2012,March,14,Wednesday,Workingday,Clear,0.7,0.6364,0.23,0.3284,61,163,224,224,292,224,3,3,4,334,2,729,175652,3,224
2012-03-14,spring,2012,March,15,Wednesday,Workingday,Clear,0.7,0.6364,0.24,0.0,86,197,283,283,292,283,3,4,4,344,2,729,183149,3,283
2012-03-14,spring,2012,March,16,Wednesday,Workingday,Clear,0.72,0.6364,0.25,0.194,78,278,356,356,292,356,3,4,4,344,2,730,227748,3,356
2012-03-14,spring,2012,March,17,Wednesday,Workingday,Clear,0.7,0.6364,0.28,0.0896,140,642,782,782,292,782,3,4,4,344,2,730,336860,3,782
2012-03-14,spring,2012,March,18,Wednesday,Workingday,Clear,0.7,0.6364,0.32,0.0,102,647,749,749,292,749,3,4,4,344,2,728,309772,3,749
2012-03-14,spring,2012,March,19,Wednesday,Workingday,Clear,0.64,0.6212,0.33,0.1642,70,402,472,472,292,472,3,4,3,343,2,728,226789,3,472
2012-03-14,spring,2012,March,20,Wednesday,Workingday,Clear,0.62,0.6212,0.35,0.1045,44,286,330,330,292,330,3,4,3,343,2,728,164550,3,330
2012-03-14,spring,2012,March,21,Wednesday,Workingday,Clear,0.6,0.6212,0.4,0.0896,47,241,288,288,292,288,3,4,3,343,2,728,125445,3,288
2012-03-14,spring,2012,March,22,Wednesday,Workingday,Clear,0.52,0.5,0.55,0.1343,43,159,202,202,292,202,3,3,3,333,0,728,95612,3,202
2012-03-14,spring,2012,March,23,Wednesday,Workingday,Clear,0.56,0.5303,0.43,0.1642,19,72,91,91,292,91,3,2,3,323,0,728,63941,3,91
2012-03-15,spring,2012,March,0,Thursday,Workingday,Clear,0.54,0.5152,0.49,0.1343,14,46,60,60,291,60,3,2,3,323,0,726,39130,3,60
2012-03-15,spring,2012,March,1,Thursday,Workingday,Clear,0.5,0.4848,0.59,0.1045,15,8,23,23,291,23,3,1,2,312,0,724,24164,3,23
2012-03-15,spring,2012,March,2,Thursday,Workingday,Clear,0.5,0.4848,0.59,0.0,14,5,19,19,291,19,3,1,2,312,0,715,16352,3,19
2012-03-15,spring,2012,March,3,Thursday,Workingday,Clear,0.5,0.4848,0.63,0.0,0,7,7,7,291,7,3,1,2,312,0,697,8174,3,7
2012-03-15,spring,2012,March,4,Thursday,Workingday,Clear,0.44,0.4394,0.77,0.1045,11,3,14,14,291,14,3,1,2,312,0,697,4428,3,14
2012-03-15,spring,2012,March,5,Thursday,Workingday,Clear,0.46,0.4545,0.67,0.0,2,24,26,26,291,26,3,1,2,312,0,717,14261,3,26
2012-03-15,spring,2012,March,6,Thursday,Workingday,Clear,0.44,0.4394,0.72,0.0896,4,113,117,117,291,117,3,2,2,322,0,725,55132,3,117
2012-03-15,spring,2012,March,7,Thursday,Workingday,Clear,0.44,0.4394,0.72,0.0896,14,367,381,381,291,381,3,4,2,342,0,727,154171,3,381
2012-03-15,spring,2012,March,8,Thursday,Workingday,Clear,0.44,0.4394,0.77,0.1045,21,602,623,623,291,623,3,4,2,342,2,727,261001,3,623
2012-03-15,spring,2012,March,9,Thursday,Workingday,Clear,0.48,0.4697,0.77,0.0896,30,285,315,315,291,315,3,4,2,342,0,727,159438,3,315
2012-03-15,spring,2012,March,10,Thursday,Workingday,Clear,0.52,0.5,0.68,0.1045,34,130,164,164,291,164,3,3,3,333,0,727,126257,3,164
2012-03-15,spring,2012,March,11,Thursday,Workingday,Clear,0.56,0.5303,0.6,0.1343,60,151,211,211,291,211,3,3,3,333,0,727,151320,3,211
2012-03-15,spring,2012,March,12,Thursday,Workingday,Mist,0.62,0.6212,0.5,0.1343,59,206,265,265,291,265,3,3,3,333,2,728,184414,3,265
2012-03-15,spring,2012,March,13,Thursday,Workingday,Mist,0.66,0.6212,0.41,0.0896,62,211,273,273,291,273,3,3,3,333,2,729,184919,3,273
2012-03-15,spring,2012,March,14,Thursday,Workingday,Mist,0.72,0.6515,0.3,0.1045,81,177,258,258,291,258,3,3,4,334,2,729,175652,3,258
2012-03-15,spring,2012,March,15,Thursday,Workingday,Clear,0.72,0.6515,0.32,0.2239,100,187,287,287,291,287,3,4,4,344,2,729,183149,3,287
2012-03-15,spring,2012,March,16,Thursday,Workingday,Clear,0.72,0.6515,0.37,0.3881,95,331,426,426,291,426,3,4,4,344,2,730,227748,3,426
2012-03-15,spring,2012,March,17,Thursday,Workingday,Clear,0.7,0.6364,0.39,0.2537,79,634,713,713,291,713,3,4,4,344,2,730,336860,3,713
2012-03-15,spring,2012,March,18,Thursday,Workingday,Clear,0.66,0.6212,0.44,0.2836,98,648,746,746,291,746,3,4,3,343,2,728,309772,3,746
2012-03-15,spring,2012,March,19,Thursday,Workingday,Mist,0.64,0.6212,0.5,0.194,72,353,425,425,291,425,3,4,3,343,2,728,226789,3,425
2012-03-15,spring,2012,March,20,Thursday,Workingday,Mist,0.58,0.5455,0.6,0.3582,60,270,330,330,291,330,3,4,3,343,2,728,164550,3,330
2012-03-15,spring,2012,March,21,Thursday,Workingday,Clear,0.54,0.5152,0.68,0.2836,36,207,243,243,291,243,3,3,3,333,0,728,125445,3,243
2012-03-15,spring,2012,March,22,Thursday,Workingday,Clear,0.52,0.5,0.68,0.1343,32,137,169,169,291,169,3,3,3,333,0,728,95612,3,169
2012-03-15,spring,2012,March,23,Thursday,Workingday,Clear,0.48,0.4697,0.72,0.194,12,85,97,97,291,97,3,2,2,322,0,728,63941,3,97
2012-03-16,spring,2012,March,0,Friday,Workingday,Clear,0.44,0.4394,0.77,0.2537,8,49,57,57,290,57,3,2,2,322,0,726,39130,3,57
2012-03-16,spring,2012,March,1,Friday,Workingday,Mist,0.42,0.4242,0.82,0.3284,4,22,26,26,290,26,3,1,2,312,1,724,24164,3,26
2012-03-16,spring,2012,March,2,Friday,Workingday,Mist,0.42,0.4242,0.82,0.194,0,4,4,4,290,4,3,1,2,312,0,715,16352,3,4
2012-03-16,spring,2012,March,3,Friday,Workingday,Mist,0.4,0.4091,0.87,0.2836,0,3,3,3,290,3,3,1,2,312,0,697,8174,3,3
2012-03-16,spring,2012,March,4,Friday,Workingday,Mist,0.4,0.4091,0.87,0.2537,0,3,3,3,290,3,3,1,2,312,0,697,4428,3,3
2012-03-16,spring,2012,March,5,Friday,Workingday,Mist,0.4,0.4091,0.87,0.2239,2,30,32,32,290,32,3,1,2,312,0,717,14261,3,32
2012-03-16,spring,2012,March,6,Friday,Workingday,Mist,0.4,0.4091,0.87,0.1642,3,96,99,99,290,99,3,2,2,322,0,725,55132,3,99
2012-03-16,spring,2012,March,7,Friday,Workingday,Mist,0.4,0.4091,0.87,0.194,13,265,278,278,290,278,3,3,2,332,0,727,154171,3,278
2012-03-16,spring,2012,March,8,Friday,Workingday,Mist,0.4,0.4091,0.87,0.2239,28,534,562,562,290,562,3,4,2,342,0,727,261001,3,562
2012-03-16,spring,2012,March,9,Friday,Workingday,Mist,0.42,0.4242,0.82,0.0,35,277,312,312,290,312,3,4,2,342,0,727,159438,3,312
2012-03-16,spring,2012,March,10,Friday,Workingday,Mist,0.4,0.4091,0.87,0.0896,44,136,180,180,290,180,3,3,2,332,0,727,126257,3,180
2012-03-16,spring,2012,March,11,Friday,Workingday,Mist,0.44,0.4394,0.77,0.0,40,167,207,207,290,207,3,3,2,332,0,727,151320,3,207
2012-03-16,spring,2012,March,12,Friday,Workingday,Mist,0.44,0.4394,0.82,0.1343,72,222,294,294,290,294,3,4,2,342,0,728,184414,3,294
2012-03-16,spring,2012,March,13,Friday,Workingday,Mist,0.46,0.4545,0.77,0.0896,52,208,260,260,290,260,3,3,2,332,0,729,184919,3,260
2012-03-16,spring,2012,March,14,Friday,Workingday,Mist,0.48,0.4697,0.72,0.0,56,146,202,202,290,202,3,3,2,332,0,729,175652,3,202
2012-03-16,spring,2012,March,15,Friday,Workingday,Light Snow,0.46,0.4545,0.82,0.1045,19,88,107,107,290,107,3,2,2,322,0,729,183149,3,107
2012-03-16,spring,2012,March,16,Friday,Workingday,Light Snow,0.48,0.4697,0.77,0.0,18,111,129,129,290,129,3,2,2,322,0,730,227748,3,129
2012-03-16,spring,2012,March,17,Friday,Workingday,Light Snow,0.48,0.4697,0.82,0.0896,23,235,258,258,290,258,3,3,2,332,0,730,336860,3,258
2012-03-16,spring,2012,March,18,Friday,Workingday,Light Snow,0.48,0.4697,0.82,0.0896,31,377,408,408,290,408,3,4,2,342,0,728,309772,3,408
2012-03-16,spring,2012,March,19,Friday,Workingday,Mist,0.46,0.4545,0.88,0.0,23,273,296,296,290,296,3,4,2,342,0,728,226789,3,296
2012-03-16,spring,2012,March,20,Friday,Workingday,Clear,0.46,0.4545,0.88,0.0,31,204,235,235,290,235,3,3,2,332,0,728,164550,3,235
2012-03-16,spring,2012,March,21,Friday,Workingday,Mist,0.44,0.4394,0.94,0.0,8,144,152,152,290,152,3,3,2,332,0,728,125445,3,152
2012-03-16,spring,2012,March,22,Friday,Workingday,Mist,0.44,0.4394,0.94,0.0,16,132,148,148,290,148,3,3,2,332,0,728,95612,3,148
2012-03-16,spring,2012,March,23,Friday,Workingday,Mist,0.44,0.4394,0.94,0.0,22,104,126,126,290,126,3,2,2,322,0,728,63941,3,126
2012-03-17,spring,2012,March,0,Saturday,Holiday,Mist,0.44,0.4394,0.94,0.0896,13,87,100,100,289,100,3,2,2,322,0,726,39130,3,100
2012-03-17,spring,2012,March,1,Saturday,Holiday,Mist,0.44,0.4394,0.94,0.0,12,57,69,69,289,69,3,2,2,322,0,724,24164,3,69
2012-03-17,spring,2012,March,2,Saturday,Holiday,Mist,0.44,0.4394,0.88,0.0,10,32,42,42,289,42,3,2,2,322,0,715,16352,3,42
2012-03-17,spring,2012,March,3,Saturday,Holiday,Mist,0.44,0.4394,0.88,0.0,2,24,26,26,289,26,3,1,2,312,0,697,8174,3,26
2012-03-17,spring,2012,March,4,Saturday,Holiday,Mist,0.42,0.4242,0.94,0.0,0,2,2,2,289,2,3,1,2,312,0,697,4428,3,2
2012-03-17,spring,2012,March,5,Saturday,Holiday,Mist,0.42,0.4242,0.94,0.0896,5,3,8,8,289,8,3,1,2,312,0,717,14261,3,8
2012-03-17,spring,2012,March,6,Saturday,Holiday,Mist,0.42,0.4242,0.94,0.194,1,29,30,30,289,30,3,1,2,312,0,725,55132,3,30
2012-03-17,spring,2012,March,7,Saturday,Holiday,Mist,0.4,0.4091,1.0,0.1343,29,57,86,86,289,86,3,2,2,322,0,727,154171,3,86
2012-03-17,spring,2012,March,8,Saturday,Holiday,Mist,0.42,0.4242,0.94,0.1045,63,155,218,218,289,218,3,3,2,332,0,727,261001,3,218
2012-03-17,spring,2012,March,9,Saturday,Holiday,Mist,0.44,0.4394,0.88,0.0896,104,217,321,321,289,321,3,4,2,342,0,727,159438,3,321
2012-03-17,spring,2012,March,10,Saturday,Holiday,Mist,0.5,0.4848,0.77,0.0896,140,303,443,443,289,443,3,4,2,342,2,727,126257,3,443
2012-03-17,spring,2012,March,11,Saturday,Holiday,Mist,0.52,0.5,0.77,0.1343,226,359,585,585,289,585,3,4,3,343,2,727,151320,3,585
2012-03-17,spring,2012,March,12,Saturday,Holiday,Clear,0.56,0.5303,0.68,0.1642,286,365,651,651,289,651,3,4,3,343,2,728,184414,3,651
2012-03-17,spring,2012,March,13,Saturday,Holiday,Clear,0.6,0.6061,0.6,0.1045,286,400,686,686,289,686,3,4,3,343,2,729,184919,3,686
2012-03-17,spring,2012,March,14,Saturday,Holiday,Clear,0.62,0.6212,0.53,0.0896,352,338,690,690,289,690,3,4,3,343,2,729,175652,3,690
2012-03-17,spring,2012,March,15,Saturday,Holiday,Clear,0.64,0.6212,0.53,0.1343,357,322,679,679,289,679,3,4,3,343,2,729,183149,3,679
2012-03-17,spring,2012,March,16,Saturday,Holiday,Clear,0.64,0.6212,0.5,0.0,367,318,685,685,289,685,3,4,3,343,2,730,227748,3,685
2012-03-17,spring,2012,March,17,Saturday,Holiday,Clear,0.64,0.6212,0.5,0.1343,291,357,648,648,289,648,3,4,3,343,2,730,336860,3,648
2012-03-17,spring,2012,March,18,Saturday,Holiday,Clear,0.62,0.6212,0.57,0.2985,221,339,560,560,289,560,3,4,3,343,2,728,309772,3,560
2012-03-17,spring,2012,March,19,Saturday,Holiday,Clear,0.58,0.5455,0.64,0.2836,155,262,417,417,289,417,3,4,3,343,2,728,226789,3,417
2012-03-17,spring,2012,March,20,Saturday,Holiday,Clear,0.56,0.5303,0.64,0.194,89,182,271,271,289,271,3,3,3,333,2,728,164550,3,271
2012-03-17,spring,2012,March,21,Saturday,Holiday,Clear,0.54,0.5152,0.68,0.1642,54,169,223,223,289,223,3,3,3,333,0,728,125445,3,223
2012-03-17,spring,2012,March,22,Saturday,Holiday,Clear,0.54,0.5152,0.68,0.0,58,153,211,211,289,211,3,3,3,333,0,728,95612,3,211
2012-03-17,spring,2012,March,23,Saturday,Holiday,Clear,0.5,0.4848,0.77,0.1642,34,151,185,185,289,185,3,3,2,332,0,728,63941,3,185
2012-03-18,spring,2012,March,0,Sunday,Holiday,Clear,0.46,0.4545,0.88,0.194,27,80,107,107,288,107,3,2,2,322,0,726,39130,3,107
2012-03-18,spring,2012,March,1,Sunday,Holiday,Clear,0.46,0.4545,0.82,0.1343,25,88,113,113,288,113,3,2,2,322,0,724,24164,3,113
2012-03-18,spring,2012,March,2,Sunday,Holiday,Mist,0.46,0.4545,0.82,0.1045,15,41,56,56,288,56,3,2,2,322,0,715,16352,3,56
2012-03-18,spring,2012,March,3,Sunday,Holiday,Mist,0.44,0.4394,0.88,0.1343,3,15,18,18,288,18,3,1,2,312,0,697,8174,3,18
2012-03-18,spring,2012,March,4,Sunday,Holiday,Mist,0.42,0.4242,0.94,0.1642,6,8,14,14,288,14,3,1,2,312,0,697,4428,3,14
2012-03-18,spring,2012,March,5,Sunday,Holiday,Mist,0.4,0.4091,0.94,0.1045,0,6,6,6,288,6,3,1,2,312,0,717,14261,3,6
2012-03-18,spring,2012,March,6,Sunday,Holiday,Mist,0.4,0.4091,0.94,0.1045,2,9,11,11,288,11,3,1,2,312,0,725,55132,3,11
2012-03-18,spring,2012,March,7,Sunday,Holiday,Light Snow,0.42,0.4242,0.88,0.1642,17,25,42,42,288,42,3,2,2,322,0,727,154171,3,42
2012-03-18,spring,2012,March,8,Sunday,Holiday,Mist,0.42,0.4242,0.88,0.1045,25,71,96,96,288,96,3,2,2,322,0,727,261001,3,96
2012-03-18,spring,2012,March,9,Sunday,Holiday,Mist,0.42,0.4242,0.88,0.0896,65,113,178,178,288,178,3,3,2,332,0,727,159438,3,178
2012-03-18,spring,2012,March,10,Sunday,Holiday,Mist,0.42,0.4242,0.88,0.1045,139,212,351,351,288,351,3,4,2,342,0,727,126257,3,351
2012-03-18,spring,2012,March,11,Sunday,Holiday,Mist,0.44,0.4394,0.82,0.1642,129,239,368,368,288,368,3,4,2,342,2,727,151320,3,368
2012-03-18,spring,2012,March,12,Sunday,Holiday,Mist,0.44,0.4394,0.88,0.1343,222,281,503,503,288,503,3,4,2,342,2,728,184414,3,503
2012-03-18,spring,2012,March,13,Sunday,Holiday,Mist,0.46,0.4545,0.82,0.1642,198,346,544,544,288,544,3,4,2,342,2,729,184919,3,544
2012-03-18,spring,2012,March,14,Sunday,Holiday,Mist,0.5,0.4848,0.77,0.0896,218,303,521,521,288,521,3,4,2,342,2,729,175652,3,521
2012-03-18,spring,2012,March,15,Sunday,Holiday,Clear,0.54,0.5152,0.68,0.0896,240,314,554,554,288,554,3,4,3,343,2,729,183149,3,554
2012-03-18,spring,2012,March,16,Sunday,Holiday,Clear,0.54,0.5152,0.73,0.0896,229,312,541,541,288,541,3,4,3,343,2,730,227748,3,541
2012-03-18,spring,2012,March,17,Sunday,Holiday,Clear,0.56,0.5303,0.64,0.0896,233,308,541,541,288,541,3,4,3,343,2,730,336860,3,541
2012-03-18,spring,2012,March,18,Sunday,Holiday,Clear,0.56,0.5303,0.64,0.1642,165,294,459,459,288,459,3,4,3,343,2,728,309772,3,459
2012-03-18,spring,2012,March,19,Sunday,Holiday,Clear,0.56,0.5303,0.64,0.1642,118,234,352,352,288,352,3,4,3,343,2,728,226789,3,352
2012-03-18,spring,2012,March,20,Sunday,Holiday,Clear,0.52,0.5,0.77,0.1343,59,139,198,198,288,198,3,3,3,333,0,728,164550,3,198
2012-03-18,spring,2012,March,21,Sunday,Holiday,Clear,0.52,0.5,0.72,0.0896,44,129,173,173,288,173,3,3,3,333,0,728,125445,3,173
2012-03-18,spring,2012,March,22,Sunday,Holiday,Clear,0.5,0.4848,0.77,0.1045,21,79,100,100,288,100,3,2,2,322,0,728,95612,3,100
2012-03-18,spring,2012,March,23,Sunday,Holiday,Clear,0.48,0.4697,0.82,0.1642,7,39,46,46,288,46,3,2,2,322,0,728,63941,3,46
2012-03-19,spring,2012,March,0,Monday,Workingday,Clear,0.48,0.4697,0.82,0.1045,4,19,23,23,287,23,3,1,2,312,0,726,39130,3,23
2012-03-19,spring,2012,March,1,Monday,Workingday,Clear,0.46,0.4545,0.88,0.1045,0,15,15,15,287,15,3,1,2,312,0,724,24164,3,15
2012-03-19,spring,2012,March,2,Monday,Workingday,Clear,0.46,0.4545,0.88,0.1642,1,7,8,8,287,8,3,1,2,312,0,715,16352,3,8
2012-03-19,spring,2012,March,3,Monday,Workingday,Clear,0.46,0.4545,0.88,0.0896,0,2,2,2,287,2,3,1,2,312,0,697,8174,3,2
2012-03-19,spring,2012,March,4,Monday,Workingday,Clear,0.44,0.4394,0.94,0.0,0,3,3,3,287,3,3,1,2,312,0,697,4428,3,3
2012-03-19,spring,2012,March,5,Monday,Workingday,Clear,0.44,0.4394,0.94,0.0,0,31,31,31,287,31,3,1,2,312,0,717,14261,3,31
2012-03-19,spring,2012,March,6,Monday,Workingday,Clear,0.46,0.4545,0.88,0.1343,2,118,120,120,287,120,3,2,2,322,0,725,55132,3,120
2012-03-19,spring,2012,March,7,Monday,Workingday,Clear,0.46,0.4545,0.88,0.194,25,329,354,354,287,354,3,4,2,342,0,727,154171,3,354
2012-03-19,spring,2012,March,8,Monday,Workingday,Clear,0.46,0.4545,0.88,0.1045,16,563,579,579,287,579,3,4,2,342,0,727,261001,3,579
2012-03-19,spring,2012,March,9,Monday,Workingday,Clear,0.5,0.4848,0.72,0.1642,55,276,331,331,287,331,3,4,2,342,0,727,159438,3,331
2012-03-19,spring,2012,March,10,Monday,Workingday,Clear,0.52,0.5,0.72,0.1343,56,128,184,184,287,184,3,3,3,333,0,727,126257,3,184
2012-03-19,spring,2012,March,11,Monday,Workingday,Clear,0.56,0.5303,0.68,0.1642,56,145,201,201,287,201,3,3,3,333,0,727,151320,3,201
2012-03-19,spring,2012,March,12,Monday,Workingday,Clear,0.6,0.6061,0.64,0.2537,71,211,282,282,287,282,3,4,3,343,2,728,184414,3,282
2012-03-19,spring,2012,March,13,Monday,Workingday,Clear,0.62,0.6061,0.61,0.2537,69,194,263,263,287,263,3,3,3,333,2,729,184919,3,263
2012-03-19,spring,2012,March,14,Monday,Workingday,Mist,0.64,0.6212,0.57,0.194,60,200,260,260,287,260,3,3,3,333,2,729,175652,3,260
2012-03-19,spring,2012,March,15,Monday,Workingday,Clear,0.64,0.6212,0.57,0.2239,97,189,286,286,287,286,3,4,3,343,2,729,183149,3,286
2012-03-19,spring,2012,March,16,Monday,Workingday,Clear,0.66,0.6212,0.5,0.2239,65,320,385,385,287,385,3,4,3,343,2,730,227748,3,385
2012-03-19,spring,2012,March,17,Monday,Workingday,Clear,0.64,0.6212,0.53,0.2239,106,615,721,721,287,721,3,4,3,343,2,730,336860,3,721
2012-03-19,spring,2012,March,18,Monday,Workingday,Clear,0.64,0.6212,0.57,0.2537,120,681,801,801,287,801,3,4,3,343,2,728,309772,3,801
2012-03-19,spring,2012,March,19,Monday,Workingday,Clear,0.62,0.6061,0.61,0.2239,86,463,549,549,287,549,3,4,3,343,2,728,226789,3,549
2012-03-19,spring,2012,March,20,Monday,Workingday,Clear,0.6,0.6061,0.64,0.2239,34,296,330,330,287,330,3,4,3,343,2,728,164550,3,330
2012-03-19,spring,2012,March,21,Monday,Workingday,Clear,0.6,0.6061,0.64,0.1642,33,190,223,223,287,223,3,3,3,333,0,728,125445,3,223
2012-03-19,spring,2012,March,22,Monday,Workingday,Mist,0.56,0.5303,0.73,0.1642,17,131,148,148,287,148,3,3,3,333,0,728,95612,3,148
2012-03-19,spring,2012,March,23,Monday,Workingday,Mist,0.56,0.5303,0.78,0.1343,9,45,54,54,287,54,3,2,3,323,0,728,63941,3,54
2012-03-20,spring,2012,March,0,Tuesday,Workingday,Mist,0.56,0.5303,0.78,0.0896,5,24,29,29,286,29,3,1,3,313,0,726,39130,3,29
2012-03-20,spring,2012,March,1,Tuesday,Workingday,Clear,0.54,0.5152,0.88,0.0,6,9,15,15,286,15,3,1,3,313,0,724,24164,3,15
2012-03-20,spring,2012,March,2,Tuesday,Workingday,Clear,0.54,0.5152,0.88,0.0896,2,8,10,10,286,10,3,1,3,313,0,715,16352,3,10
2012-03-20,spring,2012,March,3,Tuesday,Workingday,Mist,0.54,0.5152,0.88,0.0,0,3,3,3,286,3,3,1,3,313,0,697,8174,3,3
2012-03-20,spring,2012,March,4,Tuesday,Workingday,Mist,0.52,0.5,0.88,0.1343,0,6,6,6,286,6,3,1,3,313,0,697,4428,3,6
2012-03-20,spring,2012,March,5,Tuesday,Workingday,Mist,0.52,0.5,0.94,0.0,0,20,20,20,286,20,3,1,3,313,0,717,14261,3,20
2012-03-20,spring,2012,March,6,Tuesday,Workingday,Mist,0.52,0.5,0.94,0.1642,6,94,100,100,286,100,3,2,3,323,0,725,55132,3,100
2012-03-20,spring,2012,March,7,Tuesday,Workingday,Light Snow,0.52,0.5,0.94,0.2239,3,167,170,170,286,170,3,3,3,333,0,727,154171,3,170
2012-03-20,spring,2012,March,8,Tuesday,Workingday,Mist,0.52,0.5,0.88,0.1045,28,488,516,516,286,516,3,4,3,343,0,727,261001,3,516
2012-03-20,spring,2012,March,9,Tuesday,Workingday,Mist,0.54,0.5152,0.88,0.1642,41,284,325,325,286,325,3,4,3,343,0,727,159438,3,325
2012-03-20,spring,2012,March,10,Tuesday,Workingday,Clear,0.54,0.5152,0.88,0.194,44,119,163,163,286,163,3,3,3,333,0,727,126257,3,163
2012-03-20,spring,2012,March,11,Tuesday,Workingday,Clear,0.58,0.5455,0.83,0.1343,74,156,230,230,286,230,3,3,3,333,0,727,151320,3,230
2012-03-20,spring,2012,March,12,Tuesday,Workingday,Clear,0.6,0.5758,0.78,0.2537,56,205,261,261,286,261,3,3,3,333,0,728,184414,3,261
2012-03-20,spring,2012,March,13,Tuesday,Workingday,Clear,0.6,0.5758,0.78,0.194,77,207,284,284,286,284,3,4,3,343,0,729,184919,3,284
2012-03-20,spring,2012,March,14,Tuesday,Workingday,Mist,0.6,0.5909,0.73,0.1642,66,182,248,248,286,248,3,3,3,333,0,729,175652,3,248
2012-03-20,spring,2012,March,15,Tuesday,Workingday,Mist,0.62,0.6061,0.69,0.1045,67,177,244,244,286,244,3,3,3,333,0,729,183149,3,244
2012-03-20,spring,2012,March,16,Tuesday,Workingday,Clear,0.62,0.6061,0.66,0.2239,99,332,431,431,286,431,3,4,3,343,2,730,227748,3,431
2012-03-20,spring,2012,March,17,Tuesday,Workingday,Clear,0.6,0.5909,0.73,0.194,108,642,750,750,286,750,3,4,3,343,2,730,336860,3,750
2012-03-20,spring,2012,March,18,Tuesday,Workingday,Clear,0.6,0.5909,0.69,0.2537,136,665,801,801,286,801,3,4,3,343,2,728,309772,3,801
2012-03-20,spring,2012,March,19,Tuesday,Workingday,Clear,0.58,0.5455,0.73,0.1343,75,480,555,555,286,555,3,4,3,343,2,728,226789,3,555
2012-03-20,spring,2012,March,20,Tuesday,Workingday,Clear,0.58,0.5455,0.68,0.0896,78,299,377,377,286,377,3,4,3,343,2,728,164550,3,377
2012-03-20,spring,2012,March,21,Tuesday,Workingday,Clear,0.56,0.5303,0.73,0.0,38,239,277,277,286,277,3,3,3,333,0,728,125445,3,277
2012-03-20,spring,2012,March,22,Tuesday,Workingday,Clear,0.54,0.5152,0.77,0.0,32,156,188,188,286,188,3,3,3,333,0,728,95612,3,188
2012-03-20,spring,2012,March,23,Tuesday,Workingday,Clear,0.52,0.5,0.83,0.0,10,80,90,90,286,90,3,2,3,323,0,728,63941,3,90
2012-03-21,summer,2012,March,0,Wednesday,Workingday,Clear,0.52,0.5,0.88,0.0,4,29,33,33,285,33,3,1,3,313,0,726,39130,3,33
2012-03-21,summer,2012,March,1,Wednesday,Workingday,Clear,0.52,0.5,0.83,0.0896,4,22,26,26,285,26,3,1,3,313,0,724,24164,3,26
2012-03-21,summer,2012,March,2,Wednesday,Workingday,Clear,0.5,0.4848,0.88,0.1343,2,8,10,10,285,10,3,1,2,312,0,715,16352,3,10
2012-03-21,summer,2012,March,3,Wednesday,Workingday,Mist,0.5,0.4848,0.88,0.194,1,7,8,8,285,8,3,1,2,312,0,697,8174,3,8
2012-03-21,summer,2012,March,4,Wednesday,Workingday,Mist,0.5,0.4848,0.88,0.1343,0,4,4,4,285,4,3,1,2,312,0,697,4428,3,4
2012-03-21,summer,2012,March,5,Wednesday,Workingday,Mist,0.5,0.4848,0.88,0.1343,4,35,39,39,285,39,3,1,2,312,0,717,14261,3,39
2012-03-21,summer,2012,March,6,Wednesday,Workingday,Mist,0.48,0.4697,0.94,0.2239,10,139,149,149,285,149,3,3,2,332,0,725,55132,3,149
2012-03-21,summer,2012,March,7,Wednesday,Workingday,Light Snow,0.48,0.4697,0.94,0.194,34,338,372,372,285,372,3,4,2,342,0,727,154171,3,372
2012-03-21,summer,2012,March,8,Wednesday,Workingday,Light Snow,0.48,0.4697,0.94,0.1045,33,502,535,535,285,535,3,4,2,342,0,727,261001,3,535
2012-03-21,summer,2012,March,9,Wednesday,Workingday,Mist,0.5,0.4848,0.88,0.1642,38,255,293,293,285,293,3,4,2,342,0,727,159438,3,293
2012-03-21,summer,2012,March,10,Wednesday,Workingday,Mist,0.52,0.5,0.83,0.1642,30,124,154,154,285,154,3,3,3,333,0,727,126257,3,154
2012-03-21,summer,2012,March,11,Wednesday,Workingday,Mist,0.52,0.5,0.83,0.1642,38,154,192,192,285,192,3,3,3,333,0,727,151320,3,192
2012-03-21,summer,2012,March,12,Wednesday,Workingday,Mist,0.54,0.5152,0.77,0.0,58,171,229,229,285,229,3,3,3,333,0,728,184414,3,229
2012-03-21,summer,2012,March,13,Wednesday,Workingday,Mist,0.54,0.5152,0.83,0.0,81,222,303,303,285,303,3,4,3,343,0,729,184919,3,303
2012-03-21,summer,2012,March,14,Wednesday,Workingday,Mist,0.56,0.5303,0.78,0.0,74,151,225,225,285,225,3,3,3,333,0,729,175652,3,225
2012-03-21,summer,2012,March,15,Wednesday,Workingday,Mist,0.56,0.5303,0.78,0.0,68,175,243,243,285,243,3,3,3,333,0,729,183149,3,243
2012-03-21,summer,2012,March,16,Wednesday,Workingday,Clear,0.58,0.5455,0.73,0.0,91,287,378,378,285,378,3,4,3,343,0,730,227748,3,378
2012-03-21,summer,2012,March,17,Wednesday,Workingday,Clear,0.6,0.5909,0.69,0.0896,113,616,729,729,285,729,3,4,3,343,2,730,336860,3,729
2012-03-21,summer,2012,March,18,Wednesday,Workingday,Clear,0.6,0.5909,0.69,0.0,152,627,779,779,285,779,3,4,3,343,2,728,309772,3,779
2012-03-21,summer,2012,March,19,Wednesday,Workingday,Clear,0.6,0.6061,0.64,0.0,86,496,582,582,285,582,3,4,3,343,2,728,226789,3,582
2012-03-21,summer,2012,March,20,Wednesday,Workingday,Clear,0.56,0.5303,0.78,0.0896,76,298,374,374,285,374,3,4,3,343,0,728,164550,3,374
2012-03-21,summer,2012,March,21,Wednesday,Workingday,Clear,0.54,0.5152,0.83,0.1045,47,204,251,251,285,251,3,3,3,333,0,728,125445,3,251
2012-03-21,summer,2012,March,22,Wednesday,Workingday,Clear,0.52,0.5,0.83,0.1642,41,156,197,197,285,197,3,3,3,333,0,728,95612,3,197
2012-03-21,summer,2012,March,23,Wednesday,Workingday,Clear,0.54,0.5152,0.77,0.0,37,88,125,125,285,125,3,2,3,323,0,728,63941,3,125
2012-03-22,summer,2012,March,0,Thursday,Workingday,Clear,0.52,0.5,0.83,0.0896,9,32,41,41,284,41,3,2,3,323,0,726,39130,3,41
2012-03-22,summer,2012,March,1,Thursday,Workingday,Clear,0.52,0.5,0.83,0.0896,14,16,30,30,284,30,3,1,3,313,0,724,24164,3,30
2012-03-22,summer,2012,March,2,Thursday,Workingday,Clear,0.52,0.5,0.83,0.0896,1,5,6,6,284,6,3,1,3,313,0,715,16352,3,6
2012-03-22,summer,2012,March,3,Thursday,Workingday,Clear,0.52,0.5,0.83,0.0896,0,7,7,7,284,7,3,1,3,313,0,697,8174,3,7
2012-03-22,summer,2012,March,4,Thursday,Workingday,Mist,0.48,0.4697,1.0,0.0896,0,6,6,6,284,6,3,1,2,312,0,697,4428,3,6
2012-03-22,summer,2012,March,5,Thursday,Workingday,Mist,0.48,0.4697,1.0,0.0896,2,32,34,34,284,34,3,1,2,312,0,717,14261,3,34
2012-03-22,summer,2012,March,6,Thursday,Workingday,Mist,0.48,0.4697,1.0,0.0896,10,126,136,136,284,136,3,2,2,322,0,725,55132,3,136
2012-03-22,summer,2012,March,7,Thursday,Workingday,Mist,0.48,0.4697,1.0,0.0896,29,332,361,361,284,361,3,4,2,342,0,727,154171,3,361
2012-03-22,summer,2012,March,8,Thursday,Workingday,Mist,0.5,0.4848,0.94,0.0896,51,598,649,649,284,649,3,4,2,342,0,727,261001,3,649
2012-03-22,summer,2012,March,9,Thursday,Workingday,Mist,0.5,0.4848,0.94,0.0896,41,277,318,318,284,318,3,4,2,342,0,727,159438,3,318
2012-03-22,summer,2012,March,10,Thursday,Workingday,Mist,0.5,0.4848,1.0,0.0896,32,110,142,142,284,142,3,2,2,322,0,727,126257,3,142
2012-03-22,summer,2012,March,11,Thursday,Workingday,Mist,0.52,0.5,0.94,0.0,53,166,219,219,284,219,3,3,3,333,0,727,151320,3,219
2012-03-22,summer,2012,March,12,Thursday,Workingday,Mist,0.54,0.5152,0.88,0.194,48,224,272,272,284,272,3,3,3,333,0,728,184414,3,272
2012-03-22,summer,2012,March,13,Thursday,Workingday,Clear,0.58,0.5455,0.78,0.0896,83,215,298,298,284,298,3,4,3,343,0,729,184919,3,298
2012-03-22,summer,2012,March,14,Thursday,Workingday,Clear,0.6,0.5909,0.73,0.1045,96,161,257,257,284,257,3,3,3,333,0,729,175652,3,257
2012-03-22,summer,2012,March,15,Thursday,Workingday,Clear,0.62,0.6061,0.69,0.194,102,202,304,304,284,304,3,4,3,343,2,729,183149,3,304
2012-03-22,summer,2012,March,16,Thursday,Workingday,Clear,0.64,0.6061,0.65,0.194,125,300,425,425,284,425,3,4,3,343,2,730,227748,3,425
2012-03-22,summer,2012,March,17,Thursday,Workingday,Clear,0.66,0.6212,0.65,0.1642,154,656,810,810,284,810,3,4,3,343,2,730,336860,3,810
2012-03-22,summer,2012,March,18,Thursday,Workingday,Clear,0.66,0.6212,0.65,0.1642,147,654,801,801,284,801,3,4,3,343,2,728,309772,3,801
2012-03-22,summer,2012,March,19,Thursday,Workingday,Clear,0.66,0.6212,0.61,0.0,117,469,586,586,284,586,3,4,3,343,2,728,226789,3,586
2012-03-22,summer,2012,March,20,Thursday,Workingday,Clear,0.62,0.5909,0.73,0.2836,64,360,424,424,284,424,3,4,3,343,2,728,164550,3,424
2012-03-22,summer,2012,March,21,Thursday,Workingday,Clear,0.58,0.5455,0.78,0.1642,66,308,374,374,284,374,3,4,3,343,0,728,125445,3,374
2012-03-22,summer,2012,March,22,Thursday,Workingday,Clear,0.56,0.5303,0.83,0.194,56,164,220,220,284,220,3,3,3,333,0,728,95612,3,220
2012-03-22,summer,2012,March,23,Thursday,Workingday,Clear,0.56,0.5303,0.83,0.0896,34,117,151,151,284,151,3,3,3,333,0,728,63941,3,151
2012-03-23,summer,2012,March,0,Friday,Workingday,Clear,0.56,0.5303,0.83,0.0,30,65,95,95,283,95,3,2,3,323,0,726,39130,3,95
2012-03-23,summer,2012,March,1,Friday,Workingday,Clear,0.54,0.5152,0.88,0.0,18,32,50,50,283,50,3,2,3,323,0,724,24164,3,50
2012-03-23,summer,2012,March,2,Friday,Workingday,Clear,0.54,0.5152,0.88,0.0896,12,20,32,32,283,32,3,1,3,313,0,715,16352,3,32
2012-03-23,summer,2012,March,3,Friday,Workingday,Clear,0.52,0.5,0.88,0.1045,4,6,10,10,283,10,3,1,3,313,0,697,8174,3,10
2012-03-23,summer,2012,March,4,Friday,Workingday,Mist,0.5,0.4848,0.94,0.1045,0,3,3,3,283,3,3,1,2,312,0,697,4428,3,3
2012-03-23,summer,2012,March,5,Friday,Workingday,Mist,0.5,0.4848,0.94,0.0,5,29,34,34,283,34,3,1,2,312,0,717,14261,3,34
2012-03-23,summer,2012,March,6,Friday,Workingday,Mist,0.5,0.4848,0.88,0.0,6,110,116,116,283,116,3,2,2,322,0,725,55132,3,116
2012-03-23,summer,2012,March,7,Friday,Workingday,Mist,0.5,0.4848,0.93,0.1343,28,318,346,346,283,346,3,4,2,342,0,727,154171,3,346
2012-03-23,summer,2012,March,8,Friday,Workingday,Mist,0.5,0.4848,0.94,0.1343,47,615,662,662,283,662,3,4,2,342,2,727,261001,3,662
2012-03-23,summer,2012,March,9,Friday,Workingday,Mist,0.52,0.5,0.9,0.0896,75,305,380,380,283,380,3,4,3,343,0,727,159438,3,380
2012-03-23,summer,2012,March,10,Friday,Workingday,Mist,0.56,0.5303,0.88,0.1045,125,150,275,275,283,275,3,3,3,333,0,727,126257,3,275
2012-03-23,summer,2012,March,11,Friday,Workingday,Mist,0.62,0.5909,0.73,0.1045,131,187,318,318,283,318,3,4,3,343,2,727,151320,3,318
2012-03-23,summer,2012,March,12,Friday,Workingday,Mist,0.66,0.6212,0.61,0.2239,199,272,471,471,283,471,3,4,3,343,2,728,184414,3,471
2012-03-23,summer,2012,March,13,Friday,Workingday,Mist,0.7,0.6515,0.48,0.0,172,256,428,428,283,428,3,4,4,344,2,729,184919,3,428
2012-03-23,summer,2012,March,14,Friday,Workingday,Mist,0.72,0.6515,0.42,0.1045,208,224,432,432,283,432,3,4,4,344,2,729,175652,3,432
2012-03-23,summer,2012,March,15,Friday,Workingday,Mist,0.72,0.6515,0.42,0.1343,191,281,472,472,283,472,3,4,4,344,2,729,183149,3,472
2012-03-23,summer,2012,March,16,Friday,Workingday,Mist,0.72,0.6515,0.42,0.1642,219,370,589,589,283,589,3,4,4,344,2,730,227748,3,589
2012-03-23,summer,2012,March,17,Friday,Workingday,Mist,0.72,0.6515,0.42,0.1642,264,693,957,957,283,957,3,4,4,344,2,730,336860,3,957
2012-03-23,summer,2012,March,18,Friday,Workingday,Clear,0.7,0.6364,0.45,0.1642,237,593,830,830,283,830,3,4,4,344,2,728,309772,3,830
2012-03-23,summer,2012,March,19,Friday,Workingday,Clear,0.66,0.6212,0.5,0.194,213,473,686,686,283,686,3,4,3,343,2,728,226789,3,686
2012-03-23,summer,2012,March,20,Friday,Workingday,Clear,0.66,0.6212,0.47,0.1343,117,328,445,445,283,445,3,4,3,343,2,728,164550,3,445
2012-03-23,summer,2012,March,21,Friday,Workingday,Clear,0.62,0.6212,0.53,0.1045,64,220,284,284,283,284,3,4,3,343,2,728,125445,3,284
2012-03-23,summer,2012,March,22,Friday,Workingday,Clear,0.6,0.6061,0.64,0.2836,53,218,271,271,283,271,3,3,3,333,2,728,95612,3,271
2012-03-23,summer,2012,March,23,Friday,Workingday,Clear,0.6,0.5909,0.69,0.2537,51,125,176,176,283,176,3,3,3,333,0,728,63941,3,176
2012-03-24,summer,2012,March,0,Saturday,Holiday,Clear,0.58,0.5455,0.68,0.0,45,111,156,156,282,156,3,3,3,333,0,726,39130,3,156
2012-03-24,summer,2012,March,1,Saturday,Holiday,Clear,0.56,0.5303,0.73,0.0896,20,108,128,128,282,128,3,2,3,323,0,724,24164,3,128
2012-03-24,summer,2012,March,2,Saturday,Holiday,Clear,0.54,0.5152,0.77,0.1045,14,55,69,69,282,69,3,2,3,323,0,715,16352,3,69
2012-03-24,summer,2012,March,3,Saturday,Holiday,Clear,0.54,0.5152,0.77,0.1045,10,22,32,32,282,32,3,1,3,313,0,697,8174,3,32
2012-03-24,summer,2012,March,4,Saturday,Holiday,Clear,0.52,0.5,0.83,0.0896,1,6,7,7,282,7,3,1,3,313,0,697,4428,3,7
2012-03-24,summer,2012,March,5,Saturday,Holiday,Mist,0.52,0.5,0.83,0.1642,0,4,4,4,282,4,3,1,3,313,0,717,14261,3,4
2012-03-24,summer,2012,March,6,Saturday,Holiday,Mist,0.52,0.5,0.83,0.1642,4,24,28,28,282,28,3,1,3,313,0,725,55132,3,28
2012-03-24,summer,2012,March,7,Saturday,Holiday,Mist,0.5,0.4848,0.88,0.1343,25,45,70,70,282,70,3,2,2,322,0,727,154171,3,70
2012-03-24,summer,2012,March,8,Saturday,Holiday,Mist,0.5,0.4848,0.94,0.194,41,113,154,154,282,154,3,3,2,332,0,727,261001,3,154
2012-03-24,summer,2012,March,9,Saturday,Holiday,Mist,0.52,0.5,0.83,0.1343,96,153,249,249,282,249,3,3,3,333,0,727,159438,3,249
2012-03-24,summer,2012,March,10,Saturday,Holiday,Mist,0.52,0.5,0.88,0.194,148,197,345,345,282,345,3,4,3,343,2,727,126257,3,345
2012-03-24,summer,2012,March,11,Saturday,Holiday,Mist,0.5,0.4848,0.94,0.194,98,175,273,273,282,273,3,3,2,332,0,727,151320,3,273
2012-03-24,summer,2012,March,12,Saturday,Holiday,Light Snow,0.52,0.5,0.94,0.2239,61,122,183,183,282,183,3,3,3,333,0,728,184414,3,183
2012-03-24,summer,2012,March,13,Saturday,Holiday,Light Snow,0.52,0.5,0.94,0.2537,62,134,196,196,282,196,3,3,3,333,0,729,184919,3,196
2012-03-24,summer,2012,March,14,Saturday,Holiday,Light Snow,0.52,0.5,0.88,0.3582,63,160,223,223,282,223,3,3,3,333,0,729,175652,3,223
2012-03-24,summer,2012,March,15,Saturday,Holiday,Light Snow,0.5,0.4848,0.94,0.4179,118,172,290,290,282,290,3,4,2,342,0,729,183149,3,290
2012-03-24,summer,2012,March,16,Saturday,Holiday,Light Snow,0.5,0.4848,0.94,0.2985,49,128,177,177,282,177,3,3,2,332,0,730,227748,3,177
2012-03-24,summer,2012,March,17,Saturday,Holiday,Light Snow,0.5,0.4848,0.88,0.2239,47,68,115,115,282,115,3,2,2,322,0,730,336860,3,115
2012-03-24,summer,2012,March,18,Saturday,Holiday,Light Snow,0.46,0.4545,0.94,0.2239,27,110,137,137,282,137,3,2,2,322,0,728,309772,3,137
2012-03-24,summer,2012,March,19,Saturday,Holiday,Light Snow,0.46,0.4545,0.94,0.1343,28,105,133,133,282,133,3,2,2,322,0,728,226789,3,133
2012-03-24,summer,2012,March,20,Saturday,Holiday,Light Snow,0.44,0.4394,1.0,0.194,31,80,111,111,282,111,3,2,2,322,0,728,164550,3,111
2012-03-24,summer,2012,March,21,Saturday,Holiday,Light Snow,0.44,0.4394,1.0,0.194,16,88,104,104,282,104,3,2,2,322,0,728,125445,3,104
2012-03-24,summer,2012,March,22,Saturday,Holiday,Light Snow,0.44,0.4394,1.0,0.2537,12,71,83,83,282,83,3,2,2,322,0,728,95612,3,83
2012-03-24,summer,2012,March,23,Saturday,Holiday,Mist,0.44,0.4394,0.94,0.2836,17,88,105,105,282,105,3,2,2,322,0,728,63941,3,105
2012-03-25,summer,2012,March,0,Sunday,Holiday,Mist,0.44,0.4394,0.94,0.2836,18,62,80,80,281,80,3,2,2,322,0,726,39130,3,80
2012-03-25,summer,2012,March,1,Sunday,Holiday,Mist,0.42,0.4242,1.0,0.2537,24,65,89,89,281,89,3,2,2,322,0,724,24164,3,89
2012-03-25,summer,2012,March,2,Sunday,Holiday,Light Snow,0.42,0.4242,1.0,0.2985,6,29,35,35,281,35,3,1,2,312,0,715,16352,3,35
2012-03-25,summer,2012,March,3,Sunday,Holiday,Light Snow,0.42,0.4242,0.94,0.2985,8,10,18,18,281,18,3,1,2,312,0,697,8174,3,18
2012-03-25,summer,2012,March,4,Sunday,Holiday,Mist,0.42,0.4242,0.94,0.3284,1,7,8,8,281,8,3,1,2,312,0,697,4428,3,8
2012-03-25,summer,2012,March,5,Sunday,Holiday,Mist,0.4,0.4091,1.0,0.2537,0,6,6,6,281,6,3,1,2,312,0,717,14261,3,6
2012-03-25,summer,2012,March,6,Sunday,Holiday,Mist,0.4,0.4091,1.0,0.2537,5,13,18,18,281,18,3,1,2,312,0,725,55132,3,18
2012-03-25,summer,2012,March,7,Sunday,Holiday,Mist,0.4,0.4091,0.94,0.3284,14,25,39,39,281,39,3,1,2,312,0,727,154171,3,39
2012-03-25,summer,2012,March,8,Sunday,Holiday,Mist,0.4,0.4091,0.94,0.3284,21,68,89,89,281,89,3,2,2,322,0,727,261001,3,89
2012-03-25,summer,2012,March,9,Sunday,Holiday,Mist,0.4,0.4091,0.94,0.2537,26,92,118,118,281,118,3,2,2,322,0,727,159438,3,118
2012-03-25,summer,2012,March,10,Sunday,Holiday,Mist,0.4,0.4091,0.87,0.3284,78,172,250,250,281,250,3,3,2,332,0,727,126257,3,250
2012-03-25,summer,2012,March,11,Sunday,Holiday,Mist,0.4,0.4091,0.94,0.2537,106,217,323,323,281,323,3,4,2,342,0,727,151320,3,323
2012-03-25,summer,2012,March,12,Sunday,Holiday,Mist,0.4,0.4091,0.94,0.2239,122,238,360,360,281,360,3,4,2,342,0,728,184414,3,360
2012-03-25,summer,2012,March,13,Sunday,Holiday,Mist,0.42,0.4242,0.88,0.1642,110,257,367,367,281,367,3,4,2,342,0,729,184919,3,367
2012-03-25,summer,2012,March,14,Sunday,Holiday,Mist,0.44,0.4394,0.88,0.1642,123,291,414,414,281,414,3,4,2,342,0,729,175652,3,414
2012-03-25,summer,2012,March,15,Sunday,Holiday,Mist,0.44,0.4394,0.88,0.194,139,282,421,421,281,421,3,4,2,342,2,729,183149,3,421
2012-03-25,summer,2012,March,16,Sunday,Holiday,Clear,0.48,0.4697,0.77,0.0,153,339,492,492,281,492,3,4,2,342,2,730,227748,3,492
2012-03-25,summer,2012,March,17,Sunday,Holiday,Clear,0.5,0.4848,0.72,0.0896,146,273,419,419,281,419,3,4,2,342,2,730,336860,3,419
2012-03-25,summer,2012,March,18,Sunday,Holiday,Clear,0.5,0.4848,0.72,0.0896,202,289,491,491,281,491,3,4,2,342,2,728,309772,3,491
2012-03-25,summer,2012,March,19,Sunday,Holiday,Clear,0.5,0.4848,0.72,0.2537,114,261,375,375,281,375,3,4,2,342,2,728,226789,3,375
2012-03-25,summer,2012,March,20,Sunday,Holiday,Clear,0.48,0.4697,0.77,0.2239,63,196,259,259,281,259,3,3,2,332,0,728,164550,3,259
2012-03-25,summer,2012,March,21,Sunday,Holiday,Clear,0.48,0.4697,0.77,0.1642,25,124,149,149,281,149,3,3,2,332,0,728,125445,3,149
2012-03-25,summer,2012,March,22,Sunday,Holiday,Clear,0.46,0.4545,0.82,0.1343,19,92,111,111,281,111,3,2,2,322,0,728,95612,3,111
2012-03-25,summer,2012,March,23,Sunday,Holiday,Clear,0.48,0.4697,0.82,0.1343,9,56,65,65,281,65,3,2,2,322,0,728,63941,3,65
2012-03-26,summer,2012,March,0,Monday,Workingday,Mist,0.48,0.4697,0.82,0.1642,10,23,33,33,280,33,3,1,2,312,0,726,39130,3,33
2012-03-26,summer,2012,March,1,Monday,Workingday,Clear,0.48,0.4697,0.82,0.2537,18,10,28,28,280,28,3,1,2,312,0,724,24164,3,28
2012-03-26,summer,2012,March,2,Monday,Workingday,Clear,0.46,0.4545,0.88,0.2239,14,6,20,20,280,20,3,1,2,312,0,715,16352,3,20
2012-03-26,summer,2012,March,3,Monday,Workingday,Clear,0.46,0.4545,0.82,0.194,0,1,1,1,280,1,3,1,2,312,0,697,8174,3,1
2012-03-26,summer,2012,March,4,Monday,Workingday,Clear,0.44,0.4394,0.82,0.1642,0,4,4,4,280,4,3,1,2,312,0,697,4428,3,4
2012-03-26,summer,2012,March,5,Monday,Workingday,Clear,0.44,0.4394,0.77,0.1642,0,36,36,36,280,36,3,1,2,312,0,717,14261,3,36
2012-03-26,summer,2012,March,6,Monday,Workingday,Clear,0.42,0.4242,0.82,0.194,7,110,117,117,280,117,3,2,2,322,0,725,55132,3,117
2012-03-26,summer,2012,March,7,Monday,Workingday,Clear,0.44,0.4394,0.72,0.194,15,355,370,370,280,370,3,4,2,342,0,727,154171,3,370
2012-03-26,summer,2012,March,8,Monday,Workingday,Clear,0.44,0.4394,0.62,0.2239,32,625,657,657,280,657,3,4,2,342,2,727,261001,3,657
2012-03-26,summer,2012,March,9,Monday,Workingday,Clear,0.46,0.4545,0.47,0.2836,37,245,282,282,280,282,3,4,2,342,1,727,159438,3,282
2012-03-26,summer,2012,March,10,Monday,Workingday,Clear,0.5,0.4848,0.36,0.5821,55,98,153,153,280,153,3,3,2,332,2,727,126257,3,153
2012-03-26,summer,2012,March,11,Monday,Workingday,Clear,0.48,0.4697,0.31,0.5821,47,131,178,178,280,178,3,3,2,332,1,727,151320,3,178
2012-03-26,summer,2012,March,12,Monday,Workingday,Clear,0.48,0.4697,0.33,0.5224,63,216,279,279,280,279,3,3,2,332,2,728,184414,3,279
2012-03-26,summer,2012,March,13,Monday,Workingday,Clear,0.48,0.4697,0.29,0.6866,79,222,301,301,280,301,3,4,2,342,2,729,184919,3,301
2012-03-26,summer,2012,March,14,Monday,Workingday,Clear,0.48,0.4697,0.33,0.4478,58,159,217,217,280,217,3,3,2,332,2,729,175652,3,217
2012-03-26,summer,2012,March,15,Monday,Workingday,Clear,0.48,0.4697,0.29,0.6119,66,157,223,223,280,223,3,3,2,332,2,729,183149,3,223
2012-03-26,summer,2012,March,16,Monday,Workingday,Clear,0.48,0.4697,0.25,0.6418,60,245,305,305,280,305,3,4,2,342,2,730,227748,3,305
2012-03-26,summer,2012,March,17,Monday,Workingday,Clear,0.46,0.4545,0.24,0.4478,65,599,664,664,280,664,3,4,2,342,2,730,336860,3,664
2012-03-26,summer,2012,March,18,Monday,Workingday,Clear,0.44,0.4394,0.26,0.4478,90,594,684,684,280,684,3,4,2,342,2,728,309772,3,684
2012-03-26,summer,2012,March,19,Monday,Workingday,Clear,0.42,0.4242,0.24,0.3582,41,417,458,458,280,458,3,4,2,342,2,728,226789,3,458
2012-03-26,summer,2012,March,20,Monday,Workingday,Clear,0.4,0.4091,0.26,0.5224,12,209,221,221,280,221,3,3,2,332,1,728,164550,3,221
2012-03-26,summer,2012,March,21,Monday,Workingday,Clear,0.38,0.3939,0.25,0.4925,11,175,186,186,280,186,3,3,2,332,1,728,125445,3,186
2012-03-26,summer,2012,March,22,Monday,Workingday,Clear,0.36,0.3333,0.25,0.3582,13,80,93,93,280,93,3,2,1,321,1,728,95612,3,93
2012-03-26,summer,2012,March,23,Monday,Workingday,Clear,0.34,0.2879,0.25,0.5224,2,46,48,48,280,48,3,2,1,321,1,728,63941,3,48
2012-03-27,summer,2012,March,0,Tuesday,Workingday,Clear,0.32,0.2879,0.26,0.5224,1,9,10,10,279,10,3,1,1,311,1,726,39130,3,10
2012-03-27,summer,2012,March,1,Tuesday,Workingday,Clear,0.3,0.2727,0.26,0.4627,1,4,5,5,279,5,3,1,1,311,1,724,24164,3,5
2012-03-27,summer,2012,March,2,Tuesday,Workingday,Clear,0.26,0.2273,0.3,0.2985,1,6,7,7,279,7,3,1,1,311,1,715,16352,3,7
2012-03-27,summer,2012,March,3,Tuesday,Workingday,Clear,0.26,0.2273,0.3,0.3284,0,4,4,4,279,4,3,1,1,311,1,697,8174,3,4
2012-03-27,summer,2012,March,4,Tuesday,Workingday,Clear,0.24,0.2121,0.32,0.3582,0,3,3,3,279,3,3,1,1,311,1,697,4428,3,3
2012-03-27,summer,2012,March,5,Tuesday,Workingday,Clear,0.22,0.2121,0.37,0.2836,1,16,17,17,279,17,3,1,1,311,1,717,14261,3,17
2012-03-27,summer,2012,March,6,Tuesday,Workingday,Clear,0.22,0.2273,0.37,0.194,5,96,101,101,279,101,3,2,1,321,1,725,55132,3,101
2012-03-27,summer,2012,March,7,Tuesday,Workingday,Clear,0.22,0.2273,0.37,0.194,9,277,286,286,279,286,3,4,1,341,1,727,154171,3,286
2012-03-27,summer,2012,March,8,Tuesday,Workingday,Clear,0.22,0.2121,0.37,0.2985,14,567,581,581,279,581,3,4,1,341,1,727,261001,3,581
2012-03-27,summer,2012,March,9,Tuesday,Workingday,Clear,0.24,0.2273,0.38,0.194,8,259,267,267,279,267,3,3,1,331,1,727,159438,3,267
2012-03-27,summer,2012,March,10,Tuesday,Workingday,Clear,0.26,0.2576,0.35,0.2239,20,118,138,138,279,138,3,2,1,321,1,727,126257,3,138
2012-03-27,summer,2012,March,11,Tuesday,Workingday,Clear,0.3,0.303,0.31,0.1642,34,141,175,175,279,175,3,3,1,331,1,727,151320,3,175
2012-03-27,summer,2012,March,12,Tuesday,Workingday,Clear,0.32,0.3182,0.31,0.1642,34,186,220,220,279,220,3,3,1,331,1,728,184414,3,220
2012-03-27,summer,2012,March,13,Tuesday,Workingday,Clear,0.36,0.3485,0.27,0.0,46,165,211,211,279,211,3,3,2,332,1,729,184919,3,211
2012-03-27,summer,2012,March,14,Tuesday,Workingday,Clear,0.4,0.4091,0.24,0.1343,37,147,184,184,279,184,3,3,2,332,1,729,175652,3,184
2012-03-27,summer,2012,March,15,Tuesday,Workingday,Clear,0.42,0.4242,0.2,0.0,42,158,200,200,279,200,3,3,2,332,1,729,183149,3,200
2012-03-27,summer,2012,March,16,Tuesday,Workingday,Clear,0.42,0.4242,0.2,0.0,38,267,305,305,279,305,3,4,2,342,1,730,227748,3,305
2012-03-27,summer,2012,March,17,Tuesday,Workingday,Clear,0.44,0.4394,0.16,0.0,72,542,614,614,279,614,3,4,2,342,2,730,336860,3,614
2012-03-27,summer,2012,March,18,Tuesday,Workingday,Clear,0.42,0.4242,0.17,0.0896,67,577,644,644,279,644,3,4,2,342,2,728,309772,3,644
2012-03-27,summer,2012,March,19,Tuesday,Workingday,Clear,0.42,0.4242,0.17,0.0,40,377,417,417,279,417,3,4,2,342,2,728,226789,3,417
2012-03-27,summer,2012,March,20,Tuesday,Workingday,Clear,0.42,0.4242,0.17,0.0896,28,266,294,294,279,294,3,4,2,342,1,728,164550,3,294
2012-03-27,summer,2012,March,21,Tuesday,Workingday,Clear,0.36,0.3485,0.37,0.1642,21,200,221,221,279,221,3,3,2,332,1,728,125445,3,221
2012-03-27,summer,2012,March,22,Tuesday,Workingday,Clear,0.36,0.3485,0.37,0.1343,7,127,134,134,279,134,3,2,2,322,1,728,95612,3,134
2012-03-27,summer,2012,March,23,Tuesday,Workingday,Clear,0.36,0.3485,0.37,0.194,5,59,64,64,279,64,3,2,2,322,1,728,63941,3,64
2012-03-28,summer,2012,March,0,Wednesday,Workingday,Clear,0.36,0.3333,0.4,0.2836,1,29,30,30,278,30,3,1,1,311,1,726,39130,3,30
2012-03-28,summer,2012,March,1,Wednesday,Workingday,Clear,0.36,0.3333,0.46,0.2985,0,8,8,8,278,8,3,1,1,311,1,724,24164,3,8
2012-03-28,summer,2012,March,2,Wednesday,Workingday,Clear,0.34,0.303,0.49,0.2985,0,3,3,3,278,3,3,1,1,311,1,715,16352,3,3
2012-03-28,summer,2012,March,3,Wednesday,Workingday,Clear,0.34,0.303,0.42,0.3284,1,4,5,5,278,5,3,1,1,311,1,697,8174,3,5
2012-03-28,summer,2012,March,4,Wednesday,Workingday,Clear,0.36,0.3333,0.43,0.2985,1,0,1,1,278,1,3,1,1,311,1,697,4428,3,1
2012-03-28,summer,2012,March,5,Wednesday,Workingday,Clear,0.36,0.3333,0.43,0.2985,2,38,40,40,278,40,3,1,1,311,1,717,14261,3,40
2012-03-28,summer,2012,March,6,Wednesday,Workingday,Clear,0.36,0.3333,0.46,0.3582,4,111,115,115,278,115,3,2,1,321,1,725,55132,3,115
2012-03-28,summer,2012,March,7,Wednesday,Workingday,Clear,0.36,0.3333,0.46,0.3284,10,348,358,358,278,358,3,4,1,341,1,727,154171,3,358
2012-03-28,summer,2012,March,8,Wednesday,Workingday,Clear,0.38,0.3939,0.46,0.3582,19,639,658,658,278,658,3,4,2,342,2,727,261001,3,658
2012-03-28,summer,2012,March,9,Wednesday,Workingday,Clear,0.4,0.4091,0.43,0.4478,16,298,314,314,278,314,3,4,2,342,1,727,159438,3,314
2012-03-28,summer,2012,March,10,Wednesday,Workingday,Clear,0.46,0.4545,0.41,0.4179,33,140,173,173,278,173,3,3,2,332,1,727,126257,3,173
2012-03-28,summer,2012,March,11,Wednesday,Workingday,Clear,0.5,0.4848,0.42,0.3881,54,168,222,222,278,222,3,3,2,332,2,727,151320,3,222
2012-03-28,summer,2012,March,12,Wednesday,Workingday,Mist,0.54,0.5152,0.39,0.3582,50,218,268,268,278,268,3,3,3,333,2,728,184414,3,268
2012-03-28,summer,2012,March,13,Wednesday,Workingday,Clear,0.56,0.5303,0.43,0.3284,60,213,273,273,278,273,3,3,3,333,2,729,184919,3,273
2012-03-28,summer,2012,March,14,Wednesday,Workingday,Clear,0.62,0.6212,0.38,0.3582,52,169,221,221,278,221,3,3,3,333,2,729,175652,3,221
2012-03-28,summer,2012,March,15,Wednesday,Workingday,Mist,0.62,0.6212,0.41,0.2985,47,152,199,199,278,199,3,3,3,333,2,729,183149,3,199
2012-03-28,summer,2012,March,16,Wednesday,Workingday,Light Snow,0.62,0.6212,0.43,0.0896,51,170,221,221,278,221,3,3,3,333,2,730,227748,3,221
2012-03-28,summer,2012,March,17,Wednesday,Workingday,Clear,0.6,0.6061,0.6,0.2239,72,532,604,604,278,604,3,4,3,343,2,730,336860,3,604
2012-03-28,summer,2012,March,18,Wednesday,Workingday,Clear,0.6,0.6061,0.6,0.2239,61,580,641,641,278,641,3,4,3,343,2,728,309772,3,641
2012-03-28,summer,2012,March,19,Wednesday,Workingday,Clear,0.6,0.6212,0.56,0.194,41,415,456,456,278,456,3,4,3,343,2,728,226789,3,456
2012-03-28,summer,2012,March,20,Wednesday,Workingday,Clear,0.6,0.6212,0.56,0.2985,38,324,362,362,278,362,3,4,3,343,2,728,164550,3,362
2012-03-28,summer,2012,March,21,Wednesday,Workingday,Clear,0.58,0.5455,0.6,0.2537,28,233,261,261,278,261,3,3,3,333,0,728,125445,3,261
2012-03-28,summer,2012,March,22,Wednesday,Workingday,Clear,0.56,0.5303,0.64,0.1343,21,151,172,172,278,172,3,3,3,333,0,728,95612,3,172
2012-03-28,summer,2012,March,23,Wednesday,Workingday,Clear,0.54,0.5152,0.68,0.1343,12,81,93,93,278,93,3,2,3,323,0,728,63941,3,93
2012-03-29,summer,2012,March,0,Thursday,Workingday,Clear,0.54,0.5152,0.68,0.194,10,38,48,48,277,48,3,2,3,323,0,726,39130,3,48
2012-03-29,summer,2012,March,1,Thursday,Workingday,Clear,0.56,0.5303,0.6,0.1343,15,18,33,33,277,33,3,1,3,313,0,724,24164,3,33
2012-03-29,summer,2012,March,2,Thursday,Workingday,Clear,0.6,0.6061,0.28,0.2985,0,6,6,6,277,6,3,1,3,313,0,715,16352,3,6
2012-03-29,summer,2012,March,3,Thursday,Workingday,Clear,0.58,0.5455,0.28,0.2537,1,4,5,5,277,5,3,1,3,313,1,697,8174,3,5
2012-03-29,summer,2012,March,4,Thursday,Workingday,Clear,0.52,0.5,0.36,0.2537,1,8,9,9,277,9,3,1,3,313,1,697,4428,3,9
2012-03-29,summer,2012,March,5,Thursday,Workingday,Clear,0.5,0.4848,0.45,0.2239,2,30,32,32,277,32,3,1,2,312,1,717,14261,3,32
2012-03-29,summer,2012,March,6,Thursday,Workingday,Clear,0.46,0.4545,0.59,0.2537,3,114,117,117,277,117,3,2,2,322,1,725,55132,3,117
2012-03-29,summer,2012,March,7,Thursday,Workingday,Clear,0.46,0.4545,0.51,0.3582,14,353,367,367,277,367,3,4,2,342,1,727,154171,3,367
2012-03-29,summer,2012,March,8,Thursday,Workingday,Clear,0.46,0.4545,0.47,0.4179,26,628,654,654,277,654,3,4,2,342,2,727,261001,3,654
2012-03-29,summer,2012,March,9,Thursday,Workingday,Clear,0.48,0.4697,0.48,0.4179,22,299,321,321,277,321,3,4,2,342,2,727,159438,3,321
2012-03-29,summer,2012,March,10,Thursday,Workingday,Clear,0.46,0.4545,0.47,0.4478,42,124,166,166,277,166,3,3,2,332,1,727,126257,3,166
2012-03-29,summer,2012,March,11,Thursday,Workingday,Clear,0.5,0.4848,0.45,0.4179,54,166,220,220,277,220,3,3,2,332,2,727,151320,3,220
2012-03-29,summer,2012,March,12,Thursday,Workingday,Clear,0.5,0.4848,0.42,0.4925,64,228,292,292,277,292,3,4,2,342,2,728,184414,3,292
2012-03-29,summer,2012,March,13,Thursday,Workingday,Clear,0.46,0.4545,0.44,0.3284,50,223,273,273,277,273,3,3,2,332,1,729,184919,3,273
2012-03-29,summer,2012,March,14,Thursday,Workingday,Clear,0.5,0.4848,0.42,0.3582,63,175,238,238,277,238,3,3,2,332,2,729,175652,3,238
2012-03-29,summer,2012,March,15,Thursday,Workingday,Clear,0.52,0.5,0.39,0.3582,109,198,307,307,277,307,3,4,3,343,2,729,183149,3,307
2012-03-29,summer,2012,March,16,Thursday,Workingday,Clear,0.52,0.5,0.36,0.3284,67,321,388,388,277,388,3,4,3,343,2,730,227748,3,388
2012-03-29,summer,2012,March,17,Thursday,Workingday,Clear,0.52,0.5,0.38,0.3881,83,620,703,703,277,703,3,4,3,343,2,730,336860,3,703
2012-03-29,summer,2012,March,18,Thursday,Workingday,Clear,0.5,0.4848,0.39,0.2985,83,598,681,681,277,681,3,4,2,342,2,728,309772,3,681
2012-03-29,summer,2012,March,19,Thursday,Workingday,Clear,0.48,0.4697,0.39,0.2836,47,421,468,468,277,468,3,4,2,342,2,728,226789,3,468
2012-03-29,summer,2012,March,20,Thursday,Workingday,Clear,0.46,0.4545,0.38,0.2985,34,301,335,335,277,335,3,4,2,342,2,728,164550,3,335
2012-03-29,summer,2012,March,21,Thursday,Workingday,Clear,0.44,0.4394,0.44,0.2836,10,214,224,224,277,224,3,3,2,332,1,728,125445,3,224
2012-03-29,summer,2012,March,22,Thursday,Workingday,Clear,0.42,0.4242,0.44,0.2836,17,135,152,152,277,152,3,3,2,332,1,728,95612,3,152
2012-03-29,summer,2012,March,23,Thursday,Workingday,Clear,0.42,0.4242,0.47,0.2985,17,77,94,94,277,94,3,2,2,322,1,728,63941,3,94
2012-03-30,summer,2012,March,0,Friday,Workingday,Clear,0.4,0.4091,0.47,0.2985,10,49,59,59,276,59,3,2,2,322,1,726,39130,3,59
2012-03-30,summer,2012,March,1,Friday,Workingday,Clear,0.38,0.3939,0.5,0.2836,6,21,27,27,276,27,3,1,2,312,1,724,24164,3,27
2012-03-30,summer,2012,March,2,Friday,Workingday,Clear,0.36,0.3333,0.53,0.2985,1,6,7,7,276,7,3,1,1,311,1,715,16352,3,7
2012-03-30,summer,2012,March,3,Friday,Workingday,Clear,0.34,0.3333,0.61,0.1343,0,7,7,7,276,7,3,1,1,311,1,697,8174,3,7
2012-03-30,summer,2012,March,4,Friday,Workingday,Clear,0.34,0.3485,0.53,0.0896,1,1,2,2,276,2,3,1,2,312,1,697,4428,3,2
2012-03-30,summer,2012,March,5,Friday,Workingday,Clear,0.32,0.3333,0.61,0.0896,0,26,26,26,276,26,3,1,1,311,1,717,14261,3,26
2012-03-30,summer,2012,March,6,Friday,Workingday,Clear,0.32,0.3333,0.57,0.1343,5,81,86,86,276,86,3,2,1,321,1,725,55132,3,86
2012-03-30,summer,2012,March,7,Friday,Workingday,Clear,0.32,0.3182,0.57,0.1642,9,280,289,289,276,289,3,4,1,341,1,727,154171,3,289
2012-03-30,summer,2012,March,8,Friday,Workingday,Clear,0.32,0.3182,0.66,0.1642,38,555,593,593,276,593,3,4,1,341,1,727,261001,3,593
2012-03-30,summer,2012,March,9,Friday,Workingday,Clear,0.34,0.3333,0.57,0.1642,29,292,321,321,276,321,3,4,1,341,1,727,159438,3,321
2012-03-30,summer,2012,March,10,Friday,Workingday,Mist,0.36,0.3636,0.57,0.1045,50,137,187,187,276,187,3,3,2,332,1,727,126257,3,187
2012-03-30,summer,2012,March,11,Friday,Workingday,Mist,0.36,0.3788,0.53,0.0,48,153,201,201,276,201,3,3,2,332,1,727,151320,3,201
2012-03-30,summer,2012,March,12,Friday,Workingday,Mist,0.38,0.3939,0.54,0.0,62,208,270,270,276,270,3,3,2,332,1,728,184414,3,270
2012-03-30,summer,2012,March,13,Friday,Workingday,Light Snow,0.4,0.4091,0.5,0.0,44,198,242,242,276,242,3,3,2,332,1,729,184919,3,242
2012-03-30,summer,2012,March,14,Friday,Workingday,Light Snow,0.4,0.4091,0.54,0.0,56,173,229,229,276,229,3,3,2,332,1,729,175652,3,229
2012-03-30,summer,2012,March,15,Friday,Workingday,Light Snow,0.42,0.4242,0.54,0.0,73,207,280,280,276,280,3,3,2,332,0,729,183149,3,280
2012-03-30,summer,2012,March,16,Friday,Workingday,Light Snow,0.4,0.4091,0.62,0.2836,75,292,367,367,276,367,3,4,2,342,1,730,227748,3,367
2012-03-30,summer,2012,March,17,Friday,Workingday,Mist,0.4,0.4091,0.62,0.2239,93,513,606,606,276,606,3,4,2,342,2,730,336860,3,606
2012-03-30,summer,2012,March,18,Friday,Workingday,Clear,0.42,0.4242,0.54,0.194,68,492,560,560,276,560,3,4,2,342,2,728,309772,3,560
2012-03-30,summer,2012,March,19,Friday,Workingday,Clear,0.4,0.4091,0.62,0.2239,42,353,395,395,276,395,3,4,2,342,1,728,226789,3,395
2012-03-30,summer,2012,March,20,Friday,Workingday,Clear,0.4,0.4091,0.62,0.1642,17,192,209,209,276,209,3,3,2,332,1,728,164550,3,209
2012-03-30,summer,2012,March,21,Friday,Workingday,Clear,0.38,0.3939,0.66,0.1343,30,190,220,220,276,220,3,3,2,332,1,728,125445,3,220
2012-03-30,summer,2012,March,22,Friday,Workingday,Clear,0.36,0.3485,0.71,0.1642,23,130,153,153,276,153,3,3,2,332,1,728,95612,3,153
2012-03-30,summer,2012,March,23,Friday,Workingday,Clear,0.36,0.3788,0.71,0.0,16,107,123,123,276,123,3,2,2,322,0,728,63941,3,123
2012-03-31,summer,2012,March,0,Saturday,Holiday,Clear,0.38,0.3939,0.82,0.194,12,80,92,92,275,92,3,2,2,322,0,726,39130,3,92
2012-03-31,summer,2012,March,1,Saturday,Holiday,Mist,0.4,0.4091,0.76,0.194,17,65,82,82,275,82,3,2,2,322,0,724,24164,3,82
2012-03-31,summer,2012,March,2,Saturday,Holiday,Mist,0.42,0.4242,0.77,0.2537,14,55,69,69,275,69,3,2,2,322,0,715,16352,3,69
2012-03-31,summer,2012,March,3,Saturday,Holiday,Clear,0.4,0.4091,0.82,0.2537,10,21,31,31,275,31,3,1,2,312,0,697,8174,3,31
2012-03-31,summer,2012,March,4,Saturday,Holiday,Clear,0.42,0.4242,0.77,0.4179,4,4,8,8,275,8,3,1,2,312,1,697,4428,3,8
2012-03-31,summer,2012,March,5,Saturday,Holiday,Clear,0.4,0.4091,0.82,0.2239,0,5,5,5,275,5,3,1,2,312,0,717,14261,3,5
2012-03-31,summer,2012,March,6,Saturday,Holiday,Mist,0.36,0.3485,0.87,0.1642,7,16,23,23,275,23,3,1,2,312,1,725,55132,3,23
2012-03-31,summer,2012,March,7,Saturday,Holiday,Mist,0.36,0.3485,0.87,0.1642,5,39,44,44,275,44,3,2,2,322,1,727,154171,3,44
2012-03-31,summer,2012,March,8,Saturday,Holiday,Mist,0.36,0.3485,0.87,0.194,19,126,145,145,275,145,3,3,2,332,1,727,261001,3,145
2012-03-31,summer,2012,March,9,Saturday,Holiday,Mist,0.4,0.4091,0.76,0.194,62,161,223,223,275,223,3,3,2,332,0,727,159438,3,223
2012-03-31,summer,2012,March,10,Saturday,Holiday,Mist,0.4,0.4091,0.76,0.1343,108,205,313,313,275,313,3,4,2,342,0,727,126257,3,313
2012-03-31,summer,2012,March,11,Saturday,Holiday,Clear,0.46,0.4545,0.72,0.1343,184,279,463,463,275,463,3,4,2,342,2,727,151320,3,463
2012-03-31,summer,2012,March,12,Saturday,Holiday,Clear,0.48,0.4697,0.67,0.0,263,358,621,621,275,621,3,4,2,342,2,728,184414,3,621
2012-03-31,summer,2012,March,13,Saturday,Holiday,Clear,0.54,0.5152,0.6,0.1343,265,373,638,638,275,638,3,4,3,343,2,729,184919,3,638
2012-03-31,summer,2012,March,14,Saturday,Holiday,Mist,0.5,0.4848,0.63,0.2537,240,311,551,551,275,551,3,4,2,342,2,729,175652,3,551
2012-03-31,summer,2012,March,15,Saturday,Holiday,Mist,0.52,0.5,0.59,0.2836,275,330,605,605,275,605,3,4,3,343,2,729,183149,3,605
2012-03-31,summer,2012,March,16,Saturday,Holiday,Mist,0.5,0.4848,0.63,0.2985,243,292,535,535,275,535,3,4,2,342,2,730,227748,3,535
2012-03-31,summer,2012,March,17,Saturday,Holiday,Clear,0.48,0.4697,0.67,0.4179,238,305,543,543,275,543,3,4,2,342,2,730,336860,3,543
2012-03-31,summer,2012,March,18,Saturday,Holiday,Mist,0.44,0.4394,0.72,0.4627,102,239,341,341,275,341,3,4,2,342,2,728,309772,3,341
2012-03-31,summer,2012,March,19,Saturday,Holiday,Clear,0.42,0.4242,0.71,0.4478,93,191,284,284,275,284,3,4,2,342,1,728,226789,3,284
2012-03-31,summer,2012,March,20,Saturday,Holiday,Mist,0.4,0.4091,0.71,0.3284,52,156,208,208,275,208,3,3,2,332,1,728,164550,3,208
2012-03-31,summer,2012,March,21,Saturday,Holiday,Mist,0.4,0.4091,0.71,0.3284,36,107,143,143,275,143,3,3,2,332,1,728,125445,3,143
2012-03-31,summer,2012,March,22,Saturday,Holiday,Mist,0.38,0.3939,0.71,0.2537,40,116,156,156,275,156,3,3,2,332,1,728,95612,3,156
2012-03-31,summer,2012,March,23,Saturday,Holiday,Mist,0.36,0.3333,0.76,0.2836,12,100,112,112,275,112,3,2,1,321,1,728,63941,3,112
2012-04-01,summer,2012,April,0,Sunday,Holiday,Mist,0.36,0.3333,0.76,0.2537,8,59,67,67,274,67,3,2,1,321,1,726,39130,3,67
2012-04-01,summer,2012,April,1,Sunday,Holiday,Mist,0.36,0.3485,0.76,0.1642,13,49,62,62,274,62,3,2,2,322,1,724,24164,3,62
2012-04-01,summer,2012,April,2,Sunday,Holiday,Mist,0.36,0.3485,0.76,0.1642,20,61,81,81,274,81,3,2,2,322,1,715,16352,3,81
2012-04-01,summer,2012,April,3,Sunday,Holiday,Mist,0.34,0.3333,0.81,0.1343,4,21,25,25,274,25,3,1,1,311,1,697,8174,3,25
2012-04-01,summer,2012,April,4,Sunday,Holiday,Mist,0.34,0.3485,0.81,0.0896,3,9,12,12,274,12,3,1,2,312,1,697,4428,3,12
2012-04-01,summer,2012,April,5,Sunday,Holiday,Mist,0.34,0.3485,0.81,0.0896,8,10,18,18,274,18,3,1,2,312,1,717,14261,3,18
2012-04-01,summer,2012,April,6,Sunday,Holiday,Mist,0.36,0.3485,0.76,0.1343,9,88,97,97,274,97,3,2,2,322,1,725,55132,3,97
2012-04-01,summer,2012,April,7,Sunday,Holiday,Mist,0.36,0.3485,0.71,0.1343,29,55,84,84,274,84,3,2,2,322,1,727,154171,3,84
2012-04-01,summer,2012,April,8,Sunday,Holiday,Mist,0.36,0.3636,0.76,0.0896,37,88,125,125,274,125,3,2,2,322,1,727,261001,3,125
2012-04-01,summer,2012,April,9,Sunday,Holiday,Mist,0.36,0.3485,0.81,0.1343,102,173,275,275,274,275,3,3,2,332,0,727,159438,3,275
2012-04-01,summer,2012,April,10,Sunday,Holiday,Mist,0.4,0.4091,0.71,0.1045,132,228,360,360,274,360,3,4,2,342,2,727,126257,3,360
2012-04-01,summer,2012,April,11,Sunday,Holiday,Mist,0.4,0.4091,0.71,0.194,180,271,451,451,274,451,3,4,2,342,2,727,151320,3,451
2012-04-01,summer,2012,April,12,Sunday,Holiday,Mist,0.42,0.4242,0.67,0.2239,187,258,445,445,274,445,3,4,2,342,2,728,184414,3,445
2012-04-01,summer,2012,April,13,Sunday,Holiday,Mist,0.44,0.4394,0.62,0.194,190,274,464,464,274,464,3,4,2,342,2,729,184919,3,464
2012-04-01,summer,2012,April,14,Sunday,Holiday,Mist,0.48,0.4697,0.55,0.2239,283,278,561,561,274,561,3,4,2,342,2,729,175652,3,561
2012-04-01,summer,2012,April,15,Sunday,Holiday,Clear,0.5,0.4848,0.55,0.2537,295,278,573,573,274,573,3,4,2,342,2,729,183149,3,573
2012-04-01,summer,2012,April,16,Sunday,Holiday,Clear,0.52,0.5,0.52,0.2537,236,275,511,511,274,511,3,4,3,343,2,730,227748,3,511
2012-04-01,summer,2012,April,17,Sunday,Holiday,Clear,0.52,0.5,0.55,0.2836,232,323,555,555,274,555,3,4,3,343,2,730,336860,3,555
2012-04-01,summer,2012,April,18,Sunday,Holiday,Clear,0.52,0.5,0.52,0.2985,153,279,432,432,274,432,3,4,3,343,2,728,309772,3,432
2012-04-01,summer,2012,April,19,Sunday,Holiday,Clear,0.52,0.5,0.55,0.2239,110,236,346,346,274,346,3,4,3,343,2,728,226789,3,346
2012-04-01,summer,2012,April,20,Sunday,Holiday,Mist,0.5,0.4848,0.59,0.2239,66,166,232,232,274,232,3,3,2,332,0,728,164550,3,232
2012-04-01,summer,2012,April,21,Sunday,Holiday,Mist,0.5,0.4848,0.59,0.1642,33,101,134,134,274,134,3,2,2,322,0,728,125445,3,134
2012-04-01,summer,2012,April,22,Sunday,Holiday,Light Snow,0.5,0.4848,0.63,0.1045,7,61,68,68,274,68,3,2,2,322,0,728,95612,3,68
2012-04-01,summer,2012,April,23,Sunday,Holiday,Light Snow,0.46,0.4545,0.72,0.0,10,53,63,63,274,63,3,2,2,322,0,728,63941,3,63
2012-04-02,summer,2012,April,0,Monday,Workingday,Light Snow,0.44,0.4394,0.82,0.1045,6,11,17,17,273,17,3,1,2,312,0,726,39130,3,17
2012-04-02,summer,2012,April,1,Monday,Workingday,Light Snow,0.42,0.4242,0.88,0.0896,0,5,5,5,273,5,3,1,2,312,0,724,24164,3,5
2012-04-02,summer,2012,April,2,Monday,Workingday,Light Snow,0.44,0.4394,0.94,0.1343,2,3,5,5,273,5,3,1,2,312,0,715,16352,3,5
2012-04-02,summer,2012,April,4,Monday,Workingday,Clear,0.4,0.4091,0.76,0.4925,2,2,4,4,273,4,3,1,2,312,1,697,4428,3,4
2012-04-02,summer,2012,April,5,Monday,Workingday,Clear,0.4,0.4091,0.76,0.4925,2,22,24,24,273,24,3,1,2,312,1,717,14261,3,24
2012-04-02,summer,2012,April,6,Monday,Workingday,Clear,0.36,0.3182,0.71,0.4627,6,104,110,110,273,110,3,2,1,321,1,725,55132,3,110
2012-04-02,summer,2012,April,7,Monday,Workingday,Clear,0.34,0.303,0.66,0.3881,12,294,306,306,273,306,3,4,1,341,1,727,154171,3,306
2012-04-02,summer,2012,April,8,Monday,Workingday,Clear,0.36,0.3333,0.57,0.3284,36,553,589,589,273,589,3,4,1,341,1,727,261001,3,589
2012-04-02,summer,2012,April,9,Monday,Workingday,Clear,0.38,0.3939,0.54,0.3582,52,265,317,317,273,317,3,4,2,342,1,727,159438,3,317
2012-04-02,summer,2012,April,10,Monday,Workingday,Clear,0.4,0.4091,0.5,0.5224,85,119,204,204,273,204,3,3,2,332,1,727,126257,3,204
2012-04-02,summer,2012,April,11,Monday,Workingday,Clear,0.42,0.4242,0.47,0.4478,81,128,209,209,273,209,3,3,2,332,1,727,151320,3,209
2012-04-02,summer,2012,April,12,Monday,Workingday,Clear,0.44,0.4394,0.44,0.4478,100,181,281,281,273,281,3,3,2,332,2,728,184414,3,281
2012-04-02,summer,2012,April,13,Monday,Workingday,Clear,0.46,0.4545,0.36,0.2985,97,184,281,281,273,281,3,3,2,332,2,729,184919,3,281
2012-04-02,summer,2012,April,14,Monday,Workingday,Clear,0.46,0.4545,0.31,0.4179,127,141,268,268,273,268,3,3,2,332,2,729,175652,3,268
2012-04-02,summer,2012,April,15,Monday,Workingday,Clear,0.48,0.4697,0.33,0.4179,132,192,324,324,273,324,3,4,2,342,2,729,183149,3,324
2012-04-02,summer,2012,April,16,Monday,Workingday,Clear,0.5,0.4848,0.34,0.3284,104,291,395,395,273,395,3,4,2,342,2,730,227748,3,395
2012-04-02,summer,2012,April,17,Monday,Workingday,Clear,0.5,0.4848,0.29,0.2836,128,601,729,729,273,729,3,4,2,342,2,730,336860,3,729
2012-04-02,summer,2012,April,18,Monday,Workingday,Clear,0.5,0.4848,0.27,0.2537,75,543,618,618,273,618,3,4,2,342,2,728,309772,3,618
2012-04-02,summer,2012,April,19,Monday,Workingday,Clear,0.5,0.4848,0.27,0.2537,66,428,494,494,273,494,3,4,2,342,2,728,226789,3,494
2012-04-02,summer,2012,April,20,Monday,Workingday,Clear,0.46,0.4545,0.31,0.1642,48,281,329,329,273,329,3,4,2,342,2,728,164550,3,329
2012-04-02,summer,2012,April,21,Monday,Workingday,Clear,0.46,0.4545,0.28,0.1343,24,214,238,238,273,238,3,3,2,332,1,728,125445,3,238
2012-04-02,summer,2012,April,22,Monday,Workingday,Clear,0.42,0.4242,0.44,0.194,17,106,123,123,273,123,3,2,2,322,1,728,95612,3,123
2012-04-02,summer,2012,April,23,Monday,Workingday,Clear,0.44,0.4394,0.35,0.1642,6,60,66,66,273,66,3,2,2,322,1,728,63941,3,66
2012-04-03,summer,2012,April,0,Tuesday,Workingday,Clear,0.4,0.4091,0.43,0.1343,1,32,33,33,272,33,3,1,2,312,1,726,39130,3,33
2012-04-03,summer,2012,April,1,Tuesday,Workingday,Clear,0.38,0.3939,0.46,0.2239,0,11,11,11,272,11,3,1,2,312,1,724,24164,3,11
2012-04-03,summer,2012,April,2,Tuesday,Workingday,Clear,0.36,0.3485,0.53,0.1642,0,5,5,5,272,5,3,1,2,312,1,715,16352,3,5
2012-04-03,summer,2012,April,3,Tuesday,Workingday,Clear,0.38,0.3939,0.46,0.0,0,3,3,3,272,3,3,1,2,312,1,697,8174,3,3
2012-04-03,summer,2012,April,4,Tuesday,Workingday,Clear,0.32,0.3333,0.66,0.0896,0,1,1,1,272,1,3,1,1,311,1,697,4428,3,1
2012-04-03,summer,2012,April,5,Tuesday,Workingday,Clear,0.32,0.3333,0.66,0.0896,2,25,27,27,272,27,3,1,1,311,1,717,14261,3,27
2012-04-03,summer,2012,April,6,Tuesday,Workingday,Clear,0.3,0.3182,0.61,0.0896,2,98,100,100,272,100,3,2,1,321,1,725,55132,3,100
2012-04-03,summer,2012,April,7,Tuesday,Workingday,Clear,0.32,0.3333,0.66,0.0896,14,327,341,341,272,341,3,4,1,341,1,727,154171,3,341
2012-04-03,summer,2012,April,8,Tuesday,Workingday,Clear,0.34,0.3636,0.57,0.0,27,577,604,604,272,604,3,4,2,342,1,727,261001,3,604
2012-04-03,summer,2012,April,9,Tuesday,Workingday,Clear,0.42,0.4242,0.38,0.0896,54,354,408,408,272,408,3,4,2,342,2,727,159438,3,408
2012-04-03,summer,2012,April,10,Tuesday,Workingday,Clear,0.44,0.4394,0.33,0.0,77,142,219,219,272,219,3,3,2,332,1,727,126257,3,219
2012-04-03,summer,2012,April,11,Tuesday,Workingday,Clear,0.48,0.4697,0.23,0.0,91,167,258,258,272,258,3,3,2,332,2,727,151320,3,258
2012-04-03,summer,2012,April,12,Tuesday,Workingday,Clear,0.52,0.5,0.25,0.0,101,230,331,331,272,331,3,4,3,343,2,728,184414,3,331
2012-04-03,summer,2012,April,13,Tuesday,Workingday,Clear,0.56,0.5303,0.19,0.2537,120,225,345,345,272,345,3,4,3,343,2,729,184919,3,345
2012-04-03,summer,2012,April,14,Tuesday,Workingday,Clear,0.56,0.5303,0.21,0.2239,120,191,311,311,272,311,3,4,3,343,2,729,175652,3,311
2012-04-03,summer,2012,April,15,Tuesday,Workingday,Clear,0.6,0.5909,0.2,0.194,109,207,316,316,272,316,3,4,3,343,2,729,183149,3,316
2012-04-03,summer,2012,April,16,Tuesday,Workingday,Clear,0.62,0.6061,0.21,0.1642,145,340,485,485,272,485,3,4,3,343,2,730,227748,3,485
2012-04-03,summer,2012,April,17,Tuesday,Workingday,Clear,0.62,0.6061,0.17,0.194,123,634,757,757,272,757,3,4,3,343,2,730,336860,3,757
2012-04-03,summer,2012,April,18,Tuesday,Workingday,Clear,0.6,0.6061,0.26,0.1642,139,661,800,800,272,800,3,4,3,343,2,728,309772,3,800
2012-04-03,summer,2012,April,19,Tuesday,Workingday,Clear,0.56,0.5303,0.26,0.1045,98,460,558,558,272,558,3,4,3,343,2,728,226789,3,558
2012-04-03,summer,2012,April,20,Tuesday,Workingday,Clear,0.56,0.5303,0.24,0.1343,54,325,379,379,272,379,3,4,3,343,2,728,164550,3,379
2012-04-03,summer,2012,April,21,Tuesday,Workingday,Clear,0.54,0.5152,0.45,0.0,33,210,243,243,272,243,3,3,3,333,0,728,125445,3,243
2012-04-03,summer,2012,April,22,Tuesday,Workingday,Clear,0.5,0.4848,0.51,0.0,25,133,158,158,272,158,3,3,2,332,0,728,95612,3,158
2012-04-03,summer,2012,April,23,Tuesday,Workingday,Clear,0.5,0.4848,0.59,0.0,13,66,79,79,272,79,3,2,2,322,0,728,63941,3,79
2012-04-04,summer,2012,April,0,Wednesday,Workingday,Clear,0.48,0.4697,0.48,0.0,18,23,41,41,271,41,3,2,2,322,0,726,39130,3,41
2012-04-04,summer,2012,April,1,Wednesday,Workingday,Clear,0.46,0.4545,0.59,0.0,0,11,11,11,271,11,3,1,2,312,0,724,24164,3,11
2012-04-04,summer,2012,April,2,Wednesday,Workingday,Clear,0.46,0.4545,0.51,0.0,0,5,5,5,271,5,3,1,2,312,0,715,16352,3,5
2012-04-04,summer,2012,April,3,Wednesday,Workingday,Clear,0.44,0.4394,0.58,0.0896,0,3,3,3,271,3,3,1,2,312,0,697,8174,3,3
2012-04-04,summer,2012,April,4,Wednesday,Workingday,Clear,0.42,0.4242,0.67,0.0896,0,1,1,1,271,1,3,1,2,312,0,697,4428,3,1
2012-04-04,summer,2012,April,5,Wednesday,Workingday,Clear,0.42,0.4242,0.67,0.0896,0,27,27,27,271,27,3,1,2,312,0,717,14261,3,27
2012-04-04,summer,2012,April,6,Wednesday,Workingday,Mist,0.42,0.4242,0.58,0.0,6,120,126,126,271,126,3,2,2,322,0,725,55132,3,126
2012-04-04,summer,2012,April,7,Wednesday,Workingday,Mist,0.44,0.4394,0.62,0.0,12,354,366,366,271,366,3,4,2,342,0,727,154171,3,366
2012-04-04,summer,2012,April,8,Wednesday,Workingday,Mist,0.44,0.4394,0.72,0.1045,31,653,684,684,271,684,3,4,2,342,2,727,261001,3,684
2012-04-04,summer,2012,April,9,Wednesday,Workingday,Mist,0.48,0.4697,0.55,0.1343,47,316,363,363,271,363,3,4,2,342,2,727,159438,3,363
2012-04-04,summer,2012,April,10,Wednesday,Workingday,Mist,0.54,0.5152,0.45,0.1343,68,99,167,167,271,167,3,3,3,333,2,727,126257,3,167
2012-04-04,summer,2012,April,11,Wednesday,Workingday,Mist,0.6,0.6212,0.43,0.3582,61,152,213,213,271,213,3,3,3,333,2,727,151320,3,213
2012-04-04,summer,2012,April,12,Wednesday,Workingday,Mist,0.6,0.6212,0.46,0.4179,73,210,283,283,271,283,3,4,3,343,2,728,184414,3,283
2012-04-04,summer,2012,April,13,Wednesday,Workingday,Mist,0.6,0.6212,0.46,0.2537,70,181,251,251,271,251,3,3,3,333,2,729,184919,3,251
2012-04-04,summer,2012,April,14,Wednesday,Workingday,Mist,0.62,0.6212,0.46,0.194,82,176,258,258,271,258,3,3,3,333,2,729,175652,3,258
2012-04-04,summer,2012,April,15,Wednesday,Workingday,Mist,0.64,0.6212,0.44,0.2836,86,182,268,268,271,268,3,3,3,333,2,729,183149,3,268
2012-04-04,summer,2012,April,16,Wednesday,Workingday,Mist,0.64,0.6212,0.44,0.2836,86,304,390,390,271,390,3,4,3,343,2,730,227748,3,390
2012-04-04,summer,2012,April,17,Wednesday,Workingday,Clear,0.66,0.6212,0.41,0.2985,99,645,744,744,271,744,3,4,3,343,2,730,336860,3,744
2012-04-04,summer,2012,April,18,Wednesday,Workingday,Clear,0.66,0.6212,0.41,0.2537,113,646,759,759,271,759,3,4,3,343,2,728,309772,3,759
2012-04-04,summer,2012,April,19,Wednesday,Workingday,Clear,0.66,0.6212,0.39,0.2239,75,419,494,494,271,494,3,4,3,343,2,728,226789,3,494
2012-04-04,summer,2012,April,20,Wednesday,Workingday,Clear,0.64,0.6212,0.27,0.2239,39,333,372,372,271,372,3,4,3,343,2,728,164550,3,372
2012-04-04,summer,2012,April,21,Wednesday,Workingday,Clear,0.6,0.6061,0.23,0.3284,43,255,298,298,271,298,3,4,3,343,2,728,125445,3,298
2012-04-04,summer,2012,April,22,Wednesday,Workingday,Clear,0.56,0.5303,0.22,0.1642,30,151,181,181,271,181,3,3,3,333,2,728,95612,3,181
2012-04-04,summer,2012,April,23,Wednesday,Workingday,Clear,0.52,0.5,0.23,0.4179,19,112,131,131,271,131,3,2,3,323,1,728,63941,3,131
2012-04-05,summer,2012,April,0,Thursday,Workingday,Clear,0.52,0.5,0.23,0.4179,12,33,45,45,270,45,3,2,3,323,1,726,39130,3,45
2012-04-05,summer,2012,April,1,Thursday,Workingday,Clear,0.48,0.4697,0.27,0.3284,4,9,13,13,270,13,3,1,2,312,1,724,24164,3,13
2012-04-05,summer,2012,April,2,Thursday,Workingday,Clear,0.46,0.4545,0.33,0.4478,7,11,18,18,270,18,3,1,2,312,1,715,16352,3,18
2012-04-05,summer,2012,April,3,Thursday,Workingday,Clear,0.42,0.4242,0.41,0.2985,0,5,5,5,270,5,3,1,2,312,1,697,8174,3,5
2012-04-05,summer,2012,April,4,Thursday,Workingday,Clear,0.38,0.3939,0.43,0.2836,0,1,1,1,270,1,3,1,2,312,1,697,4428,3,1
2012-04-05,summer,2012,April,5,Thursday,Workingday,Clear,0.38,0.3939,0.43,0.2836,1,28,29,29,270,29,3,1,2,312,1,717,14261,3,29
2012-04-05,summer,2012,April,6,Thursday,Workingday,Clear,0.36,0.3333,0.46,0.3284,8,118,126,126,270,126,3,2,1,321,1,725,55132,3,126
2012-04-05,summer,2012,April,7,Thursday,Workingday,Clear,0.34,0.3333,0.49,0.194,15,339,354,354,270,354,3,4,1,341,1,727,154171,3,354
2012-04-05,summer,2012,April,8,Thursday,Workingday,Clear,0.36,0.3485,0.46,0.2239,28,610,638,638,270,638,3,4,2,342,2,727,261001,3,638
2012-04-05,summer,2012,April,9,Thursday,Workingday,Clear,0.4,0.4091,0.37,0.2537,61,290,351,351,270,351,3,4,2,342,1,727,159438,3,351
2012-04-05,summer,2012,April,10,Thursday,Workingday,Clear,0.42,0.4242,0.35,0.2836,88,158,246,246,270,246,3,3,2,332,2,727,126257,3,246
2012-04-05,summer,2012,April,11,Thursday,Workingday,Mist,0.42,0.4242,0.38,0.2239,109,159,268,268,270,268,3,3,2,332,2,727,151320,3,268
2012-04-05,summer,2012,April,12,Thursday,Workingday,Clear,0.44,0.4394,0.33,0.0,66,210,276,276,270,276,3,3,2,332,2,728,184414,3,276
2012-04-05,summer,2012,April,13,Thursday,Workingday,Clear,0.46,0.4545,0.31,0.0,89,202,291,291,270,291,3,4,2,342,2,729,184919,3,291
2012-04-05,summer,2012,April,14,Thursday,Workingday,Clear,0.46,0.4545,0.33,0.1642,143,144,287,287,270,287,3,4,2,342,2,729,175652,3,287
2012-04-05,summer,2012,April,15,Thursday,Workingday,Clear,0.5,0.4848,0.31,0.1045,98,171,269,269,270,269,3,3,2,332,2,729,183149,3,269
2012-04-05,summer,2012,April,16,Thursday,Workingday,Clear,0.5,0.4848,0.31,0.194,84,318,402,402,270,402,3,4,2,342,2,730,227748,3,402
2012-04-05,summer,2012,April,17,Thursday,Workingday,Clear,0.5,0.4848,0.31,0.1642,145,677,822,822,270,822,3,4,2,342,2,730,336860,3,822
2012-04-05,summer,2012,April,18,Thursday,Workingday,Clear,0.5,0.4848,0.31,0.1045,80,618,698,698,270,698,3,4,2,342,2,728,309772,3,698
2012-04-05,summer,2012,April,19,Thursday,Workingday,Clear,0.48,0.4697,0.31,0.2537,64,423,487,487,270,487,3,4,2,342,2,728,226789,3,487
2012-04-05,summer,2012,April,20,Thursday,Workingday,Clear,0.44,0.4394,0.41,0.194,33,279,312,312,270,312,3,4,2,342,1,728,164550,3,312
2012-04-05,summer,2012,April,21,Thursday,Workingday,Clear,0.42,0.4242,0.47,0.194,25,209,234,234,270,234,3,3,2,332,1,728,125445,3,234
2012-04-05,summer,2012,April,22,Thursday,Workingday,Clear,0.4,0.4091,0.47,0.194,20,129,149,149,270,149,3,3,2,332,1,728,95612,3,149
2012-04-05,summer,2012,April,23,Thursday,Workingday,Clear,0.4,0.4091,0.5,0.1343,12,124,136,136,270,136,3,2,2,322,1,728,63941,3,136
2012-04-06,summer,2012,April,0,Friday,Workingday,Clear,0.4,0.4091,0.43,0.0,12,49,61,61,269,61,3,2,2,322,1,726,39130,3,61
2012-04-06,summer,2012,April,1,Friday,Workingday,Clear,0.36,0.3485,0.62,0.1343,10,28,38,38,269,38,3,1,2,312,1,724,24164,3,38
2012-04-06,summer,2012,April,2,Friday,Workingday,Clear,0.36,0.3333,0.5,0.3881,6,5,11,11,269,11,3,1,1,311,1,715,16352,3,11
2012-04-06,summer,2012,April,3,Friday,Workingday,Clear,0.34,0.303,0.53,0.3284,3,5,8,8,269,8,3,1,1,311,1,697,8174,3,8
2012-04-06,summer,2012,April,4,Friday,Workingday,Clear,0.34,0.3182,0.49,0.2537,2,3,5,5,269,5,3,1,1,311,1,697,4428,3,5
2012-04-06,summer,2012,April,5,Friday,Workingday,Clear,0.32,0.303,0.53,0.3284,0,23,23,23,269,23,3,1,1,311,1,717,14261,3,23
2012-04-06,summer,2012,April,6,Friday,Workingday,Clear,0.3,0.2727,0.49,0.3881,0,80,80,80,269,80,3,2,1,321,1,725,55132,3,80
2012-04-06,summer,2012,April,7,Friday,Workingday,Clear,0.3,0.2879,0.49,0.2836,15,231,246,246,269,246,3,3,1,331,1,727,154171,3,246
2012-04-06,summer,2012,April,8,Friday,Workingday,Clear,0.3,0.2727,0.49,0.3284,19,489,508,508,269,508,3,4,1,341,1,727,261001,3,508
2012-04-06,summer,2012,April,9,Friday,Workingday,Clear,0.34,0.303,0.42,0.3284,58,318,376,376,269,376,3,4,1,341,1,727,159438,3,376
2012-04-06,summer,2012,April,10,Friday,Workingday,Clear,0.36,0.3333,0.4,0.3284,81,157,238,238,269,238,3,3,1,331,1,727,126257,3,238
2012-04-06,summer,2012,April,11,Friday,Workingday,Clear,0.4,0.4091,0.37,0.2985,112,179,291,291,269,291,3,4,2,342,2,727,151320,3,291
2012-04-06,summer,2012,April,12,Friday,Workingday,Clear,0.42,0.4242,0.35,0.2985,113,224,337,337,269,337,3,4,2,342,2,728,184414,3,337
2012-04-06,summer,2012,April,13,Friday,Workingday,Clear,0.44,0.4394,0.33,0.3284,173,238,411,411,269,411,3,4,2,342,2,729,184919,3,411
2012-04-06,summer,2012,April,14,Friday,Workingday,Clear,0.48,0.4697,0.29,0.3881,240,250,490,490,269,490,3,4,2,342,2,729,175652,3,490
2012-04-06,summer,2012,April,15,Friday,Workingday,Clear,0.5,0.4848,0.27,0.2836,218,319,537,537,269,537,3,4,2,342,2,729,183149,3,537
2012-04-06,summer,2012,April,16,Friday,Workingday,Clear,0.5,0.4848,0.22,0.4179,184,352,536,536,269,536,3,4,2,342,2,730,227748,3,536
2012-04-06,summer,2012,April,17,Friday,Workingday,Clear,0.52,0.5,0.23,0.4179,172,483,655,655,269,655,3,4,3,343,2,730,336860,3,655
2012-04-06,summer,2012,April,18,Friday,Workingday,Clear,0.5,0.4848,0.22,0.4627,104,380,484,484,269,484,3,4,2,342,2,728,309772,3,484
2012-04-06,summer,2012,April,19,Friday,Workingday,Clear,0.48,0.4697,0.23,0.2985,115,297,412,412,269,412,3,4,2,342,2,728,226789,3,412
2012-04-06,summer,2012,April,20,Friday,Workingday,Clear,0.46,0.4545,0.24,0.2836,61,191,252,252,269,252,3,3,2,332,2,728,164550,3,252
2012-04-06,summer,2012,April,21,Friday,Workingday,Clear,0.44,0.4394,0.26,0.1343,54,136,190,190,269,190,3,3,2,332,1,728,125445,3,190
2012-04-06,summer,2012,April,22,Friday,Workingday,Clear,0.4,0.4091,0.35,0.2239,34,124,158,158,269,158,3,3,2,332,1,728,95612,3,158
2012-04-06,summer,2012,April,23,Friday,Workingday,Clear,0.42,0.4242,0.3,0.2836,21,92,113,113,269,113,3,2,2,322,1,728,63941,3,113
2012-04-07,summer,2012,April,0,Saturday,Holiday,Clear,0.42,0.4242,0.26,0.2985,9,85,94,94,268,94,3,2,2,322,1,726,39130,3,94
2012-04-07,summer,2012,April,1,Saturday,Holiday,Clear,0.4,0.4091,0.28,0.2537,9,60,69,69,268,69,3,2,2,322,1,724,24164,3,69
2012-04-07,summer,2012,April,2,Saturday,Holiday,Clear,0.36,0.3333,0.29,0.3582,11,25,36,36,268,36,3,1,1,311,1,715,16352,3,36
2012-04-07,summer,2012,April,3,Saturday,Holiday,Clear,0.36,0.3333,0.32,0.2537,7,21,28,28,268,28,3,1,1,311,1,697,8174,3,28
2012-04-07,summer,2012,April,4,Saturday,Holiday,Clear,0.32,0.3182,0.36,0.1642,3,4,7,7,268,7,3,1,1,311,1,697,4428,3,7
2012-04-07,summer,2012,April,5,Saturday,Holiday,Clear,0.32,0.3182,0.33,0.1642,0,2,2,2,268,2,3,1,1,311,1,717,14261,3,2
2012-04-07,summer,2012,April,6,Saturday,Holiday,Clear,0.32,0.3182,0.36,0.194,1,18,19,19,268,19,3,1,1,311,1,725,55132,3,19
2012-04-07,summer,2012,April,7,Saturday,Holiday,Clear,0.32,0.303,0.33,0.2836,14,40,54,54,268,54,3,2,1,321,1,727,154171,3,54
2012-04-07,summer,2012,April,8,Saturday,Holiday,Clear,0.34,0.3182,0.34,0.2537,29,94,123,123,268,123,3,2,1,321,1,727,261001,3,123
2012-04-07,summer,2012,April,9,Saturday,Holiday,Clear,0.4,0.4091,0.3,0.2537,103,173,276,276,268,276,3,3,2,332,2,727,159438,3,276
2012-04-07,summer,2012,April,10,Saturday,Holiday,Clear,0.42,0.4242,0.28,0.2537,187,176,363,363,268,363,3,4,2,342,2,727,126257,3,363
2012-04-07,summer,2012,April,11,Saturday,Holiday,Clear,0.44,0.4394,0.24,0.2985,251,244,495,495,268,495,3,4,2,342,2,727,151320,3,495
2012-04-07,summer,2012,April,12,Saturday,Holiday,Clear,0.46,0.4545,0.23,0.3881,320,270,590,590,268,590,3,4,2,342,2,728,184414,3,590
2012-04-07,summer,2012,April,13,Saturday,Holiday,Clear,0.5,0.4848,0.22,0.194,355,288,643,643,268,643,3,4,2,342,2,729,184919,3,643
2012-04-07,summer,2012,April,14,Saturday,Holiday,Clear,0.5,0.4848,0.22,0.2985,326,252,578,578,268,578,3,4,2,342,2,729,175652,3,578
2012-04-07,summer,2012,April,15,Saturday,Holiday,Clear,0.52,0.5,0.19,0.4179,321,305,626,626,268,626,3,4,3,343,2,729,183149,3,626
2012-04-07,summer,2012,April,16,Saturday,Holiday,Clear,0.54,0.5152,0.19,0.3881,354,261,615,615,268,615,3,4,3,343,2,730,227748,3,615
2012-04-07,summer,2012,April,17,Saturday,Holiday,Clear,0.54,0.5152,0.19,0.4179,299,268,567,567,268,567,3,4,3,343,2,730,336860,3,567
2012-04-07,summer,2012,April,18,Saturday,Holiday,Clear,0.54,0.5152,0.18,0.2985,227,290,517,517,268,517,3,4,3,343,2,728,309772,3,517
2012-04-07,summer,2012,April,19,Saturday,Holiday,Clear,0.54,0.5152,0.16,0.3284,170,243,413,413,268,413,3,4,3,343,2,728,226789,3,413
2012-04-07,summer,2012,April,20,Saturday,Holiday,Clear,0.5,0.4848,0.2,0.2239,73,135,208,208,268,208,3,3,2,332,2,728,164550,3,208
2012-04-07,summer,2012,April,21,Saturday,Holiday,Clear,0.5,0.4848,0.2,0.194,75,159,234,234,268,234,3,3,2,332,2,728,125445,3,234
2012-04-07,summer,2012,April,22,Saturday,Holiday,Clear,0.48,0.4697,0.2,0.194,76,106,182,182,268,182,3,3,2,332,2,728,95612,3,182
2012-04-07,summer,2012,April,23,Saturday,Holiday,Clear,0.46,0.4545,0.23,0.2239,32,86,118,118,268,118,3,2,2,322,1,728,63941,3,118
2012-04-08,summer,2012,April,0,Sunday,Holiday,Clear,0.44,0.4394,0.24,0.2239,21,64,85,85,267,85,3,2,2,322,1,726,39130,3,85
2012-04-08,summer,2012,April,1,Sunday,Holiday,Clear,0.44,0.4394,0.24,0.2239,14,50,64,64,267,64,3,2,2,322,1,724,24164,3,64
2012-04-08,summer,2012,April,2,Sunday,Holiday,Clear,0.44,0.4394,0.24,0.2239,7,25,32,32,267,32,3,1,2,312,1,715,16352,3,32
2012-04-08,summer,2012,April,3,Sunday,Holiday,Clear,0.42,0.4242,0.26,0.1343,8,18,26,26,267,26,3,1,2,312,1,697,8174,3,26
2012-04-08,summer,2012,April,4,Sunday,Holiday,Clear,0.4,0.4091,0.4,0.0,0,7,7,7,267,7,3,1,2,312,1,697,4428,3,7
2012-04-08,summer,2012,April,5,Sunday,Holiday,Clear,0.38,0.3939,0.46,0.0,4,8,12,12,267,12,3,1,2,312,1,717,14261,3,12
2012-04-08,summer,2012,April,6,Sunday,Holiday,Clear,0.36,0.3788,0.37,0.0,7,21,28,28,267,28,3,1,2,312,1,725,55132,3,28
2012-04-08,summer,2012,April,7,Sunday,Holiday,Clear,0.38,0.3939,0.27,0.1642,12,25,37,37,267,37,3,1,2,312,1,727,154171,3,37
2012-04-08,summer,2012,April,8,Sunday,Holiday,Clear,0.4,0.4091,0.3,0.194,19,65,84,84,267,84,3,2,2,322,1,727,261001,3,84
2012-04-08,summer,2012,April,9,Sunday,Holiday,Clear,0.44,0.4394,0.26,0.2239,71,108,179,179,267,179,3,3,2,332,1,727,159438,3,179
2012-04-08,summer,2012,April,10,Sunday,Holiday,Clear,0.5,0.4848,0.25,0.2239,113,186,299,299,267,299,3,4,2,342,2,727,126257,3,299
2012-04-08,summer,2012,April,11,Sunday,Holiday,Clear,0.5,0.4848,0.25,0.2836,195,209,404,404,267,404,3,4,2,342,2,727,151320,3,404
2012-04-08,summer,2012,April,12,Sunday,Holiday,Clear,0.54,0.5152,0.24,0.2537,198,259,457,457,267,457,3,4,3,343,2,728,184414,3,457
2012-04-08,summer,2012,April,13,Sunday,Holiday,Clear,0.58,0.5455,0.23,0.1642,229,254,483,483,267,483,3,4,3,343,2,729,184919,3,483
2012-04-08,summer,2012,April,14,Sunday,Holiday,Clear,0.6,0.5909,0.18,0.4478,254,249,503,503,267,503,3,4,3,343,2,729,175652,3,503
2012-04-08,summer,2012,April,15,Sunday,Holiday,Clear,0.62,0.6061,0.17,0.3582,260,226,486,486,267,486,3,4,3,343,2,729,183149,3,486
2012-04-08,summer,2012,April,16,Sunday,Holiday,Clear,0.64,0.6061,0.19,0.3284,232,244,476,476,267,476,3,4,3,343,2,730,227748,3,476
2012-04-08,summer,2012,April,17,Sunday,Holiday,Clear,0.62,0.6061,0.22,0.2985,185,226,411,411,267,411,3,4,3,343,2,730,336860,3,411
2012-04-08,summer,2012,April,18,Sunday,Holiday,Clear,0.62,0.6061,0.25,0.3284,151,159,310,310,267,310,3,4,3,343,2,728,309772,3,310
2012-04-08,summer,2012,April,19,Sunday,Holiday,Clear,0.6,0.6061,0.23,0.3881,89,187,276,276,267,276,3,3,3,333,2,728,226789,3,276
2012-04-08,summer,2012,April,20,Sunday,Holiday,Clear,0.56,0.5303,0.28,0.4179,65,146,211,211,267,211,3,3,3,333,2,728,164550,3,211
2012-04-08,summer,2012,April,21,Sunday,Holiday,Clear,0.52,0.5,0.34,0.2239,53,77,130,130,267,130,3,2,3,323,2,728,125445,3,130
2012-04-08,summer,2012,April,22,Sunday,Holiday,Clear,0.5,0.4848,0.36,0.2239,33,85,118,118,267,118,3,2,2,322,1,728,95612,3,118
2012-04-08,summer,2012,April,23,Sunday,Holiday,Clear,0.5,0.4848,0.39,0.2537,10,41,51,51,267,51,3,2,2,322,1,728,63941,3,51
2012-04-09,summer,2012,April,0,Monday,Workingday,Clear,0.48,0.4697,0.39,0.2836,8,29,37,37,266,37,3,1,2,312,1,726,39130,3,37
2012-04-09,summer,2012,April,1,Monday,Workingday,Clear,0.46,0.4545,0.41,0.1343,4,12,16,16,266,16,3,1,2,312,1,724,24164,3,16
2012-04-09,summer,2012,April,2,Monday,Workingday,Clear,0.46,0.4545,0.31,0.194,2,4,6,6,266,6,3,1,2,312,1,715,16352,3,6
2012-04-09,summer,2012,April,3,Monday,Workingday,Clear,0.44,0.4394,0.3,0.1642,0,3,3,3,266,3,3,1,2,312,1,697,8174,3,3
2012-04-09,summer,2012,April,4,Monday,Workingday,Clear,0.44,0.4394,0.24,0.194,2,3,5,5,266,5,3,1,2,312,1,697,4428,3,5
2012-04-09,summer,2012,April,5,Monday,Workingday,Clear,0.44,0.4394,0.24,0.194,2,30,32,32,266,32,3,1,2,312,1,717,14261,3,32
2012-04-09,summer,2012,April,6,Monday,Workingday,Clear,0.42,0.4242,0.26,0.2239,3,108,111,111,266,111,3,2,2,322,1,725,55132,3,111
2012-04-09,summer,2012,April,7,Monday,Workingday,Clear,0.42,0.4242,0.28,0.194,11,320,331,331,266,331,3,4,2,342,1,727,154171,3,331
2012-04-09,summer,2012,April,8,Monday,Workingday,Clear,0.44,0.4394,0.3,0.194,22,595,617,617,266,617,3,4,2,342,2,727,261001,3,617
2012-04-09,summer,2012,April,9,Monday,Workingday,Clear,0.46,0.4545,0.31,0.3582,50,236,286,286,266,286,3,4,2,342,2,727,159438,3,286
2012-04-09,summer,2012,April,10,Monday,Workingday,Clear,0.5,0.4848,0.27,0.4925,65,113,178,178,266,178,3,3,2,332,2,727,126257,3,178
2012-04-09,summer,2012,April,11,Monday,Workingday,Clear,0.52,0.5,0.27,0.4179,96,127,223,223,266,223,3,3,3,333,2,727,151320,3,223
2012-04-09,summer,2012,April,12,Monday,Workingday,Clear,0.54,0.5152,0.28,0.7164,94,186,280,280,266,280,3,3,3,333,2,728,184414,3,280
2012-04-09,summer,2012,April,13,Monday,Workingday,Clear,0.54,0.5152,0.28,0.5821,108,173,281,281,266,281,3,3,3,333,2,729,184919,3,281
2012-04-09,summer,2012,April,14,Monday,Workingday,Clear,0.56,0.5303,0.28,0.5522,66,152,218,218,266,218,3,3,3,333,2,729,175652,3,218
2012-04-09,summer,2012,April,15,Monday,Workingday,Clear,0.58,0.5455,0.28,0.5522,82,173,255,255,266,255,3,3,3,333,2,729,183149,3,255
2012-04-09,summer,2012,April,16,Monday,Workingday,Clear,0.56,0.5303,0.3,0.4179,81,310,391,391,266,391,3,4,3,343,2,730,227748,3,391
2012-04-09,summer,2012,April,17,Monday,Workingday,Clear,0.54,0.5152,0.32,0.4179,67,565,632,632,266,632,3,4,3,343,2,730,336860,3,632
2012-04-09,summer,2012,April,18,Monday,Workingday,Clear,0.54,0.5152,0.34,0.2985,60,586,646,646,266,646,3,4,3,343,2,728,309772,3,646
2012-04-09,summer,2012,April,19,Monday,Workingday,Clear,0.52,0.5,0.34,0.3582,35,386,421,421,266,421,3,4,3,343,2,728,226789,3,421
2012-04-09,summer,2012,April,20,Monday,Workingday,Clear,0.5,0.4848,0.36,0.4478,21,255,276,276,266,276,3,3,2,332,2,728,164550,3,276
2012-04-09,summer,2012,April,21,Monday,Workingday,Light Snow,0.48,0.4697,0.41,0.4179,14,151,165,165,266,165,3,3,2,332,1,728,125445,3,165
2012-04-09,summer,2012,April,22,Monday,Workingday,Mist,0.46,0.4545,0.41,0.4925,6,102,108,108,266,108,3,2,2,322,1,728,95612,3,108
2012-04-09,summer,2012,April,23,Monday,Workingday,Clear,0.44,0.4394,0.44,0.2985,6,61,67,67,266,67,3,2,2,322,1,728,63941,3,67
2012-04-10,summer,2012,April,0,Tuesday,Workingday,Mist,0.44,0.4394,0.47,0.2836,3,23,26,26,265,26,3,1,2,312,1,726,39130,3,26
2012-04-10,summer,2012,April,1,Tuesday,Workingday,Clear,0.42,0.4242,0.5,0.2239,0,9,9,9,265,9,3,1,2,312,1,724,24164,3,9
2012-04-10,summer,2012,April,2,Tuesday,Workingday,Clear,0.36,0.3485,0.71,0.1343,0,2,2,2,265,2,3,1,2,312,1,715,16352,3,2
2012-04-10,summer,2012,April,3,Tuesday,Workingday,Clear,0.36,0.3485,0.71,0.1343,0,2,2,2,265,2,3,1,2,312,1,697,8174,3,2
2012-04-10,summer,2012,April,4,Tuesday,Workingday,Clear,0.34,0.3333,0.71,0.1343,0,2,2,2,265,2,3,1,1,311,1,697,4428,3,2
2012-04-10,summer,2012,April,5,Tuesday,Workingday,Clear,0.34,0.3333,0.71,0.1343,0,24,24,24,265,24,3,1,1,311,1,717,14261,3,24
2012-04-10,summer,2012,April,6,Tuesday,Workingday,Clear,0.34,0.3485,0.71,0.1045,3,100,103,103,265,103,3,2,2,322,1,725,55132,3,103
2012-04-10,summer,2012,April,7,Tuesday,Workingday,Clear,0.34,0.3485,0.71,0.1045,16,368,384,384,265,384,3,4,2,342,1,727,154171,3,384
2012-04-10,summer,2012,April,8,Tuesday,Workingday,Clear,0.38,0.3939,0.62,0.1343,22,670,692,692,265,692,3,4,2,342,2,727,261001,3,692
2012-04-10,summer,2012,April,9,Tuesday,Workingday,Clear,0.42,0.4242,0.67,0.194,16,303,319,319,265,319,3,4,2,342,1,727,159438,3,319
2012-04-10,summer,2012,April,10,Tuesday,Workingday,Clear,0.46,0.4545,0.47,0.1642,49,132,181,181,265,181,3,3,2,332,1,727,126257,3,181
2012-04-10,summer,2012,April,11,Tuesday,Workingday,Clear,0.5,0.4848,0.36,0.0,78,161,239,239,265,239,3,3,2,332,2,727,151320,3,239
2012-04-10,summer,2012,April,12,Tuesday,Workingday,Clear,0.54,0.5152,0.22,0.2836,75,184,259,259,265,259,3,3,3,333,2,728,184414,3,259
2012-04-10,summer,2012,April,13,Tuesday,Workingday,Clear,0.52,0.5,0.23,0.1642,81,202,283,283,265,283,3,4,3,343,2,729,184919,3,283
2012-04-10,summer,2012,April,14,Tuesday,Workingday,Clear,0.54,0.5152,0.24,0.194,75,149,224,224,265,224,3,3,3,333,2,729,175652,3,224
2012-04-10,summer,2012,April,15,Tuesday,Workingday,Clear,0.56,0.5303,0.21,0.2985,46,157,203,203,265,203,3,3,3,333,2,729,183149,3,203
2012-04-10,summer,2012,April,16,Tuesday,Workingday,Clear,0.58,0.5455,0.21,0.2537,66,296,362,362,265,362,3,4,3,343,2,730,227748,3,362
2012-04-10,summer,2012,April,17,Tuesday,Workingday,Clear,0.56,0.5303,0.21,0.5224,88,656,744,744,265,744,3,4,3,343,2,730,336860,3,744
2012-04-10,summer,2012,April,18,Tuesday,Workingday,Clear,0.54,0.5152,0.22,0.4179,78,626,704,704,265,704,3,4,3,343,2,728,309772,3,704
2012-04-10,summer,2012,April,19,Tuesday,Workingday,Clear,0.52,0.5,0.2,0.3582,51,428,479,479,265,479,3,4,3,343,2,728,226789,3,479
2012-04-10,summer,2012,April,20,Tuesday,Workingday,Clear,0.46,0.4545,0.28,0.3881,34,248,282,282,265,282,3,4,2,342,2,728,164550,3,282
2012-04-10,summer,2012,April,21,Tuesday,Workingday,Clear,0.44,0.4394,0.3,0.4478,15,191,206,206,265,206,3,3,2,332,1,728,125445,3,206
2012-04-10,summer,2012,April,22,Tuesday,Workingday,Clear,0.4,0.4091,0.37,0.4925,9,118,127,127,265,127,3,2,2,322,1,728,95612,3,127
2012-04-10,summer,2012,April,23,Tuesday,Workingday,Clear,0.36,0.3333,0.4,0.4179,14,48,62,62,265,62,3,2,1,321,1,728,63941,3,62
2012-04-11,summer,2012,April,0,Wednesday,Workingday,Clear,0.34,0.303,0.36,0.4179,8,22,30,30,264,30,3,1,1,311,1,726,39130,3,30
2012-04-11,summer,2012,April,1,Wednesday,Workingday,Clear,0.34,0.3182,0.39,0.2836,3,9,12,12,264,12,3,1,1,311,1,724,24164,3,12
2012-04-11,summer,2012,April,2,Wednesday,Workingday,Clear,0.32,0.303,0.45,0.2836,0,2,2,2,264,2,3,1,1,311,1,715,16352,3,2
2012-04-11,summer,2012,April,3,Wednesday,Workingday,Clear,0.3,0.2879,0.49,0.2239,0,2,2,2,264,2,3,1,1,311,1,697,8174,3,2
2012-04-11,summer,2012,April,5,Wednesday,Workingday,Clear,0.28,0.2727,0.56,0.194,1,26,27,27,264,27,3,1,1,311,1,717,14261,3,27
2012-04-11,summer,2012,April,6,Wednesday,Workingday,Clear,0.28,0.2879,0.56,0.1045,3,103,106,106,264,106,3,2,1,321,1,725,55132,3,106
2012-04-11,summer,2012,April,7,Wednesday,Workingday,Clear,0.28,0.2879,0.52,0.1343,18,303,321,321,264,321,3,4,1,341,1,727,154171,3,321
2012-04-11,summer,2012,April,8,Wednesday,Workingday,Clear,0.3,0.2879,0.49,0.2239,14,581,595,595,264,595,3,4,1,341,1,727,261001,3,595
2012-04-11,summer,2012,April,9,Wednesday,Workingday,Mist,0.32,0.303,0.49,0.2985,20,282,302,302,264,302,3,4,1,341,1,727,159438,3,302
2012-04-11,summer,2012,April,10,Wednesday,Workingday,Mist,0.34,0.303,0.49,0.3284,26,127,153,153,264,153,3,3,1,331,1,727,126257,3,153
2012-04-11,summer,2012,April,11,Wednesday,Workingday,Mist,0.38,0.3939,0.43,0.3284,38,142,180,180,264,180,3,3,2,332,1,727,151320,3,180
2012-04-11,summer,2012,April,12,Wednesday,Workingday,Mist,0.36,0.3333,0.46,0.3881,35,147,182,182,264,182,3,3,1,331,1,728,184414,3,182
2012-04-11,summer,2012,April,13,Wednesday,Workingday,Mist,0.4,0.4091,0.4,0.3582,16,147,163,163,264,163,3,3,2,332,1,729,184919,3,163
2012-04-11,summer,2012,April,14,Wednesday,Workingday,Clear,0.36,0.3485,0.57,0.194,34,101,135,135,264,135,3,2,2,322,1,729,175652,3,135
2012-04-11,summer,2012,April,15,Wednesday,Workingday,Light Snow,0.38,0.3939,0.46,0.2239,50,152,202,202,264,202,3,3,2,332,1,729,183149,3,202
2012-04-11,summer,2012,April,16,Wednesday,Workingday,Clear,0.44,0.4394,0.33,0.2985,51,256,307,307,264,307,3,4,2,342,2,730,227748,3,307
2012-04-11,summer,2012,April,17,Wednesday,Workingday,Clear,0.42,0.4242,0.35,0.3881,52,527,579,579,264,579,3,4,2,342,2,730,336860,3,579
2012-04-11,summer,2012,April,18,Wednesday,Workingday,Light Snow,0.4,0.4091,0.43,0.4179,39,546,585,585,264,585,3,4,2,342,2,728,309772,3,585
2012-04-11,summer,2012,April,19,Wednesday,Workingday,Clear,0.4,0.4091,0.4,0.3582,28,356,384,384,264,384,3,4,2,342,1,728,226789,3,384
2012-04-11,summer,2012,April,20,Wednesday,Workingday,Clear,0.36,0.3333,0.46,0.3284,22,213,235,235,264,235,3,3,1,331,1,728,164550,3,235
2012-04-11,summer,2012,April,21,Wednesday,Workingday,Clear,0.34,0.303,0.57,0.3881,11,154,165,165,264,165,3,3,1,331,1,728,125445,3,165
2012-04-11,summer,2012,April,22,Wednesday,Workingday,Clear,0.34,0.303,0.57,0.3284,4,130,134,134,264,134,3,2,1,321,1,728,95612,3,134
2012-04-11,summer,2012,April,23,Wednesday,Workingday,Clear,0.34,0.303,0.57,0.2985,9,52,61,61,264,61,3,2,1,321,1,728,63941,3,61
2012-04-12,summer,2012,April,0,Thursday,Workingday,Clear,0.32,0.303,0.66,0.2836,1,22,23,23,263,23,3,1,1,311,1,726,39130,3,23
2012-04-12,summer,2012,April,1,Thursday,Workingday,Clear,0.32,0.303,0.66,0.2239,2,7,9,9,263,9,3,1,1,311,1,724,24164,3,9
2012-04-12,summer,2012,April,2,Thursday,Workingday,Clear,0.32,0.303,0.61,0.2836,0,4,4,4,263,4,3,1,1,311,1,715,16352,3,4
2012-04-12,summer,2012,April,3,Thursday,Workingday,Clear,0.32,0.303,0.61,0.2537,2,3,5,5,263,5,3,1,1,311,1,697,8174,3,5
2012-04-12,summer,2012,April,4,Thursday,Workingday,Clear,0.3,0.2879,0.61,0.2239,0,1,1,1,263,1,3,1,1,311,1,697,4428,3,1
2012-04-12,summer,2012,April,5,Thursday,Workingday,Clear,0.3,0.2879,0.61,0.2239,0,21,21,21,263,21,3,1,1,311,1,717,14261,3,21
2012-04-12,summer,2012,April,6,Thursday,Workingday,Clear,0.3,0.2879,0.65,0.2537,2,94,96,96,263,96,3,2,1,321,1,725,55132,3,96
2012-04-12,summer,2012,April,7,Thursday,Workingday,Clear,0.3,0.2727,0.65,0.3284,12,294,306,306,263,306,3,4,1,341,1,727,154171,3,306
2012-04-12,summer,2012,April,8,Thursday,Workingday,Clear,0.32,0.303,0.66,0.3284,20,604,624,624,263,624,3,4,1,341,1,727,261001,3,624
2012-04-12,summer,2012,April,9,Thursday,Workingday,Clear,0.36,0.3333,0.57,0.3582,16,271,287,287,263,287,3,4,1,341,1,727,159438,3,287
2012-04-12,summer,2012,April,10,Thursday,Workingday,Clear,0.4,0.4091,0.5,0.2985,38,103,141,141,263,141,3,2,2,322,1,727,126257,3,141
2012-04-12,summer,2012,April,11,Thursday,Workingday,Clear,0.42,0.4242,0.47,0.2985,50,174,224,224,263,224,3,3,2,332,1,727,151320,3,224
2012-04-12,summer,2012,April,12,Thursday,Workingday,Clear,0.46,0.4545,0.41,0.4478,60,199,259,259,263,259,3,3,2,332,2,728,184414,3,259
2012-04-12,summer,2012,April,13,Thursday,Workingday,Clear,0.48,0.4697,0.36,0.4478,55,148,203,203,263,203,3,3,2,332,2,729,184919,3,203
2012-04-12,summer,2012,April,14,Thursday,Workingday,Clear,0.5,0.4848,0.31,0.3284,74,150,224,224,263,224,3,3,2,332,2,729,175652,3,224
2012-04-12,summer,2012,April,15,Thursday,Workingday,Clear,0.48,0.4697,0.31,0.2537,42,169,211,211,263,211,3,3,2,332,1,729,183149,3,211
2012-04-12,summer,2012,April,16,Thursday,Workingday,Clear,0.48,0.4697,0.31,0.2836,54,299,353,353,263,353,3,4,2,342,2,730,227748,3,353
2012-04-12,summer,2012,April,17,Thursday,Workingday,Clear,0.5,0.4848,0.27,0.3881,60,596,656,656,263,656,3,4,2,342,2,730,336860,3,656
2012-04-12,summer,2012,April,18,Thursday,Workingday,Clear,0.5,0.4848,0.27,0.3881,63,547,610,610,263,610,3,4,2,342,2,728,309772,3,610
2012-04-12,summer,2012,April,19,Thursday,Workingday,Clear,0.46,0.4545,0.31,0.2985,50,383,433,433,263,433,3,4,2,342,2,728,226789,3,433
2012-04-12,summer,2012,April,20,Thursday,Workingday,Clear,0.44,0.4394,0.33,0.2537,26,254,280,280,263,280,3,3,2,332,1,728,164550,3,280
2012-04-12,summer,2012,April,21,Thursday,Workingday,Clear,0.42,0.4242,0.35,0.1343,13,174,187,187,263,187,3,3,2,332,1,728,125445,3,187
2012-04-12,summer,2012,April,22,Thursday,Workingday,Clear,0.42,0.4242,0.35,0.194,15,143,158,158,263,158,3,3,2,332,1,728,95612,3,158
2012-04-12,summer,2012,April,23,Thursday,Workingday,Clear,0.42,0.4242,0.35,0.194,8,86,94,94,263,94,3,2,2,322,1,728,63941,3,94
2012-04-13,summer,2012,April,0,Friday,Workingday,Clear,0.4,0.4091,0.37,0.2537,14,41,55,55,262,55,3,2,2,322,1,726,39130,3,55
2012-04-13,summer,2012,April,1,Friday,Workingday,Clear,0.36,0.3485,0.46,0.194,2,28,30,30,262,30,3,1,2,312,1,724,24164,3,30
2012-04-13,summer,2012,April,2,Friday,Workingday,Clear,0.34,0.3333,0.49,0.194,6,5,11,11,262,11,3,1,1,311,1,715,16352,3,11
2012-04-13,summer,2012,April,3,Friday,Workingday,Clear,0.34,0.3333,0.61,0.1642,3,8,11,11,262,11,3,1,1,311,1,697,8174,3,11
2012-04-13,summer,2012,April,4,Friday,Workingday,Mist,0.34,0.3333,0.53,0.1343,1,4,5,5,262,5,3,1,1,311,1,697,4428,3,5
2012-04-13,summer,2012,April,5,Friday,Workingday,Mist,0.34,0.3333,0.53,0.1642,2,19,21,21,262,21,3,1,1,311,1,717,14261,3,21
2012-04-13,summer,2012,April,6,Friday,Workingday,Clear,0.32,0.3182,0.57,0.1642,0,84,84,84,262,84,3,2,1,321,1,725,55132,3,84
2012-04-13,summer,2012,April,7,Friday,Workingday,Clear,0.34,0.3182,0.61,0.2239,13,283,296,296,262,296,3,4,1,341,1,727,154171,3,296
2012-04-13,summer,2012,April,8,Friday,Workingday,Clear,0.38,0.3939,0.46,0.1642,24,539,563,563,262,563,3,4,2,342,2,727,261001,3,563
2012-04-13,summer,2012,April,9,Friday,Workingday,Clear,0.42,0.4242,0.41,0.1642,36,294,330,330,262,330,3,4,2,342,1,727,159438,3,330
2012-04-13,summer,2012,April,10,Friday,Workingday,Clear,0.44,0.4394,0.38,0.194,59,133,192,192,262,192,3,3,2,332,1,727,126257,3,192
2012-04-13,summer,2012,April,11,Friday,Workingday,Clear,0.46,0.4545,0.36,0.1343,75,158,233,233,262,233,3,3,2,332,2,727,151320,3,233
2012-04-13,summer,2012,April,12,Friday,Workingday,Clear,0.5,0.4848,0.31,0.0,104,218,322,322,262,322,3,4,2,342,2,728,184414,3,322
2012-04-13,summer,2012,April,13,Friday,Workingday,Clear,0.52,0.5,0.27,0.2836,112,246,358,358,262,358,3,4,3,343,2,729,184919,3,358
2012-04-13,summer,2012,April,14,Friday,Workingday,Clear,0.52,0.5,0.27,0.0,125,223,348,348,262,348,3,4,3,343,2,729,175652,3,348
2012-04-13,summer,2012,April,15,Friday,Workingday,Clear,0.54,0.5152,0.28,0.2537,115,237,352,352,262,352,3,4,3,343,2,729,183149,3,352
2012-04-13,summer,2012,April,16,Friday,Workingday,Clear,0.56,0.5303,0.26,0.2537,113,350,463,463,262,463,3,4,3,343,2,730,227748,3,463
2012-04-13,summer,2012,April,17,Friday,Workingday,Clear,0.56,0.5303,0.24,0.1642,117,621,738,738,262,738,3,4,3,343,2,730,336860,3,738
2012-04-13,summer,2012,April,18,Friday,Workingday,Clear,0.54,0.5152,0.26,0.1343,107,564,671,671,262,671,3,4,3,343,2,728,309772,3,671
2012-04-13,summer,2012,April,19,Friday,Workingday,Clear,0.54,0.5152,0.24,0.1642,75,352,427,427,262,427,3,4,3,343,2,728,226789,3,427
2012-04-13,summer,2012,April,20,Friday,Workingday,Clear,0.5,0.4848,0.29,0.1343,44,242,286,286,262,286,3,4,2,342,2,728,164550,3,286
2012-04-13,summer,2012,April,21,Friday,Workingday,Clear,0.5,0.4848,0.36,0.0,36,153,189,189,262,189,3,3,2,332,0,728,125445,3,189
2012-04-13,summer,2012,April,22,Friday,Workingday,Clear,0.44,0.4394,0.62,0.1045,34,181,215,215,262,215,3,3,2,332,0,728,95612,3,215
2012-04-13,summer,2012,April,23,Friday,Workingday,Clear,0.42,0.4242,0.62,0.0896,35,163,198,198,262,198,3,3,2,332,0,728,63941,3,198
2012-04-14,summer,2012,April,0,Saturday,Holiday,Clear,0.4,0.4091,0.58,0.1343,11,85,96,96,261,96,3,2,2,322,1,726,39130,3,96
2012-04-14,summer,2012,April,1,Saturday,Holiday,Clear,0.4,0.4091,0.58,0.1343,10,60,70,70,261,70,3,2,2,322,1,724,24164,3,70
2012-04-14,summer,2012,April,2,Saturday,Holiday,Clear,0.38,0.3939,0.66,0.1343,3,53,56,56,261,56,3,2,2,322,1,715,16352,3,56
2012-04-14,summer,2012,April,3,Saturday,Holiday,Clear,0.36,0.3636,0.66,0.0896,6,26,32,32,261,32,3,1,2,312,1,697,8174,3,32
2012-04-14,summer,2012,April,4,Saturday,Holiday,Clear,0.36,0.3636,0.71,0.1045,5,9,14,14,261,14,3,1,2,312,1,697,4428,3,14
2012-04-14,summer,2012,April,5,Saturday,Holiday,Clear,0.36,0.3636,0.66,0.1045,2,5,7,7,261,7,3,1,2,312,1,717,14261,3,7
2012-04-14,summer,2012,April,6,Saturday,Holiday,Clear,0.34,0.3333,0.76,0.1642,2,19,21,21,261,21,3,1,1,311,1,725,55132,3,21
2012-04-14,summer,2012,April,7,Saturday,Holiday,Clear,0.36,0.3636,0.71,0.1045,8,56,64,64,261,64,3,2,2,322,1,727,154171,3,64
2012-04-14,summer,2012,April,8,Saturday,Holiday,Clear,0.36,0.3485,0.71,0.1343,24,136,160,160,261,160,3,3,2,332,1,727,261001,3,160
2012-04-14,summer,2012,April,9,Saturday,Holiday,Clear,0.42,0.4242,0.54,0.1343,59,206,265,265,261,265,3,3,2,332,1,727,159438,3,265
2012-04-14,summer,2012,April,10,Saturday,Holiday,Clear,0.46,0.4545,0.51,0.1642,139,267,406,406,261,406,3,4,2,342,2,727,126257,3,406
2012-04-14,summer,2012,April,11,Saturday,Holiday,Clear,0.52,0.5,0.45,0.194,207,357,564,564,261,564,3,4,3,343,2,727,151320,3,564
2012-04-14,summer,2012,April,12,Saturday,Holiday,Clear,0.58,0.5455,0.35,0.2537,274,404,678,678,261,678,3,4,3,343,2,728,184414,3,678
2012-04-14,summer,2012,April,13,Saturday,Holiday,Clear,0.62,0.6212,0.33,0.2985,308,370,678,678,261,678,3,4,3,343,2,729,184919,3,678
2012-04-14,summer,2012,April,14,Saturday,Holiday,Mist,0.64,0.6212,0.27,0.4478,288,372,660,660,261,660,3,4,3,343,2,729,175652,3,660
2012-04-14,summer,2012,April,15,Saturday,Holiday,Mist,0.64,0.6212,0.27,0.3582,311,347,658,658,261,658,3,4,3,343,2,729,183149,3,658
2012-04-14,summer,2012,April,16,Saturday,Holiday,Mist,0.64,0.6212,0.27,0.3582,253,329,582,582,261,582,3,4,3,343,2,730,227748,3,582
2012-04-14,summer,2012,April,17,Saturday,Holiday,Mist,0.62,0.6212,0.33,0.2537,251,309,560,560,261,560,3,4,3,343,2,730,336860,3,560
2012-04-14,summer,2012,April,18,Saturday,Holiday,Mist,0.62,0.6212,0.35,0.2239,197,284,481,481,261,481,3,4,3,343,2,728,309772,3,481
2012-04-14,summer,2012,April,19,Saturday,Holiday,Mist,0.6,0.6212,0.4,0.1642,163,296,459,459,261,459,3,4,3,343,2,728,226789,3,459
2012-04-14,summer,2012,April,20,Saturday,Holiday,Mist,0.56,0.5303,0.46,0.1343,112,209,321,321,261,321,3,4,3,343,2,728,164550,3,321
2012-04-14,summer,2012,April,21,Saturday,Holiday,Mist,0.56,0.5303,0.43,0.1343,53,167,220,220,261,220,3,3,3,333,2,728,125445,3,220
2012-04-14,summer,2012,April,22,Saturday,Holiday,Mist,0.54,0.5152,0.52,0.1642,64,148,212,212,261,212,3,3,3,333,2,728,95612,3,212
2012-04-14,summer,2012,April,23,Saturday,Holiday,Mist,0.54,0.5152,0.56,0.194,45,151,196,196,261,196,3,3,3,333,0,728,63941,3,196
2012-04-15,summer,2012,April,0,Sunday,Holiday,Mist,0.54,0.5152,0.56,0.194,30,94,124,124,260,124,3,2,3,323,0,726,39130,3,124
2012-04-15,summer,2012,April,1,Sunday,Holiday,Mist,0.54,0.5152,0.56,0.1642,17,89,106,106,260,106,3,2,3,323,0,724,24164,3,106
2012-04-15,summer,2012,April,2,Sunday,Holiday,Mist,0.54,0.5152,0.56,0.1045,20,54,74,74,260,74,3,2,3,323,0,715,16352,3,74
2012-04-15,summer,2012,April,3,Sunday,Holiday,Mist,0.52,0.5,0.59,0.1343,18,27,45,45,260,45,3,2,3,323,0,697,8174,3,45
2012-04-15,summer,2012,April,4,Sunday,Holiday,Mist,0.54,0.5152,0.52,0.0,2,10,12,12,260,12,3,1,3,313,0,697,4428,3,12
2012-04-15,summer,2012,April,5,Sunday,Holiday,Clear,0.5,0.4848,0.68,0.1642,4,6,10,10,260,10,3,1,2,312,0,717,14261,3,10
2012-04-15,summer,2012,April,6,Sunday,Holiday,Clear,0.5,0.4848,0.63,0.1343,5,11,16,16,260,16,3,1,2,312,0,725,55132,3,16
2012-04-15,summer,2012,April,7,Sunday,Holiday,Clear,0.5,0.4848,0.63,0.1045,16,30,46,46,260,46,3,2,2,322,0,727,154171,3,46
2012-04-15,summer,2012,April,8,Sunday,Holiday,Clear,0.52,0.5,0.59,0.0,33,64,97,97,260,97,3,2,3,323,0,727,261001,3,97
2012-04-15,summer,2012,April,9,Sunday,Holiday,Clear,0.54,0.5152,0.56,0.2239,97,154,251,251,260,251,3,3,3,333,2,727,159438,3,251
2012-04-15,summer,2012,April,10,Sunday,Holiday,Clear,0.58,0.5455,0.53,0.2239,186,235,421,421,260,421,3,4,3,343,2,727,126257,3,421
2012-04-15,summer,2012,April,11,Sunday,Holiday,Clear,0.62,0.6212,0.46,0.2985,227,301,528,528,260,528,3,4,3,343,2,727,151320,3,528
2012-04-15,summer,2012,April,12,Sunday,Holiday,Clear,0.64,0.6212,0.44,0.2836,275,360,635,635,260,635,3,4,3,343,2,728,184414,3,635
2012-04-15,summer,2012,April,13,Sunday,Holiday,Clear,0.66,0.6212,0.44,0.2836,298,383,681,681,260,681,3,4,3,343,2,729,184919,3,681
2012-04-15,summer,2012,April,14,Sunday,Holiday,Clear,0.7,0.6364,0.39,0.2836,282,346,628,628,260,628,3,4,4,344,2,729,175652,3,628
2012-04-15,summer,2012,April,15,Sunday,Holiday,Clear,0.7,0.6364,0.39,0.3881,266,351,617,617,260,617,3,4,4,344,2,729,183149,3,617
2012-04-15,summer,2012,April,16,Sunday,Holiday,Clear,0.72,0.6515,0.39,0.3582,286,330,616,616,260,616,3,4,4,344,2,730,227748,3,616
2012-04-15,summer,2012,April,17,Sunday,Holiday,Clear,0.7,0.6364,0.42,0.3284,262,361,623,623,260,623,3,4,4,344,2,730,336860,3,623
2012-04-15,summer,2012,April,18,Sunday,Holiday,Clear,0.7,0.6364,0.42,0.2537,184,295,479,479,260,479,3,4,4,344,2,728,309772,3,479
2012-04-15,summer,2012,April,19,Sunday,Holiday,Clear,0.7,0.6364,0.42,0.2537,114,265,379,379,260,379,3,4,4,344,2,728,226789,3,379
2012-04-15,summer,2012,April,20,Sunday,Holiday,Clear,0.64,0.6212,0.5,0.2239,86,205,291,291,260,291,3,4,3,343,2,728,164550,3,291
2012-04-15,summer,2012,April,21,Sunday,Holiday,Clear,0.62,0.6212,0.57,0.2537,76,153,229,229,260,229,3,3,3,333,2,728,125445,3,229
2012-04-15,summer,2012,April,22,Sunday,Holiday,Clear,0.68,0.6364,0.44,0.3582,37,97,134,134,260,134,3,2,4,324,2,728,95612,3,134
2012-04-15,summer,2012,April,23,Sunday,Holiday,Clear,0.66,0.6212,0.5,0.3881,25,65,90,90,260,90,3,2,3,323,2,728,63941,3,90
2012-04-16,summer,2012,April,0,Monday,Holiday,Clear,0.64,0.6212,0.53,0.3284,15,26,41,41,259,41,3,2,3,323,0,726,39130,3,41
2012-04-16,summer,2012,April,1,Monday,Holiday,Clear,0.62,0.6061,0.61,0.3582,7,21,28,28,259,28,3,1,3,313,0,724,24164,3,28
2012-04-16,summer,2012,April,2,Monday,Holiday,Clear,0.6,0.6061,0.64,0.2537,5,9,14,14,259,14,3,1,3,313,0,715,16352,3,14
2012-04-16,summer,2012,April,3,Monday,Holiday,Clear,0.58,0.5455,0.68,0.194,3,5,8,8,259,8,3,1,3,313,0,697,8174,3,8
2012-04-16,summer,2012,April,4,Monday,Holiday,Clear,0.54,0.5152,0.77,0.2239,0,6,6,6,259,6,3,1,3,313,0,697,4428,3,6
2012-04-16,summer,2012,April,5,Monday,Holiday,Clear,0.54,0.5152,0.77,0.2239,4,34,38,38,259,38,3,1,3,313,0,717,14261,3,38
2012-04-16,summer,2012,April,6,Monday,Holiday,Clear,0.52,0.5,0.83,0.1642,10,123,133,133,259,133,3,2,3,323,0,725,55132,3,133
2012-04-16,summer,2012,April,7,Monday,Holiday,Clear,0.52,0.5,0.83,0.1343,20,367,387,387,259,387,3,4,3,343,0,727,154171,3,387
2012-04-16,summer,2012,April,8,Monday,Holiday,Mist,0.56,0.5303,0.83,0.1642,48,549,597,597,259,597,3,4,3,343,2,727,261001,3,597
2012-04-16,summer,2012,April,9,Monday,Holiday,Clear,0.62,0.6061,0.69,0.2239,59,238,297,297,259,297,3,4,3,343,2,727,159438,3,297
2012-04-16,summer,2012,April,10,Monday,Holiday,Clear,0.62,0.6061,0.69,0.2537,75,149,224,224,259,224,3,3,3,333,2,727,126257,3,224
2012-04-16,summer,2012,April,11,Monday,Holiday,Clear,0.64,0.6061,0.65,0.2537,115,136,251,251,259,251,3,3,3,333,2,727,151320,3,251
2012-04-16,summer,2012,April,12,Monday,Holiday,Clear,0.68,0.6364,0.57,0.2537,75,196,271,271,259,271,3,3,4,334,2,728,184414,3,271
2012-04-16,summer,2012,April,13,Monday,Holiday,Clear,0.74,0.6667,0.45,0.2985,79,184,263,263,259,263,3,3,4,334,2,729,184919,3,263
2012-04-16,summer,2012,April,14,Monday,Holiday,Clear,0.76,0.6818,0.45,0.3284,105,183,288,288,259,288,3,4,4,344,2,729,175652,3,288
2012-04-16,summer,2012,April,15,Monday,Holiday,Clear,0.8,0.697,0.33,0.4478,81,194,275,275,259,275,3,3,4,334,2,729,183149,3,275
2012-04-16,summer,2012,April,16,Monday,Holiday,Clear,0.8,0.697,0.33,0.4627,92,266,358,358,259,358,3,4,4,344,2,730,227748,3,358
2012-04-16,summer,2012,April,17,Monday,Holiday,Clear,0.8,0.697,0.33,0.3881,111,601,712,712,259,712,3,4,4,344,2,730,336860,3,712
2012-04-16,summer,2012,April,18,Monday,Holiday,Clear,0.8,0.697,0.31,0.3881,87,589,676,676,259,676,3,4,4,344,2,728,309772,3,676
2012-04-16,summer,2012,April,19,Monday,Holiday,Clear,0.76,0.6667,0.35,0.3881,61,461,522,522,259,522,3,4,4,344,2,728,226789,3,522
2012-04-16,summer,2012,April,20,Monday,Holiday,Clear,0.74,0.6515,0.37,0.2985,48,327,375,375,259,375,3,4,4,344,2,728,164550,3,375
2012-04-16,summer,2012,April,21,Monday,Holiday,Clear,0.68,0.6364,0.51,0.2537,39,232,271,271,259,271,3,3,4,334,2,728,125445,3,271
2012-04-16,summer,2012,April,22,Monday,Holiday,Clear,0.68,0.6364,0.51,0.2537,35,179,214,214,259,214,3,3,4,334,2,728,95612,3,214
2012-04-16,summer,2012,April,23,Monday,Holiday,Clear,0.7,0.6364,0.45,0.2985,24,97,121,121,259,121,3,2,4,324,2,728,63941,3,121
2012-04-17,summer,2012,April,0,Tuesday,Workingday,Clear,0.66,0.6212,0.54,0.194,10,33,43,43,258,43,3,2,3,323,0,726,39130,3,43
2012-04-17,summer,2012,April,1,Tuesday,Workingday,Clear,0.64,0.6212,0.57,0.1642,6,5,11,11,258,11,3,1,3,313,0,724,24164,3,11
2012-04-17,summer,2012,April,2,Tuesday,Workingday,Clear,0.56,0.5303,0.83,0.1045,1,3,4,4,258,4,3,1,3,313,0,715,16352,3,4
2012-04-17,summer,2012,April,3,Tuesday,Workingday,Clear,0.56,0.5303,0.83,0.0896,0,6,6,6,258,6,3,1,3,313,0,697,8174,3,6
2012-04-17,summer,2012,April,4,Tuesday,Workingday,Clear,0.66,0.6212,0.44,0.2239,3,6,9,9,258,9,3,1,3,313,0,697,4428,3,9
2012-04-17,summer,2012,April,5,Tuesday,Workingday,Clear,0.6,0.6212,0.53,0.2537,1,29,30,30,258,30,3,1,3,313,0,717,14261,3,30
2012-04-17,summer,2012,April,6,Tuesday,Workingday,Clear,0.6,0.6212,0.46,0.2537,8,136,144,144,258,144,3,3,3,333,0,725,55132,3,144
2012-04-17,summer,2012,April,7,Tuesday,Workingday,Clear,0.6,0.6212,0.43,0.2537,18,443,461,461,258,461,3,4,3,343,2,727,154171,3,461
2012-04-17,summer,2012,April,8,Tuesday,Workingday,Clear,0.6,0.6212,0.43,0.2239,42,631,673,673,258,673,3,4,3,343,2,727,261001,3,673
2012-04-17,summer,2012,April,9,Tuesday,Workingday,Clear,0.6,0.6212,0.38,0.4925,71,329,400,400,258,400,3,4,3,343,2,727,159438,3,400
2012-04-17,summer,2012,April,10,Tuesday,Workingday,Clear,0.6,0.6212,0.38,0.4179,52,165,217,217,258,217,3,3,3,333,2,727,126257,3,217
2012-04-17,summer,2012,April,11,Tuesday,Workingday,Clear,0.6,0.6212,0.33,0.4179,65,174,239,239,258,239,3,3,3,333,2,727,151320,3,239
2012-04-17,summer,2012,April,12,Tuesday,Workingday,Clear,0.6,0.6212,0.33,0.3582,65,179,244,244,258,244,3,3,3,333,2,728,184414,3,244
2012-04-17,summer,2012,April,13,Tuesday,Workingday,Clear,0.62,0.6212,0.29,0.2537,52,187,239,239,258,239,3,3,3,333,2,729,184919,3,239
2012-04-17,summer,2012,April,14,Tuesday,Workingday,Clear,0.64,0.6212,0.27,0.2836,59,198,257,257,258,257,3,3,3,333,2,729,175652,3,257
2012-04-17,summer,2012,April,15,Tuesday,Workingday,Clear,0.66,0.6212,0.24,0.3284,91,217,308,308,258,308,3,4,3,343,2,729,183149,3,308
2012-04-17,summer,2012,April,16,Tuesday,Workingday,Clear,0.68,0.6212,0.22,0.3582,50,320,370,370,258,370,3,4,3,343,2,730,227748,3,370
2012-04-17,summer,2012,April,17,Tuesday,Workingday,Clear,0.64,0.6061,0.25,0.2985,108,673,781,781,258,781,3,4,3,343,2,730,336860,3,781
2012-04-17,summer,2012,April,18,Tuesday,Workingday,Clear,0.64,0.6061,0.25,0.2836,105,670,775,775,258,775,3,4,3,343,2,728,309772,3,775
2012-04-17,summer,2012,April,19,Tuesday,Workingday,Clear,0.6,0.6061,0.26,0.2537,73,464,537,537,258,537,3,4,3,343,2,728,226789,3,537
2012-04-17,summer,2012,April,20,Tuesday,Workingday,Clear,0.6,0.6061,0.23,0.2836,44,358,402,402,258,402,3,4,3,343,2,728,164550,3,402
2012-04-17,summer,2012,April,21,Tuesday,Workingday,Clear,0.56,0.5303,0.26,0.2985,37,260,297,297,258,297,3,4,3,343,2,728,125445,3,297
2012-04-17,summer,2012,April,22,Tuesday,Workingday,Clear,0.54,0.5152,0.3,0.2537,18,144,162,162,258,162,3,3,3,333,2,728,95612,3,162
2012-04-17,summer,2012,April,23,Tuesday,Workingday,Clear,0.54,0.5152,0.32,0.2239,10,72,82,82,258,82,3,2,3,323,1,728,63941,3,82
2012-04-18,summer,2012,April,0,Wednesday,Workingday,Clear,0.54,0.5152,0.32,0.1642,3,35,38,38,257,38,3,1,3,313,1,726,39130,3,38
2012-04-18,summer,2012,April,1,Wednesday,Workingday,Clear,0.52,0.5,0.34,0.194,1,13,14,14,257,14,3,1,3,313,1,724,24164,3,14
2012-04-18,summer,2012,April,2,Wednesday,Workingday,Mist,0.5,0.4848,0.42,0.194,1,8,9,9,257,9,3,1,2,312,1,715,16352,3,9
2012-04-18,summer,2012,April,3,Wednesday,Workingday,Mist,0.5,0.4848,0.42,0.2239,0,6,6,6,257,6,3,1,2,312,1,697,8174,3,6
2012-04-18,summer,2012,April,4,Wednesday,Workingday,Mist,0.5,0.4848,0.42,0.2836,0,7,7,7,257,7,3,1,2,312,1,697,4428,3,7
2012-04-18,summer,2012,April,5,Wednesday,Workingday,Mist,0.5,0.4848,0.39,0.2836,0,34,34,34,257,34,3,1,2,312,1,717,14261,3,34
2012-04-18,summer,2012,April,6,Wednesday,Workingday,Mist,0.5,0.4848,0.39,0.2836,6,128,134,134,257,134,3,2,2,322,1,725,55132,3,134
2012-04-18,summer,2012,April,7,Wednesday,Workingday,Mist,0.5,0.4848,0.39,0.194,10,408,418,418,257,418,3,4,2,342,2,727,154171,3,418
2012-04-18,summer,2012,April,8,Wednesday,Workingday,Light Snow,0.5,0.4848,0.39,0.194,25,551,576,576,257,576,3,4,2,342,2,727,261001,3,576
2012-04-18,summer,2012,April,9,Wednesday,Workingday,Light Snow,0.48,0.4697,0.44,0.2985,20,245,265,265,257,265,3,3,2,332,1,727,159438,3,265
2012-04-18,summer,2012,April,10,Wednesday,Workingday,Light Snow,0.48,0.4697,0.47,0.2239,31,116,147,147,257,147,3,3,2,332,1,727,126257,3,147
2012-04-18,summer,2012,April,11,Wednesday,Workingday,Light Snow,0.46,0.4545,0.47,0.2537,14,105,119,119,257,119,3,2,2,322,1,727,151320,3,119
2012-04-18,summer,2012,April,12,Wednesday,Workingday,Light Snow,0.46,0.4545,0.51,0.1045,15,95,110,110,257,110,3,2,2,322,1,728,184414,3,110
2012-04-18,summer,2012,April,13,Wednesday,Workingday,Light Snow,0.46,0.4545,0.59,0.0,13,51,64,64,257,64,3,2,2,322,0,729,184919,3,64
2012-04-18,summer,2012,April,14,Wednesday,Workingday,Light Snow,0.44,0.4394,0.72,0.1045,8,43,51,51,257,51,3,2,2,322,0,729,175652,3,51
2012-04-18,summer,2012,April,15,Wednesday,Workingday,Light Snow,0.42,0.4242,0.77,0.194,10,88,98,98,257,98,3,2,2,322,0,729,183149,3,98
2012-04-18,summer,2012,April,16,Wednesday,Workingday,Mist,0.42,0.4242,0.77,0.2239,36,199,235,235,257,235,3,3,2,332,0,730,227748,3,235
2012-04-18,summer,2012,April,17,Wednesday,Workingday,Mist,0.42,0.4242,0.77,0.194,46,442,488,488,257,488,3,4,2,342,0,730,336860,3,488
2012-04-18,summer,2012,April,18,Wednesday,Workingday,Mist,0.42,0.4242,0.77,0.0,27,478,505,505,257,505,3,4,2,342,0,728,309772,3,505
2012-04-18,summer,2012,April,19,Wednesday,Workingday,Mist,0.42,0.4242,0.77,0.1343,26,342,368,368,257,368,3,4,2,342,0,728,226789,3,368
2012-04-18,summer,2012,April,20,Wednesday,Workingday,Mist,0.42,0.4242,0.77,0.1045,8,252,260,260,257,260,3,3,2,332,0,728,164550,3,260
2012-04-18,summer,2012,April,21,Wednesday,Workingday,Mist,0.42,0.4242,0.82,0.0896,24,165,189,189,257,189,3,3,2,332,0,728,125445,3,189
2012-04-18,summer,2012,April,22,Wednesday,Workingday,Mist,0.42,0.4242,0.77,0.0896,9,153,162,162,257,162,3,3,2,332,0,728,95612,3,162
2012-04-18,summer,2012,April,23,Wednesday,Workingday,Mist,0.42,0.4242,0.77,0.0,14,56,70,70,257,70,3,2,2,322,0,728,63941,3,70
2012-04-19,summer,2012,April,0,Thursday,Workingday,Light Snow,0.42,0.4242,0.77,0.0,5,20,25,25,256,25,3,1,2,312,0,726,39130,3,25
2012-04-19,summer,2012,April,1,Thursday,Workingday,Light Snow,0.42,0.4242,0.77,0.1045,2,11,13,13,256,13,3,1,2,312,0,724,24164,3,13
2012-04-19,summer,2012,April,2,Thursday,Workingday,Mist,0.42,0.4242,0.77,0.0,2,4,6,6,256,6,3,1,2,312,0,715,16352,3,6
2012-04-19,summer,2012,April,3,Thursday,Workingday,Mist,0.42,0.4242,0.77,0.0,1,3,4,4,256,4,3,1,2,312,0,697,8174,3,4
2012-04-19,summer,2012,April,4,Thursday,Workingday,Mist,0.42,0.4242,0.71,0.0,0,4,4,4,256,4,3,1,2,312,0,697,4428,3,4
2012-04-19,summer,2012,April,5,Thursday,Workingday,Clear,0.4,0.4091,0.82,0.0,0,30,30,30,256,30,3,1,2,312,0,717,14261,3,30
2012-04-19,summer,2012,April,6,Thursday,Workingday,Mist,0.4,0.4091,0.82,0.1045,4,116,120,120,256,120,3,2,2,322,0,725,55132,3,120
2012-04-19,summer,2012,April,7,Thursday,Workingday,Mist,0.4,0.4091,0.82,0.1343,15,391,406,406,256,406,3,4,2,342,0,727,154171,3,406
2012-04-19,summer,2012,April,8,Thursday,Workingday,Mist,0.42,0.4242,0.82,0.1045,26,651,677,677,256,677,3,4,2,342,2,727,261001,3,677
2012-04-19,summer,2012,April,9,Thursday,Workingday,Mist,0.46,0.4545,0.72,0.0,31,270,301,301,256,301,3,4,2,342,0,727,159438,3,301
2012-04-19,summer,2012,April,10,Thursday,Workingday,Clear,0.48,0.4697,0.63,0.0896,46,143,189,189,256,189,3,3,2,332,0,727,126257,3,189
2012-04-19,summer,2012,April,11,Thursday,Workingday,Clear,0.52,0.5,0.48,0.0,46,183,229,229,256,229,3,3,3,333,0,727,151320,3,229
2012-04-19,summer,2012,April,12,Thursday,Workingday,Clear,0.54,0.5152,0.49,0.0,51,213,264,264,256,264,3,3,3,333,0,728,184414,3,264
2012-04-19,summer,2012,April,13,Thursday,Workingday,Clear,0.56,0.5303,0.46,0.0,52,186,238,238,256,238,3,3,3,333,0,729,184919,3,238
2012-04-19,summer,2012,April,14,Thursday,Workingday,Clear,0.58,0.5455,0.43,0.0,54,183,237,237,256,237,3,3,3,333,2,729,175652,3,237
2012-04-19,summer,2012,April,15,Thursday,Workingday,Clear,0.6,0.6212,0.43,0.0,66,196,262,262,256,262,3,3,3,333,2,729,183149,3,262
2012-04-19,summer,2012,April,16,Thursday,Workingday,Clear,0.62,0.6212,0.41,0.1045,63,324,387,387,256,387,3,4,3,343,2,730,227748,3,387
2012-04-19,summer,2012,April,17,Thursday,Workingday,Clear,0.6,0.6212,0.43,0.0896,85,663,748,748,256,748,3,4,3,343,2,730,336860,3,748
2012-04-19,summer,2012,April,18,Thursday,Workingday,Clear,0.6,0.6212,0.43,0.0896,99,677,776,776,256,776,3,4,3,343,2,728,309772,3,776
2012-04-19,summer,2012,April,19,Thursday,Workingday,Clear,0.58,0.5455,0.46,0.1343,70,516,586,586,256,586,3,4,3,343,2,728,226789,3,586
2012-04-19,summer,2012,April,20,Thursday,Workingday,Clear,0.56,0.5303,0.49,0.2239,52,352,404,404,256,404,3,4,3,343,2,728,164550,3,404
2012-04-19,summer,2012,April,21,Thursday,Workingday,Clear,0.52,0.5,0.55,0.1045,27,240,267,267,256,267,3,3,3,333,0,728,125445,3,267
2012-04-19,summer,2012,April,22,Thursday,Workingday,Clear,0.52,0.5,0.59,0.194,29,219,248,248,256,248,3,3,3,333,0,728,95612,3,248
2012-04-19,summer,2012,April,23,Thursday,Workingday,Clear,0.5,0.4848,0.63,0.1045,20,124,144,144,256,144,3,3,2,332,0,728,63941,3,144
2012-04-20,summer,2012,April,0,Friday,Workingday,Clear,0.48,0.4697,0.67,0.1045,5,59,64,64,255,64,3,2,2,322,0,726,39130,3,64
2012-04-20,summer,2012,April,1,Friday,Workingday,Clear,0.46,0.4545,0.82,0.194,3,22,25,25,255,25,3,1,2,312,0,724,24164,3,25
2012-04-20,summer,2012,April,2,Friday,Workingday,Clear,0.44,0.4394,0.88,0.194,3,18,21,21,255,21,3,1,2,312,0,715,16352,3,21
2012-04-20,summer,2012,April,3,Friday,Workingday,Clear,0.44,0.4394,0.88,0.1045,1,9,10,10,255,10,3,1,2,312,0,697,8174,3,10
2012-04-20,summer,2012,April,4,Friday,Workingday,Clear,0.42,0.4242,0.94,0.1045,0,3,3,3,255,3,3,1,2,312,0,697,4428,3,3
2012-04-20,summer,2012,April,5,Friday,Workingday,Clear,0.42,0.4242,0.94,0.0,1,24,25,25,255,25,3,1,2,312,0,717,14261,3,25
2012-04-20,summer,2012,April,6,Friday,Workingday,Clear,0.42,0.4242,0.88,0.0,8,105,113,113,255,113,3,2,2,322,0,725,55132,3,113
2012-04-20,summer,2012,April,7,Friday,Workingday,Clear,0.42,0.4242,0.94,0.0,9,350,359,359,255,359,3,4,2,342,0,727,154171,3,359
2012-04-20,summer,2012,April,8,Friday,Workingday,Clear,0.44,0.4394,0.94,0.0,32,668,700,700,255,700,3,4,2,342,0,727,261001,3,700
2012-04-20,summer,2012,April,9,Friday,Workingday,Clear,0.46,0.4545,0.88,0.0896,30,329,359,359,255,359,3,4,2,342,0,727,159438,3,359
2012-04-20,summer,2012,April,10,Friday,Workingday,Clear,0.5,0.4848,0.77,0.194,67,170,237,237,255,237,3,3,2,332,0,727,126257,3,237
2012-04-20,summer,2012,April,11,Friday,Workingday,Clear,0.54,0.5152,0.68,0.1642,64,190,254,254,255,254,3,3,3,333,0,727,151320,3,254
2012-04-20,summer,2012,April,12,Friday,Workingday,Clear,0.58,0.5455,0.53,0.194,102,260,362,362,255,362,3,4,3,343,2,728,184414,3,362
2012-04-20,summer,2012,April,13,Friday,Workingday,Clear,0.62,0.6212,0.43,0.194,105,276,381,381,255,381,3,4,3,343,2,729,184919,3,381
2012-04-20,summer,2012,April,14,Friday,Workingday,Clear,0.64,0.6212,0.44,0.2239,156,238,394,394,255,394,3,4,3,343,2,729,175652,3,394
2012-04-20,summer,2012,April,15,Friday,Workingday,Clear,0.64,0.6212,0.47,0.194,145,262,407,407,255,407,3,4,3,343,2,729,183149,3,407
2012-04-20,summer,2012,April,16,Friday,Workingday,Clear,0.66,0.6212,0.44,0.194,151,429,580,580,255,580,3,4,3,343,2,730,227748,3,580
2012-04-20,summer,2012,April,17,Friday,Workingday,Clear,0.64,0.6212,0.47,0.2836,122,697,819,819,255,819,3,4,3,343,2,730,336860,3,819
2012-04-20,summer,2012,April,18,Friday,Workingday,Clear,0.62,0.6212,0.5,0.2836,110,558,668,668,255,668,3,4,3,343,2,728,309772,3,668
2012-04-20,summer,2012,April,19,Friday,Workingday,Clear,0.6,0.6212,0.53,0.194,82,410,492,492,255,492,3,4,3,343,2,728,226789,3,492
2012-04-20,summer,2012,April,20,Friday,Workingday,Clear,0.58,0.5455,0.56,0.1642,52,289,341,341,255,341,3,4,3,343,2,728,164550,3,341
2012-04-20,summer,2012,April,21,Friday,Workingday,Clear,0.56,0.5303,0.68,0.1343,35,252,287,287,255,287,3,4,3,343,0,728,125445,3,287
2012-04-20,summer,2012,April,22,Friday,Workingday,Clear,0.54,0.5152,0.68,0.2537,26,176,202,202,255,202,3,3,3,333,0,728,95612,3,202
2012-04-20,summer,2012,April,23,Friday,Workingday,Clear,0.52,0.5,0.72,0.1343,31,156,187,187,255,187,3,3,3,333,0,728,63941,3,187
2012-04-21,summer,2012,April,0,Saturday,Holiday,Clear,0.52,0.5,0.77,0.2239,31,111,142,142,254,142,3,2,3,323,0,726,39130,3,142
2012-04-21,summer,2012,April,1,Saturday,Holiday,Clear,0.52,0.5,0.77,0.2239,24,64,88,88,254,88,3,2,3,323,0,724,24164,3,88
2012-04-21,summer,2012,April,2,Saturday,Holiday,Clear,0.52,0.5,0.77,0.1343,12,69,81,81,254,81,3,2,3,323,0,715,16352,3,81
2012-04-21,summer,2012,April,3,Saturday,Holiday,Clear,0.5,0.4848,0.82,0.2239,4,25,29,29,254,29,3,1,2,312,0,697,8174,3,29
2012-04-21,summer,2012,April,4,Saturday,Holiday,Clear,0.5,0.4848,0.82,0.2537,0,9,9,9,254,9,3,1,2,312,0,697,4428,3,9
2012-04-21,summer,2012,April,5,Saturday,Holiday,Clear,0.5,0.4848,0.82,0.2537,0,1,1,1,254,1,3,1,2,312,0,717,14261,3,1
2012-04-21,summer,2012,April,6,Saturday,Holiday,Clear,0.5,0.4848,0.82,0.2239,10,21,31,31,254,31,3,1,2,312,0,725,55132,3,31
2012-04-21,summer,2012,April,7,Saturday,Holiday,Clear,0.5,0.4848,0.82,0.2836,21,55,76,76,254,76,3,2,2,322,0,727,154171,3,76
2012-04-21,summer,2012,April,8,Saturday,Holiday,Clear,0.52,0.5,0.81,0.2537,52,149,201,201,254,201,3,3,3,333,0,727,261001,3,201
2012-04-21,summer,2012,April,9,Saturday,Holiday,Clear,0.54,0.5152,0.77,0.1642,115,216,331,331,254,331,3,4,3,343,2,727,159438,3,331
2012-04-21,summer,2012,April,10,Saturday,Holiday,Clear,0.6,0.6061,0.64,0.2836,183,299,482,482,254,482,3,4,3,343,2,727,126257,3,482
2012-04-21,summer,2012,April,11,Saturday,Holiday,Clear,0.62,0.6061,0.61,0.3284,260,348,608,608,254,608,3,4,3,343,2,727,151320,3,608
2012-04-21,summer,2012,April,12,Saturday,Holiday,Clear,0.64,0.6212,0.57,0.2239,262,378,640,640,254,640,3,4,3,343,2,728,184414,3,640
2012-04-21,summer,2012,April,13,Saturday,Holiday,Clear,0.66,0.6212,0.54,0.2239,291,358,649,649,254,649,3,4,3,343,2,729,184919,3,649
2012-04-21,summer,2012,April,14,Saturday,Holiday,Clear,0.7,0.6364,0.45,0.2836,278,331,609,609,254,609,3,4,4,344,2,729,175652,3,609
2012-04-21,summer,2012,April,15,Saturday,Holiday,Clear,0.72,0.6515,0.39,0.2537,267,361,628,628,254,628,3,4,4,344,2,729,183149,3,628
2012-04-21,summer,2012,April,16,Saturday,Holiday,Clear,0.7,0.6364,0.42,0.3284,267,372,639,639,254,639,3,4,4,344,2,730,227748,3,639
2012-04-21,summer,2012,April,17,Saturday,Holiday,Mist,0.74,0.6515,0.3,0.3881,259,309,568,568,254,568,3,4,4,344,2,730,336860,3,568
2012-04-21,summer,2012,April,18,Saturday,Holiday,Mist,0.68,0.6364,0.47,0.4925,133,283,416,416,254,416,3,4,4,344,2,728,309772,3,416
2012-04-21,summer,2012,April,19,Saturday,Holiday,Light Snow,0.56,0.5303,0.73,0.4925,9,45,54,54,254,54,3,2,3,323,0,728,226789,3,54
2012-04-21,summer,2012,April,20,Saturday,Holiday,Light Snow,0.5,0.4848,0.82,0.2985,5,34,39,39,254,39,3,1,2,312,0,728,164550,3,39
2012-04-21,summer,2012,April,21,Saturday,Holiday,Light Snow,0.5,0.4848,0.82,0.3881,20,82,102,102,254,102,3,2,2,322,0,728,125445,3,102
2012-04-21,summer,2012,April,22,Saturday,Holiday,Clear,0.48,0.4697,0.82,0.2985,20,90,110,110,254,110,3,2,2,322,0,728,95612,3,110
2012-04-21,summer,2012,April,23,Saturday,Holiday,Mist,0.46,0.4545,0.82,0.2836,18,73,91,91,254,91,3,2,2,322,0,728,63941,3,91
2012-04-22,summer,2012,April,0,Sunday,Holiday,Mist,0.46,0.4545,0.82,0.194,32,85,117,117,253,117,3,2,2,322,0,726,39130,3,117
2012-04-22,summer,2012,April,1,Sunday,Holiday,Mist,0.46,0.4545,0.82,0.3284,10,63,73,73,253,73,3,2,2,322,0,724,24164,3,73
2012-04-22,summer,2012,April,2,Sunday,Holiday,Clear,0.46,0.4545,0.72,0.2836,7,49,56,56,253,56,3,2,2,322,0,715,16352,3,56
2012-04-22,summer,2012,April,3,Sunday,Holiday,Mist,0.44,0.4394,0.82,0.1642,7,33,40,40,253,40,3,1,2,312,0,697,8174,3,40
2012-04-22,summer,2012,April,4,Sunday,Holiday,Mist,0.44,0.4394,0.77,0.1642,0,7,7,7,253,7,3,1,2,312,0,697,4428,3,7
2012-04-22,summer,2012,April,5,Sunday,Holiday,Mist,0.44,0.4394,0.77,0.2239,0,6,6,6,253,6,3,1,2,312,0,717,14261,3,6
2012-04-22,summer,2012,April,6,Sunday,Holiday,Mist,0.44,0.4394,0.72,0.3284,6,6,12,12,253,12,3,1,2,312,1,725,55132,3,12
2012-04-22,summer,2012,April,7,Sunday,Holiday,Light Snow,0.42,0.4242,0.77,0.3881,2,22,24,24,253,24,3,1,2,312,1,727,154171,3,24
2012-04-22,summer,2012,April,8,Sunday,Holiday,Light Snow,0.4,0.4091,0.82,0.2537,8,43,51,51,253,51,3,2,2,322,0,727,261001,3,51
2012-04-22,summer,2012,April,9,Sunday,Holiday,Light Snow,0.4,0.4091,0.82,0.2537,8,71,79,79,253,79,3,2,2,322,0,727,159438,3,79
2012-04-22,summer,2012,April,10,Sunday,Holiday,Light Snow,0.38,0.3939,0.82,0.3284,11,57,68,68,253,68,3,2,2,322,1,727,126257,3,68
2012-04-22,summer,2012,April,11,Sunday,Holiday,Light Snow,0.38,0.3939,0.87,0.2985,7,70,77,77,253,77,3,2,2,322,1,727,151320,3,77
2012-04-22,summer,2012,April,12,Sunday,Holiday,Light Snow,0.38,0.3939,0.87,0.3284,5,56,61,61,253,61,3,2,2,322,1,728,184414,3,61
2012-04-22,summer,2012,April,13,Sunday,Holiday,Light Snow,0.38,0.3939,0.82,0.3582,5,47,52,52,253,52,3,2,2,322,1,729,184919,3,52
2012-04-22,summer,2012,April,14,Sunday,Holiday,Light Snow,0.38,0.3939,0.87,0.3284,3,50,53,53,253,53,3,2,2,322,1,729,175652,3,53
2012-04-22,summer,2012,April,15,Sunday,Holiday,Light Snow,0.38,0.3939,0.87,0.3881,0,38,38,38,253,38,3,1,2,312,1,729,183149,3,38
2012-04-22,summer,2012,April,16,Sunday,Holiday,Light Snow,0.38,0.3939,0.87,0.4478,4,32,36,36,253,36,3,1,2,312,1,730,227748,3,36
2012-04-22,summer,2012,April,17,Sunday,Holiday,Light Snow,0.36,0.3182,0.93,0.4478,2,25,27,27,253,27,3,1,1,311,1,730,336860,3,27
2012-04-22,summer,2012,April,18,Sunday,Holiday,Light Snow,0.36,0.3182,0.93,0.4478,1,38,39,39,253,39,3,1,1,311,1,728,309772,3,39
2012-04-22,summer,2012,April,19,Sunday,Holiday,Light Snow,0.36,0.3182,0.87,0.5224,1,34,35,35,253,35,3,1,1,311,1,728,226789,3,35
2012-04-22,summer,2012,April,20,Sunday,Holiday,Light Snow,0.36,0.3333,0.93,0.4179,1,34,35,35,253,35,3,1,1,311,1,728,164550,3,35
2012-04-22,summer,2012,April,21,Sunday,Holiday,Light Snow,0.36,0.3333,0.87,0.3881,0,11,11,11,253,11,3,1,1,311,1,728,125445,3,11
2012-04-22,summer,2012,April,22,Sunday,Holiday,Light Snow,0.34,0.2879,0.87,0.5224,0,13,13,13,253,13,3,1,1,311,1,728,95612,3,13
2012-04-22,summer,2012,April,23,Sunday,Holiday,Light Snow,0.36,0.3182,0.81,0.4627,0,17,17,17,253,17,3,1,1,311,1,728,63941,3,17
2012-04-23,summer,2012,April,0,Monday,Workingday,Light Snow,0.36,0.3333,0.81,0.4179,0,6,6,6,252,6,3,1,1,311,1,726,39130,3,6
2012-04-23,summer,2012,April,1,Monday,Workingday,Light Snow,0.34,0.303,0.87,0.3582,1,1,2,2,252,2,3,1,1,311,1,724,24164,3,2
2012-04-23,summer,2012,April,2,Monday,Workingday,Mist,0.32,0.303,0.87,0.3284,1,3,4,4,252,4,3,1,1,311,1,715,16352,3,4
2012-04-23,summer,2012,April,3,Monday,Workingday,Mist,0.32,0.303,0.81,0.2836,0,1,1,1,252,1,3,1,1,311,1,697,8174,3,1
2012-04-23,summer,2012,April,4,Monday,Workingday,Light Snow,0.3,0.2879,0.81,0.2836,0,3,3,3,252,3,3,1,1,311,1,697,4428,3,3
2012-04-23,summer,2012,April,5,Monday,Workingday,Light Snow,0.3,0.2879,0.81,0.2836,0,14,14,14,252,14,3,1,1,311,1,717,14261,3,14
2012-04-23,summer,2012,April,6,Monday,Workingday,Mist,0.3,0.2727,0.81,0.2985,2,43,45,45,252,45,3,2,1,321,1,725,55132,3,45
2012-04-23,summer,2012,April,7,Monday,Workingday,Light Snow,0.3,0.2879,0.81,0.2537,1,206,207,207,252,207,3,3,1,331,1,727,154171,3,207
2012-04-23,summer,2012,April,8,Monday,Workingday,Mist,0.3,0.2727,0.75,0.3284,11,471,482,482,252,482,3,4,1,341,1,727,261001,3,482
2012-04-23,summer,2012,April,9,Monday,Workingday,Mist,0.3,0.2727,0.75,0.3881,17,255,272,272,252,272,3,3,1,331,1,727,159438,3,272
2012-04-23,summer,2012,April,10,Monday,Workingday,Mist,0.32,0.303,0.7,0.3284,12,88,100,100,252,100,3,2,1,321,1,727,126257,3,100
2012-04-23,summer,2012,April,11,Monday,Workingday,Mist,0.32,0.2879,0.7,0.3582,10,91,101,101,252,101,3,2,1,321,1,727,151320,3,101
2012-04-23,summer,2012,April,12,Monday,Workingday,Light Snow,0.34,0.303,0.71,0.3582,12,117,129,129,252,129,3,2,1,321,1,728,184414,3,129
2012-04-23,summer,2012,April,13,Monday,Workingday,Light Snow,0.34,0.303,0.66,0.3881,9,98,107,107,252,107,3,2,1,321,1,729,184919,3,107
2012-04-23,summer,2012,April,14,Monday,Workingday,Light Snow,0.36,0.3182,0.62,0.4478,12,102,114,114,252,114,3,2,1,321,1,729,175652,3,114
2012-04-23,summer,2012,April,15,Monday,Workingday,Mist,0.36,0.3333,0.62,0.3881,11,101,112,112,252,112,3,2,1,321,1,729,183149,3,112
2012-04-23,summer,2012,April,16,Monday,Workingday,Light Snow,0.3,0.2727,0.81,0.3582,10,93,103,103,252,103,3,2,1,321,1,730,227748,3,103
2012-04-23,summer,2012,April,17,Monday,Workingday,Light Snow,0.3,0.2727,0.82,0.3284,13,219,232,232,252,232,3,3,1,331,1,730,336860,3,232
2012-04-23,summer,2012,April,18,Monday,Workingday,Light Snow,0.32,0.3333,0.81,0.1343,10,369,379,379,252,379,3,4,1,341,1,728,309772,3,379
2012-04-23,summer,2012,April,19,Monday,Workingday,Mist,0.34,0.3182,0.76,0.2239,11,287,298,298,252,298,3,4,1,341,1,728,226789,3,298
2012-04-23,summer,2012,April,20,Monday,Workingday,Mist,0.32,0.3182,0.76,0.1642,17,186,203,203,252,203,3,3,1,331,1,728,164550,3,203
2012-04-23,summer,2012,April,21,Monday,Workingday,Mist,0.32,0.303,0.81,0.2239,7,145,152,152,252,152,3,3,1,331,1,728,125445,3,152
2012-04-23,summer,2012,April,22,Monday,Workingday,Clear,0.32,0.3182,0.76,0.194,18,71,89,89,252,89,3,2,1,321,1,728,95612,3,89
2012-04-23,summer,2012,April,23,Monday,Workingday,Clear,0.32,0.3182,0.76,0.1642,10,49,59,59,252,59,3,2,1,321,1,728,63941,3,59
2012-04-24,summer,2012,April,0,Tuesday,Workingday,Mist,0.32,0.3333,0.76,0.1343,0,13,13,13,251,13,3,1,1,311,1,726,39130,3,13
2012-04-24,summer,2012,April,1,Tuesday,Workingday,Mist,0.32,0.3333,0.81,0.1343,1,6,7,7,251,7,3,1,1,311,1,724,24164,3,7
2012-04-24,summer,2012,April,2,Tuesday,Workingday,Clear,0.32,0.3182,0.81,0.194,0,3,3,3,251,3,3,1,1,311,1,715,16352,3,3
2012-04-24,summer,2012,April,3,Tuesday,Workingday,Clear,0.32,0.303,0.81,0.2239,0,2,2,2,251,2,3,1,1,311,1,697,8174,3,2
2012-04-24,summer,2012,April,4,Tuesday,Workingday,Clear,0.3,0.2879,0.7,0.194,0,3,3,3,251,3,3,1,1,311,1,697,4428,3,3
2012-04-24,summer,2012,April,5,Tuesday,Workingday,Clear,0.3,0.2879,0.7,0.194,0,22,22,22,251,22,3,1,1,311,1,717,14261,3,22
2012-04-24,summer,2012,April,6,Tuesday,Workingday,Clear,0.3,0.2879,0.7,0.2239,3,117,120,120,251,120,3,2,1,321,1,725,55132,3,120
2012-04-24,summer,2012,April,7,Tuesday,Workingday,Clear,0.32,0.303,0.66,0.2836,3,387,390,390,251,390,3,4,1,341,1,727,154171,3,390
2012-04-24,summer,2012,April,8,Tuesday,Workingday,Clear,0.34,0.3182,0.61,0.2537,12,599,611,611,251,611,3,4,1,341,1,727,261001,3,611
2012-04-24,summer,2012,April,9,Tuesday,Workingday,Clear,0.4,0.4091,0.47,0.3582,6,302,308,308,251,308,3,4,2,342,1,727,159438,3,308
2012-04-24,summer,2012,April,10,Tuesday,Workingday,Clear,0.42,0.4242,0.47,0.2985,33,129,162,162,251,162,3,3,2,332,1,727,126257,3,162
2012-04-24,summer,2012,April,11,Tuesday,Workingday,Clear,0.46,0.4545,0.31,0.3881,27,157,184,184,251,184,3,3,2,332,1,727,151320,3,184
2012-04-24,summer,2012,April,12,Tuesday,Workingday,Clear,0.48,0.4697,0.29,0.3881,36,188,224,224,251,224,3,3,2,332,1,728,184414,3,224
2012-04-24,summer,2012,April,13,Tuesday,Workingday,Clear,0.5,0.4848,0.29,0.3881,35,189,224,224,251,224,3,3,2,332,2,729,184919,3,224
2012-04-24,summer,2012,April,14,Tuesday,Workingday,Clear,0.5,0.4848,0.25,0.3881,50,166,216,216,251,216,3,3,2,332,2,729,175652,3,216
2012-04-24,summer,2012,April,15,Tuesday,Workingday,Clear,0.5,0.4848,0.23,0.4179,60,176,236,236,251,236,3,3,2,332,2,729,183149,3,236
2012-04-24,summer,2012,April,16,Tuesday,Workingday,Clear,0.5,0.4848,0.23,0.194,54,308,362,362,251,362,3,4,2,342,2,730,227748,3,362
2012-04-24,summer,2012,April,17,Tuesday,Workingday,Clear,0.52,0.5,0.22,0.3881,72,619,691,691,251,691,3,4,3,343,2,730,336860,3,691
2012-04-24,summer,2012,April,18,Tuesday,Workingday,Clear,0.5,0.4848,0.18,0.0,52,580,632,632,251,632,3,4,2,342,2,728,309772,3,632
2012-04-24,summer,2012,April,19,Tuesday,Workingday,Clear,0.5,0.4848,0.18,0.2537,33,449,482,482,251,482,3,4,2,342,2,728,226789,3,482
2012-04-24,summer,2012,April,20,Tuesday,Workingday,Clear,0.48,0.4697,0.21,0.3284,16,269,285,285,251,285,3,4,2,342,2,728,164550,3,285
2012-04-24,summer,2012,April,21,Tuesday,Workingday,Mist,0.46,0.4545,0.28,0.1642,13,213,226,226,251,226,3,3,2,332,1,728,125445,3,226
2012-04-24,summer,2012,April,22,Tuesday,Workingday,Clear,0.44,0.4394,0.35,0.1045,8,149,157,157,251,157,3,3,2,332,1,728,95612,3,157
2012-04-24,summer,2012,April,23,Tuesday,Workingday,Clear,0.42,0.4242,0.38,0.0896,4,69,73,73,251,73,3,2,2,322,1,728,63941,3,73
2012-04-25,summer,2012,April,0,Wednesday,Workingday,Clear,0.44,0.4394,0.38,0.0,13,23,36,36,250,36,3,1,2,312,1,726,39130,3,36
2012-04-25,summer,2012,April,1,Wednesday,Workingday,Clear,0.42,0.4242,0.41,0.0,8,17,25,25,250,25,3,1,2,312,1,724,24164,3,25
2012-04-25,summer,2012,April,2,Wednesday,Workingday,Clear,0.36,0.3788,0.62,0.0,1,6,7,7,250,7,3,1,2,312,1,715,16352,3,7
2012-04-25,summer,2012,April,3,Wednesday,Workingday,Clear,0.32,0.3333,0.7,0.0896,0,3,3,3,250,3,3,1,1,311,1,697,8174,3,3
2012-04-25,summer,2012,April,4,Wednesday,Workingday,Clear,0.34,0.3485,0.66,0.0896,0,6,6,6,250,6,3,1,2,312,1,697,4428,3,6
2012-04-25,summer,2012,April,5,Wednesday,Workingday,Clear,0.34,0.3636,0.66,0.0,0,24,24,24,250,24,3,1,2,312,1,717,14261,3,24
2012-04-25,summer,2012,April,6,Wednesday,Workingday,Clear,0.34,0.3636,0.66,0.0,3,103,106,106,250,106,3,2,2,322,1,725,55132,3,106
2012-04-25,summer,2012,April,7,Wednesday,Workingday,Clear,0.34,0.3636,0.71,0.0,13,376,389,389,250,389,3,4,2,342,1,727,154171,3,389
2012-04-25,summer,2012,April,8,Wednesday,Workingday,Clear,0.36,0.3636,0.76,0.0896,20,634,654,654,250,654,3,4,2,342,1,727,261001,3,654
2012-04-25,summer,2012,April,9,Wednesday,Workingday,Clear,0.42,0.4242,0.54,0.0,33,288,321,321,250,321,3,4,2,342,0,727,159438,3,321
2012-04-25,summer,2012,April,10,Wednesday,Workingday,Clear,0.52,0.5,0.34,0.0,44,138,182,182,250,182,3,3,3,333,0,727,126257,3,182
2012-04-25,summer,2012,April,11,Wednesday,Workingday,Clear,0.52,0.5,0.32,0.1343,42,177,219,219,250,219,3,3,3,333,2,727,151320,3,219
2012-04-25,summer,2012,April,12,Wednesday,Workingday,Clear,0.54,0.5152,0.28,0.2836,49,220,269,269,250,269,3,3,3,333,2,728,184414,3,269
2012-04-25,summer,2012,April,13,Wednesday,Workingday,Clear,0.56,0.5303,0.26,0.2239,35,193,228,228,250,228,3,3,3,333,2,729,184919,3,228
2012-04-25,summer,2012,April,14,Wednesday,Workingday,Clear,0.56,0.5303,0.22,0.3582,47,176,223,223,250,223,3,3,3,333,2,729,175652,3,223
2012-04-25,summer,2012,April,15,Wednesday,Workingday,Clear,0.58,0.5455,0.19,0.1642,47,182,229,229,250,229,3,3,3,333,2,729,183149,3,229
2012-04-25,summer,2012,April,16,Wednesday,Workingday,Clear,0.6,0.5909,0.2,0.3284,49,327,376,376,250,376,3,4,3,343,2,730,227748,3,376
2012-04-25,summer,2012,April,17,Wednesday,Workingday,Clear,0.6,0.5909,0.2,0.2985,68,664,732,732,250,732,3,4,3,343,2,730,336860,3,732
2012-04-25,summer,2012,April,18,Wednesday,Workingday,Clear,0.6,0.5909,0.2,0.2836,60,649,709,709,250,709,3,4,3,343,2,728,309772,3,709
2012-04-25,summer,2012,April,19,Wednesday,Workingday,Clear,0.6,0.5909,0.2,0.194,42,501,543,543,250,543,3,4,3,343,2,728,226789,3,543
2012-04-25,summer,2012,April,20,Wednesday,Workingday,Clear,0.56,0.5303,0.22,0.0896,22,358,380,380,250,380,3,4,3,343,2,728,164550,3,380
2012-04-25,summer,2012,April,21,Wednesday,Workingday,Clear,0.52,0.5,0.52,0.1343,27,212,239,239,250,239,3,3,3,333,0,728,125445,3,239
2012-04-25,summer,2012,April,22,Wednesday,Workingday,Clear,0.5,0.4848,0.51,0.0,22,170,192,192,250,192,3,3,2,332,0,728,95612,3,192
2012-04-25,summer,2012,April,23,Wednesday,Workingday,Mist,0.5,0.4848,0.51,0.0896,10,94,104,104,250,104,3,2,2,322,0,728,63941,3,104
2012-04-26,summer,2012,April,0,Thursday,Workingday,Mist,0.48,0.4697,0.63,0.0,1,42,43,43,249,43,3,2,2,322,0,726,39130,3,43
2012-04-26,summer,2012,April,1,Thursday,Workingday,Mist,0.48,0.4697,0.48,0.0896,1,22,23,23,249,23,3,1,2,312,0,724,24164,3,23
2012-04-26,summer,2012,April,2,Thursday,Workingday,Mist,0.48,0.4697,0.55,0.1045,3,10,13,13,249,13,3,1,2,312,0,715,16352,3,13
2012-04-26,summer,2012,April,3,Thursday,Workingday,Mist,0.48,0.4697,0.55,0.0896,1,5,6,6,249,6,3,1,2,312,0,697,8174,3,6
2012-04-26,summer,2012,April,4,Thursday,Workingday,Mist,0.48,0.4697,0.59,0.0896,1,2,3,3,249,3,3,1,2,312,0,697,4428,3,3
2012-04-26,summer,2012,April,5,Thursday,Workingday,Mist,0.48,0.4697,0.63,0.1343,0,17,17,17,249,17,3,1,2,312,0,717,14261,3,17
2012-04-26,summer,2012,April,6,Thursday,Workingday,Mist,0.48,0.4697,0.63,0.2537,5,122,127,127,249,127,3,2,2,322,0,725,55132,3,127
2012-04-26,summer,2012,April,7,Thursday,Workingday,Light Snow,0.46,0.4545,0.82,0.3582,3,222,225,225,249,225,3,3,2,332,0,727,154171,3,225
2012-04-26,summer,2012,April,8,Thursday,Workingday,Light Snow,0.46,0.4545,0.82,0.194,4,358,362,362,249,362,3,4,2,342,0,727,261001,3,362
2012-04-26,summer,2012,April,9,Thursday,Workingday,Light Snow,0.46,0.4545,0.88,0.1642,12,189,201,201,249,201,3,3,2,332,0,727,159438,3,201
2012-04-26,summer,2012,April,10,Thursday,Workingday,Mist,0.46,0.4545,0.94,0.1642,14,125,139,139,249,139,3,2,2,322,0,727,126257,3,139
2012-04-26,summer,2012,April,11,Thursday,Workingday,Mist,0.46,0.4545,0.94,0.2239,16,135,151,151,249,151,3,3,2,332,0,727,151320,3,151
2012-04-26,summer,2012,April,12,Thursday,Workingday,Mist,0.52,0.5,0.83,0.1343,24,180,204,204,249,204,3,3,3,333,0,728,184414,3,204
2012-04-26,summer,2012,April,13,Thursday,Workingday,Mist,0.5,0.4848,0.82,0.1642,19,178,197,197,249,197,3,3,2,332,0,729,184919,3,197
2012-04-26,summer,2012,April,14,Thursday,Workingday,Mist,0.54,0.5152,0.77,0.194,37,132,169,169,249,169,3,3,3,333,0,729,175652,3,169
2012-04-26,summer,2012,April,15,Thursday,Workingday,Mist,0.52,0.5,0.83,0.3284,39,165,204,204,249,204,3,3,3,333,0,729,183149,3,204
2012-04-26,summer,2012,April,16,Thursday,Workingday,Mist,0.52,0.5,0.83,0.2239,37,281,318,318,249,318,3,4,3,343,0,730,227748,3,318
2012-04-26,summer,2012,April,17,Thursday,Workingday,Clear,0.54,0.5152,0.77,0.1642,49,565,614,614,249,614,3,4,3,343,2,730,336860,3,614
2012-04-26,summer,2012,April,18,Thursday,Workingday,Mist,0.54,0.5152,0.77,0.194,75,589,664,664,249,664,3,4,3,343,2,728,309772,3,664
2012-04-26,summer,2012,April,19,Thursday,Workingday,Mist,0.54,0.5152,0.77,0.2239,57,407,464,464,249,464,3,4,3,343,2,728,226789,3,464
2012-04-26,summer,2012,April,20,Thursday,Workingday,Clear,0.54,0.5152,0.77,0.194,23,314,337,337,249,337,3,4,3,343,0,728,164550,3,337
2012-04-26,summer,2012,April,21,Thursday,Workingday,Clear,0.52,0.5,0.83,0.2239,28,222,250,250,249,250,3,3,3,333,0,728,125445,3,250
2012-04-26,summer,2012,April,22,Thursday,Workingday,Clear,0.52,0.5,0.83,0.1642,20,163,183,183,249,183,3,3,3,333,0,728,95612,3,183
2012-04-26,summer,2012,April,23,Thursday,Workingday,Clear,0.5,0.4848,0.88,0.1642,6,106,112,112,249,112,3,2,2,322,0,728,63941,3,112
2012-04-27,summer,2012,April,0,Friday,Workingday,Clear,0.54,0.5152,0.68,0.5522,12,61,73,73,248,73,3,2,3,323,1,726,39130,3,73
2012-04-27,summer,2012,April,1,Friday,Workingday,Clear,0.5,0.4848,0.59,0.4478,3,32,35,35,248,35,3,1,2,312,1,724,24164,3,35
2012-04-27,summer,2012,April,2,Friday,Workingday,Clear,0.48,0.4697,0.59,0.4179,4,18,22,22,248,22,3,1,2,312,1,715,16352,3,22
2012-04-27,summer,2012,April,3,Friday,Workingday,Clear,0.44,0.4394,0.47,0.4925,1,2,3,3,248,3,3,1,2,312,1,697,8174,3,3
2012-04-27,summer,2012,April,4,Friday,Workingday,Clear,0.42,0.4242,0.44,0.2537,0,6,6,6,248,6,3,1,2,312,1,697,4428,3,6
2012-04-27,summer,2012,April,5,Friday,Workingday,Clear,0.42,0.4242,0.44,0.3582,0,19,19,19,248,19,3,1,2,312,1,717,14261,3,19
2012-04-27,summer,2012,April,6,Friday,Workingday,Clear,0.4,0.4091,0.43,0.2537,5,115,120,120,248,120,3,2,2,322,1,725,55132,3,120
2012-04-27,summer,2012,April,7,Friday,Workingday,Clear,0.38,0.3939,0.5,0.2836,10,305,315,315,248,315,3,4,2,342,1,727,154171,3,315
2012-04-27,summer,2012,April,8,Friday,Workingday,Clear,0.4,0.4091,0.5,0.0,17,575,592,592,248,592,3,4,2,342,2,727,261001,3,592
2012-04-27,summer,2012,April,9,Friday,Workingday,Clear,0.42,0.4242,0.44,0.4925,42,292,334,334,248,334,3,4,2,342,1,727,159438,3,334
2012-04-27,summer,2012,April,10,Friday,Workingday,Clear,0.44,0.4394,0.38,0.4179,64,172,236,236,248,236,3,3,2,332,1,727,126257,3,236
2012-04-27,summer,2012,April,11,Friday,Workingday,Clear,0.44,0.4394,0.38,0.3284,47,186,233,233,248,233,3,3,2,332,1,727,151320,3,233
2012-04-27,summer,2012,April,12,Friday,Workingday,Clear,0.46,0.4545,0.36,0.3582,63,244,307,307,248,307,3,4,2,342,2,728,184414,3,307
2012-04-27,summer,2012,April,13,Friday,Workingday,Clear,0.46,0.4545,0.33,0.3881,94,212,306,306,248,306,3,4,2,342,2,729,184919,3,306
2012-04-27,summer,2012,April,14,Friday,Workingday,Clear,0.46,0.4545,0.33,0.3284,94,206,300,300,248,300,3,4,2,342,2,729,175652,3,300
2012-04-27,summer,2012,April,15,Friday,Workingday,Clear,0.52,0.5,0.29,0.4925,101,223,324,324,248,324,3,4,3,343,2,729,183149,3,324
2012-04-27,summer,2012,April,16,Friday,Workingday,Clear,0.52,0.5,0.29,0.2537,105,335,440,440,248,440,3,4,3,343,2,730,227748,3,440
2012-04-27,summer,2012,April,17,Friday,Workingday,Clear,0.54,0.5152,0.24,0.3881,89,613,702,702,248,702,3,4,3,343,2,730,336860,3,702
2012-04-27,summer,2012,April,18,Friday,Workingday,Clear,0.52,0.5,0.25,0.3582,94,560,654,654,248,654,3,4,3,343,2,728,309772,3,654
2012-04-27,summer,2012,April,19,Friday,Workingday,Clear,0.5,0.4848,0.27,0.3881,62,379,441,441,248,441,3,4,2,342,2,728,226789,3,441
2012-04-27,summer,2012,April,20,Friday,Workingday,Clear,0.46,0.4545,0.31,0.2836,49,240,289,289,248,289,3,4,2,342,2,728,164550,3,289
2012-04-27,summer,2012,April,21,Friday,Workingday,Clear,0.44,0.4394,0.33,0.2985,23,185,208,208,248,208,3,3,2,332,1,728,125445,3,208
2012-04-27,summer,2012,April,22,Friday,Workingday,Clear,0.42,0.4242,0.38,0.2537,24,134,158,158,248,158,3,3,2,332,1,728,95612,3,158
2012-04-27,summer,2012,April,23,Friday,Workingday,Clear,0.4,0.4091,0.4,0.2537,11,105,116,116,248,116,3,2,2,322,1,728,63941,3,116
2012-04-28,summer,2012,April,0,Saturday,Holiday,Clear,0.38,0.3939,0.43,0.1642,4,99,103,103,247,103,3,2,2,322,1,726,39130,3,103
2012-04-28,summer,2012,April,1,Saturday,Holiday,Clear,0.36,0.3333,0.5,0.2985,7,60,67,67,247,67,3,2,1,321,1,724,24164,3,67
2012-04-28,summer,2012,April,2,Saturday,Holiday,Clear,0.36,0.3485,0.43,0.1642,8,49,57,57,247,57,3,2,2,322,1,715,16352,3,57
2012-04-28,summer,2012,April,3,Saturday,Holiday,Clear,0.34,0.3182,0.49,0.2239,3,23,26,26,247,26,3,1,1,311,1,697,8174,3,26
2012-04-28,summer,2012,April,4,Saturday,Holiday,Clear,0.34,0.3333,0.49,0.1642,0,2,2,2,247,2,3,1,1,311,1,697,4428,3,2
2012-04-28,summer,2012,April,5,Saturday,Holiday,Clear,0.34,0.3333,0.46,0.1343,2,3,5,5,247,5,3,1,1,311,1,717,14261,3,5
2012-04-28,summer,2012,April,6,Saturday,Holiday,Clear,0.34,0.3333,0.49,0.194,10,18,28,28,247,28,3,1,1,311,1,725,55132,3,28
2012-04-28,summer,2012,April,7,Saturday,Holiday,Clear,0.34,0.3333,0.49,0.1642,10,45,55,55,247,55,3,2,1,321,1,727,154171,3,55
2012-04-28,summer,2012,April,8,Saturday,Holiday,Clear,0.38,0.3939,0.4,0.1343,24,134,158,158,247,158,3,3,2,332,1,727,261001,3,158
2012-04-28,summer,2012,April,9,Saturday,Holiday,Mist,0.38,0.3939,0.37,0.0,45,169,214,214,247,214,3,3,2,332,1,727,159438,3,214
2012-04-28,summer,2012,April,10,Saturday,Holiday,Mist,0.38,0.3939,0.4,0.1642,60,231,291,291,247,291,3,4,2,342,1,727,126257,3,291
2012-04-28,summer,2012,April,11,Saturday,Holiday,Mist,0.38,0.3939,0.4,0.1045,96,262,358,358,247,358,3,4,2,342,2,727,151320,3,358
2012-04-28,summer,2012,April,12,Saturday,Holiday,Mist,0.38,0.3939,0.43,0.0,105,276,381,381,247,381,3,4,2,342,2,728,184414,3,381
2012-04-28,summer,2012,April,13,Saturday,Holiday,Mist,0.4,0.4091,0.37,0.0,120,269,389,389,247,389,3,4,2,342,2,729,184919,3,389
2012-04-28,summer,2012,April,14,Saturday,Holiday,Clear,0.42,0.4242,0.38,0.1045,147,293,440,440,247,440,3,4,2,342,2,729,175652,3,440
2012-04-28,summer,2012,April,15,Saturday,Holiday,Clear,0.42,0.4242,0.41,0.2239,148,260,408,408,247,408,3,4,2,342,2,729,183149,3,408
2012-04-28,summer,2012,April,16,Saturday,Holiday,Mist,0.44,0.4394,0.38,0.194,132,244,376,376,247,376,3,4,2,342,2,730,227748,3,376
2012-04-28,summer,2012,April,17,Saturday,Holiday,Mist,0.42,0.4242,0.41,0.1343,98,224,322,322,247,322,3,4,2,342,2,730,336860,3,322
2012-04-28,summer,2012,April,18,Saturday,Holiday,Light Snow,0.4,0.4091,0.47,0.0,17,73,90,90,247,90,3,2,2,322,1,728,309772,3,90
2012-04-28,summer,2012,April,19,Saturday,Holiday,Light Snow,0.36,0.3485,0.71,0.1343,29,110,139,139,247,139,3,2,2,322,1,728,226789,3,139
2012-04-28,summer,2012,April,20,Saturday,Holiday,Mist,0.38,0.3939,0.66,0.0,21,81,102,102,247,102,3,2,2,322,0,728,164550,3,102
2012-04-28,summer,2012,April,21,Saturday,Holiday,Light Snow,0.36,0.3485,0.71,0.194,12,72,84,84,247,84,3,2,2,322,1,728,125445,3,84
2012-04-28,summer,2012,April,22,Saturday,Holiday,Mist,0.36,0.3485,0.71,0.1343,17,66,83,83,247,83,3,2,2,322,1,728,95612,3,83
2012-04-28,summer,2012,April,23,Saturday,Holiday,Mist,0.38,0.3939,0.76,0.0896,5,37,42,42,247,42,3,2,2,322,0,728,63941,3,42
2012-04-29,summer,2012,April,0,Sunday,Holiday,Light Snow,0.36,0.3485,0.81,0.1343,0,36,36,36,246,36,3,1,2,312,1,726,39130,3,36
2012-04-29,summer,2012,April,1,Sunday,Holiday,Mist,0.36,0.3485,0.81,0.1343,5,37,42,42,246,42,3,2,2,322,1,724,24164,3,42
2012-04-29,summer,2012,April,2,Sunday,Holiday,Mist,0.36,0.3636,0.87,0.1045,4,36,40,40,246,40,3,1,2,312,0,715,16352,3,40
2012-04-29,summer,2012,April,3,Sunday,Holiday,Mist,0.36,0.3485,0.87,0.194,2,14,16,16,246,16,3,1,2,312,1,697,8174,3,16
2012-04-29,summer,2012,April,4,Sunday,Holiday,Mist,0.36,0.3485,0.87,0.1343,0,4,4,4,246,4,3,1,2,312,0,697,4428,3,4
2012-04-29,summer,2012,April,5,Sunday,Holiday,Clear,0.34,0.3636,0.87,0.0,0,6,6,6,246,6,3,1,2,312,0,717,14261,3,6
2012-04-29,summer,2012,April,6,Sunday,Holiday,Clear,0.34,0.3333,0.87,0.1343,1,6,7,7,246,7,3,1,1,311,1,725,55132,3,7
2012-04-29,summer,2012,April,7,Sunday,Holiday,Mist,0.34,0.3333,0.87,0.1343,7,20,27,27,246,27,3,1,1,311,1,727,154171,3,27
2012-04-29,summer,2012,April,8,Sunday,Holiday,Clear,0.38,0.3939,0.76,0.1343,26,81,107,107,246,107,3,2,2,322,0,727,261001,3,107
2012-04-29,summer,2012,April,9,Sunday,Holiday,Clear,0.4,0.4091,0.71,0.1343,52,133,185,185,246,185,3,3,2,332,0,727,159438,3,185
2012-04-29,summer,2012,April,10,Sunday,Holiday,Clear,0.42,0.4242,0.67,0.0896,127,253,380,380,246,380,3,4,2,342,2,727,126257,3,380
2012-04-29,summer,2012,April,11,Sunday,Holiday,Clear,0.46,0.4545,0.51,0.0,128,283,411,411,246,411,3,4,2,342,2,727,151320,3,411
2012-04-29,summer,2012,April,12,Sunday,Holiday,Clear,0.48,0.4697,0.44,0.1045,223,361,584,584,246,584,3,4,2,342,2,728,184414,3,584
2012-04-29,summer,2012,April,13,Sunday,Holiday,Clear,0.5,0.4848,0.45,0.1045,226,369,595,595,246,595,3,4,2,342,2,729,184919,3,595
2012-04-29,summer,2012,April,14,Sunday,Holiday,Clear,0.54,0.5152,0.34,0.0,281,372,653,653,246,653,3,4,3,343,2,729,175652,3,653
2012-04-29,summer,2012,April,15,Sunday,Holiday,Clear,0.56,0.5303,0.37,0.1343,279,324,603,603,246,603,3,4,3,343,2,729,183149,3,603
2012-04-29,summer,2012,April,16,Sunday,Holiday,Clear,0.6,0.6061,0.28,0.194,240,347,587,587,246,587,3,4,3,343,2,730,227748,3,587
2012-04-29,summer,2012,April,17,Sunday,Holiday,Clear,0.62,0.6061,0.27,0.2985,188,334,522,522,246,522,3,4,3,343,2,730,336860,3,522
2012-04-29,summer,2012,April,18,Sunday,Holiday,Clear,0.6,0.6061,0.26,0.2836,164,323,487,487,246,487,3,4,3,343,2,728,309772,3,487
2012-04-29,summer,2012,April,19,Sunday,Holiday,Clear,0.56,0.5303,0.35,0.1343,128,247,375,375,246,375,3,4,3,343,2,728,226789,3,375
2012-04-29,summer,2012,April,20,Sunday,Holiday,Clear,0.56,0.5303,0.32,0.0896,45,198,243,243,246,243,3,3,3,333,2,728,164550,3,243
2012-04-29,summer,2012,April,21,Sunday,Holiday,Clear,0.52,0.5,0.48,0.1343,65,139,204,204,246,204,3,3,3,333,2,728,125445,3,204
2012-04-29,summer,2012,April,22,Sunday,Holiday,Clear,0.5,0.4848,0.45,0.0,23,85,108,108,246,108,3,2,2,322,0,728,95612,3,108
2012-04-29,summer,2012,April,23,Sunday,Holiday,Clear,0.48,0.4697,0.59,0.0,15,67,82,82,246,82,3,2,2,322,0,728,63941,3,82
2012-04-30,summer,2012,April,0,Monday,Workingday,Clear,0.44,0.4394,0.72,0.1045,12,36,48,48,245,48,3,2,2,322,0,726,39130,3,48
2012-04-30,summer,2012,April,1,Monday,Workingday,Clear,0.42,0.4242,0.77,0.0896,9,15,24,24,245,24,3,1,2,312,0,724,24164,3,24
2012-04-30,summer,2012,April,2,Monday,Workingday,Clear,0.42,0.4242,0.71,0.1343,3,5,8,8,245,8,3,1,2,312,0,715,16352,3,8
2012-04-30,summer,2012,April,3,Monday,Workingday,Clear,0.4,0.4091,0.76,0.1642,0,4,4,4,245,4,3,1,2,312,0,697,8174,3,4
2012-04-30,summer,2012,April,4,Monday,Workingday,Clear,0.38,0.3939,0.62,0.2537,0,2,2,2,245,2,3,1,2,312,1,697,4428,3,2
2012-04-30,summer,2012,April,5,Monday,Workingday,Clear,0.38,0.3939,0.62,0.2537,1,19,20,20,245,20,3,1,2,312,1,717,14261,3,20
2012-04-30,summer,2012,April,6,Monday,Workingday,Clear,0.4,0.4091,0.47,0.194,2,121,123,123,245,123,3,2,2,322,1,725,55132,3,123
2012-04-30,summer,2012,April,7,Monday,Workingday,Clear,0.4,0.4091,0.5,0.194,6,343,349,349,245,349,3,4,2,342,1,727,154171,3,349
2012-04-30,summer,2012,April,8,Monday,Workingday,Clear,0.4,0.4091,0.43,0.194,17,579,596,596,245,596,3,4,2,342,2,727,261001,3,596
2012-04-30,summer,2012,April,9,Monday,Workingday,Mist,0.4,0.4091,0.43,0.194,29,239,268,268,245,268,3,3,2,332,1,727,159438,3,268
2012-04-30,summer,2012,April,10,Monday,Workingday,Mist,0.42,0.4242,0.41,0.1642,41,116,157,157,245,157,3,3,2,332,1,727,126257,3,157
2012-04-30,summer,2012,April,11,Monday,Workingday,Mist,0.44,0.4394,0.44,0.1045,52,111,163,163,245,163,3,3,2,332,1,727,151320,3,163
2012-04-30,summer,2012,April,12,Monday,Workingday,Mist,0.44,0.4394,0.47,0.1343,45,180,225,225,245,225,3,3,2,332,1,728,184414,3,225
2012-04-30,summer,2012,April,13,Monday,Workingday,Mist,0.48,0.4697,0.51,0.0896,48,199,247,247,245,247,3,3,2,332,0,729,184919,3,247
2012-04-30,summer,2012,April,14,Monday,Workingday,Mist,0.5,0.4848,0.55,0.1343,56,162,218,218,245,218,3,3,2,332,0,729,175652,3,218
2012-04-30,summer,2012,April,15,Monday,Workingday,Mist,0.52,0.5,0.55,0.1045,55,176,231,231,245,231,3,3,3,333,0,729,183149,3,231
2012-04-30,summer,2012,April,16,Monday,Workingday,Clear,0.56,0.5303,0.6,0.194,44,303,347,347,245,347,3,4,3,343,2,730,227748,3,347
2012-04-30,summer,2012,April,17,Monday,Workingday,Clear,0.56,0.5303,0.6,0.1642,66,617,683,683,245,683,3,4,3,343,2,730,336860,3,683
2012-04-30,summer,2012,April,18,Monday,Workingday,Mist,0.56,0.5303,0.6,0.2239,53,611,664,664,245,664,3,4,3,343,2,728,309772,3,664
2012-04-30,summer,2012,April,19,Monday,Workingday,Mist,0.54,0.5152,0.64,0.2537,51,420,471,471,245,471,3,4,3,343,2,728,226789,3,471
2012-04-30,summer,2012,April,20,Monday,Workingday,Mist,0.52,0.5,0.59,0.194,28,281,309,309,245,309,3,4,3,343,0,728,164550,3,309
2012-04-30,summer,2012,April,21,Monday,Workingday,Mist,0.52,0.5,0.59,0.194,26,195,221,221,245,221,3,3,3,333,0,728,125445,3,221
2012-04-30,summer,2012,April,22,Monday,Workingday,Mist,0.52,0.5,0.55,0.1642,11,123,134,134,245,134,3,2,3,323,0,728,95612,3,134
2012-04-30,summer,2012,April,23,Monday,Workingday,Mist,0.52,0.5,0.55,0.2239,10,50,60,60,245,60,3,2,3,323,0,728,63941,3,60
2012-05-01,summer,2012,May,0,Tuesday,Workingday,Mist,0.5,0.4848,0.59,0.194,7,28,35,35,244,35,3,1,2,312,0,726,39130,3,35
2012-05-01,summer,2012,May,1,Tuesday,Workingday,Mist,0.5,0.4848,0.63,0.1343,0,21,21,21,244,21,3,1,2,312,0,724,24164,3,21
2012-05-01,summer,2012,May,2,Tuesday,Workingday,Mist,0.5,0.4848,0.72,0.0896,1,7,8,8,244,8,3,1,2,312,0,715,16352,3,8
2012-05-01,summer,2012,May,3,Tuesday,Workingday,Mist,0.5,0.4848,0.77,0.0,1,2,3,3,244,3,3,1,2,312,0,697,8174,3,3
2012-05-01,summer,2012,May,4,Tuesday,Workingday,Mist,0.52,0.5,0.72,0.0896,1,7,8,8,244,8,3,1,3,313,0,697,4428,3,8
2012-05-01,summer,2012,May,5,Tuesday,Workingday,Mist,0.52,0.5,0.72,0.0896,0,17,17,17,244,17,3,1,3,313,0,717,14261,3,17
2012-05-01,summer,2012,May,6,Tuesday,Workingday,Light Snow,0.52,0.5,0.77,0.1045,2,24,26,26,244,26,3,1,3,313,0,725,55132,3,26
2012-05-01,summer,2012,May,7,Tuesday,Workingday,Mist,0.5,0.4848,0.94,0.2537,8,161,169,169,244,169,3,3,2,332,0,727,154171,3,169
2012-05-01,summer,2012,May,8,Tuesday,Workingday,Mist,0.52,0.5,0.94,0.2836,19,538,557,557,244,557,3,4,3,343,0,727,261001,3,557
2012-05-01,summer,2012,May,9,Tuesday,Workingday,Mist,0.54,0.5152,0.88,0.194,18,331,349,349,244,349,3,4,3,343,0,727,159438,3,349
2012-05-01,summer,2012,May,10,Tuesday,Workingday,Clear,0.62,0.5909,0.78,0.2537,30,144,174,174,244,174,3,3,3,333,0,727,126257,3,174
2012-05-01,summer,2012,May,11,Tuesday,Workingday,Mist,0.66,0.6212,0.65,0.2836,50,179,229,229,244,229,3,3,3,333,2,727,151320,3,229
2012-05-01,summer,2012,May,12,Tuesday,Workingday,Mist,0.7,0.6515,0.58,0.2239,41,228,269,269,244,269,3,3,4,334,2,728,184414,3,269
2012-05-01,summer,2012,May,13,Tuesday,Workingday,Mist,0.72,0.6667,0.51,0.2239,41,208,249,249,244,249,3,3,4,334,2,729,184919,3,249
2012-05-01,summer,2012,May,14,Tuesday,Workingday,Mist,0.74,0.6667,0.48,0.2537,37,167,204,204,244,204,3,3,4,334,2,729,175652,3,204
2012-05-01,summer,2012,May,15,Tuesday,Workingday,Mist,0.74,0.6667,0.45,0.2239,48,186,234,234,244,234,3,3,4,334,2,729,183149,3,234
2012-05-01,summer,2012,May,16,Tuesday,Workingday,Clear,0.74,0.6667,0.45,0.194,41,313,354,354,244,354,3,4,4,344,2,730,227748,3,354
2012-05-01,summer,2012,May,17,Tuesday,Workingday,Clear,0.74,0.6667,0.48,0.0896,65,616,681,681,244,681,3,4,4,344,2,730,336860,3,681
2012-05-01,summer,2012,May,18,Tuesday,Workingday,Clear,0.7,0.6515,0.54,0.1343,81,662,743,743,244,743,3,4,4,344,2,728,309772,3,743
2012-05-01,summer,2012,May,19,Tuesday,Workingday,Clear,0.7,0.6515,0.54,0.1343,58,429,487,487,244,487,3,4,4,344,2,728,226789,3,487
2012-05-01,summer,2012,May,20,Tuesday,Workingday,Clear,0.66,0.6212,0.61,0.1642,36,299,335,335,244,335,3,4,3,343,2,728,164550,3,335
2012-05-01,summer,2012,May,21,Tuesday,Workingday,Clear,0.64,0.6061,0.65,0.1343,31,251,282,282,244,282,3,4,3,343,0,728,125445,3,282
2012-05-01,summer,2012,May,22,Tuesday,Workingday,Clear,0.64,0.6061,0.65,0.0,21,190,211,211,244,211,3,3,3,333,0,728,95612,3,211
2012-05-01,summer,2012,May,23,Tuesday,Workingday,Clear,0.6,0.5758,0.78,0.0,16,79,95,95,244,95,3,2,3,323,0,728,63941,3,95
2012-05-02,summer,2012,May,0,Wednesday,Workingday,Clear,0.6,0.5758,0.78,0.1045,4,43,47,47,243,47,3,2,3,323,0,726,39130,3,47
2012-05-02,summer,2012,May,1,Wednesday,Workingday,Clear,0.56,0.5303,0.83,0.0,8,7,15,15,243,15,3,1,3,313,0,724,24164,3,15
2012-05-02,summer,2012,May,2,Wednesday,Workingday,Clear,0.56,0.5303,0.83,0.0,7,9,16,16,243,16,3,1,3,313,0,715,16352,3,16
2012-05-02,summer,2012,May,3,Wednesday,Workingday,Clear,0.56,0.5303,0.83,0.0896,0,6,6,6,243,6,3,1,3,313,0,697,8174,3,6
2012-05-02,summer,2012,May,4,Wednesday,Workingday,Clear,0.54,0.5152,0.88,0.0,2,2,4,4,243,4,3,1,3,313,0,697,4428,3,4
2012-05-02,summer,2012,May,5,Wednesday,Workingday,Clear,0.54,0.5152,0.9,0.1343,2,31,33,33,243,33,3,1,3,313,0,717,14261,3,33
2012-05-02,summer,2012,May,6,Wednesday,Workingday,Light Snow,0.56,0.5303,0.84,0.0,3,117,120,120,243,120,3,2,3,323,0,725,55132,3,120
2012-05-02,summer,2012,May,7,Wednesday,Workingday,Mist,0.54,0.5152,0.88,0.194,14,344,358,358,243,358,3,4,3,343,0,727,154171,3,358
2012-05-02,summer,2012,May,8,Wednesday,Workingday,Mist,0.56,0.5303,0.88,0.0,26,640,666,666,243,666,3,4,3,343,0,727,261001,3,666
2012-05-02,summer,2012,May,9,Wednesday,Workingday,Mist,0.56,0.5303,0.88,0.0,26,289,315,315,243,315,3,4,3,343,0,727,159438,3,315
2012-05-02,summer,2012,May,10,Wednesday,Workingday,Mist,0.58,0.5455,0.83,0.1045,28,147,175,175,243,175,3,3,3,333,0,727,126257,3,175
2012-05-02,summer,2012,May,11,Wednesday,Workingday,Mist,0.58,0.5455,0.81,0.1343,39,145,184,184,243,184,3,3,3,333,0,727,151320,3,184
2012-05-02,summer,2012,May,12,Wednesday,Workingday,Mist,0.58,0.5455,0.83,0.2239,35,210,245,245,243,245,3,3,3,333,0,728,184414,3,245
2012-05-02,summer,2012,May,13,Wednesday,Workingday,Mist,0.58,0.5455,0.78,0.194,49,179,228,228,243,228,3,3,3,333,0,729,184919,3,228
2012-05-02,summer,2012,May,14,Wednesday,Workingday,Clear,0.62,0.6061,0.69,0.0896,51,189,240,240,243,240,3,3,3,333,0,729,175652,3,240
2012-05-02,summer,2012,May,15,Wednesday,Workingday,Clear,0.64,0.6061,0.65,0.194,52,204,256,256,243,256,3,3,3,333,2,729,183149,3,256
2012-05-02,summer,2012,May,16,Wednesday,Workingday,Clear,0.64,0.6061,0.65,0.1642,54,313,367,367,243,367,3,4,3,343,2,730,227748,3,367
2012-05-02,summer,2012,May,17,Wednesday,Workingday,Clear,0.6,0.5909,0.73,0.2537,70,659,729,729,243,729,3,4,3,343,2,730,336860,3,729
2012-05-02,summer,2012,May,18,Wednesday,Workingday,Clear,0.56,0.5303,0.73,0.2239,43,770,813,813,243,813,3,4,3,343,2,728,309772,3,813
2012-05-02,summer,2012,May,19,Wednesday,Workingday,Clear,0.54,0.5152,0.77,0.2537,43,461,504,504,243,504,3,4,3,343,2,728,226789,3,504
2012-05-02,summer,2012,May,20,Wednesday,Workingday,Clear,0.52,0.5,0.77,0.2537,42,296,338,338,243,338,3,4,3,343,0,728,164550,3,338
2012-05-02,summer,2012,May,21,Wednesday,Workingday,Clear,0.52,0.5,0.77,0.2239,21,218,239,239,243,239,3,3,3,333,0,728,125445,3,239
2012-05-02,summer,2012,May,22,Wednesday,Workingday,Clear,0.5,0.4848,0.82,0.2239,27,146,173,173,243,173,3,3,2,332,0,728,95612,3,173
2012-05-02,summer,2012,May,23,Wednesday,Workingday,Mist,0.5,0.4848,0.77,0.2537,21,77,98,98,243,98,3,2,2,322,0,728,63941,3,98
2012-05-03,summer,2012,May,0,Thursday,Workingday,Mist,0.48,0.4697,0.82,0.2239,15,75,90,90,242,90,3,2,2,322,0,726,39130,3,90
2012-05-03,summer,2012,May,1,Thursday,Workingday,Mist,0.46,0.4545,0.88,0.1045,9,15,24,24,242,24,3,1,2,312,0,724,24164,3,24
2012-05-03,summer,2012,May,2,Thursday,Workingday,Mist,0.46,0.4545,0.88,0.1343,4,13,17,17,242,17,3,1,2,312,0,715,16352,3,17
2012-05-03,summer,2012,May,3,Thursday,Workingday,Mist,0.46,0.4545,0.88,0.0,2,4,6,6,242,6,3,1,2,312,0,697,8174,3,6
2012-05-03,summer,2012,May,4,Thursday,Workingday,Mist,0.46,0.4545,0.88,0.2537,0,2,2,2,242,2,3,1,2,312,0,697,4428,3,2
2012-05-03,summer,2012,May,5,Thursday,Workingday,Mist,0.46,0.4545,0.88,0.2537,1,20,21,21,242,21,3,1,2,312,0,717,14261,3,21
2012-05-03,summer,2012,May,6,Thursday,Workingday,Mist,0.46,0.4545,0.88,0.1642,8,128,136,136,242,136,3,2,2,322,0,725,55132,3,136
2012-05-03,summer,2012,May,7,Thursday,Workingday,Light Snow,0.44,0.4394,0.94,0.1045,8,376,384,384,242,384,3,4,2,342,0,727,154171,3,384
2012-05-03,summer,2012,May,8,Thursday,Workingday,Light Snow,0.46,0.4545,0.88,0.194,19,608,627,627,242,627,3,4,2,342,0,727,261001,3,627
2012-05-03,summer,2012,May,9,Thursday,Workingday,Mist,0.48,0.4697,0.88,0.1045,25,279,304,304,242,304,3,4,2,342,0,727,159438,3,304
2012-05-03,summer,2012,May,10,Thursday,Workingday,Mist,0.52,0.5,0.77,0.0,36,132,168,168,242,168,3,3,3,333,0,727,126257,3,168
2012-05-03,summer,2012,May,11,Thursday,Workingday,Clear,0.54,0.5152,0.77,0.0,34,167,201,201,242,201,3,3,3,333,0,727,151320,3,201
2012-05-03,summer,2012,May,12,Thursday,Workingday,Clear,0.56,0.5303,0.73,0.1343,64,237,301,301,242,301,3,4,3,343,0,728,184414,3,301
2012-05-03,summer,2012,May,13,Thursday,Workingday,Clear,0.6,0.5909,0.69,0.194,48,217,265,265,242,265,3,3,3,333,0,729,184919,3,265
2012-05-03,summer,2012,May,14,Thursday,Workingday,Clear,0.64,0.6061,0.65,0.194,33,171,204,204,242,204,3,3,3,333,0,729,175652,3,204
2012-05-03,summer,2012,May,15,Thursday,Workingday,Clear,0.66,0.6212,0.61,0.194,63,220,283,283,242,283,3,4,3,343,2,729,183149,3,283
2012-05-03,summer,2012,May,16,Thursday,Workingday,Clear,0.68,0.6364,0.57,0.1642,45,325,370,370,242,370,3,4,4,344,2,730,227748,3,370
2012-05-03,summer,2012,May,17,Thursday,Workingday,Clear,0.72,0.6667,0.54,0.1343,87,617,704,704,242,704,3,4,4,344,2,730,336860,3,704
2012-05-03,summer,2012,May,18,Thursday,Workingday,Clear,0.72,0.6667,0.58,0.1343,64,642,706,706,242,706,3,4,4,344,2,728,309772,3,706
2012-05-03,summer,2012,May,19,Thursday,Workingday,Clear,0.7,0.6515,0.61,0.194,55,467,522,522,242,522,3,4,4,344,2,728,226789,3,522
2012-05-03,summer,2012,May,20,Thursday,Workingday,Clear,0.64,0.6061,0.73,0.194,52,368,420,420,242,420,3,4,3,343,2,728,164550,3,420
2012-05-03,summer,2012,May,21,Thursday,Workingday,Clear,0.62,0.5909,0.78,0.1343,42,257,299,299,242,299,3,4,3,343,0,728,125445,3,299
2012-05-03,summer,2012,May,22,Thursday,Workingday,Clear,0.62,0.5909,0.78,0.0,29,217,246,246,242,246,3,3,3,333,0,728,95612,3,246
2012-05-03,summer,2012,May,23,Thursday,Workingday,Clear,0.6,0.5606,0.83,0.0,21,100,121,121,242,121,3,2,3,323,0,728,63941,3,121
2012-05-04,summer,2012,May,0,Friday,Workingday,Clear,0.6,0.5758,0.78,0.3284,19,70,89,89,241,89,3,2,3,323,0,726,39130,3,89
2012-05-04,summer,2012,May,1,Friday,Workingday,Clear,0.6,0.5758,0.78,0.1045,15,33,48,48,241,48,3,2,3,323,0,724,24164,3,48
2012-05-04,summer,2012,May,2,Friday,Workingday,Clear,0.58,0.5455,0.83,0.1343,0,11,11,11,241,11,3,1,3,313,0,715,16352,3,11
2012-05-04,summer,2012,May,3,Friday,Workingday,Clear,0.56,0.5303,0.88,0.2239,0,14,14,14,241,14,3,1,3,313,0,697,8174,3,14
2012-05-04,summer,2012,May,4,Friday,Workingday,Clear,0.56,0.5303,0.88,0.194,0,4,4,4,241,4,3,1,3,313,0,697,4428,3,4
2012-05-04,summer,2012,May,5,Friday,Workingday,Clear,0.56,0.5303,0.88,0.194,0,24,24,24,241,24,3,1,3,313,0,717,14261,3,24
2012-05-04,summer,2012,May,6,Friday,Workingday,Clear,0.54,0.5152,0.94,0.1045,8,127,135,135,241,135,3,2,3,323,0,725,55132,3,135
2012-05-04,summer,2012,May,7,Friday,Workingday,Clear,0.56,0.5303,0.88,0.0,9,347,356,356,241,356,3,4,3,343,0,727,154171,3,356
2012-05-04,summer,2012,May,8,Friday,Workingday,Clear,0.56,0.5303,0.88,0.0,34,584,618,618,241,618,3,4,3,343,0,727,261001,3,618
2012-05-04,summer,2012,May,9,Friday,Workingday,Clear,0.6,0.5758,0.78,0.0,32,262,294,294,241,294,3,4,3,343,0,727,159438,3,294
2012-05-04,summer,2012,May,10,Friday,Workingday,Mist,0.62,0.5909,0.73,0.1343,45,154,199,199,241,199,3,3,3,333,0,727,126257,3,199
2012-05-04,summer,2012,May,11,Friday,Workingday,Mist,0.7,0.6515,0.61,0.0,77,181,258,258,241,258,3,3,4,334,2,727,151320,3,258
2012-05-04,summer,2012,May,12,Friday,Workingday,Light Snow,0.62,0.5909,0.78,0.3582,46,125,171,171,241,171,3,3,3,333,0,728,184414,3,171
2012-05-04,summer,2012,May,13,Friday,Workingday,Mist,0.64,0.6061,0.73,0.0,71,207,278,278,241,278,3,3,3,333,0,729,184919,3,278
2012-05-04,summer,2012,May,14,Friday,Workingday,Mist,0.66,0.6212,0.74,0.2836,83,159,242,242,241,242,3,3,3,333,2,729,175652,3,242
2012-05-04,summer,2012,May,15,Friday,Workingday,Mist,0.72,0.6818,0.62,0.1045,103,240,343,343,241,343,3,4,4,344,2,729,183149,3,343
2012-05-04,summer,2012,May,16,Friday,Workingday,Clear,0.76,0.6818,0.48,0.1642,82,358,440,440,241,440,3,4,4,344,2,730,227748,3,440
2012-05-04,summer,2012,May,17,Friday,Workingday,Clear,0.7,0.6515,0.54,0.4627,96,547,643,643,241,643,3,4,4,344,2,730,336860,3,643
2012-05-04,summer,2012,May,18,Friday,Workingday,Clear,0.7,0.6515,0.54,0.4627,77,564,641,641,241,641,3,4,4,344,2,728,309772,3,641
2012-05-04,summer,2012,May,19,Friday,Workingday,Clear,0.7,0.6515,0.51,0.1343,64,388,452,452,241,452,3,4,4,344,2,728,226789,3,452
2012-05-04,summer,2012,May,20,Friday,Workingday,Clear,0.68,0.6364,0.51,0.1045,58,255,313,313,241,313,3,4,4,344,2,728,164550,3,313
2012-05-04,summer,2012,May,21,Friday,Workingday,Clear,0.64,0.6061,0.69,0.194,49,186,235,235,241,235,3,3,3,333,0,728,125445,3,235
2012-05-04,summer,2012,May,22,Friday,Workingday,Clear,0.6,0.5606,0.83,0.1343,50,182,232,232,241,232,3,3,3,333,0,728,95612,3,232
2012-05-04,summer,2012,May,23,Friday,Workingday,Clear,0.6,0.5606,0.83,0.0896,51,205,256,256,241,256,3,3,3,333,0,728,63941,3,256
2012-05-05,summer,2012,May,0,Saturday,Holiday,Clear,0.6,0.5606,0.83,0.0,42,111,153,153,240,153,3,3,3,333,0,726,39130,3,153
2012-05-05,summer,2012,May,1,Saturday,Holiday,Clear,0.6,0.5606,0.83,0.0,28,79,107,107,240,107,3,2,3,323,0,724,24164,3,107
2012-05-05,summer,2012,May,2,Saturday,Holiday,Clear,0.58,0.5455,0.88,0.0,24,51,75,75,240,75,3,2,3,323,0,715,16352,3,75
2012-05-05,summer,2012,May,3,Saturday,Holiday,Clear,0.58,0.5455,0.83,0.0,11,21,32,32,240,32,3,1,3,313,0,697,8174,3,32
2012-05-05,summer,2012,May,4,Saturday,Holiday,Clear,0.56,0.5303,0.88,0.1045,0,9,9,9,240,9,3,1,3,313,0,697,4428,3,9
2012-05-05,summer,2012,May,5,Saturday,Holiday,Clear,0.56,0.5303,0.88,0.0896,8,14,22,22,240,22,3,1,3,313,0,717,14261,3,22
2012-05-05,summer,2012,May,6,Saturday,Holiday,Mist,0.54,0.5152,0.94,0.0,9,33,42,42,240,42,3,2,3,323,0,725,55132,3,42
2012-05-05,summer,2012,May,7,Saturday,Holiday,Clear,0.56,0.5303,0.88,0.0,8,79,87,87,240,87,3,2,3,323,0,727,154171,3,87
2012-05-05,summer,2012,May,8,Saturday,Holiday,Clear,0.58,0.5455,0.83,0.0896,42,155,197,197,240,197,3,3,3,333,0,727,261001,3,197
2012-05-05,summer,2012,May,9,Saturday,Holiday,Clear,0.62,0.5909,0.78,0.1045,61,223,284,284,240,284,3,4,3,343,0,727,159438,3,284
2012-05-05,summer,2012,May,10,Saturday,Holiday,Clear,0.66,0.6212,0.65,0.1343,148,284,432,432,240,432,3,4,3,343,2,727,126257,3,432
2012-05-05,summer,2012,May,11,Saturday,Holiday,Clear,0.7,0.6515,0.58,0.0896,221,354,575,575,240,575,3,4,4,344,2,727,151320,3,575
2012-05-05,summer,2012,May,12,Saturday,Holiday,Clear,0.72,0.6667,0.58,0.1045,220,330,550,550,240,550,3,4,4,344,2,728,184414,3,550
2012-05-05,summer,2012,May,13,Saturday,Holiday,Clear,0.74,0.6818,0.55,0.1343,217,307,524,524,240,524,3,4,4,344,2,729,184919,3,524
2012-05-05,summer,2012,May,14,Saturday,Holiday,Light Snow,0.7,0.6515,0.61,0.2985,187,241,428,428,240,428,3,4,4,344,2,729,175652,3,428
2012-05-05,summer,2012,May,15,Saturday,Holiday,Light Snow,0.66,0.6212,0.74,0.194,241,300,541,541,240,541,3,4,3,343,2,729,183149,3,541
2012-05-05,summer,2012,May,16,Saturday,Holiday,Mist,0.68,0.6364,0.65,0.3881,230,310,540,540,240,540,3,4,4,344,2,730,227748,3,540
2012-05-05,summer,2012,May,17,Saturday,Holiday,Mist,0.68,0.6364,0.65,0.2985,204,298,502,502,240,502,3,4,4,344,2,730,336860,3,502
2012-05-05,summer,2012,May,18,Saturday,Holiday,Mist,0.66,0.6212,0.69,0.3582,156,278,434,434,240,434,3,4,3,343,2,728,309772,3,434
2012-05-05,summer,2012,May,19,Saturday,Holiday,Mist,0.62,0.5909,0.73,0.3284,151,254,405,405,240,405,3,4,3,343,2,728,226789,3,405
2012-05-05,summer,2012,May,20,Saturday,Holiday,Clear,0.6,0.5758,0.78,0.2537,100,209,309,309,240,309,3,4,3,343,2,728,164550,3,309
2012-05-05,summer,2012,May,21,Saturday,Holiday,Mist,0.58,0.5455,0.78,0.2239,86,183,269,269,240,269,3,3,3,333,0,728,125445,3,269
2012-05-05,summer,2012,May,22,Saturday,Holiday,Mist,0.58,0.5455,0.78,0.194,67,150,217,217,240,217,3,3,3,333,0,728,95612,3,217
2012-05-05,summer,2012,May,23,Saturday,Holiday,Mist,0.56,0.5303,0.83,0.2836,35,114,149,149,240,149,3,3,3,333,0,728,63941,3,149
2012-05-06,summer,2012,May,0,Sunday,Holiday,Mist,0.56,0.5303,0.83,0.1343,23,111,134,134,239,134,3,2,3,323,0,726,39130,3,134
2012-05-06,summer,2012,May,1,Sunday,Holiday,Mist,0.54,0.5152,0.83,0.2239,37,84,121,121,239,121,3,2,3,323,0,724,24164,3,121
2012-05-06,summer,2012,May,2,Sunday,Holiday,Mist,0.54,0.5152,0.83,0.2836,29,64,93,93,239,93,3,2,3,323,0,715,16352,3,93
2012-05-06,summer,2012,May,3,Sunday,Holiday,Mist,0.54,0.5152,0.83,0.194,9,19,28,28,239,28,3,1,3,313,0,697,8174,3,28
2012-05-06,summer,2012,May,4,Sunday,Holiday,Light Snow,0.52,0.5,0.83,0.1642,9,7,16,16,239,16,3,1,3,313,0,697,4428,3,16
2012-05-06,summer,2012,May,5,Sunday,Holiday,Light Snow,0.52,0.5,0.83,0.1642,1,10,11,11,239,11,3,1,3,313,0,717,14261,3,11
2012-05-06,summer,2012,May,6,Sunday,Holiday,Light Snow,0.52,0.5,0.83,0.2239,3,14,17,17,239,17,3,1,3,313,0,725,55132,3,17
2012-05-06,summer,2012,May,7,Sunday,Holiday,Light Snow,0.52,0.5,0.83,0.1642,5,31,36,36,239,36,3,1,3,313,0,727,154171,3,36
2012-05-06,summer,2012,May,8,Sunday,Holiday,Mist,0.5,0.4848,0.88,0.1343,23,91,114,114,239,114,3,2,2,322,0,727,261001,3,114
2012-05-06,summer,2012,May,9,Sunday,Holiday,Mist,0.52,0.5,0.83,0.1642,63,128,191,191,239,191,3,3,3,333,0,727,159438,3,191
2012-05-06,summer,2012,May,10,Sunday,Holiday,Mist,0.54,0.5152,0.77,0.1045,112,221,333,333,239,333,3,4,3,343,2,727,126257,3,333
2012-05-06,summer,2012,May,11,Sunday,Holiday,Clear,0.56,0.5303,0.73,0.1045,144,270,414,414,239,414,3,4,3,343,2,727,151320,3,414
2012-05-06,summer,2012,May,12,Sunday,Holiday,Mist,0.6,0.6061,0.64,0.0896,207,351,558,558,239,558,3,4,3,343,2,728,184414,3,558
2012-05-06,summer,2012,May,13,Sunday,Holiday,Mist,0.6,0.6061,0.64,0.0,197,368,565,565,239,565,3,4,3,343,2,729,184919,3,565
2012-05-06,summer,2012,May,14,Sunday,Holiday,Mist,0.6,0.6061,0.64,0.1045,226,292,518,518,239,518,3,4,3,343,2,729,175652,3,518
2012-05-06,summer,2012,May,15,Sunday,Holiday,Mist,0.62,0.6061,0.61,0.1045,229,342,571,571,239,571,3,4,3,343,2,729,183149,3,571
2012-05-06,summer,2012,May,16,Sunday,Holiday,Mist,0.62,0.6061,0.61,0.0,181,363,544,544,239,544,3,4,3,343,2,730,227748,3,544
2012-05-06,summer,2012,May,17,Sunday,Holiday,Mist,0.62,0.6061,0.65,0.1343,195,316,511,511,239,511,3,4,3,343,2,730,336860,3,511
2012-05-06,summer,2012,May,18,Sunday,Holiday,Mist,0.62,0.6061,0.61,0.194,131,332,463,463,239,463,3,4,3,343,2,728,309772,3,463
2012-05-06,summer,2012,May,19,Sunday,Holiday,Mist,0.6,0.6061,0.64,0.1642,117,266,383,383,239,383,3,4,3,343,2,728,226789,3,383
2012-05-06,summer,2012,May,20,Sunday,Holiday,Clear,0.6,0.6061,0.64,0.194,73,203,276,276,239,276,3,3,3,333,2,728,164550,3,276
2012-05-06,summer,2012,May,21,Sunday,Holiday,Clear,0.56,0.5303,0.73,0.194,55,148,203,203,239,203,3,3,3,333,0,728,125445,3,203
2012-05-06,summer,2012,May,22,Sunday,Holiday,Clear,0.56,0.5303,0.73,0.1642,44,113,157,157,239,157,3,3,3,333,0,728,95612,3,157
2012-05-06,summer,2012,May,23,Sunday,Holiday,Clear,0.52,0.5,0.77,0.194,22,80,102,102,239,102,3,2,3,323,0,728,63941,3,102
2012-05-07,summer,2012,May,0,Monday,Workingday,Mist,0.52,0.5,0.77,0.1343,13,21,34,34,238,34,3,1,3,313,0,726,39130,3,34
2012-05-07,summer,2012,May,1,Monday,Workingday,Mist,0.52,0.5,0.77,0.194,1,8,9,9,238,9,3,1,3,313,0,724,24164,3,9
2012-05-07,summer,2012,May,2,Monday,Workingday,Clear,0.5,0.4848,0.77,0.194,1,5,6,6,238,6,3,1,2,312,0,715,16352,3,6
2012-05-07,summer,2012,May,3,Monday,Workingday,Clear,0.5,0.4848,0.77,0.194,2,3,5,5,238,5,3,1,2,312,0,697,8174,3,5
2012-05-07,summer,2012,May,4,Monday,Workingday,Mist,0.46,0.4545,0.88,0.1343,0,2,2,2,238,2,3,1,2,312,0,697,4428,3,2
2012-05-07,summer,2012,May,5,Monday,Workingday,Clear,0.46,0.4545,0.88,0.1045,2,21,23,23,238,23,3,1,2,312,0,717,14261,3,23
2012-05-07,summer,2012,May,6,Monday,Workingday,Clear,0.46,0.4545,0.88,0.1045,8,134,142,142,238,142,3,2,2,322,0,725,55132,3,142
2012-05-07,summer,2012,May,7,Monday,Workingday,Mist,0.48,0.4697,0.82,0.1045,18,367,385,385,238,385,3,4,2,342,0,727,154171,3,385
2012-05-07,summer,2012,May,8,Monday,Workingday,Mist,0.5,0.4848,0.82,0.194,31,608,639,639,238,639,3,4,2,342,2,727,261001,3,639
2012-05-07,summer,2012,May,9,Monday,Workingday,Mist,0.5,0.4848,0.82,0.2239,61,289,350,350,238,350,3,4,2,342,0,727,159438,3,350
2012-05-07,summer,2012,May,10,Monday,Workingday,Mist,0.52,0.5,0.77,0.194,62,128,190,190,238,190,3,3,3,333,0,727,126257,3,190
2012-05-07,summer,2012,May,11,Monday,Workingday,Mist,0.54,0.5152,0.73,0.194,64,149,213,213,238,213,3,3,3,333,0,727,151320,3,213
2012-05-07,summer,2012,May,12,Monday,Workingday,Mist,0.56,0.5303,0.68,0.2239,74,189,263,263,238,263,3,3,3,333,0,728,184414,3,263
2012-05-07,summer,2012,May,13,Monday,Workingday,Mist,0.6,0.6212,0.53,0.3284,75,197,272,272,238,272,3,3,3,333,2,729,184919,3,272
2012-05-07,summer,2012,May,14,Monday,Workingday,Mist,0.62,0.6212,0.5,0.3582,59,180,239,239,238,239,3,3,3,333,2,729,175652,3,239
2012-05-07,summer,2012,May,15,Monday,Workingday,Mist,0.62,0.6212,0.53,0.2985,76,186,262,262,238,262,3,3,3,333,2,729,183149,3,262
2012-05-07,summer,2012,May,16,Monday,Workingday,Mist,0.6,0.6212,0.53,0.3881,68,320,388,388,238,388,3,4,3,343,2,730,227748,3,388
2012-05-07,summer,2012,May,17,Monday,Workingday,Mist,0.6,0.6212,0.53,0.3284,102,667,769,769,238,769,3,4,3,343,2,730,336860,3,769
2012-05-07,summer,2012,May,18,Monday,Workingday,Mist,0.6,0.6212,0.53,0.3582,78,602,680,680,238,680,3,4,3,343,2,728,309772,3,680
2012-05-07,summer,2012,May,19,Monday,Workingday,Clear,0.58,0.5455,0.56,0.3284,83,463,546,546,238,546,3,4,3,343,2,728,226789,3,546
2012-05-07,summer,2012,May,20,Monday,Workingday,Clear,0.54,0.5152,0.52,0.2836,46,277,323,323,238,323,3,4,3,343,2,728,164550,3,323
2012-05-07,summer,2012,May,21,Monday,Workingday,Mist,0.54,0.5152,0.45,0.2239,37,210,247,247,238,247,3,3,3,333,2,728,125445,3,247
2012-05-07,summer,2012,May,22,Monday,Workingday,Mist,0.54,0.5152,0.45,0.2537,26,147,173,173,238,173,3,3,3,333,0,728,95612,3,173
2012-05-07,summer,2012,May,23,Monday,Workingday,Mist,0.54,0.5152,0.45,0.194,21,92,113,113,238,113,3,2,3,323,0,728,63941,3,113
2012-05-08,summer,2012,May,0,Tuesday,Workingday,Mist,0.52,0.5,0.52,0.2537,10,28,38,38,237,38,3,1,3,313,0,726,39130,3,38
2012-05-08,summer,2012,May,1,Tuesday,Workingday,Mist,0.52,0.5,0.59,0.2239,6,3,9,9,237,9,3,1,3,313,0,724,24164,3,9
2012-05-08,summer,2012,May,2,Tuesday,Workingday,Mist,0.52,0.5,0.63,0.2985,9,7,16,16,237,16,3,1,3,313,0,715,16352,3,16
2012-05-08,summer,2012,May,3,Tuesday,Workingday,Mist,0.52,0.5,0.68,0.2836,2,4,6,6,237,6,3,1,3,313,0,697,8174,3,6
2012-05-08,summer,2012,May,4,Tuesday,Workingday,Mist,0.52,0.5,0.68,0.3284,0,5,5,5,237,5,3,1,3,313,0,697,4428,3,5
2012-05-08,summer,2012,May,5,Tuesday,Workingday,Mist,0.52,0.5,0.72,0.2836,0,20,20,20,237,20,3,1,3,313,0,717,14261,3,20
2012-05-08,summer,2012,May,6,Tuesday,Workingday,Clear,0.5,0.4848,0.77,0.2985,7,158,165,165,237,165,3,3,2,332,0,725,55132,3,165
2012-05-08,summer,2012,May,7,Tuesday,Workingday,Clear,0.52,0.5,0.72,0.2836,21,442,463,463,237,463,3,4,3,343,2,727,154171,3,463
2012-05-08,summer,2012,May,8,Tuesday,Workingday,Mist,0.54,0.5152,0.73,0.2985,36,605,641,641,237,641,3,4,3,343,2,727,261001,3,641
2012-05-08,summer,2012,May,9,Tuesday,Workingday,Mist,0.56,0.5303,0.68,0.3582,37,258,295,295,237,295,3,4,3,343,2,727,159438,3,295
2012-05-08,summer,2012,May,10,Tuesday,Workingday,Mist,0.58,0.5455,0.68,0.4179,46,111,157,157,237,157,3,3,3,333,0,727,126257,3,157
2012-05-08,summer,2012,May,11,Tuesday,Workingday,Mist,0.6,0.6061,0.64,0.3881,60,157,217,217,237,217,3,3,3,333,2,727,151320,3,217
2012-05-08,summer,2012,May,12,Tuesday,Workingday,Mist,0.62,0.6061,0.65,0.3284,60,203,263,263,237,263,3,3,3,333,2,728,184414,3,263
2012-05-08,summer,2012,May,13,Tuesday,Workingday,Light Snow,0.64,0.6061,0.65,0.2537,53,166,219,219,237,219,3,3,3,333,2,729,184919,3,219
2012-05-08,summer,2012,May,14,Tuesday,Workingday,Light Snow,0.62,0.6061,0.69,0.3284,8,63,71,71,237,71,3,2,3,323,0,729,175652,3,71
2012-05-08,summer,2012,May,15,Tuesday,Workingday,Light Snow,0.62,0.5909,0.73,0.2537,40,94,134,134,237,134,3,2,3,323,0,729,183149,3,134
2012-05-08,summer,2012,May,16,Tuesday,Workingday,Light Snow,0.64,0.6061,0.73,0.2239,54,335,389,389,237,389,3,4,3,343,2,730,227748,3,389
2012-05-08,summer,2012,May,17,Tuesday,Workingday,Mist,0.64,0.6061,0.69,0.2836,77,640,717,717,237,717,3,4,3,343,2,730,336860,3,717
2012-05-08,summer,2012,May,18,Tuesday,Workingday,Mist,0.64,0.6061,0.69,0.2836,69,641,710,710,237,710,3,4,3,343,2,728,309772,3,710
2012-05-08,summer,2012,May,19,Tuesday,Workingday,Mist,0.64,0.6061,0.69,0.2836,59,399,458,458,237,458,3,4,3,343,2,728,226789,3,458
2012-05-08,summer,2012,May,20,Tuesday,Workingday,Mist,0.64,0.6061,0.69,0.2836,40,262,302,302,237,302,3,4,3,343,2,728,164550,3,302
2012-05-08,summer,2012,May,21,Tuesday,Workingday,Mist,0.64,0.6061,0.65,0.2836,21,202,223,223,237,223,3,3,3,333,0,728,125445,3,223
2012-05-08,summer,2012,May,22,Tuesday,Workingday,Light Snow,0.6,0.5758,0.78,0.2537,13,134,147,147,237,147,3,3,3,333,0,728,95612,3,147
2012-05-08,summer,2012,May,23,Tuesday,Workingday,Light Snow,0.6,0.5758,0.78,0.3284,10,53,63,63,237,63,3,2,3,323,0,728,63941,3,63
2012-05-09,summer,2012,May,0,Wednesday,Workingday,Mist,0.58,0.5455,0.83,0.194,8,27,35,35,236,35,3,1,3,313,0,726,39130,3,35
2012-05-09,summer,2012,May,1,Wednesday,Workingday,Mist,0.6,0.5758,0.78,0.2537,3,11,14,14,236,14,3,1,3,313,0,724,24164,3,14
2012-05-09,summer,2012,May,2,Wednesday,Workingday,Light Snow,0.56,0.5303,0.88,0.4478,0,1,1,1,236,1,3,1,3,313,0,715,16352,3,1
2012-05-09,summer,2012,May,3,Wednesday,Workingday,Light Snow,0.56,0.5303,0.88,0.1642,0,2,2,2,236,2,3,1,3,313,0,697,8174,3,2
2012-05-09,summer,2012,May,4,Wednesday,Workingday,Light Snow,0.56,0.5303,0.88,0.2239,0,5,5,5,236,5,3,1,3,313,0,697,4428,3,5
2012-05-09,summer,2012,May,5,Wednesday,Workingday,Mist,0.56,0.5303,0.88,0.1343,1,27,28,28,236,28,3,1,3,313,0,717,14261,3,28
2012-05-09,summer,2012,May,6,Wednesday,Workingday,Mist,0.56,0.5303,0.88,0.1045,5,121,126,126,236,126,3,2,3,323,0,725,55132,3,126
2012-05-09,summer,2012,May,7,Wednesday,Workingday,Mist,0.56,0.5303,0.94,0.194,17,401,418,418,236,418,3,4,3,343,0,727,154171,3,418
2012-05-09,summer,2012,May,8,Wednesday,Workingday,Mist,0.6,0.5606,0.83,0.1343,28,594,622,622,236,622,3,4,3,343,2,727,261001,3,622
2012-05-09,summer,2012,May,9,Wednesday,Workingday,Mist,0.6,0.5606,0.83,0.0,40,285,325,325,236,325,3,4,3,343,0,727,159438,3,325
2012-05-09,summer,2012,May,10,Wednesday,Workingday,Mist,0.62,0.6061,0.65,0.2537,40,113,153,153,236,153,3,3,3,333,0,727,126257,3,153
2012-05-09,summer,2012,May,11,Wednesday,Workingday,Mist,0.62,0.6212,0.59,0.2985,45,156,201,201,236,201,3,3,3,333,2,727,151320,3,201
2012-05-09,summer,2012,May,12,Wednesday,Workingday,Mist,0.62,0.6212,0.57,0.2239,58,222,280,280,236,280,3,3,3,333,2,728,184414,3,280
2012-05-09,summer,2012,May,13,Wednesday,Workingday,Mist,0.64,0.6212,0.53,0.2537,50,216,266,266,236,266,3,3,3,333,2,729,184919,3,266
2012-05-09,summer,2012,May,14,Wednesday,Workingday,Mist,0.64,0.6212,0.53,0.2537,68,175,243,243,236,243,3,3,3,333,2,729,175652,3,243
2012-05-09,summer,2012,May,15,Wednesday,Workingday,Mist,0.64,0.6212,0.53,0.1045,68,191,259,259,236,259,3,3,3,333,2,729,183149,3,259
2012-05-09,summer,2012,May,16,Wednesday,Workingday,Mist,0.66,0.6212,0.5,0.194,68,289,357,357,236,357,3,4,3,343,2,730,227748,3,357
2012-05-09,summer,2012,May,17,Wednesday,Workingday,Mist,0.64,0.6212,0.53,0.1343,76,629,705,705,236,705,3,4,3,343,2,730,336860,3,705
2012-05-09,summer,2012,May,18,Wednesday,Workingday,Light Snow,0.52,0.5,0.77,0.5821,23,349,372,372,236,372,3,4,3,343,2,728,309772,3,372
2012-05-09,summer,2012,May,19,Wednesday,Workingday,Light Snow,0.5,0.4848,0.77,0.3582,2,96,98,98,236,98,3,2,2,322,0,728,226789,3,98
2012-05-09,summer,2012,May,20,Wednesday,Workingday,Light Snow,0.5,0.4848,0.82,0.2239,3,48,51,51,236,51,3,2,2,322,0,728,164550,3,51
2012-05-09,summer,2012,May,21,Wednesday,Workingday,Light Snow,0.5,0.4848,0.82,0.1642,4,30,34,34,236,34,3,1,2,312,0,728,125445,3,34
2012-05-09,summer,2012,May,22,Wednesday,Workingday,Light Snow,0.48,0.4697,0.82,0.1045,5,62,67,67,236,67,3,2,2,322,0,728,95612,3,67
2012-05-09,summer,2012,May,23,Wednesday,Workingday,Light Snow,0.48,0.4697,0.82,0.194,8,47,55,55,236,55,3,2,2,322,0,728,63941,3,55
2012-05-10,summer,2012,May,0,Thursday,Workingday,Light Snow,0.5,0.4848,0.77,0.1642,2,31,33,33,235,33,3,1,2,312,0,726,39130,3,33
2012-05-10,summer,2012,May,1,Thursday,Workingday,Mist,0.48,0.4697,0.88,0.1343,2,9,11,11,235,11,3,1,2,312,0,724,24164,3,11
2012-05-10,summer,2012,May,2,Thursday,Workingday,Mist,0.48,0.4697,0.88,0.1045,0,3,3,3,235,3,3,1,2,312,0,715,16352,3,3
2012-05-10,summer,2012,May,3,Thursday,Workingday,Clear,0.46,0.4545,0.88,0.2239,0,3,3,3,235,3,3,1,2,312,0,697,8174,3,3
2012-05-10,summer,2012,May,4,Thursday,Workingday,Clear,0.46,0.4545,0.77,0.194,0,2,2,2,235,2,3,1,2,312,0,697,4428,3,2
2012-05-10,summer,2012,May,5,Thursday,Workingday,Clear,0.46,0.4545,0.72,0.2985,1,23,24,24,235,24,3,1,2,312,0,717,14261,3,24
2012-05-10,summer,2012,May,6,Thursday,Workingday,Clear,0.44,0.4394,0.72,0.2239,9,130,139,139,235,139,3,2,2,322,0,725,55132,3,139
2012-05-10,summer,2012,May,7,Thursday,Workingday,Clear,0.44,0.4394,0.72,0.2985,8,393,401,401,235,401,3,4,2,342,1,727,154171,3,401
2012-05-10,summer,2012,May,8,Thursday,Workingday,Clear,0.46,0.4545,0.67,0.3582,27,603,630,630,235,630,3,4,2,342,2,727,261001,3,630
2012-05-10,summer,2012,May,9,Thursday,Workingday,Clear,0.5,0.4848,0.59,0.4627,62,299,361,361,235,361,3,4,2,342,2,727,159438,3,361
2012-05-10,summer,2012,May,10,Thursday,Workingday,Clear,0.5,0.4848,0.51,0.4179,42,112,154,154,235,154,3,3,2,332,1,727,126257,3,154
2012-05-10,summer,2012,May,11,Thursday,Workingday,Clear,0.52,0.5,0.48,0.5224,77,179,256,256,235,256,3,3,3,333,2,727,151320,3,256
2012-05-10,summer,2012,May,12,Thursday,Workingday,Clear,0.52,0.5,0.48,0.4179,65,207,272,272,235,272,3,3,3,333,2,728,184414,3,272
2012-05-10,summer,2012,May,13,Thursday,Workingday,Clear,0.54,0.5152,0.39,0.4478,90,228,318,318,235,318,3,4,3,343,2,729,184919,3,318
2012-05-10,summer,2012,May,14,Thursday,Workingday,Clear,0.56,0.5303,0.37,0.4179,61,186,247,247,235,247,3,3,3,333,2,729,175652,3,247
2012-05-10,summer,2012,May,15,Thursday,Workingday,Clear,0.54,0.5152,0.37,0.3881,79,192,271,271,235,271,3,3,3,333,2,729,183149,3,271
2012-05-10,summer,2012,May,16,Thursday,Workingday,Clear,0.58,0.5455,0.3,0.4627,87,334,421,421,235,421,3,4,3,343,2,730,227748,3,421
2012-05-10,summer,2012,May,17,Thursday,Workingday,Clear,0.6,0.6212,0.31,0.3881,84,648,732,732,235,732,3,4,3,343,2,730,336860,3,732
2012-05-10,summer,2012,May,18,Thursday,Workingday,Clear,0.56,0.5303,0.35,0.5224,109,661,770,770,235,770,3,4,3,343,2,728,309772,3,770
2012-05-10,summer,2012,May,19,Thursday,Workingday,Clear,0.54,0.5152,0.37,0.3582,84,469,553,553,235,553,3,4,3,343,2,728,226789,3,553
2012-05-10,summer,2012,May,20,Thursday,Workingday,Clear,0.52,0.5,0.4,0.3284,59,315,374,374,235,374,3,4,3,343,2,728,164550,3,374
2012-05-10,summer,2012,May,21,Thursday,Workingday,Clear,0.5,0.4848,0.42,0.194,19,211,230,230,235,230,3,3,2,332,1,728,125445,3,230
2012-05-10,summer,2012,May,22,Thursday,Workingday,Clear,0.5,0.4848,0.42,0.1045,36,196,232,232,235,232,3,3,2,332,0,728,95612,3,232
2012-05-10,summer,2012,May,23,Thursday,Workingday,Clear,0.48,0.4697,0.48,0.1045,23,112,135,135,235,135,3,2,2,322,0,728,63941,3,135
2012-05-11,summer,2012,May,0,Friday,Workingday,Clear,0.46,0.4545,0.55,0.1045,17,47,64,64,234,64,3,2,2,322,0,726,39130,3,64
2012-05-11,summer,2012,May,1,Friday,Workingday,Clear,0.46,0.4545,0.51,0.1343,14,32,46,46,234,46,3,2,2,322,1,724,24164,3,46
2012-05-11,summer,2012,May,2,Friday,Workingday,Clear,0.46,0.4545,0.44,0.1642,15,16,31,31,234,31,3,1,2,312,1,715,16352,3,31
2012-05-11,summer,2012,May,3,Friday,Workingday,Clear,0.46,0.4545,0.41,0.2836,5,8,13,13,234,13,3,1,2,312,1,697,8174,3,13
2012-05-11,summer,2012,May,4,Friday,Workingday,Clear,0.42,0.4242,0.5,0.194,3,6,9,9,234,9,3,1,2,312,1,697,4428,3,9
2012-05-11,summer,2012,May,5,Friday,Workingday,Clear,0.42,0.4242,0.47,0.1642,3,23,26,26,234,26,3,1,2,312,1,717,14261,3,26
2012-05-11,summer,2012,May,6,Friday,Workingday,Clear,0.42,0.4242,0.5,0.2537,7,128,135,135,234,135,3,2,2,322,1,725,55132,3,135
2012-05-11,summer,2012,May,7,Friday,Workingday,Clear,0.42,0.4242,0.5,0.2537,6,345,351,351,234,351,3,4,2,342,1,727,154171,3,351
2012-05-11,summer,2012,May,8,Friday,Workingday,Clear,0.46,0.4545,0.44,0.2537,41,579,620,620,234,620,3,4,2,342,2,727,261001,3,620
2012-05-11,summer,2012,May,9,Friday,Workingday,Clear,0.48,0.4697,0.41,0.2985,34,288,322,322,234,322,3,4,2,342,2,727,159438,3,322
2012-05-11,summer,2012,May,10,Friday,Workingday,Clear,0.52,0.5,0.36,0.3284,69,141,210,210,234,210,3,3,3,333,2,727,126257,3,210
2012-05-11,summer,2012,May,11,Friday,Workingday,Clear,0.56,0.5303,0.35,0.2537,88,203,291,291,234,291,3,4,3,343,2,727,151320,3,291
2012-05-11,summer,2012,May,12,Friday,Workingday,Clear,0.56,0.5303,0.28,0.4179,89,259,348,348,234,348,3,4,3,343,2,728,184414,3,348
2012-05-11,summer,2012,May,13,Friday,Workingday,Clear,0.6,0.6061,0.26,0.3881,100,263,363,363,234,363,3,4,3,343,2,729,184919,3,363
2012-05-11,summer,2012,May,14,Friday,Workingday,Clear,0.62,0.6061,0.23,0.2239,116,218,334,334,234,334,3,4,3,343,2,729,175652,3,334
2012-05-11,summer,2012,May,15,Friday,Workingday,Clear,0.62,0.6061,0.25,0.194,140,299,439,439,234,439,3,4,3,343,2,729,183149,3,439
2012-05-11,summer,2012,May,16,Friday,Workingday,Clear,0.62,0.6061,0.25,0.3284,128,397,525,525,234,525,3,4,3,343,2,730,227748,3,525
2012-05-11,summer,2012,May,17,Friday,Workingday,Clear,0.64,0.6061,0.23,0.2537,102,677,779,779,234,779,3,4,3,343,2,730,336860,3,779
2012-05-11,summer,2012,May,18,Friday,Workingday,Clear,0.64,0.6061,0.23,0.2836,78,518,596,596,234,596,3,4,3,343,2,728,309772,3,596
2012-05-11,summer,2012,May,19,Friday,Workingday,Clear,0.64,0.6061,0.23,0.2537,73,430,503,503,234,503,3,4,3,343,2,728,226789,3,503
2012-05-11,summer,2012,May,20,Friday,Workingday,Clear,0.62,0.6061,0.25,0.1343,64,277,341,341,234,341,3,4,3,343,2,728,164550,3,341
2012-05-11,summer,2012,May,21,Friday,Workingday,Clear,0.6,0.6061,0.28,0.1045,45,225,270,270,234,270,3,3,3,333,2,728,125445,3,270
2012-05-11,summer,2012,May,22,Friday,Workingday,Clear,0.56,0.5303,0.35,0.2239,44,190,234,234,234,234,3,3,3,333,2,728,95612,3,234
2012-05-11,summer,2012,May,23,Friday,Workingday,Clear,0.54,0.5152,0.37,0.194,38,142,180,180,234,180,3,3,3,333,2,728,63941,3,180
2012-05-12,summer,2012,May,0,Saturday,Holiday,Clear,0.52,0.5,0.42,0.1642,25,111,136,136,233,136,3,2,3,323,0,726,39130,3,136
2012-05-12,summer,2012,May,1,Saturday,Holiday,Clear,0.5,0.4848,0.48,0.0,14,79,93,93,233,93,3,2,2,322,0,724,24164,3,93
2012-05-12,summer,2012,May,2,Saturday,Holiday,Clear,0.46,0.4545,0.59,0.1343,10,46,56,56,233,56,3,2,2,322,0,715,16352,3,56
2012-05-12,summer,2012,May,3,Saturday,Holiday,Clear,0.48,0.4697,0.59,0.0,14,20,34,34,233,34,3,1,2,312,0,697,8174,3,34
2012-05-12,summer,2012,May,4,Saturday,Holiday,Clear,0.44,0.4394,0.67,0.1045,3,6,9,9,233,9,3,1,2,312,0,697,4428,3,9
2012-05-12,summer,2012,May,5,Saturday,Holiday,Clear,0.42,0.4242,0.67,0.1343,5,8,13,13,233,13,3,1,2,312,0,717,14261,3,13
2012-05-12,summer,2012,May,6,Saturday,Holiday,Clear,0.42,0.4242,0.67,0.0896,10,23,33,33,233,33,3,1,2,312,0,725,55132,3,33
2012-05-12,summer,2012,May,7,Saturday,Holiday,Clear,0.42,0.4242,0.71,0.1343,10,57,67,67,233,67,3,2,2,322,0,727,154171,3,67
2012-05-12,summer,2012,May,8,Saturday,Holiday,Clear,0.52,0.5,0.48,0.0,22,156,178,178,233,178,3,3,3,333,0,727,261001,3,178
2012-05-12,summer,2012,May,9,Saturday,Holiday,Clear,0.54,0.5152,0.49,0.0,87,248,335,335,233,335,3,4,3,343,2,727,159438,3,335
2012-05-12,summer,2012,May,10,Saturday,Holiday,Clear,0.56,0.5303,0.49,0.0896,132,279,411,411,233,411,3,4,3,343,2,727,126257,3,411
2012-05-12,summer,2012,May,11,Saturday,Holiday,Clear,0.62,0.6212,0.41,0.0896,157,365,522,522,233,522,3,4,3,343,2,727,151320,3,522
2012-05-12,summer,2012,May,12,Saturday,Holiday,Clear,0.64,0.6212,0.36,0.1642,206,353,559,559,233,559,3,4,3,343,2,728,184414,3,559
2012-05-12,summer,2012,May,13,Saturday,Holiday,Clear,0.64,0.6212,0.36,0.194,293,366,659,659,233,659,3,4,3,343,2,729,184919,3,659
2012-05-12,summer,2012,May,14,Saturday,Holiday,Clear,0.66,0.6212,0.36,0.194,257,358,615,615,233,615,3,4,3,343,2,729,175652,3,615
2012-05-12,summer,2012,May,15,Saturday,Holiday,Clear,0.68,0.6212,0.24,0.194,269,321,590,590,233,590,3,4,3,343,2,729,183149,3,590
2012-05-12,summer,2012,May,16,Saturday,Holiday,Mist,0.7,0.6364,0.21,0.194,254,337,591,591,233,591,3,4,4,344,2,730,227748,3,591
2012-05-12,summer,2012,May,17,Saturday,Holiday,Mist,0.66,0.6212,0.36,0.194,233,343,576,576,233,576,3,4,3,343,2,730,336860,3,576
2012-05-12,summer,2012,May,18,Saturday,Holiday,Mist,0.66,0.6212,0.31,0.194,164,382,546,546,233,546,3,4,3,343,2,728,309772,3,546
2012-05-12,summer,2012,May,19,Saturday,Holiday,Mist,0.64,0.6212,0.36,0.1642,166,273,439,439,233,439,3,4,3,343,2,728,226789,3,439
2012-05-12,summer,2012,May,20,Saturday,Holiday,Clear,0.62,0.6212,0.46,0.1642,113,174,287,287,233,287,3,4,3,343,2,728,164550,3,287
2012-05-12,summer,2012,May,21,Saturday,Holiday,Mist,0.6,0.6061,0.6,0.1343,74,156,230,230,233,230,3,3,3,333,2,728,125445,3,230
2012-05-12,summer,2012,May,22,Saturday,Holiday,Clear,0.56,0.5303,0.68,0.1343,62,212,274,274,233,274,3,3,3,333,0,728,95612,3,274
2012-05-12,summer,2012,May,23,Saturday,Holiday,Clear,0.58,0.5455,0.56,0.0896,42,134,176,176,233,176,3,3,3,333,0,728,63941,3,176
2012-05-13,summer,2012,May,0,Sunday,Holiday,Clear,0.56,0.5303,0.64,0.1642,19,79,98,98,232,98,3,2,3,323,0,726,39130,3,98
2012-05-13,summer,2012,May,1,Sunday,Holiday,Mist,0.54,0.5152,0.68,0.1343,22,72,94,94,232,94,3,2,3,323,0,724,24164,3,94
2012-05-13,summer,2012,May,2,Sunday,Holiday,Mist,0.54,0.5152,0.68,0.1642,22,60,82,82,232,82,3,2,3,323,0,715,16352,3,82
2012-05-13,summer,2012,May,3,Sunday,Holiday,Mist,0.54,0.5152,0.64,0.1343,2,26,28,28,232,28,3,1,3,313,0,697,8174,3,28
2012-05-13,summer,2012,May,4,Sunday,Holiday,Mist,0.54,0.5152,0.68,0.194,2,7,9,9,232,9,3,1,3,313,0,697,4428,3,9
2012-05-13,summer,2012,May,5,Sunday,Holiday,Clear,0.52,0.5,0.72,0.194,4,8,12,12,232,12,3,1,3,313,0,717,14261,3,12
2012-05-13,summer,2012,May,6,Sunday,Holiday,Clear,0.52,0.5,0.68,0.1642,6,15,21,21,232,21,3,1,3,313,0,725,55132,3,21
2012-05-13,summer,2012,May,7,Sunday,Holiday,Clear,0.52,0.5,0.68,0.1642,18,42,60,60,232,60,3,2,3,323,0,727,154171,3,60
2012-05-13,summer,2012,May,8,Sunday,Holiday,Clear,0.56,0.5303,0.64,0.1642,32,124,156,156,232,156,3,3,3,333,0,727,261001,3,156
2012-05-13,summer,2012,May,9,Sunday,Holiday,Clear,0.6,0.6212,0.56,0.1343,79,143,222,222,232,222,3,3,3,333,2,727,159438,3,222
2012-05-13,summer,2012,May,10,Sunday,Holiday,Clear,0.6,0.6061,0.6,0.2537,128,222,350,350,232,350,3,4,3,343,2,727,126257,3,350
2012-05-13,summer,2012,May,11,Sunday,Holiday,Clear,0.62,0.6212,0.57,0.2537,150,278,428,428,232,428,3,4,3,343,2,727,151320,3,428
2012-05-13,summer,2012,May,12,Sunday,Holiday,Clear,0.64,0.6212,0.57,0.2239,189,342,531,531,232,531,3,4,3,343,2,728,184414,3,531
2012-05-13,summer,2012,May,13,Sunday,Holiday,Clear,0.68,0.6364,0.54,0.2537,255,347,602,602,232,602,3,4,4,344,2,729,184919,3,602
2012-05-13,summer,2012,May,14,Sunday,Holiday,Clear,0.7,0.6515,0.48,0.1343,228,324,552,552,232,552,3,4,4,344,2,729,175652,3,552
2012-05-13,summer,2012,May,15,Sunday,Holiday,Clear,0.72,0.6515,0.45,0.3582,190,309,499,499,232,499,3,4,4,344,2,729,183149,3,499
2012-05-13,summer,2012,May,16,Sunday,Holiday,Clear,0.72,0.6515,0.42,0.2537,225,339,564,564,232,564,3,4,4,344,2,730,227748,3,564
2012-05-13,summer,2012,May,17,Sunday,Holiday,Clear,0.7,0.6364,0.45,0.4179,191,287,478,478,232,478,3,4,4,344,2,730,336860,3,478
2012-05-13,summer,2012,May,18,Sunday,Holiday,Mist,0.68,0.6364,0.44,0.3582,129,260,389,389,232,389,3,4,4,344,2,728,309772,3,389
2012-05-13,summer,2012,May,19,Sunday,Holiday,Mist,0.66,0.6212,0.5,0.4179,107,232,339,339,232,339,3,4,3,343,2,728,226789,3,339
2012-05-13,summer,2012,May,20,Sunday,Holiday,Mist,0.66,0.6212,0.5,0.2836,67,163,230,230,232,230,3,3,3,333,2,728,164550,3,230
2012-05-13,summer,2012,May,21,Sunday,Holiday,Mist,0.64,0.6212,0.53,0.194,48,121,169,169,232,169,3,3,3,333,2,728,125445,3,169
2012-05-13,summer,2012,May,22,Sunday,Holiday,Mist,0.62,0.6061,0.61,0.1642,42,89,131,131,232,131,3,2,3,323,0,728,95612,3,131
2012-05-13,summer,2012,May,23,Sunday,Holiday,Mist,0.62,0.6212,0.57,0.2239,17,57,74,74,232,74,3,2,3,323,0,728,63941,3,74
2012-05-14,summer,2012,May,0,Monday,Workingday,Mist,0.6,0.6212,0.56,0.2537,21,14,35,35,231,35,3,1,3,313,0,726,39130,3,35
2012-05-14,summer,2012,May,1,Monday,Workingday,Mist,0.6,0.6061,0.6,0.2836,5,6,11,11,231,11,3,1,3,313,0,724,24164,3,11
2012-05-14,summer,2012,May,2,Monday,Workingday,Clear,0.6,0.6061,0.6,0.2985,1,1,2,2,231,2,3,1,3,313,0,715,16352,3,2
2012-05-14,summer,2012,May,3,Monday,Workingday,Mist,0.58,0.5455,0.68,0.3284,0,2,2,2,231,2,3,1,3,313,0,697,8174,3,2
2012-05-14,summer,2012,May,4,Monday,Workingday,Mist,0.54,0.5152,0.77,0.2239,3,3,6,6,231,6,3,1,3,313,0,697,4428,3,6
2012-05-14,summer,2012,May,5,Monday,Workingday,Mist,0.54,0.5152,0.77,0.1642,1,25,26,26,231,26,3,1,3,313,0,717,14261,3,26
2012-05-14,summer,2012,May,6,Monday,Workingday,Light Snow,0.52,0.5,0.94,0.2985,3,62,65,65,231,65,3,2,3,323,0,725,55132,3,65
2012-05-14,summer,2012,May,7,Monday,Workingday,Light Snow,0.52,0.5,0.94,0.194,3,72,75,75,231,75,3,2,3,323,0,727,154171,3,75
2012-05-14,summer,2012,May,8,Monday,Workingday,Light Snow,0.54,0.5152,0.88,0.2239,1,155,156,156,231,156,3,3,3,333,0,727,261001,3,156
2012-05-14,summer,2012,May,9,Monday,Workingday,Light Snow,0.54,0.5152,0.88,0.2836,5,105,110,110,231,110,3,2,3,323,0,727,159438,3,110
2012-05-14,summer,2012,May,10,Monday,Workingday,Light Snow,0.54,0.5152,0.88,0.2537,6,53,59,59,231,59,3,2,3,323,0,727,126257,3,59
2012-05-14,summer,2012,May,11,Monday,Workingday,Mist,0.56,0.5303,0.83,0.2239,12,67,79,79,231,79,3,2,3,323,0,727,151320,3,79
2012-05-14,summer,2012,May,12,Monday,Workingday,Mist,0.56,0.5303,0.88,0.2836,53,132,185,185,231,185,3,3,3,333,0,728,184414,3,185
2012-05-14,summer,2012,May,13,Monday,Workingday,Mist,0.62,0.5909,0.73,0.2239,33,143,176,176,231,176,3,3,3,333,0,729,184919,3,176
2012-05-14,summer,2012,May,14,Monday,Workingday,Mist,0.62,0.5909,0.73,0.2537,43,128,171,171,231,171,3,3,3,333,0,729,175652,3,171
2012-05-14,summer,2012,May,15,Monday,Workingday,Mist,0.62,0.5909,0.73,0.1642,40,156,196,196,231,196,3,3,3,333,0,729,183149,3,196
2012-05-14,summer,2012,May,16,Monday,Workingday,Light Snow,0.62,0.6061,0.69,0.2836,20,91,111,111,231,111,3,2,3,323,0,730,227748,3,111
2012-05-14,summer,2012,May,17,Monday,Workingday,Light Snow,0.56,0.5303,0.88,0.2537,25,204,229,229,231,229,3,3,3,333,0,730,336860,3,229
2012-05-14,summer,2012,May,18,Monday,Workingday,Mist,0.58,0.5455,0.83,0.0,17,283,300,300,231,300,3,4,3,343,0,728,309772,3,300
2012-05-14,summer,2012,May,19,Monday,Workingday,Light Snow,0.58,0.5455,0.88,0.1343,10,294,304,304,231,304,3,4,3,343,0,728,226789,3,304
2012-05-14,summer,2012,May,20,Monday,Workingday,Mist,0.58,0.5455,0.88,0.194,11,178,189,189,231,189,3,3,3,333,0,728,164550,3,189
2012-05-14,summer,2012,May,21,Monday,Workingday,Mist,0.58,0.5455,0.83,0.0896,7,145,152,152,231,152,3,3,3,333,0,728,125445,3,152
2012-05-14,summer,2012,May,22,Monday,Workingday,Mist,0.58,0.5455,0.78,0.0896,11,118,129,129,231,129,3,2,3,323,0,728,95612,3,129
2012-05-14,summer,2012,May,23,Monday,Workingday,Mist,0.58,0.5455,0.78,0.1045,11,64,75,75,231,75,3,2,3,323,0,728,63941,3,75
2012-05-15,summer,2012,May,0,Tuesday,Workingday,Mist,0.56,0.5303,0.88,0.1343,7,25,32,32,230,32,3,1,3,313,0,726,39130,3,32
2012-05-15,summer,2012,May,1,Tuesday,Workingday,Light Snow,0.56,0.5303,0.88,0.1343,5,14,19,19,230,19,3,1,3,313,0,724,24164,3,19
2012-05-15,summer,2012,May,2,Tuesday,Workingday,Mist,0.56,0.5303,0.88,0.1343,1,3,4,4,230,4,3,1,3,313,0,715,16352,3,4
2012-05-15,summer,2012,May,3,Tuesday,Workingday,Light Snow,0.58,0.5455,0.83,0.1343,1,5,6,6,230,6,3,1,3,313,0,697,8174,3,6
2012-05-15,summer,2012,May,4,Tuesday,Workingday,Light Snow,0.56,0.5303,0.94,0.0,1,4,5,5,230,5,3,1,3,313,0,697,4428,3,5
2012-05-15,summer,2012,May,5,Tuesday,Workingday,Light Snow,0.56,0.5303,0.94,0.2239,0,8,8,8,230,8,3,1,3,313,0,717,14261,3,8
2012-05-15,summer,2012,May,6,Tuesday,Workingday,Light Snow,0.56,0.5303,0.94,0.2239,2,22,24,24,230,24,3,1,3,313,0,725,55132,3,24
2012-05-15,summer,2012,May,7,Tuesday,Workingday,Light Snow,0.56,0.5303,0.94,0.1343,1,91,92,92,230,92,3,2,3,323,0,727,154171,3,92
2012-05-15,summer,2012,May,8,Tuesday,Workingday,Mist,0.58,0.5455,0.88,0.0896,8,401,409,409,230,409,3,4,3,343,0,727,261001,3,409
2012-05-15,summer,2012,May,9,Tuesday,Workingday,Mist,0.58,0.5455,0.88,0.0896,28,327,355,355,230,355,3,4,3,343,0,727,159438,3,355
2012-05-15,summer,2012,May,10,Tuesday,Workingday,Clear,0.62,0.5909,0.78,0.1045,27,144,171,171,230,171,3,3,3,333,0,727,126257,3,171
2012-05-15,summer,2012,May,11,Tuesday,Workingday,Clear,0.64,0.5909,0.78,0.194,38,186,224,224,230,224,3,3,3,333,0,727,151320,3,224
2012-05-15,summer,2012,May,12,Tuesday,Workingday,Clear,0.64,0.6061,0.73,0.194,44,220,264,264,230,264,3,3,3,333,0,728,184414,3,264
2012-05-15,summer,2012,May,13,Tuesday,Workingday,Light Snow,0.64,0.6061,0.73,0.194,35,204,239,239,230,239,3,3,3,333,0,729,184919,3,239
2012-05-15,summer,2012,May,14,Tuesday,Workingday,Mist,0.64,0.6061,0.73,0.194,39,145,184,184,230,184,3,3,3,333,0,729,175652,3,184
2012-05-15,summer,2012,May,15,Tuesday,Workingday,Mist,0.7,0.6515,0.61,0.0896,51,205,256,256,230,256,3,3,4,334,2,729,183149,3,256
2012-05-15,summer,2012,May,16,Tuesday,Workingday,Clear,0.68,0.6364,0.65,0.1642,74,300,374,374,230,374,3,4,4,344,2,730,227748,3,374
2012-05-15,summer,2012,May,17,Tuesday,Workingday,Clear,0.68,0.6364,0.65,0.1045,75,603,678,678,230,678,3,4,4,344,2,730,336860,3,678
2012-05-15,summer,2012,May,18,Tuesday,Workingday,Clear,0.7,0.6515,0.61,0.0896,68,665,733,733,230,733,3,4,4,344,2,728,309772,3,733
2012-05-15,summer,2012,May,19,Tuesday,Workingday,Clear,0.66,0.6212,0.69,0.1642,57,455,512,512,230,512,3,4,3,343,2,728,226789,3,512
2012-05-15,summer,2012,May,20,Tuesday,Workingday,Light Snow,0.64,0.6061,0.73,0.1343,30,233,263,263,230,263,3,3,3,333,0,728,164550,3,263
2012-05-15,summer,2012,May,21,Tuesday,Workingday,Light Snow,0.64,0.6061,0.73,0.2836,11,98,109,109,230,109,3,2,3,323,0,728,125445,3,109
2012-05-15,summer,2012,May,22,Tuesday,Workingday,Clear,0.58,0.5455,0.78,0.2239,9,74,83,83,230,83,3,2,3,323,0,728,95612,3,83
2012-05-15,summer,2012,May,23,Tuesday,Workingday,Light Snow,0.56,0.5303,0.88,0.1045,13,58,71,71,230,71,3,2,3,323,0,728,63941,3,71
2012-05-16,summer,2012,May,0,Wednesday,Workingday,Mist,0.58,0.5455,0.88,0.0,12,27,39,39,229,39,3,1,3,313,0,726,39130,3,39
2012-05-16,summer,2012,May,1,Wednesday,Workingday,Mist,0.58,0.5455,0.88,0.1343,7,14,21,21,229,21,3,1,3,313,0,724,24164,3,21
2012-05-16,summer,2012,May,2,Wednesday,Workingday,Clear,0.56,0.5303,0.94,0.194,5,14,19,19,229,19,3,1,3,313,0,715,16352,3,19
2012-05-16,summer,2012,May,3,Wednesday,Workingday,Clear,0.56,0.5303,0.88,0.1045,1,5,6,6,229,6,3,1,3,313,0,697,8174,3,6
2012-05-16,summer,2012,May,4,Wednesday,Workingday,Clear,0.54,0.5152,0.94,0.1343,1,3,4,4,229,4,3,1,3,313,0,697,4428,3,4
2012-05-16,summer,2012,May,5,Wednesday,Workingday,Clear,0.54,0.5152,0.94,0.1045,4,34,38,38,229,38,3,1,3,313,0,717,14261,3,38
2012-05-16,summer,2012,May,6,Wednesday,Workingday,Clear,0.54,0.5152,0.94,0.0896,8,150,158,158,229,158,3,3,3,333,0,725,55132,3,158
2012-05-16,summer,2012,May,7,Wednesday,Workingday,Clear,0.56,0.5303,0.83,0.0,14,426,440,440,229,440,3,4,3,343,0,727,154171,3,440
2012-05-16,summer,2012,May,8,Wednesday,Workingday,Clear,0.58,0.5455,0.83,0.0,33,617,650,650,229,650,3,4,3,343,2,727,261001,3,650
2012-05-16,summer,2012,May,9,Wednesday,Workingday,Mist,0.6,0.5758,0.78,0.1343,33,314,347,347,229,347,3,4,3,343,0,727,159438,3,347
2012-05-16,summer,2012,May,10,Wednesday,Workingday,Clear,0.66,0.6212,0.61,0.0,43,149,192,192,229,192,3,3,3,333,0,727,126257,3,192
2012-05-16,summer,2012,May,11,Wednesday,Workingday,Clear,0.7,0.6515,0.54,0.1343,55,212,267,267,229,267,3,3,4,334,2,727,151320,3,267
2012-05-16,summer,2012,May,12,Wednesday,Workingday,Clear,0.7,0.6515,0.54,0.194,59,271,330,330,229,330,3,4,4,344,2,728,184414,3,330
2012-05-16,summer,2012,May,13,Wednesday,Workingday,Clear,0.72,0.6515,0.42,0.0,77,273,350,350,229,350,3,4,4,344,2,729,184919,3,350
2012-05-16,summer,2012,May,14,Wednesday,Workingday,Clear,0.72,0.6515,0.42,0.0896,42,221,263,263,229,263,3,3,4,334,2,729,175652,3,263
2012-05-16,summer,2012,May,15,Wednesday,Workingday,Mist,0.72,0.6667,0.48,0.1045,52,222,274,274,229,274,3,3,4,334,2,729,183149,3,274
2012-05-16,summer,2012,May,16,Wednesday,Workingday,Clear,0.72,0.6515,0.45,0.1045,70,376,446,446,229,446,3,4,4,344,2,730,227748,3,446
2012-05-16,summer,2012,May,17,Wednesday,Workingday,Clear,0.72,0.6667,0.51,0.194,104,769,873,873,229,873,3,4,4,344,2,730,336860,3,873
2012-05-16,summer,2012,May,18,Wednesday,Workingday,Clear,0.72,0.6667,0.51,0.2239,97,749,846,846,229,846,3,4,4,344,2,728,309772,3,846
2012-05-16,summer,2012,May,19,Wednesday,Workingday,Clear,0.7,0.6515,0.54,0.2836,91,499,590,590,229,590,3,4,4,344,2,728,226789,3,590
2012-05-16,summer,2012,May,20,Wednesday,Workingday,Clear,0.66,0.6212,0.65,0.2537,61,398,459,459,229,459,3,4,3,343,2,728,164550,3,459
2012-05-16,summer,2012,May,21,Wednesday,Workingday,Clear,0.64,0.6061,0.73,0.194,63,330,393,393,229,393,3,4,3,343,2,728,125445,3,393
2012-05-16,summer,2012,May,22,Wednesday,Workingday,Clear,0.64,0.6061,0.73,0.1642,33,253,286,286,229,286,3,4,3,343,0,728,95612,3,286
2012-05-16,summer,2012,May,23,Wednesday,Workingday,Clear,0.62,0.5909,0.78,0.1045,26,107,133,133,229,133,3,2,3,323,0,728,63941,3,133
2012-05-17,summer,2012,May,0,Thursday,Workingday,Clear,0.6,0.5758,0.78,0.1343,30,49,79,79,228,79,3,2,3,323,0,726,39130,3,79
2012-05-17,summer,2012,May,1,Thursday,Workingday,Clear,0.6,0.5606,0.83,0.1642,12,16,28,28,228,28,3,1,3,313,0,724,24164,3,28
2012-05-17,summer,2012,May,2,Thursday,Workingday,Clear,0.6,0.5758,0.78,0.1642,8,8,16,16,228,16,3,1,3,313,0,715,16352,3,16
2012-05-17,summer,2012,May,3,Thursday,Workingday,Clear,0.6,0.5909,0.73,0.2537,0,3,3,3,228,3,3,1,3,313,0,697,8174,3,3
2012-05-17,summer,2012,May,4,Thursday,Workingday,Clear,0.6,0.6061,0.64,0.3284,3,13,16,16,228,16,3,1,3,313,0,697,4428,3,16
2012-05-17,summer,2012,May,5,Thursday,Workingday,Clear,0.56,0.5303,0.68,0.3284,1,34,35,35,228,35,3,1,3,313,0,717,14261,3,35
2012-05-17,summer,2012,May,6,Thursday,Workingday,Clear,0.54,0.5152,0.73,0.3582,10,149,159,159,228,159,3,3,3,333,0,725,55132,3,159
2012-05-17,summer,2012,May,7,Thursday,Workingday,Clear,0.54,0.5152,0.73,0.3881,25,449,474,474,228,474,3,4,3,343,2,727,154171,3,474
2012-05-17,summer,2012,May,8,Thursday,Workingday,Clear,0.52,0.5,0.55,0.4478,29,605,634,634,228,634,3,4,3,343,2,727,261001,3,634
2012-05-17,summer,2012,May,9,Thursday,Workingday,Clear,0.54,0.5152,0.52,0.4179,57,289,346,346,228,346,3,4,3,343,2,727,159438,3,346
2012-05-17,summer,2012,May,10,Thursday,Workingday,Clear,0.56,0.5303,0.52,0.2537,43,162,205,205,228,205,3,3,3,333,2,727,126257,3,205
2012-05-17,summer,2012,May,11,Thursday,Workingday,Clear,0.58,0.5455,0.49,0.2239,77,202,279,279,228,279,3,3,3,333,2,727,151320,3,279
2012-05-17,summer,2012,May,12,Thursday,Workingday,Clear,0.6,0.6212,0.43,0.194,72,276,348,348,228,348,3,4,3,343,2,728,184414,3,348
2012-05-17,summer,2012,May,13,Thursday,Workingday,Clear,0.62,0.6212,0.41,0.194,86,241,327,327,228,327,3,4,3,343,2,729,184919,3,327
2012-05-17,summer,2012,May,14,Thursday,Workingday,Clear,0.64,0.6212,0.38,0.194,68,202,270,270,228,270,3,3,3,333,2,729,175652,3,270
2012-05-17,summer,2012,May,15,Thursday,Workingday,Clear,0.64,0.6212,0.36,0.2537,83,233,316,316,228,316,3,4,3,343,2,729,183149,3,316
2012-05-17,summer,2012,May,16,Thursday,Workingday,Clear,0.66,0.6212,0.31,0.194,86,344,430,430,228,430,3,4,3,343,2,730,227748,3,430
2012-05-17,summer,2012,May,17,Thursday,Workingday,Clear,0.66,0.6212,0.31,0.1343,133,719,852,852,228,852,3,4,3,343,2,730,336860,3,852
2012-05-17,summer,2012,May,18,Thursday,Workingday,Clear,0.66,0.6212,0.27,0.1642,134,734,868,868,228,868,3,4,3,343,2,728,309772,3,868
2012-05-17,summer,2012,May,19,Thursday,Workingday,Clear,0.64,0.6212,0.31,0.194,86,451,537,537,228,537,3,4,3,343,2,728,226789,3,537
2012-05-17,summer,2012,May,20,Thursday,Workingday,Clear,0.6,0.6212,0.4,0.194,83,363,446,446,228,446,3,4,3,343,2,728,164550,3,446
2012-05-17,summer,2012,May,21,Thursday,Workingday,Clear,0.58,0.5455,0.4,0.1045,45,254,299,299,228,299,3,4,3,343,2,728,125445,3,299
2012-05-17,summer,2012,May,22,Thursday,Workingday,Clear,0.56,0.5303,0.43,0.0896,42,209,251,251,228,251,3,3,3,333,2,728,95612,3,251
2012-05-17,summer,2012,May,23,Thursday,Workingday,Clear,0.54,0.5152,0.49,0.1343,29,137,166,166,228,166,3,3,3,333,0,728,63941,3,166
2012-05-18,summer,2012,May,0,Friday,Workingday,Clear,0.52,0.5,0.59,0.1045,13,57,70,70,227,70,3,2,3,323,0,726,39130,3,70
2012-05-18,summer,2012,May,1,Friday,Workingday,Clear,0.5,0.4848,0.59,0.0896,16,33,49,49,227,49,3,2,2,322,0,724,24164,3,49
2012-05-18,summer,2012,May,2,Friday,Workingday,Clear,0.48,0.4697,0.67,0.1343,12,9,21,21,227,21,3,1,2,312,0,715,16352,3,21
2012-05-18,summer,2012,May,3,Friday,Workingday,Clear,0.46,0.4545,0.72,0.0896,6,8,14,14,227,14,3,1,2,312,0,697,8174,3,14
2012-05-18,summer,2012,May,4,Friday,Workingday,Clear,0.46,0.4545,0.77,0.1642,0,11,11,11,227,11,3,1,2,312,0,697,4428,3,11
2012-05-18,summer,2012,May,5,Friday,Workingday,Clear,0.46,0.4545,0.77,0.1045,1,33,34,34,227,34,3,1,2,312,0,717,14261,3,34
2012-05-18,summer,2012,May,6,Friday,Workingday,Clear,0.44,0.4394,0.77,0.1343,14,168,182,182,227,182,3,3,2,332,0,725,55132,3,182
2012-05-18,summer,2012,May,7,Friday,Workingday,Clear,0.46,0.4545,0.82,0.1045,40,475,515,515,227,515,3,4,2,342,0,727,154171,3,515
2012-05-18,summer,2012,May,8,Friday,Workingday,Clear,0.52,0.5,0.59,0.1343,49,696,745,745,227,745,3,4,3,343,2,727,261001,3,745
2012-05-18,summer,2012,May,9,Friday,Workingday,Clear,0.56,0.5303,0.56,0.1045,57,304,361,361,227,361,3,4,3,343,2,727,159438,3,361
2012-05-18,summer,2012,May,10,Friday,Workingday,Clear,0.6,0.6212,0.46,0.1343,74,181,255,255,227,255,3,3,3,333,2,727,126257,3,255
2012-05-18,summer,2012,May,11,Friday,Workingday,Clear,0.62,0.6212,0.43,0.0,109,225,334,334,227,334,3,4,3,343,2,727,151320,3,334
2012-05-18,summer,2012,May,12,Friday,Workingday,Clear,0.62,0.6212,0.41,0.194,108,252,360,360,227,360,3,4,3,343,2,728,184414,3,360
2012-05-18,summer,2012,May,13,Friday,Workingday,Clear,0.64,0.6212,0.36,0.1642,98,297,395,395,227,395,3,4,3,343,2,729,184919,3,395
2012-05-18,summer,2012,May,14,Friday,Workingday,Clear,0.66,0.6212,0.34,0.1343,108,242,350,350,227,350,3,4,3,343,2,729,175652,3,350
2012-05-18,summer,2012,May,15,Friday,Workingday,Clear,0.66,0.6212,0.36,0.194,131,260,391,391,227,391,3,4,3,343,2,729,183149,3,391
2012-05-18,summer,2012,May,16,Friday,Workingday,Clear,0.66,0.6212,0.34,0.2537,151,417,568,568,227,568,3,4,3,343,2,730,227748,3,568
2012-05-18,summer,2012,May,17,Friday,Workingday,Clear,0.66,0.6212,0.34,0.1343,124,688,812,812,227,812,3,4,3,343,2,730,336860,3,812
2012-05-18,summer,2012,May,18,Friday,Workingday,Clear,0.64,0.6212,0.38,0.2239,99,570,669,669,227,669,3,4,3,343,2,728,309772,3,669
2012-05-18,summer,2012,May,19,Friday,Workingday,Clear,0.62,0.6212,0.41,0.194,91,392,483,483,227,483,3,4,3,343,2,728,226789,3,483
2012-05-18,summer,2012,May,20,Friday,Workingday,Clear,0.62,0.6212,0.41,0.1642,73,264,337,337,227,337,3,4,3,343,2,728,164550,3,337
2012-05-18,summer,2012,May,21,Friday,Workingday,Clear,0.6,0.6212,0.4,0.0,49,209,258,258,227,258,3,3,3,333,2,728,125445,3,258
2012-05-18,summer,2012,May,22,Friday,Workingday,Clear,0.56,0.5303,0.52,0.3284,57,194,251,251,227,251,3,3,3,333,2,728,95612,3,251
2012-05-18,summer,2012,May,23,Friday,Workingday,Clear,0.52,0.5,0.55,0.0,41,133,174,174,227,174,3,3,3,333,0,728,63941,3,174
2012-05-19,summer,2012,May,0,Saturday,Holiday,Clear,0.52,0.5,0.48,0.1045,30,118,148,148,226,148,3,3,3,333,0,726,39130,3,148
2012-05-19,summer,2012,May,1,Saturday,Holiday,Clear,0.5,0.4848,0.48,0.0,20,84,104,104,226,104,3,2,2,322,0,724,24164,3,104
2012-05-19,summer,2012,May,2,Saturday,Holiday,Clear,0.5,0.4848,0.51,0.1045,13,56,69,69,226,69,3,2,2,322,0,715,16352,3,69
2012-05-19,summer,2012,May,3,Saturday,Holiday,Clear,0.5,0.4848,0.48,0.1045,10,23,33,33,226,33,3,1,2,312,0,697,8174,3,33
2012-05-19,summer,2012,May,4,Saturday,Holiday,Clear,0.48,0.4697,0.59,0.0896,6,8,14,14,226,14,3,1,2,312,0,697,4428,3,14
2012-05-19,summer,2012,May,5,Saturday,Holiday,Clear,0.46,0.4545,0.67,0.0,1,11,12,12,226,12,3,1,2,312,0,717,14261,3,12
2012-05-19,summer,2012,May,6,Saturday,Holiday,Clear,0.44,0.4394,0.72,0.0896,12,38,50,50,226,50,3,2,2,322,0,725,55132,3,50
2012-05-19,summer,2012,May,7,Saturday,Holiday,Clear,0.46,0.4545,0.67,0.1045,28,67,95,95,226,95,3,2,2,322,0,727,154171,3,95
2012-05-19,summer,2012,May,8,Saturday,Holiday,Clear,0.52,0.5,0.52,0.1642,33,162,195,195,226,195,3,3,3,333,0,727,261001,3,195
2012-05-19,summer,2012,May,9,Saturday,Holiday,Clear,0.56,0.5303,0.43,0.1642,79,213,292,292,226,292,3,4,3,343,2,727,159438,3,292
2012-05-19,summer,2012,May,10,Saturday,Holiday,Clear,0.56,0.5303,0.43,0.0,177,275,452,452,226,452,3,4,3,343,2,727,126257,3,452
2012-05-19,summer,2012,May,11,Saturday,Holiday,Clear,0.62,0.6212,0.38,0.0896,235,351,586,586,226,586,3,4,3,343,2,727,151320,3,586
2012-05-19,summer,2012,May,12,Saturday,Holiday,Clear,0.66,0.6212,0.36,0.0,276,366,642,642,226,642,3,4,3,343,2,728,184414,3,642
2012-05-19,summer,2012,May,13,Saturday,Holiday,Clear,0.7,0.6364,0.37,0.1343,332,372,704,704,226,704,3,4,4,344,2,729,184919,3,704
2012-05-19,summer,2012,May,14,Saturday,Holiday,Clear,0.72,0.6515,0.3,0.0896,361,369,730,730,226,730,3,4,4,344,2,729,175652,3,730
2012-05-19,summer,2012,May,15,Saturday,Holiday,Clear,0.72,0.6515,0.3,0.1045,356,316,672,672,226,672,3,4,4,344,2,729,183149,3,672
2012-05-19,summer,2012,May,16,Saturday,Holiday,Clear,0.74,0.6515,0.3,0.1045,331,311,642,642,226,642,3,4,4,344,2,730,227748,3,642
2012-05-19,summer,2012,May,17,Saturday,Holiday,Clear,0.74,0.6515,0.3,0.0896,279,347,626,626,226,626,3,4,4,344,2,730,336860,3,626
2012-05-19,summer,2012,May,18,Saturday,Holiday,Clear,0.74,0.6515,0.33,0.0896,254,391,645,645,226,645,3,4,4,344,2,728,309772,3,645
2012-05-19,summer,2012,May,19,Saturday,Holiday,Clear,0.7,0.6364,0.39,0.1343,203,229,432,432,226,432,3,4,4,344,2,728,226789,3,432
2012-05-19,summer,2012,May,20,Saturday,Holiday,Clear,0.68,0.6364,0.41,0.0896,118,197,315,315,226,315,3,4,4,344,2,728,164550,3,315
2012-05-19,summer,2012,May,21,Saturday,Holiday,Clear,0.64,0.6212,0.5,0.0,81,178,259,259,226,259,3,3,3,333,2,728,125445,3,259
2012-05-19,summer,2012,May,22,Saturday,Holiday,Clear,0.64,0.6212,0.47,0.0,104,234,338,338,226,338,3,4,3,343,2,728,95612,3,338
2012-05-19,summer,2012,May,23,Saturday,Holiday,Clear,0.6,0.6212,0.56,0.1642,71,168,239,239,226,239,3,3,3,333,2,728,63941,3,239
2012-05-20,summer,2012,May,0,Sunday,Holiday,Clear,0.58,0.5455,0.53,0.1045,42,128,170,170,225,170,3,3,3,333,0,726,39130,3,170
2012-05-20,summer,2012,May,1,Sunday,Holiday,Clear,0.56,0.5303,0.52,0.0,28,102,130,130,225,130,3,2,3,323,0,724,24164,3,130
2012-05-20,summer,2012,May,2,Sunday,Holiday,Clear,0.56,0.5303,0.52,0.0,36,62,98,98,225,98,3,2,3,323,0,715,16352,3,98
2012-05-20,summer,2012,May,3,Sunday,Holiday,Clear,0.54,0.5152,0.56,0.0896,26,40,66,66,225,66,3,2,3,323,0,697,8174,3,66
2012-05-20,summer,2012,May,4,Sunday,Holiday,Clear,0.52,0.5,0.68,0.0896,2,14,16,16,225,16,3,1,3,313,0,697,4428,3,16
2012-05-20,summer,2012,May,5,Sunday,Holiday,Clear,0.5,0.4848,0.72,0.1045,1,7,8,8,225,8,3,1,2,312,0,717,14261,3,8
2012-05-20,summer,2012,May,6,Sunday,Holiday,Clear,0.5,0.4848,0.63,0.1343,4,21,25,25,225,25,3,1,2,312,0,725,55132,3,25
2012-05-20,summer,2012,May,7,Sunday,Holiday,Clear,0.52,0.5,0.68,0.194,35,55,90,90,225,90,3,2,3,323,0,727,154171,3,90
2012-05-20,summer,2012,May,8,Sunday,Holiday,Clear,0.56,0.5303,0.56,0.1642,51,120,171,171,225,171,3,3,3,333,0,727,261001,3,171
2012-05-20,summer,2012,May,9,Sunday,Holiday,Clear,0.62,0.6212,0.32,0.2537,129,184,313,313,225,313,3,4,3,343,2,727,159438,3,313
2012-05-20,summer,2012,May,10,Sunday,Holiday,Clear,0.66,0.6212,0.34,0.2985,174,258,432,432,225,432,3,4,3,343,2,727,126257,3,432
2012-05-20,summer,2012,May,11,Sunday,Holiday,Clear,0.66,0.6212,0.36,0.3284,258,323,581,581,225,581,3,4,3,343,2,727,151320,3,581
2012-05-20,summer,2012,May,12,Sunday,Holiday,Clear,0.68,0.6364,0.36,0.3284,247,390,637,637,225,637,3,4,4,344,2,728,184414,3,637
2012-05-20,summer,2012,May,13,Sunday,Holiday,Clear,0.7,0.6364,0.37,0.2836,244,363,607,607,225,607,3,4,4,344,2,729,184919,3,607
2012-05-20,summer,2012,May,14,Sunday,Holiday,Clear,0.72,0.6515,0.39,0.3881,236,307,543,543,225,543,3,4,4,344,2,729,175652,3,543
2012-05-20,summer,2012,May,15,Sunday,Holiday,Mist,0.7,0.6364,0.39,0.4179,246,256,502,502,225,502,3,4,4,344,2,729,183149,3,502
2012-05-20,summer,2012,May,16,Sunday,Holiday,Clear,0.72,0.6515,0.42,0.3582,238,339,577,577,225,577,3,4,4,344,2,730,227748,3,577
2012-05-20,summer,2012,May,17,Sunday,Holiday,Clear,0.72,0.6515,0.45,0.3284,209,340,549,549,225,549,3,4,4,344,2,730,336860,3,549
2012-05-20,summer,2012,May,18,Sunday,Holiday,Clear,0.7,0.6515,0.51,0.3284,146,328,474,474,225,474,3,4,4,344,2,728,309772,3,474
2012-05-20,summer,2012,May,19,Sunday,Holiday,Clear,0.66,0.6212,0.61,0.4179,142,260,402,402,225,402,3,4,3,343,2,728,226789,3,402
2012-05-20,summer,2012,May,20,Sunday,Holiday,Clear,0.66,0.6212,0.61,0.4179,83,191,274,274,225,274,3,3,3,333,2,728,164550,3,274
2012-05-20,summer,2012,May,21,Sunday,Holiday,Clear,0.64,0.6061,0.69,0.3881,51,182,233,233,225,233,3,3,3,333,2,728,125445,3,233
2012-05-20,summer,2012,May,22,Sunday,Holiday,Clear,0.62,0.5909,0.73,0.3284,44,101,145,145,225,145,3,3,3,333,0,728,95612,3,145
2012-05-20,summer,2012,May,23,Sunday,Holiday,Light Snow,0.6,0.5758,0.78,0.3582,32,54,86,86,225,86,3,2,3,323,0,728,63941,3,86
2012-05-21,summer,2012,May,0,Monday,Workingday,Light Snow,0.58,0.5455,0.88,0.2985,12,28,40,40,224,40,3,1,3,313,0,726,39130,3,40
2012-05-21,summer,2012,May,1,Monday,Workingday,Light Snow,0.58,0.5455,0.88,0.3582,4,11,15,15,224,15,3,1,3,313,0,724,24164,3,15
2012-05-21,summer,2012,May,2,Monday,Workingday,Light Snow,0.56,0.5303,0.94,0.2537,2,9,11,11,224,11,3,1,3,313,0,715,16352,3,11
2012-05-21,summer,2012,May,3,Monday,Workingday,Mist,0.56,0.5303,0.88,0.2985,0,2,2,2,224,2,3,1,3,313,0,697,8174,3,2
2012-05-21,summer,2012,May,4,Monday,Workingday,Light Snow,0.56,0.5303,0.88,0.2985,2,5,7,7,224,7,3,1,3,313,0,697,4428,3,7
2012-05-21,summer,2012,May,5,Monday,Workingday,Light Snow,0.56,0.5303,0.88,0.2985,1,14,15,15,224,15,3,1,3,313,0,717,14261,3,15
2012-05-21,summer,2012,May,6,Monday,Workingday,Light Snow,0.56,0.5303,0.88,0.2985,3,76,79,79,224,79,3,2,3,323,0,725,55132,3,79
2012-05-21,summer,2012,May,7,Monday,Workingday,Light Snow,0.56,0.5303,0.88,0.2985,7,146,153,153,224,153,3,3,3,333,0,727,154171,3,153
2012-05-21,summer,2012,May,8,Monday,Workingday,Light Snow,0.56,0.5303,0.88,0.2537,12,258,270,270,224,270,3,3,3,333,0,727,261001,3,270
2012-05-21,summer,2012,May,9,Monday,Workingday,Light Snow,0.56,0.5303,0.88,0.2239,14,172,186,186,224,186,3,3,3,333,0,727,159438,3,186
2012-05-21,summer,2012,May,10,Monday,Workingday,Light Snow,0.58,0.5455,0.88,0.2836,28,71,99,99,224,99,3,2,3,323,0,727,126257,3,99
2012-05-21,summer,2012,May,11,Monday,Workingday,Mist,0.6,0.5606,0.83,0.1642,24,82,106,106,224,106,3,2,3,323,0,727,151320,3,106
2012-05-21,summer,2012,May,12,Monday,Workingday,Mist,0.6,0.5606,0.83,0.2537,46,124,170,170,224,170,3,3,3,333,0,728,184414,3,170
2012-05-21,summer,2012,May,13,Monday,Workingday,Light Snow,0.6,0.5606,0.83,0.2537,49,135,184,184,224,184,3,3,3,333,0,729,184919,3,184
2012-05-21,summer,2012,May,14,Monday,Workingday,Light Snow,0.6,0.5606,0.83,0.194,45,135,180,180,224,180,3,3,3,333,0,729,175652,3,180
2012-05-21,summer,2012,May,15,Monday,Workingday,Mist,0.64,0.6061,0.73,0.194,67,158,225,225,224,225,3,3,3,333,0,729,183149,3,225
2012-05-21,summer,2012,May,16,Monday,Workingday,Mist,0.64,0.6061,0.73,0.2537,46,269,315,315,224,315,3,4,3,343,2,730,227748,3,315
2012-05-21,summer,2012,May,17,Monday,Workingday,Mist,0.66,0.6212,0.69,0.2537,40,468,508,508,224,508,3,4,3,343,2,730,336860,3,508
2012-05-21,summer,2012,May,18,Monday,Workingday,Clear,0.64,0.6061,0.73,0.1045,52,478,530,530,224,530,3,4,3,343,2,728,309772,3,530
2012-05-21,summer,2012,May,19,Monday,Workingday,Clear,0.66,0.6212,0.69,0.0896,57,391,448,448,224,448,3,4,3,343,2,728,226789,3,448
2012-05-21,summer,2012,May,20,Monday,Workingday,Clear,0.64,0.6061,0.69,0.1343,44,292,336,336,224,336,3,4,3,343,0,728,164550,3,336
2012-05-21,summer,2012,May,21,Monday,Workingday,Clear,0.62,0.6061,0.69,0.0896,31,210,241,241,224,241,3,3,3,333,0,728,125445,3,241
2012-05-21,summer,2012,May,22,Monday,Workingday,Mist,0.62,0.5909,0.73,0.1642,26,116,142,142,224,142,3,2,3,323,0,728,95612,3,142
2012-05-21,summer,2012,May,23,Monday,Workingday,Clear,0.62,0.5909,0.73,0.2836,18,79,97,97,224,97,3,2,3,323,0,728,63941,3,97
2012-05-22,summer,2012,May,0,Tuesday,Workingday,Clear,0.58,0.5455,0.83,0.2537,10,26,36,36,223,36,3,1,3,313,0,726,39130,3,36
2012-05-22,summer,2012,May,1,Tuesday,Workingday,Mist,0.58,0.5455,0.83,0.1343,11,16,27,27,223,27,3,1,3,313,0,724,24164,3,27
2012-05-22,summer,2012,May,2,Tuesday,Workingday,Mist,0.58,0.5455,0.83,0.1045,1,10,11,11,223,11,3,1,3,313,0,715,16352,3,11
2012-05-22,summer,2012,May,3,Tuesday,Workingday,Mist,0.58,0.5455,0.83,0.1045,0,5,5,5,223,5,3,1,3,313,0,697,8174,3,5
2012-05-22,summer,2012,May,4,Tuesday,Workingday,Mist,0.56,0.5303,0.88,0.1642,0,7,7,7,223,7,3,1,3,313,0,697,4428,3,7
2012-05-22,summer,2012,May,5,Tuesday,Workingday,Light Snow,0.56,0.5303,0.88,0.194,0,17,17,17,223,17,3,1,3,313,0,717,14261,3,17
2012-05-22,summer,2012,May,6,Tuesday,Workingday,Light Snow,0.56,0.5303,0.88,0.1045,8,129,137,137,223,137,3,2,3,323,0,725,55132,3,137
2012-05-22,summer,2012,May,7,Tuesday,Workingday,Light Snow,0.56,0.5303,0.88,0.1045,9,315,324,324,223,324,3,4,3,343,0,727,154171,3,324
2012-05-22,summer,2012,May,8,Tuesday,Workingday,Mist,0.56,0.5303,0.88,0.1343,20,570,590,590,223,590,3,4,3,343,0,727,261001,3,590
2012-05-22,summer,2012,May,9,Tuesday,Workingday,Mist,0.6,0.5606,0.83,0.1045,46,287,333,333,223,333,3,4,3,343,0,727,159438,3,333
2012-05-22,summer,2012,May,10,Tuesday,Workingday,Mist,0.6,0.5758,0.78,0.0896,52,148,200,200,223,200,3,3,3,333,0,727,126257,3,200
2012-05-22,summer,2012,May,11,Tuesday,Workingday,Mist,0.6,0.5758,0.78,0.0,39,150,189,189,223,189,3,3,3,333,0,727,151320,3,189
2012-05-22,summer,2012,May,12,Tuesday,Workingday,Mist,0.62,0.5909,0.78,0.1045,76,178,254,254,223,254,3,3,3,333,0,728,184414,3,254
2012-05-22,summer,2012,May,13,Tuesday,Workingday,Mist,0.64,0.6061,0.73,0.0,48,195,243,243,223,243,3,3,3,333,0,729,184919,3,243
2012-05-22,summer,2012,May,14,Tuesday,Workingday,Mist,0.64,0.6061,0.73,0.1045,73,149,222,222,223,222,3,3,3,333,0,729,175652,3,222
2012-05-22,summer,2012,May,15,Tuesday,Workingday,Clear,0.7,0.6515,0.61,0.0896,54,191,245,245,223,245,3,3,4,334,2,729,183149,3,245
2012-05-22,summer,2012,May,16,Tuesday,Workingday,Clear,0.68,0.6364,0.61,0.1045,70,316,386,386,223,386,3,4,4,344,2,730,227748,3,386
2012-05-22,summer,2012,May,17,Tuesday,Workingday,Clear,0.72,0.6667,0.54,0.0,69,716,785,785,223,785,3,4,4,344,2,730,336860,3,785
2012-05-22,summer,2012,May,18,Tuesday,Workingday,Clear,0.68,0.6364,0.61,0.1343,76,709,785,785,223,785,3,4,4,344,2,728,309772,3,785
2012-05-22,summer,2012,May,19,Tuesday,Workingday,Clear,0.66,0.6212,0.69,0.2239,44,320,364,364,223,364,3,4,3,343,2,728,226789,3,364
2012-05-22,summer,2012,May,20,Tuesday,Workingday,Clear,0.64,0.6061,0.73,0.2537,54,319,373,373,223,373,3,4,3,343,2,728,164550,3,373
2012-05-22,summer,2012,May,21,Tuesday,Workingday,Clear,0.62,0.5909,0.78,0.1343,28,233,261,261,223,261,3,3,3,333,0,728,125445,3,261
2012-05-22,summer,2012,May,22,Tuesday,Workingday,Clear,0.62,0.5909,0.73,0.0896,17,157,174,174,223,174,3,3,3,333,0,728,95612,3,174
2012-05-22,summer,2012,May,23,Tuesday,Workingday,Clear,0.62,0.5909,0.73,0.1045,14,91,105,105,223,105,3,2,3,323,0,728,63941,3,105
2012-05-23,summer,2012,May,0,Wednesday,Workingday,Clear,0.62,0.5909,0.78,0.1343,19,28,47,47,222,47,3,2,3,323,0,726,39130,3,47
2012-05-23,summer,2012,May,1,Wednesday,Workingday,Clear,0.6,0.5606,0.83,0.1642,23,9,32,32,222,32,3,1,3,313,0,724,24164,3,32
2012-05-23,summer,2012,May,2,Wednesday,Workingday,Mist,0.6,0.5606,0.83,0.1642,2,10,12,12,222,12,3,1,3,313,0,715,16352,3,12
2012-05-23,summer,2012,May,3,Wednesday,Workingday,Clear,0.6,0.5758,0.78,0.1045,0,5,5,5,222,5,3,1,3,313,0,697,8174,3,5
2012-05-23,summer,2012,May,4,Wednesday,Workingday,Light Snow,0.58,0.5455,0.83,0.194,0,3,3,3,222,3,3,1,3,313,0,697,4428,3,3
2012-05-23,summer,2012,May,5,Wednesday,Workingday,Light Snow,0.56,0.5303,0.88,0.2537,6,29,35,35,222,35,3,1,3,313,0,717,14261,3,35
2012-05-23,summer,2012,May,6,Wednesday,Workingday,Clear,0.56,0.5303,0.88,0.1045,6,154,160,160,222,160,3,3,3,333,0,725,55132,3,160
2012-05-23,summer,2012,May,7,Wednesday,Workingday,Clear,0.58,0.5455,0.83,0.0,16,452,468,468,222,468,3,4,3,343,0,727,154171,3,468
2012-05-23,summer,2012,May,8,Wednesday,Workingday,Clear,0.58,0.5455,0.83,0.0,38,681,719,719,222,719,3,4,3,343,2,727,261001,3,719
2012-05-23,summer,2012,May,9,Wednesday,Workingday,Mist,0.62,0.5909,0.78,0.0,39,258,297,297,222,297,3,4,3,343,0,727,159438,3,297
2012-05-23,summer,2012,May,10,Wednesday,Workingday,Clear,0.62,0.5909,0.78,0.0896,52,139,191,191,222,191,3,3,3,333,0,727,126257,3,191
2012-05-23,summer,2012,May,11,Wednesday,Workingday,Clear,0.64,0.6061,0.73,0.0,46,151,197,197,222,197,3,3,3,333,0,727,151320,3,197
2012-05-23,summer,2012,May,12,Wednesday,Workingday,Mist,0.66,0.6212,0.69,0.0896,42,206,248,248,222,248,3,3,3,333,0,728,184414,3,248
2012-05-23,summer,2012,May,13,Wednesday,Workingday,Mist,0.66,0.6212,0.74,0.1642,69,201,270,270,222,270,3,3,3,333,0,729,184919,3,270
2012-05-23,summer,2012,May,14,Wednesday,Workingday,Clear,0.68,0.6364,0.65,0.1343,67,181,248,248,222,248,3,3,4,334,2,729,175652,3,248
2012-05-23,summer,2012,May,15,Wednesday,Workingday,Mist,0.7,0.6515,0.61,0.0,65,192,257,257,222,257,3,3,4,334,0,729,183149,3,257
2012-05-23,summer,2012,May,16,Wednesday,Workingday,Light Snow,0.7,0.6515,0.61,0.0896,62,216,278,278,222,278,3,3,4,334,2,730,227748,3,278
2012-05-23,summer,2012,May,17,Wednesday,Workingday,Light Snow,0.64,0.6061,0.69,0.1045,45,240,285,285,222,285,3,4,3,343,0,730,336860,3,285
2012-05-23,summer,2012,May,18,Wednesday,Workingday,Light Snow,0.64,0.6061,0.69,0.1045,31,296,327,327,222,327,3,4,3,343,0,728,309772,3,327
2012-05-23,summer,2012,May,19,Wednesday,Workingday,Mist,0.62,0.5758,0.83,0.1642,40,336,376,376,222,376,3,4,3,343,0,728,226789,3,376
2012-05-23,summer,2012,May,20,Wednesday,Workingday,Mist,0.62,0.5758,0.83,0.0896,28,267,295,295,222,295,3,4,3,343,0,728,164550,3,295
2012-05-23,summer,2012,May,21,Wednesday,Workingday,Mist,0.62,0.5758,0.83,0.0,24,221,245,245,222,245,3,3,3,333,0,728,125445,3,245
2012-05-23,summer,2012,May,22,Wednesday,Workingday,Mist,0.62,0.5758,0.83,0.1642,23,136,159,159,222,159,3,3,3,333,0,728,95612,3,159
2012-05-23,summer,2012,May,23,Wednesday,Workingday,Clear,0.6,0.5606,0.83,0.1343,23,83,106,106,222,106,3,2,3,323,0,728,63941,3,106
2012-05-24,summer,2012,May,0,Thursday,Workingday,Clear,0.6,0.5606,0.83,0.0896,7,49,56,56,221,56,3,2,3,323,0,726,39130,3,56
2012-05-24,summer,2012,May,1,Thursday,Workingday,Clear,0.6,0.5455,0.88,0.0896,9,21,30,30,221,30,3,1,3,313,0,724,24164,3,30
2012-05-24,summer,2012,May,2,Thursday,Workingday,Clear,0.6,0.5455,0.88,0.0,1,15,16,16,221,16,3,1,3,313,0,715,16352,3,16
2012-05-24,summer,2012,May,3,Thursday,Workingday,Mist,0.6,0.5455,0.88,0.1045,1,3,4,4,221,4,3,1,3,313,0,697,8174,3,4
2012-05-24,summer,2012,May,4,Thursday,Workingday,Mist,0.6,0.5455,0.88,0.1642,0,5,5,5,221,5,3,1,3,313,0,697,4428,3,5
2012-05-24,summer,2012,May,5,Thursday,Workingday,Mist,0.6,0.5455,0.88,0.1642,1,29,30,30,221,30,3,1,3,313,0,717,14261,3,30
2012-05-24,summer,2012,May,6,Thursday,Workingday,Mist,0.6,0.5455,0.88,0.1642,10,146,156,156,221,156,3,3,3,333,0,725,55132,3,156
2012-05-24,summer,2012,May,7,Thursday,Workingday,Clear,0.6,0.5606,0.83,0.1045,22,393,415,415,221,415,3,4,3,343,0,727,154171,3,415
2012-05-24,summer,2012,May,8,Thursday,Workingday,Clear,0.62,0.5909,0.73,0.1343,33,659,692,692,221,692,3,4,3,343,2,727,261001,3,692
2012-05-24,summer,2012,May,9,Thursday,Workingday,Clear,0.62,0.5909,0.73,0.1642,34,267,301,301,221,301,3,4,3,343,0,727,159438,3,301
2012-05-24,summer,2012,May,10,Thursday,Workingday,Clear,0.64,0.6061,0.65,0.1343,47,138,185,185,221,185,3,3,3,333,0,727,126257,3,185
2012-05-24,summer,2012,May,11,Thursday,Workingday,Clear,0.66,0.6212,0.65,0.1343,61,160,221,221,221,221,3,3,3,333,0,727,151320,3,221
2012-05-24,summer,2012,May,12,Thursday,Workingday,Clear,0.7,0.6515,0.58,0.1045,76,213,289,289,221,289,3,4,4,344,2,728,184414,3,289
2012-05-24,summer,2012,May,13,Thursday,Workingday,Clear,0.72,0.6667,0.54,0.1642,69,233,302,302,221,302,3,4,4,344,2,729,184919,3,302
2012-05-24,summer,2012,May,14,Thursday,Workingday,Clear,0.74,0.6818,0.55,0.2239,72,180,252,252,221,252,3,3,4,334,2,729,175652,3,252
2012-05-24,summer,2012,May,15,Thursday,Workingday,Clear,0.74,0.6818,0.55,0.2537,69,222,291,291,221,291,3,4,4,344,2,729,183149,3,291
2012-05-24,summer,2012,May,16,Thursday,Workingday,Clear,0.74,0.6818,0.55,0.3582,61,329,390,390,221,390,3,4,4,344,2,730,227748,3,390
2012-05-24,summer,2012,May,17,Thursday,Workingday,Clear,0.74,0.6818,0.55,0.2836,120,678,798,798,221,798,3,4,4,344,2,730,336860,3,798
2012-05-24,summer,2012,May,18,Thursday,Workingday,Clear,0.72,0.6667,0.54,0.3284,118,634,752,752,221,752,3,4,4,344,2,728,309772,3,752
2012-05-24,summer,2012,May,19,Thursday,Workingday,Clear,0.7,0.6515,0.61,0.2985,76,416,492,492,221,492,3,4,4,344,2,728,226789,3,492
2012-05-24,summer,2012,May,20,Thursday,Workingday,Mist,0.66,0.6212,0.69,0.2836,55,343,398,398,221,398,3,4,3,343,2,728,164550,3,398
2012-05-24,summer,2012,May,21,Thursday,Workingday,Light Snow,0.64,0.5909,0.78,0.1642,48,237,285,285,221,285,3,4,3,343,0,728,125445,3,285
2012-05-24,summer,2012,May,22,Thursday,Workingday,Mist,0.64,0.5909,0.78,0.1045,33,210,243,243,221,243,3,3,3,333,0,728,95612,3,243
2012-05-24,summer,2012,May,23,Thursday,Workingday,Mist,0.64,0.5909,0.78,0.1343,36,131,167,167,221,167,3,3,3,333,0,728,63941,3,167
2012-05-25,summer,2012,May,0,Friday,Workingday,Clear,0.62,0.5758,0.83,0.1343,10,63,73,73,220,73,3,2,3,323,0,726,39130,3,73
2012-05-25,summer,2012,May,1,Friday,Workingday,Clear,0.62,0.5758,0.83,0.0896,8,34,42,42,220,42,3,2,3,323,0,724,24164,3,42
2012-05-25,summer,2012,May,2,Friday,Workingday,Mist,0.62,0.5758,0.83,0.0,7,16,23,23,220,23,3,1,3,313,0,715,16352,3,23
2012-05-25,summer,2012,May,3,Friday,Workingday,Mist,0.62,0.5606,0.88,0.1045,8,6,14,14,220,14,3,1,3,313,0,697,8174,3,14
2012-05-25,summer,2012,May,4,Friday,Workingday,Mist,0.62,0.5606,0.88,0.0,3,6,9,9,220,9,3,1,3,313,0,697,4428,3,9
2012-05-25,summer,2012,May,5,Friday,Workingday,Mist,0.62,0.5606,0.88,0.0896,2,28,30,30,220,30,3,1,3,313,0,717,14261,3,30
2012-05-25,summer,2012,May,6,Friday,Workingday,Mist,0.62,0.5606,0.88,0.1045,5,108,113,113,220,113,3,2,3,323,0,725,55132,3,113
2012-05-25,summer,2012,May,7,Friday,Workingday,Mist,0.62,0.5606,0.88,0.1642,7,352,359,359,220,359,3,4,3,343,0,727,154171,3,359
2012-05-25,summer,2012,May,8,Friday,Workingday,Mist,0.64,0.5758,0.89,0.1045,32,551,583,583,220,583,3,4,3,343,2,727,261001,3,583
2012-05-25,summer,2012,May,9,Friday,Workingday,Mist,0.64,0.5758,0.89,0.1343,52,288,340,340,220,340,3,4,3,343,0,727,159438,3,340
2012-05-25,summer,2012,May,10,Friday,Workingday,Clear,0.68,0.6364,0.79,0.1642,69,163,232,232,220,232,3,3,4,334,0,727,126257,3,232
2012-05-25,summer,2012,May,11,Friday,Workingday,Clear,0.68,0.6364,0.79,0.1343,90,193,283,283,220,283,3,4,4,344,0,727,151320,3,283
2012-05-25,summer,2012,May,12,Friday,Workingday,Clear,0.72,0.6818,0.66,0.1045,84,237,321,321,220,321,3,4,4,344,2,728,184414,3,321
2012-05-25,summer,2012,May,13,Friday,Workingday,Clear,0.74,0.6818,0.62,0.1343,86,247,333,333,220,333,3,4,4,344,2,729,184919,3,333
2012-05-25,summer,2012,May,14,Friday,Workingday,Clear,0.74,0.6818,0.58,0.1343,104,263,367,367,220,367,3,4,4,344,2,729,175652,3,367
2012-05-25,summer,2012,May,15,Friday,Workingday,Clear,0.76,0.7121,0.62,0.194,106,360,466,466,220,466,3,4,4,344,2,729,183149,3,466
2012-05-25,summer,2012,May,16,Friday,Workingday,Clear,0.78,0.7121,0.52,0.2239,137,447,584,584,220,584,3,4,4,344,2,730,227748,3,584
2012-05-25,summer,2012,May,17,Friday,Workingday,Clear,0.76,0.7121,0.62,0.2836,124,529,653,653,220,653,3,4,4,344,2,730,336860,3,653
2012-05-25,summer,2012,May,18,Friday,Workingday,Clear,0.76,0.7121,0.62,0.194,131,391,522,522,220,522,3,4,4,344,2,728,309772,3,522
2012-05-25,summer,2012,May,19,Friday,Workingday,Clear,0.74,0.6818,0.62,0.2537,111,293,404,404,220,404,3,4,4,344,2,728,226789,3,404
2012-05-25,summer,2012,May,20,Friday,Workingday,Clear,0.7,0.6515,0.65,0.1642,80,270,350,350,220,350,3,4,4,344,2,728,164550,3,350
2012-05-25,summer,2012,May,21,Friday,Workingday,Clear,0.7,0.6515,0.65,0.1343,62,193,255,255,220,255,3,3,4,334,2,728,125445,3,255
2012-05-25,summer,2012,May,22,Friday,Workingday,Clear,0.66,0.6212,0.74,0.1045,65,147,212,212,220,212,3,3,3,333,0,728,95612,3,212
2012-05-25,summer,2012,May,23,Friday,Workingday,Clear,0.66,0.6061,0.78,0.2239,34,132,166,166,220,166,3,3,3,333,0,728,63941,3,166
2012-05-26,summer,2012,May,0,Saturday,Holiday,Clear,0.64,0.5758,0.83,0.1642,18,98,116,116,219,116,3,2,3,323,0,726,39130,3,116
2012-05-26,summer,2012,May,1,Saturday,Holiday,Clear,0.64,0.5758,0.83,0.1343,18,64,82,82,219,82,3,2,3,323,0,724,24164,3,82
2012-05-26,summer,2012,May,2,Saturday,Holiday,Clear,0.64,0.5758,0.89,0.1343,9,55,64,64,219,64,3,2,3,323,0,715,16352,3,64
2012-05-26,summer,2012,May,3,Saturday,Holiday,Clear,0.62,0.5606,0.88,0.1045,9,22,31,31,219,31,3,1,3,313,0,697,8174,3,31
2012-05-26,summer,2012,May,4,Saturday,Holiday,Clear,0.62,0.5606,0.88,0.1343,0,2,2,2,219,2,3,1,3,313,0,697,4428,3,2
2012-05-26,summer,2012,May,5,Saturday,Holiday,Clear,0.62,0.5758,0.83,0.2537,0,10,10,10,219,10,3,1,3,313,0,717,14261,3,10
2012-05-26,summer,2012,May,6,Saturday,Holiday,Clear,0.62,0.5606,0.88,0.194,6,25,31,31,219,31,3,1,3,313,0,725,55132,3,31
2012-05-26,summer,2012,May,7,Saturday,Holiday,Mist,0.62,0.5606,0.88,0.1642,10,44,54,54,219,54,3,2,3,323,0,727,154171,3,54
2012-05-26,summer,2012,May,8,Saturday,Holiday,Clear,0.64,0.5909,0.78,0.1343,38,103,141,141,219,141,3,2,3,323,0,727,261001,3,141
2012-05-26,summer,2012,May,9,Saturday,Holiday,Clear,0.64,0.5758,0.83,0.194,97,192,289,289,219,289,3,4,3,343,0,727,159438,3,289
2012-05-26,summer,2012,May,10,Saturday,Holiday,Clear,0.68,0.6364,0.79,0.2239,181,256,437,437,219,437,3,4,4,344,2,727,126257,3,437
2012-05-26,summer,2012,May,11,Saturday,Holiday,Clear,0.7,0.6667,0.74,0.194,208,312,520,520,219,520,3,4,4,344,2,727,151320,3,520
2012-05-26,summer,2012,May,12,Saturday,Holiday,Clear,0.74,0.697,0.66,0.2239,236,293,529,529,219,529,3,4,4,344,2,728,184414,3,529
2012-05-26,summer,2012,May,13,Saturday,Holiday,Clear,0.76,0.7273,0.66,0.194,265,274,539,539,219,539,3,4,4,344,2,729,184919,3,539
2012-05-26,summer,2012,May,14,Saturday,Holiday,Clear,0.76,0.7273,0.66,0.2239,307,257,564,564,219,564,3,4,4,344,2,729,175652,3,564
2012-05-26,summer,2012,May,15,Saturday,Holiday,Clear,0.76,0.7273,0.66,0.2836,274,239,513,513,219,513,3,4,4,344,2,729,183149,3,513
2012-05-26,summer,2012,May,16,Saturday,Holiday,Clear,0.78,0.7273,0.55,0.2537,261,243,504,504,219,504,3,4,4,344,2,730,227748,3,504
2012-05-26,summer,2012,May,17,Saturday,Holiday,Mist,0.78,0.7121,0.52,0.2537,235,227,462,462,219,462,3,4,4,344,2,730,336860,3,462
2012-05-26,summer,2012,May,18,Saturday,Holiday,Mist,0.76,0.697,0.52,0.194,199,216,415,415,219,415,3,4,4,344,2,728,309772,3,415
2012-05-26,summer,2012,May,19,Saturday,Holiday,Mist,0.74,0.697,0.66,0.2239,159,214,373,373,219,373,3,4,4,344,2,728,226789,3,373
2012-05-26,summer,2012,May,20,Saturday,Holiday,Mist,0.74,0.6818,0.55,0.194,103,152,255,255,219,255,3,3,4,334,2,728,164550,3,255
2012-05-26,summer,2012,May,21,Saturday,Holiday,Mist,0.72,0.6818,0.62,0.194,100,151,251,251,219,251,3,3,4,334,2,728,125445,3,251
2012-05-26,summer,2012,May,22,Saturday,Holiday,Clear,0.7,0.6667,0.74,0.2537,86,118,204,204,219,204,3,3,4,334,2,728,95612,3,204
2012-05-26,summer,2012,May,23,Saturday,Holiday,Clear,0.7,0.6667,0.74,0.2537,36,114,150,150,219,150,3,3,4,334,0,728,63941,3,150
2012-05-27,summer,2012,May,0,Sunday,Holiday,Mist,0.68,0.6364,0.69,0.1642,48,89,137,137,218,137,3,2,4,324,0,726,39130,3,137
2012-05-27,summer,2012,May,1,Sunday,Holiday,Clear,0.66,0.6212,0.74,0.2239,17,61,78,78,218,78,3,2,3,323,0,724,24164,3,78
2012-05-27,summer,2012,May,2,Sunday,Holiday,Clear,0.64,0.6061,0.73,0.2239,16,45,61,61,218,61,3,2,3,323,0,715,16352,3,61
2012-05-27,summer,2012,May,3,Sunday,Holiday,Clear,0.64,0.6061,0.73,0.1642,11,25,36,36,218,36,3,1,3,313,0,697,8174,3,36
2012-05-27,summer,2012,May,4,Sunday,Holiday,Clear,0.62,0.5758,0.83,0.194,4,7,11,11,218,11,3,1,3,313,0,697,4428,3,11
2012-05-27,summer,2012,May,5,Sunday,Holiday,Clear,0.62,0.5758,0.83,0.194,2,5,7,7,218,7,3,1,3,313,0,717,14261,3,7
2012-05-27,summer,2012,May,6,Sunday,Holiday,Clear,0.62,0.5758,0.83,0.1642,8,14,22,22,218,22,3,1,3,313,0,725,55132,3,22
2012-05-27,summer,2012,May,7,Sunday,Holiday,Clear,0.62,0.5606,0.88,0.1642,22,30,52,52,218,52,3,2,3,323,0,727,154171,3,52
2012-05-27,summer,2012,May,8,Sunday,Holiday,Clear,0.64,0.5758,0.83,0.194,69,82,151,151,218,151,3,3,3,333,0,727,261001,3,151
2012-05-27,summer,2012,May,9,Sunday,Holiday,Clear,0.66,0.6061,0.83,0.2239,130,140,270,270,218,270,3,3,3,333,2,727,159438,3,270
2012-05-27,summer,2012,May,10,Sunday,Holiday,Clear,0.68,0.6364,0.74,0.2537,209,215,424,424,218,424,3,4,4,344,2,727,126257,3,424
2012-05-27,summer,2012,May,11,Sunday,Holiday,Clear,0.72,0.6818,0.66,0.2239,268,251,519,519,218,519,3,4,4,344,2,727,151320,3,519
2012-05-27,summer,2012,May,12,Sunday,Holiday,Clear,0.74,0.697,0.66,0.2537,301,269,570,570,218,570,3,4,4,344,2,728,184414,3,570
2012-05-27,summer,2012,May,13,Sunday,Holiday,Clear,0.76,0.7121,0.58,0.194,270,228,498,498,218,498,3,4,4,344,2,729,184919,3,498
2012-05-27,summer,2012,May,14,Sunday,Holiday,Clear,0.76,0.7121,0.58,0.2537,317,230,547,547,218,547,3,4,4,344,2,729,175652,3,547
2012-05-27,summer,2012,May,15,Sunday,Holiday,Clear,0.78,0.7121,0.52,0.2836,290,245,535,535,218,535,3,4,4,344,2,729,183149,3,535
2012-05-27,summer,2012,May,16,Sunday,Holiday,Clear,0.78,0.7121,0.52,0.2836,258,243,501,501,218,501,3,4,4,344,2,730,227748,3,501
2012-05-27,summer,2012,May,17,Sunday,Holiday,Clear,0.78,0.7121,0.49,0.2985,275,247,522,522,218,522,3,4,4,344,2,730,336860,3,522
2012-05-27,summer,2012,May,18,Sunday,Holiday,Clear,0.76,0.7121,0.58,0.2985,266,252,518,518,218,518,3,4,4,344,2,728,309772,3,518
2012-05-27,summer,2012,May,19,Sunday,Holiday,Clear,0.76,0.7121,0.58,0.194,230,212,442,442,218,442,3,4,4,344,2,728,226789,3,442
2012-05-27,summer,2012,May,20,Sunday,Holiday,Clear,0.74,0.6818,0.55,0.1642,168,224,392,392,218,392,3,4,4,344,2,728,164550,3,392
2012-05-27,summer,2012,May,21,Sunday,Holiday,Light Snow,0.66,0.6212,0.69,0.4179,64,79,143,143,218,143,3,3,3,333,2,728,125445,3,143
2012-05-27,summer,2012,May,22,Sunday,Holiday,Light Snow,0.62,0.5758,0.83,0.0,9,50,59,59,218,59,3,2,3,323,0,728,95612,3,59
2012-05-27,summer,2012,May,23,Sunday,Holiday,Light Snow,0.62,0.5758,0.83,0.1343,31,65,96,96,218,96,3,2,3,323,0,728,63941,3,96
2012-05-28,summer,2012,May,0,Monday,Holiday,Clear,0.62,0.5758,0.83,0.2239,21,44,65,65,217,65,3,2,3,323,0,726,39130,3,65
2012-05-28,summer,2012,May,1,Monday,Holiday,Mist,0.62,0.5909,0.78,0.2985,14,45,59,59,217,59,3,2,3,323,0,724,24164,3,59
2012-05-28,summer,2012,May,2,Monday,Holiday,Clear,0.6,0.5606,0.83,0.2239,20,28,48,48,217,48,3,2,3,323,0,715,16352,3,48
2012-05-28,summer,2012,May,3,Monday,Holiday,Clear,0.62,0.5909,0.73,0.1642,6,12,18,18,217,18,3,1,3,313,0,697,8174,3,18
2012-05-28,summer,2012,May,4,Monday,Holiday,Clear,0.6,0.5758,0.78,0.1343,2,4,6,6,217,6,3,1,3,313,0,697,4428,3,6
2012-05-28,summer,2012,May,5,Monday,Holiday,Clear,0.6,0.5758,0.78,0.1343,4,5,9,9,217,9,3,1,3,313,0,717,14261,3,9
2012-05-28,summer,2012,May,6,Monday,Holiday,Clear,0.62,0.5909,0.73,0.1642,6,14,20,20,217,20,3,1,3,313,0,725,55132,3,20
2012-05-28,summer,2012,May,7,Monday,Holiday,Clear,0.62,0.5909,0.78,0.1045,24,43,67,67,217,67,3,2,3,323,0,727,154171,3,67
2012-05-28,summer,2012,May,8,Monday,Holiday,Clear,0.66,0.6212,0.69,0.0,62,93,155,155,217,155,3,3,3,333,0,727,261001,3,155
2012-05-28,summer,2012,May,9,Monday,Holiday,Clear,0.7,0.6515,0.61,0.0,121,142,263,263,217,263,3,3,4,334,2,727,159438,3,263
2012-05-28,summer,2012,May,10,Monday,Holiday,Clear,0.7,0.6515,0.61,0.0,189,175,364,364,217,364,3,4,4,344,2,727,126257,3,364
2012-05-28,summer,2012,May,11,Monday,Holiday,Clear,0.72,0.6818,0.66,0.1343,254,222,476,476,217,476,3,4,4,344,2,727,151320,3,476
2012-05-28,summer,2012,May,12,Monday,Holiday,Clear,0.76,0.7121,0.62,0.1343,233,292,525,525,217,525,3,4,4,344,2,728,184414,3,525
2012-05-28,summer,2012,May,13,Monday,Holiday,Clear,0.8,0.7879,0.63,0.2836,272,284,556,556,217,556,3,4,4,344,2,729,184919,3,556
2012-05-28,summer,2012,May,14,Monday,Holiday,Clear,0.8,0.7879,0.63,0.2836,238,227,465,465,217,465,3,4,4,344,2,729,175652,3,465
2012-05-28,summer,2012,May,15,Monday,Holiday,Clear,0.82,0.7879,0.56,0.2985,181,279,460,460,217,460,3,4,4,344,2,729,183149,3,460
2012-05-28,summer,2012,May,16,Monday,Holiday,Clear,0.82,0.7879,0.56,0.3284,223,278,501,501,217,501,3,4,4,344,2,730,227748,3,501
2012-05-28,summer,2012,May,17,Monday,Holiday,Clear,0.82,0.7879,0.56,0.2985,158,247,405,405,217,405,3,4,4,344,2,730,336860,3,405
2012-05-28,summer,2012,May,18,Monday,Holiday,Clear,0.8,0.7727,0.59,0.2985,132,251,383,383,217,383,3,4,4,344,2,728,309772,3,383
2012-05-28,summer,2012,May,19,Monday,Holiday,Clear,0.8,0.7576,0.55,0.2985,148,247,395,395,217,395,3,4,4,344,2,728,226789,3,395
2012-05-28,summer,2012,May,20,Monday,Holiday,Clear,0.78,0.7424,0.62,0.2985,114,203,317,317,217,317,3,4,4,344,2,728,164550,3,317
2012-05-28,summer,2012,May,21,Monday,Holiday,Clear,0.76,0.7273,0.66,0.2836,66,181,247,247,217,247,3,3,4,334,2,728,125445,3,247
2012-05-28,summer,2012,May,22,Monday,Holiday,Clear,0.74,0.697,0.7,0.1642,47,110,157,157,217,157,3,3,4,334,0,728,95612,3,157
2012-05-28,summer,2012,May,23,Monday,Holiday,Clear,0.72,0.697,0.74,0.1642,22,60,82,82,217,82,3,2,4,324,0,728,63941,3,82
2012-05-29,summer,2012,May,0,Tuesday,Workingday,Clear,0.7,0.6667,0.79,0.194,12,33,45,45,216,45,3,2,4,324,0,726,39130,3,45
2012-05-29,summer,2012,May,1,Tuesday,Workingday,Clear,0.7,0.6667,0.79,0.194,1,13,14,14,216,14,3,1,4,314,0,724,24164,3,14
2012-05-29,summer,2012,May,2,Tuesday,Workingday,Clear,0.68,0.6364,0.83,0.1343,0,8,8,8,216,8,3,1,4,314,0,715,16352,3,8
2012-05-29,summer,2012,May,3,Tuesday,Workingday,Clear,0.68,0.6364,0.79,0.2836,1,2,3,3,216,3,3,1,4,314,0,697,8174,3,3
2012-05-29,summer,2012,May,4,Tuesday,Workingday,Clear,0.66,0.6061,0.78,0.2239,0,5,5,5,216,5,3,1,3,313,0,697,4428,3,5
2012-05-29,summer,2012,May,5,Tuesday,Workingday,Clear,0.66,0.6061,0.78,0.2239,1,32,33,33,216,33,3,1,3,313,0,717,14261,3,33
2012-05-29,summer,2012,May,6,Tuesday,Workingday,Clear,0.66,0.6061,0.78,0.2239,9,145,154,154,216,154,3,3,3,333,0,725,55132,3,154
2012-05-29,summer,2012,May,7,Tuesday,Workingday,Clear,0.66,0.6061,0.78,0.2239,19,431,450,450,216,450,3,4,3,343,2,727,154171,3,450
2012-05-29,summer,2012,May,8,Tuesday,Workingday,Clear,0.7,0.6667,0.74,0.194,46,588,634,634,216,634,3,4,4,344,2,727,261001,3,634
2012-05-29,summer,2012,May,9,Tuesday,Workingday,Clear,0.72,0.6818,0.7,0.2537,26,231,257,257,216,257,3,3,4,334,0,727,159438,3,257
2012-05-29,summer,2012,May,10,Tuesday,Workingday,Clear,0.74,0.697,0.7,0.2985,67,116,183,183,216,183,3,3,4,334,2,727,126257,3,183
2012-05-29,summer,2012,May,11,Tuesday,Workingday,Clear,0.76,0.7121,0.62,0.2985,50,147,197,197,216,197,3,3,4,334,2,727,151320,3,197
2012-05-29,summer,2012,May,12,Tuesday,Workingday,Clear,0.8,0.7576,0.55,0.3284,56,181,237,237,216,237,3,3,4,334,2,728,184414,3,237
2012-05-29,summer,2012,May,13,Tuesday,Workingday,Clear,0.82,0.7727,0.52,0.3881,63,176,239,239,216,239,3,3,4,334,2,729,184919,3,239
2012-05-29,summer,2012,May,14,Tuesday,Workingday,Clear,0.82,0.7727,0.52,0.4179,80,158,238,238,216,238,3,3,4,334,2,729,175652,3,238
2012-05-29,summer,2012,May,15,Tuesday,Workingday,Clear,0.82,0.7727,0.49,0.3881,71,185,256,256,216,256,3,3,4,334,2,729,183149,3,256
2012-05-29,summer,2012,May,16,Tuesday,Workingday,Clear,0.82,0.7727,0.49,0.4925,73,320,393,393,216,393,3,4,4,344,2,730,227748,3,393
2012-05-29,summer,2012,May,17,Tuesday,Workingday,Clear,0.82,0.7576,0.46,0.4179,107,674,781,781,216,781,3,4,4,344,2,730,336860,3,781
2012-05-29,summer,2012,May,18,Tuesday,Workingday,Clear,0.8,0.7424,0.49,0.4925,78,632,710,710,216,710,3,4,4,344,2,728,309772,3,710
2012-05-29,summer,2012,May,19,Tuesday,Workingday,Clear,0.78,0.7121,0.52,0.3582,69,457,526,526,216,526,3,4,4,344,2,728,226789,3,526
2012-05-29,summer,2012,May,20,Tuesday,Workingday,Light Snow,0.7,0.6515,0.61,0.5224,36,168,204,204,216,204,3,3,4,334,2,728,164550,3,204
2012-05-29,summer,2012,May,21,Tuesday,Workingday,Light Snow,0.6,0.5455,0.88,0.4478,3,68,71,71,216,71,3,2,3,323,0,728,125445,3,71
2012-05-29,summer,2012,May,22,Tuesday,Workingday,Mist,0.62,0.5606,0.88,0.0896,2,53,55,55,216,55,3,2,3,323,0,728,95612,3,55
2012-05-29,summer,2012,May,23,Tuesday,Workingday,Light Snow,0.62,0.5455,0.94,0.0,10,40,50,50,216,50,3,2,3,323,0,728,63941,3,50
2012-05-30,summer,2012,May,0,Wednesday,Workingday,Light Snow,0.64,0.5758,0.89,0.1045,4,32,36,36,215,36,3,1,3,313,0,726,39130,3,36
2012-05-30,summer,2012,May,1,Wednesday,Workingday,Light Snow,0.64,0.5758,0.89,0.194,0,4,4,4,215,4,3,1,3,313,0,724,24164,3,4
2012-05-30,summer,2012,May,2,Wednesday,Workingday,Light Snow,0.62,0.5455,0.94,0.0896,1,4,5,5,215,5,3,1,3,313,0,715,16352,3,5
2012-05-30,summer,2012,May,3,Wednesday,Workingday,Light Snow,0.62,0.5606,0.88,0.1343,0,5,5,5,215,5,3,1,3,313,0,697,8174,3,5
2012-05-30,summer,2012,May,4,Wednesday,Workingday,Mist,0.62,0.5606,0.88,0.1343,0,6,6,6,215,6,3,1,3,313,0,697,4428,3,6
2012-05-30,summer,2012,May,5,Wednesday,Workingday,Mist,0.62,0.5909,0.78,0.1343,1,40,41,41,215,41,3,2,3,323,0,717,14261,3,41
2012-05-30,summer,2012,May,6,Wednesday,Workingday,Mist,0.6,0.5758,0.78,0.1045,5,139,144,144,215,144,3,3,3,333,0,725,55132,3,144
2012-05-30,summer,2012,May,7,Wednesday,Workingday,Light Snow,0.6,0.5758,0.78,0.194,14,469,483,483,215,483,3,4,3,343,2,727,154171,3,483
2012-05-30,summer,2012,May,8,Wednesday,Workingday,Mist,0.6,0.5909,0.73,0.1642,29,642,671,671,215,671,3,4,3,343,2,727,261001,3,671
2012-05-30,summer,2012,May,9,Wednesday,Workingday,Mist,0.62,0.6061,0.69,0.194,23,282,305,305,215,305,3,4,3,343,0,727,159438,3,305
2012-05-30,summer,2012,May,10,Wednesday,Workingday,Mist,0.62,0.6061,0.69,0.2836,39,138,177,177,215,177,3,3,3,333,0,727,126257,3,177
2012-05-30,summer,2012,May,11,Wednesday,Workingday,Mist,0.66,0.6212,0.65,0.194,53,155,208,208,215,208,3,3,3,333,0,727,151320,3,208
2012-05-30,summer,2012,May,12,Wednesday,Workingday,Clear,0.7,0.6515,0.54,0.0,33,220,253,253,215,253,3,3,4,334,0,728,184414,3,253
2012-05-30,summer,2012,May,13,Wednesday,Workingday,Clear,0.7,0.6515,0.51,0.0,53,236,289,289,215,289,3,4,4,344,2,729,184919,3,289
2012-05-30,summer,2012,May,14,Wednesday,Workingday,Clear,0.72,0.6515,0.42,0.1343,44,208,252,252,215,252,3,3,4,334,2,729,175652,3,252
2012-05-30,summer,2012,May,15,Wednesday,Workingday,Clear,0.72,0.6667,0.51,0.1343,54,221,275,275,215,275,3,3,4,334,2,729,183149,3,275
2012-05-30,summer,2012,May,16,Wednesday,Workingday,Clear,0.72,0.6667,0.51,0.1642,46,352,398,398,215,398,3,4,4,344,2,730,227748,3,398
2012-05-30,summer,2012,May,17,Wednesday,Workingday,Clear,0.74,0.6667,0.48,0.0896,83,756,839,839,215,839,3,4,4,344,2,730,336860,3,839
2012-05-30,summer,2012,May,18,Wednesday,Workingday,Clear,0.74,0.6667,0.48,0.1642,50,746,796,796,215,796,3,4,4,344,2,728,309772,3,796
2012-05-30,summer,2012,May,19,Wednesday,Workingday,Clear,0.72,0.6667,0.54,0.1642,50,506,556,556,215,556,3,4,4,344,2,728,226789,3,556
2012-05-30,summer,2012,May,20,Wednesday,Workingday,Mist,0.54,0.5152,0.6,0.1343,57,374,431,431,215,431,3,4,3,343,2,728,164550,3,431
2012-05-30,summer,2012,May,21,Wednesday,Workingday,Clear,0.68,0.6364,0.57,0.1045,41,263,304,304,215,304,3,4,4,344,2,728,125445,3,304
2012-05-30,summer,2012,May,22,Wednesday,Workingday,Clear,0.66,0.6212,0.69,0.1045,26,191,217,217,215,217,3,3,3,333,0,728,95612,3,217
2012-05-30,summer,2012,May,23,Wednesday,Workingday,Clear,0.66,0.6212,0.65,0.1045,39,121,160,160,215,160,3,3,3,333,0,728,63941,3,160
2012-05-31,summer,2012,May,0,Thursday,Workingday,Clear,0.64,0.6061,0.69,0.1343,13,48,61,61,214,61,3,2,3,323,0,726,39130,3,61
2012-05-31,summer,2012,May,1,Thursday,Workingday,Clear,0.64,0.6061,0.69,0.0896,4,22,26,26,214,26,3,1,3,313,0,724,24164,3,26
2012-05-31,summer,2012,May,2,Thursday,Workingday,Clear,0.64,0.6061,0.65,0.0896,6,8,14,14,214,14,3,1,3,313,0,715,16352,3,14
2012-05-31,summer,2012,May,3,Thursday,Workingday,Clear,0.62,0.6061,0.69,0.0896,0,8,8,8,214,8,3,1,3,313,0,697,8174,3,8
2012-05-31,summer,2012,May,4,Thursday,Workingday,Clear,0.62,0.6061,0.69,0.0,0,8,8,8,214,8,3,1,3,313,0,697,4428,3,8
2012-05-31,summer,2012,May,5,Thursday,Workingday,Clear,0.62,0.6061,0.69,0.2537,1,32,33,33,214,33,3,1,3,313,0,717,14261,3,33
2012-05-31,summer,2012,May,6,Thursday,Workingday,Clear,0.6,0.5909,0.73,0.2239,7,171,178,178,214,178,3,3,3,333,0,725,55132,3,178
2012-05-31,summer,2012,May,7,Thursday,Workingday,Clear,0.6,0.6061,0.64,0.2836,18,489,507,507,214,507,3,4,3,343,2,727,154171,3,507
2012-05-31,summer,2012,May,8,Thursday,Workingday,Clear,0.62,0.6212,0.57,0.2537,18,675,693,693,214,693,3,4,3,343,2,727,261001,3,693
2012-05-31,summer,2012,May,9,Thursday,Workingday,Clear,0.66,0.6212,0.47,0.2537,47,264,311,311,214,311,3,4,3,343,2,727,159438,3,311
2012-05-31,summer,2012,May,10,Thursday,Workingday,Clear,0.7,0.6364,0.39,0.3881,65,155,220,220,214,220,3,3,4,334,2,727,126257,3,220
2012-05-31,summer,2012,May,11,Thursday,Workingday,Clear,0.72,0.6515,0.37,0.2836,65,153,218,218,214,218,3,3,4,334,2,727,151320,3,218
2012-05-31,summer,2012,May,12,Thursday,Workingday,Clear,0.72,0.6515,0.37,0.194,62,230,292,292,214,292,3,4,4,344,2,728,184414,3,292
2012-05-31,summer,2012,May,13,Thursday,Workingday,Clear,0.74,0.6515,0.35,0.1343,77,216,293,293,214,293,3,4,4,344,2,729,184919,3,293
2012-05-31,summer,2012,May,14,Thursday,Workingday,Clear,0.76,0.6667,0.31,0.194,61,193,254,254,214,254,3,3,4,334,2,729,175652,3,254
2012-05-31,summer,2012,May,15,Thursday,Workingday,Clear,0.76,0.6667,0.33,0.2985,81,209,290,290,214,290,3,4,4,344,2,729,183149,3,290
2012-05-31,summer,2012,May,16,Thursday,Workingday,Clear,0.76,0.6667,0.33,0.2836,103,384,487,487,214,487,3,4,4,344,2,730,227748,3,487
2012-05-31,summer,2012,May,17,Thursday,Workingday,Clear,0.76,0.6667,0.31,0.1642,85,742,827,827,214,827,3,4,4,344,2,730,336860,3,827
2012-05-31,summer,2012,May,18,Thursday,Workingday,Clear,0.74,0.6515,0.3,0.194,85,700,785,785,214,785,3,4,4,344,2,728,309772,3,785
2012-05-31,summer,2012,May,19,Thursday,Workingday,Clear,0.72,0.6515,0.34,0.1642,104,487,591,591,214,591,3,4,4,344,2,728,226789,3,591
2012-05-31,summer,2012,May,20,Thursday,Workingday,Clear,0.68,0.6364,0.44,0.1642,88,391,479,479,214,479,3,4,4,344,2,728,164550,3,479
2012-05-31,summer,2012,May,21,Thursday,Workingday,Clear,0.68,0.6364,0.44,0.1642,41,318,359,359,214,359,3,4,4,344,2,728,125445,3,359
2012-05-31,summer,2012,May,22,Thursday,Workingday,Clear,0.66,0.6212,0.5,0.1642,43,221,264,264,214,264,3,3,3,333,2,728,95612,3,264
2012-05-31,summer,2012,May,23,Thursday,Workingday,Clear,0.66,0.6212,0.54,0.2239,26,114,140,140,214,140,3,2,3,323,0,728,63941,3,140
2012-06-01,summer,2012,June,0,Friday,Workingday,Clear,0.66,0.6212,0.5,0.2537,10,76,86,86,213,86,3,2,3,323,0,726,39130,3,86
2012-06-01,summer,2012,June,1,Friday,Workingday,Clear,0.64,0.6212,0.53,0.2239,0,34,34,34,213,34,3,1,3,313,0,724,24164,3,34
2012-06-01,summer,2012,June,2,Friday,Workingday,Clear,0.64,0.6212,0.57,0.2239,3,13,16,16,213,16,3,1,3,313,0,715,16352,3,16
2012-06-01,summer,2012,June,3,Friday,Workingday,Mist,0.62,0.5909,0.73,0.0896,0,4,4,4,213,4,3,1,3,313,0,697,8174,3,4
2012-06-01,summer,2012,June,4,Friday,Workingday,Mist,0.62,0.5909,0.73,0.0896,1,5,6,6,213,6,3,1,3,313,0,697,4428,3,6
2012-06-01,summer,2012,June,5,Friday,Workingday,Mist,0.62,0.5909,0.78,0.0896,4,41,45,45,213,45,3,2,3,323,0,717,14261,3,45
2012-06-01,summer,2012,June,6,Friday,Workingday,Light Snow,0.62,0.5606,0.88,0.1343,5,136,141,141,213,141,3,2,3,323,0,725,55132,3,141
2012-06-01,summer,2012,June,7,Friday,Workingday,Mist,0.64,0.5758,0.89,0.194,33,369,402,402,213,402,3,4,3,343,0,727,154171,3,402
2012-06-01,summer,2012,June,8,Friday,Workingday,Mist,0.64,0.5758,0.89,0.194,19,675,694,694,213,694,3,4,3,343,2,727,261001,3,694
2012-06-01,summer,2012,June,9,Friday,Workingday,Mist,0.64,0.5758,0.83,0.2239,24,274,298,298,213,298,3,4,3,343,0,727,159438,3,298
2012-06-01,summer,2012,June,10,Friday,Workingday,Mist,0.66,0.6061,0.78,0.2836,49,155,204,204,213,204,3,3,3,333,0,727,126257,3,204
2012-06-01,summer,2012,June,11,Friday,Workingday,Mist,0.7,0.6667,0.74,0.2836,42,193,235,235,213,235,3,3,4,334,0,727,151320,3,235
2012-06-01,summer,2012,June,12,Friday,Workingday,Mist,0.7,0.6667,0.74,0.3582,72,238,310,310,213,310,3,4,4,344,2,728,184414,3,310
2012-06-01,summer,2012,June,13,Friday,Workingday,Clear,0.72,0.6818,0.7,0.2985,76,240,316,316,213,316,3,4,4,344,2,729,184919,3,316
2012-06-01,summer,2012,June,14,Friday,Workingday,Light Snow,0.72,0.6818,0.66,0.2836,55,199,254,254,213,254,3,3,4,334,2,729,175652,3,254
2012-06-01,summer,2012,June,15,Friday,Workingday,Light Snow,0.72,0.6818,0.66,0.2836,45,213,258,258,213,258,3,3,4,334,2,729,183149,3,258
2012-06-01,summer,2012,June,16,Friday,Workingday,Light Snow,0.74,0.6818,0.58,0.4478,36,186,222,222,213,222,3,3,4,334,2,730,227748,3,222
2012-06-01,summer,2012,June,17,Friday,Workingday,Light Snow,0.7,0.6515,0.7,0.2537,25,202,227,227,213,227,3,3,4,334,0,730,336860,3,227
2012-06-01,summer,2012,June,18,Friday,Workingday,Light Snow,0.62,0.5606,0.88,0.3582,10,100,110,110,213,110,3,2,3,323,0,728,309772,3,110
2012-06-01,summer,2012,June,19,Friday,Workingday,Light Snow,0.62,0.5606,0.88,0.3582,4,41,45,45,213,45,3,2,3,323,0,728,226789,3,45
2012-06-01,summer,2012,June,20,Friday,Workingday,Light Snow,0.62,0.5455,0.94,0.2537,1,38,39,39,213,39,3,1,3,313,0,728,164550,3,39
2012-06-01,summer,2012,June,21,Friday,Workingday,Light Snow,0.64,0.5909,0.78,0.2537,12,73,85,85,213,85,3,2,3,323,0,728,125445,3,85
2012-06-01,summer,2012,June,22,Friday,Workingday,Light Snow,0.6,0.5455,0.88,0.1343,1,22,23,23,213,23,3,1,3,313,0,728,95612,3,23
2012-06-01,summer,2012,June,23,Friday,Workingday,Light Snow,0.6,0.5455,0.88,0.1343,6,67,73,73,213,73,3,2,3,323,0,728,63941,3,73
2012-06-02,summer,2012,June,0,Saturday,Holiday,Mist,0.56,0.5303,0.83,0.1343,5,81,86,86,212,86,3,2,3,323,0,726,39130,3,86
2012-06-02,summer,2012,June,1,Saturday,Holiday,Mist,0.56,0.5303,0.83,0.1045,15,61,76,76,212,76,3,2,3,323,0,724,24164,3,76
2012-06-02,summer,2012,June,2,Saturday,Holiday,Mist,0.54,0.5152,0.88,0.0,3,38,41,41,212,41,3,2,3,323,0,715,16352,3,41
2012-06-02,summer,2012,June,3,Saturday,Holiday,Clear,0.56,0.5303,0.73,0.2537,8,18,26,26,212,26,3,1,3,313,0,697,8174,3,26
2012-06-02,summer,2012,June,4,Saturday,Holiday,Clear,0.54,0.5152,0.68,0.2836,2,11,13,13,212,13,3,1,3,313,0,697,4428,3,13
2012-06-02,summer,2012,June,5,Saturday,Holiday,Clear,0.5,0.4848,0.72,0.194,1,11,12,12,212,12,3,1,2,312,0,717,14261,3,12
2012-06-02,summer,2012,June,6,Saturday,Holiday,Mist,0.5,0.4848,0.77,0.194,5,31,36,36,212,36,3,1,2,312,0,725,55132,3,36
2012-06-02,summer,2012,June,7,Saturday,Holiday,Clear,0.52,0.5,0.72,0.1045,9,77,86,86,212,86,3,2,3,323,0,727,154171,3,86
2012-06-02,summer,2012,June,8,Saturday,Holiday,Clear,0.54,0.5152,0.64,0.1642,30,180,210,210,212,210,3,3,3,333,0,727,261001,3,210
2012-06-02,summer,2012,June,9,Saturday,Holiday,Clear,0.56,0.5303,0.6,0.2537,89,243,332,332,212,332,3,4,3,343,2,727,159438,3,332
2012-06-02,summer,2012,June,10,Saturday,Holiday,Clear,0.6,0.6212,0.53,0.2985,145,348,493,493,212,493,3,4,3,343,2,727,126257,3,493
2012-06-02,summer,2012,June,11,Saturday,Holiday,Clear,0.58,0.5455,0.46,0.2836,179,357,536,536,212,536,3,4,3,343,2,727,151320,3,536
2012-06-02,summer,2012,June,12,Saturday,Holiday,Clear,0.62,0.6212,0.43,0.3582,250,418,668,668,212,668,3,4,3,343,2,728,184414,3,668
2012-06-02,summer,2012,June,13,Saturday,Holiday,Clear,0.62,0.6212,0.41,0.2537,279,400,679,679,212,679,3,4,3,343,2,729,184919,3,679
2012-06-02,summer,2012,June,14,Saturday,Holiday,Clear,0.64,0.6212,0.38,0.2985,259,388,647,647,212,647,3,4,3,343,2,729,175652,3,647
2012-06-02,summer,2012,June,15,Saturday,Holiday,Clear,0.64,0.6212,0.38,0.2537,297,405,702,702,212,702,3,4,3,343,2,729,183149,3,702
2012-06-02,summer,2012,June,16,Saturday,Holiday,Clear,0.64,0.6212,0.38,0.2537,275,369,644,644,212,644,3,4,3,343,2,730,227748,3,644
2012-06-02,summer,2012,June,17,Saturday,Holiday,Clear,0.64,0.6212,0.36,0.0,248,338,586,586,212,586,3,4,3,343,2,730,336860,3,586
2012-06-02,summer,2012,June,18,Saturday,Holiday,Clear,0.64,0.6212,0.36,0.0,171,341,512,512,212,512,3,4,3,343,2,728,309772,3,512
2012-06-02,summer,2012,June,19,Saturday,Holiday,Clear,0.64,0.6212,0.36,0.1642,185,369,554,554,212,554,3,4,3,343,2,728,226789,3,554
2012-06-02,summer,2012,June,20,Saturday,Holiday,Clear,0.62,0.6212,0.35,0.2836,139,260,399,399,212,399,3,4,3,343,2,728,164550,3,399
2012-06-02,summer,2012,June,21,Saturday,Holiday,Clear,0.6,0.6212,0.4,0.1045,96,220,316,316,212,316,3,4,3,343,2,728,125445,3,316
2012-06-02,summer,2012,June,22,Saturday,Holiday,Clear,0.58,0.5455,0.46,0.1343,52,176,228,228,212,228,3,3,3,333,2,728,95612,3,228
2012-06-02,summer,2012,June,23,Saturday,Holiday,Clear,0.56,0.5303,0.52,0.1045,53,185,238,238,212,238,3,3,3,333,0,728,63941,3,238
2012-06-03,summer,2012,June,0,Sunday,Holiday,Clear,0.54,0.5152,0.6,0.1642,27,142,169,169,211,169,3,3,3,333,0,726,39130,3,169
2012-06-03,summer,2012,June,1,Sunday,Holiday,Clear,0.54,0.5152,0.56,0.1343,21,100,121,121,211,121,3,2,3,323,0,724,24164,3,121
2012-06-03,summer,2012,June,2,Sunday,Holiday,Clear,0.52,0.5,0.59,0.1045,22,67,89,89,211,89,3,2,3,323,0,715,16352,3,89
2012-06-03,summer,2012,June,3,Sunday,Holiday,Clear,0.52,0.5,0.63,0.1045,16,34,50,50,211,50,3,2,3,323,0,697,8174,3,50
2012-06-03,summer,2012,June,4,Sunday,Holiday,Clear,0.5,0.4848,0.72,0.0896,1,12,13,13,211,13,3,1,2,312,0,697,4428,3,13
2012-06-03,summer,2012,June,5,Sunday,Holiday,Clear,0.5,0.4848,0.68,0.0,1,11,12,12,211,12,3,1,2,312,0,717,14261,3,12
2012-06-03,summer,2012,June,6,Sunday,Holiday,Clear,0.46,0.4545,0.82,0.1045,6,16,22,22,211,22,3,1,2,312,0,725,55132,3,22
2012-06-03,summer,2012,June,7,Sunday,Holiday,Clear,0.5,0.4848,0.68,0.1045,6,29,35,35,211,35,3,1,2,312,0,727,154171,3,35
2012-06-03,summer,2012,June,8,Sunday,Holiday,Clear,0.54,0.5152,0.6,0.0896,30,110,140,140,211,140,3,2,3,323,0,727,261001,3,140
2012-06-03,summer,2012,June,9,Sunday,Holiday,Clear,0.6,0.6212,0.46,0.194,70,230,300,300,211,300,3,4,3,343,2,727,159438,3,300
2012-06-03,summer,2012,June,10,Sunday,Holiday,Clear,0.62,0.6212,0.43,0.2239,127,277,404,404,211,404,3,4,3,343,2,727,126257,3,404
2012-06-03,summer,2012,June,11,Sunday,Holiday,Clear,0.64,0.6212,0.41,0.2537,199,312,511,511,211,511,3,4,3,343,2,727,151320,3,511
2012-06-03,summer,2012,June,12,Sunday,Holiday,Clear,0.66,0.6212,0.39,0.2985,276,408,684,684,211,684,3,4,3,343,2,728,184414,3,684
2012-06-03,summer,2012,June,13,Sunday,Holiday,Clear,0.68,0.6364,0.36,0.2836,265,421,686,686,211,686,3,4,4,344,2,729,184919,3,686
2012-06-03,summer,2012,June,14,Sunday,Holiday,Clear,0.68,0.6364,0.36,0.3284,267,411,678,678,211,678,3,4,4,344,2,729,175652,3,678
2012-06-03,summer,2012,June,15,Sunday,Holiday,Clear,0.7,0.6364,0.34,0.0,236,408,644,644,211,644,3,4,4,344,2,729,183149,3,644
2012-06-03,summer,2012,June,16,Sunday,Holiday,Clear,0.7,0.6364,0.34,0.2985,226,436,662,662,211,662,3,4,4,344,2,730,227748,3,662
2012-06-03,summer,2012,June,17,Sunday,Holiday,Clear,0.7,0.6364,0.34,0.2537,192,386,578,578,211,578,3,4,4,344,2,730,336860,3,578
2012-06-03,summer,2012,June,18,Sunday,Holiday,Clear,0.7,0.6364,0.34,0.2537,153,343,496,496,211,496,3,4,4,344,2,728,309772,3,496
2012-06-03,summer,2012,June,19,Sunday,Holiday,Clear,0.68,0.6364,0.34,0.2836,116,337,453,453,211,453,3,4,4,344,2,728,226789,3,453
2012-06-03,summer,2012,June,20,Sunday,Holiday,Clear,0.66,0.6212,0.39,0.194,84,230,314,314,211,314,3,4,3,343,2,728,164550,3,314
2012-06-03,summer,2012,June,21,Sunday,Holiday,Clear,0.62,0.6212,0.43,0.1642,66,180,246,246,211,246,3,3,3,333,2,728,125445,3,246
2012-06-03,summer,2012,June,22,Sunday,Holiday,Clear,0.62,0.6212,0.5,0.3881,61,165,226,226,211,226,3,3,3,333,2,728,95612,3,226
2012-06-03,summer,2012,June,23,Sunday,Holiday,Clear,0.58,0.5455,0.53,0.1045,26,82,108,108,211,108,3,2,3,323,0,728,63941,3,108
2012-06-04,summer,2012,June,0,Monday,Workingday,Clear,0.58,0.5455,0.53,0.0,11,38,49,49,210,49,3,2,3,323,0,726,39130,3,49
2012-06-04,summer,2012,June,1,Monday,Workingday,Light Snow,0.56,0.5303,0.6,0.1642,4,10,14,14,210,14,3,1,3,313,0,724,24164,3,14
2012-06-04,summer,2012,June,2,Monday,Workingday,Clear,0.56,0.5303,0.6,0.2239,1,10,11,11,210,11,3,1,3,313,0,715,16352,3,11
2012-06-04,summer,2012,June,3,Monday,Workingday,Mist,0.56,0.5303,0.6,0.1642,0,5,5,5,210,5,3,1,3,313,0,697,8174,3,5
2012-06-04,summer,2012,June,4,Monday,Workingday,Clear,0.54,0.5152,0.64,0.0896,2,6,8,8,210,8,3,1,3,313,0,697,4428,3,8
2012-06-04,summer,2012,June,5,Monday,Workingday,Clear,0.52,0.5,0.68,0.0,2,33,35,35,210,35,3,1,3,313,0,717,14261,3,35
2012-06-04,summer,2012,June,6,Monday,Workingday,Clear,0.52,0.5,0.68,0.0,4,135,139,139,210,139,3,2,3,323,0,725,55132,3,139
2012-06-04,summer,2012,June,7,Monday,Workingday,Clear,0.56,0.5303,0.6,0.2239,13,504,517,517,210,517,3,4,3,343,2,727,154171,3,517
2012-06-04,summer,2012,June,8,Monday,Workingday,Clear,0.6,0.6212,0.49,0.2239,22,643,665,665,210,665,3,4,3,343,2,727,261001,3,665
2012-06-04,summer,2012,June,9,Monday,Workingday,Clear,0.62,0.6212,0.43,0.2836,38,244,282,282,210,282,3,4,3,343,2,727,159438,3,282
2012-06-04,summer,2012,June,10,Monday,Workingday,Clear,0.64,0.6212,0.41,0.4627,67,120,187,187,210,187,3,3,3,333,2,727,126257,3,187
2012-06-04,summer,2012,June,11,Monday,Workingday,Clear,0.64,0.6212,0.38,0.4925,71,168,239,239,210,239,3,3,3,333,2,727,151320,3,239
2012-06-04,summer,2012,June,12,Monday,Workingday,Clear,0.64,0.6212,0.41,0.4478,62,220,282,282,210,282,3,4,3,343,2,728,184414,3,282
2012-06-04,summer,2012,June,13,Monday,Workingday,Clear,0.64,0.6212,0.41,0.3582,85,189,274,274,210,274,3,3,3,333,2,729,184919,3,274
2012-06-04,summer,2012,June,14,Monday,Workingday,Clear,0.62,0.6212,0.41,0.4925,84,186,270,270,210,270,3,3,3,333,2,729,175652,3,270
2012-06-04,summer,2012,June,15,Monday,Workingday,Clear,0.66,0.6212,0.39,0.2985,77,215,292,292,210,292,3,4,3,343,2,729,183149,3,292
2012-06-04,summer,2012,June,16,Monday,Workingday,Clear,0.66,0.6212,0.39,0.4627,73,375,448,448,210,448,3,4,3,343,2,730,227748,3,448
2012-06-04,summer,2012,June,17,Monday,Workingday,Clear,0.64,0.6212,0.38,0.4478,101,733,834,834,210,834,3,4,3,343,2,730,336860,3,834
2012-06-04,summer,2012,June,18,Monday,Workingday,Clear,0.64,0.6212,0.38,0.3881,103,719,822,822,210,822,3,4,3,343,2,728,309772,3,822
2012-06-04,summer,2012,June,19,Monday,Workingday,Clear,0.62,0.6212,0.38,0.4179,91,554,645,645,210,645,3,4,3,343,2,728,226789,3,645
2012-06-04,summer,2012,June,20,Monday,Workingday,Clear,0.6,0.6212,0.4,0.3582,71,390,461,461,210,461,3,4,3,343,2,728,164550,3,461
2012-06-04,summer,2012,June,21,Monday,Workingday,Clear,0.58,0.5455,0.49,0.2537,40,225,265,265,210,265,3,3,3,333,2,728,125445,3,265
2012-06-04,summer,2012,June,22,Monday,Workingday,Clear,0.56,0.5303,0.52,0.2836,41,127,168,168,210,168,3,3,3,333,0,728,95612,3,168
2012-06-04,summer,2012,June,23,Monday,Workingday,Clear,0.58,0.5455,0.49,0.2985,8,78,86,86,210,86,3,2,3,323,0,728,63941,3,86
2012-06-05,summer,2012,June,0,Tuesday,Workingday,Clear,0.54,0.5152,0.68,0.4179,6,28,34,34,209,34,3,1,3,313,0,726,39130,3,34
2012-06-05,summer,2012,June,1,Tuesday,Workingday,Mist,0.52,0.5,0.77,0.3284,2,18,20,20,209,20,3,1,3,313,0,724,24164,3,20
2012-06-05,summer,2012,June,2,Tuesday,Workingday,Light Snow,0.52,0.5,0.72,0.2985,0,8,8,8,209,8,3,1,3,313,0,715,16352,3,8
2012-06-05,summer,2012,June,3,Tuesday,Workingday,Light Snow,0.5,0.4848,0.82,0.194,0,5,5,5,209,5,3,1,2,312,0,697,8174,3,5
2012-06-05,summer,2012,June,4,Tuesday,Workingday,Light Snow,0.5,0.4848,0.82,0.194,1,4,5,5,209,5,3,1,2,312,0,697,4428,3,5
2012-06-05,summer,2012,June,5,Tuesday,Workingday,Light Snow,0.48,0.4697,0.82,0.1642,1,35,36,36,209,36,3,1,2,312,0,717,14261,3,36
2012-06-05,summer,2012,June,6,Tuesday,Workingday,Clear,0.48,0.4697,0.82,0.2537,7,177,184,184,209,184,3,3,2,332,0,725,55132,3,184
2012-06-05,summer,2012,June,7,Tuesday,Workingday,Clear,0.48,0.4697,0.77,0.2985,29,540,569,569,209,569,3,4,2,342,2,727,154171,3,569
2012-06-05,summer,2012,June,8,Tuesday,Workingday,Mist,0.48,0.4697,0.77,0.2239,30,680,710,710,209,710,3,4,2,342,2,727,261001,3,710
2012-06-05,summer,2012,June,9,Tuesday,Workingday,Mist,0.52,0.5,0.72,0.2537,50,285,335,335,209,335,3,4,3,343,0,727,159438,3,335
2012-06-05,summer,2012,June,10,Tuesday,Workingday,Mist,0.52,0.5,0.63,0.2985,58,118,176,176,209,176,3,3,3,333,0,727,126257,3,176
2012-06-05,summer,2012,June,11,Tuesday,Workingday,Mist,0.56,0.5303,0.56,0.194,65,162,227,227,209,227,3,3,3,333,2,727,151320,3,227
2012-06-05,summer,2012,June,12,Tuesday,Workingday,Mist,0.54,0.5152,0.56,0.2239,45,202,247,247,209,247,3,3,3,333,2,728,184414,3,247
2012-06-05,summer,2012,June,13,Tuesday,Workingday,Mist,0.6,0.6212,0.46,0.1642,66,201,267,267,209,267,3,3,3,333,2,729,184919,3,267
2012-06-05,summer,2012,June,14,Tuesday,Workingday,Mist,0.58,0.5455,0.46,0.1642,82,194,276,276,209,276,3,3,3,333,2,729,175652,3,276
2012-06-05,summer,2012,June,15,Tuesday,Workingday,Mist,0.58,0.5455,0.46,0.1343,54,218,272,272,209,272,3,3,3,333,2,729,183149,3,272
2012-06-05,summer,2012,June,16,Tuesday,Workingday,Clear,0.6,0.6212,0.43,0.194,91,382,473,473,209,473,3,4,3,343,2,730,227748,3,473
2012-06-05,summer,2012,June,17,Tuesday,Workingday,Clear,0.6,0.6212,0.43,0.0,86,764,850,850,209,850,3,4,3,343,2,730,336860,3,850
2012-06-05,summer,2012,June,18,Tuesday,Workingday,Clear,0.6,0.6212,0.43,0.194,111,679,790,790,209,790,3,4,3,343,2,728,309772,3,790
2012-06-05,summer,2012,June,19,Tuesday,Workingday,Clear,0.58,0.5455,0.46,0.2537,68,445,513,513,209,513,3,4,3,343,2,728,226789,3,513
2012-06-05,summer,2012,June,20,Tuesday,Workingday,Clear,0.56,0.5303,0.49,0.2239,44,371,415,415,209,415,3,4,3,343,2,728,164550,3,415
2012-06-05,summer,2012,June,21,Tuesday,Workingday,Clear,0.54,0.5152,0.56,0.1642,30,253,283,283,209,283,3,4,3,343,0,728,125445,3,283
2012-06-05,summer,2012,June,22,Tuesday,Workingday,Clear,0.56,0.5303,0.52,0.1045,22,171,193,193,209,193,3,3,3,333,0,728,95612,3,193
2012-06-05,summer,2012,June,23,Tuesday,Workingday,Clear,0.54,0.5152,0.56,0.0896,20,93,113,113,209,113,3,2,3,323,0,728,63941,3,113
2012-06-06,summer,2012,June,0,Wednesday,Workingday,Clear,0.52,0.5,0.59,0.0896,3,46,49,49,208,49,3,2,3,323,0,726,39130,3,49
2012-06-06,summer,2012,June,1,Wednesday,Workingday,Clear,0.52,0.5,0.68,0.0,6,21,27,27,208,27,3,1,3,313,0,724,24164,3,27
2012-06-06,summer,2012,June,2,Wednesday,Workingday,Clear,0.5,0.4848,0.68,0.0,4,7,11,11,208,11,3,1,2,312,0,715,16352,3,11
2012-06-06,summer,2012,June,3,Wednesday,Workingday,Clear,0.46,0.4545,0.82,0.0,0,8,8,8,208,8,3,1,2,312,0,697,8174,3,8
2012-06-06,summer,2012,June,4,Wednesday,Workingday,Clear,0.46,0.4545,0.82,0.1045,3,7,10,10,208,10,3,1,2,312,0,697,4428,3,10
2012-06-06,summer,2012,June,5,Wednesday,Workingday,Clear,0.48,0.4697,0.77,0.0,1,37,38,38,208,38,3,1,2,312,0,717,14261,3,38
2012-06-06,summer,2012,June,6,Wednesday,Workingday,Clear,0.48,0.4697,0.77,0.0,7,165,172,172,208,172,3,3,2,332,0,725,55132,3,172
2012-06-06,summer,2012,June,7,Wednesday,Workingday,Clear,0.5,0.4848,0.72,0.0,16,531,547,547,208,547,3,4,2,342,0,727,154171,3,547
2012-06-06,summer,2012,June,8,Wednesday,Workingday,Clear,0.54,0.5152,0.68,0.0,31,637,668,668,208,668,3,4,3,343,2,727,261001,3,668
2012-06-06,summer,2012,June,9,Wednesday,Workingday,Clear,0.56,0.5303,0.6,0.0896,35,268,303,303,208,303,3,4,3,343,0,727,159438,3,303
2012-06-06,summer,2012,June,10,Wednesday,Workingday,Clear,0.6,0.6212,0.46,0.0896,55,148,203,203,208,203,3,3,3,333,2,727,126257,3,203
2012-06-06,summer,2012,June,11,Wednesday,Workingday,Clear,0.62,0.6212,0.43,0.0896,65,161,226,226,208,226,3,3,3,333,2,727,151320,3,226
2012-06-06,summer,2012,June,12,Wednesday,Workingday,Clear,0.62,0.6212,0.38,0.0,80,235,315,315,208,315,3,4,3,343,2,728,184414,3,315
2012-06-06,summer,2012,June,13,Wednesday,Workingday,Clear,0.62,0.6212,0.41,0.0896,73,230,303,303,208,303,3,4,3,343,2,729,184919,3,303
2012-06-06,summer,2012,June,14,Wednesday,Workingday,Clear,0.64,0.6212,0.38,0.0,111,191,302,302,208,302,3,4,3,343,2,729,175652,3,302
2012-06-06,summer,2012,June,15,Wednesday,Workingday,Clear,0.64,0.6212,0.38,0.0,75,225,300,300,208,300,3,4,3,343,2,729,183149,3,300
2012-06-06,summer,2012,June,16,Wednesday,Workingday,Clear,0.64,0.6212,0.41,0.1343,107,345,452,452,208,452,3,4,3,343,2,730,227748,3,452
2012-06-06,summer,2012,June,17,Wednesday,Workingday,Clear,0.62,0.6212,0.43,0.1343,72,652,724,724,208,724,3,4,3,343,2,730,336860,3,724
2012-06-06,summer,2012,June,18,Wednesday,Workingday,Light Snow,0.6,0.6212,0.53,0.194,94,688,782,782,208,782,3,4,3,343,2,728,309772,3,782
2012-06-06,summer,2012,June,19,Wednesday,Workingday,Clear,0.56,0.5303,0.73,0.2985,52,486,538,538,208,538,3,4,3,343,2,728,226789,3,538
2012-06-06,summer,2012,June,20,Wednesday,Workingday,Clear,0.54,0.5152,0.73,0.2836,59,349,408,408,208,408,3,4,3,343,2,728,164550,3,408
2012-06-06,summer,2012,June,21,Wednesday,Workingday,Clear,0.54,0.5152,0.73,0.1642,38,260,298,298,208,298,3,4,3,343,0,728,125445,3,298
2012-06-06,summer,2012,June,22,Wednesday,Workingday,Clear,0.52,0.5,0.77,0.0896,27,221,248,248,208,248,3,3,3,333,0,728,95612,3,248
2012-06-06,summer,2012,June,23,Wednesday,Workingday,Clear,0.52,0.5,0.77,0.0,13,110,123,123,208,123,3,2,3,323,0,728,63941,3,123
2012-06-07,summer,2012,June,0,Thursday,Workingday,Clear,0.52,0.5,0.77,0.1343,9,50,59,59,207,59,3,2,3,323,0,726,39130,3,59
2012-06-07,summer,2012,June,1,Thursday,Workingday,Clear,0.52,0.5,0.77,0.1642,5,17,22,22,207,22,3,1,3,313,0,724,24164,3,22
2012-06-07,summer,2012,June,2,Thursday,Workingday,Clear,0.52,0.5,0.77,0.0896,0,12,12,12,207,12,3,1,3,313,0,715,16352,3,12
2012-06-07,summer,2012,June,3,Thursday,Workingday,Clear,0.5,0.4848,0.77,0.1045,0,5,5,5,207,5,3,1,2,312,0,697,8174,3,5
2012-06-07,summer,2012,June,4,Thursday,Workingday,Clear,0.46,0.4545,0.88,0.1045,0,6,6,6,207,6,3,1,2,312,0,697,4428,3,6
2012-06-07,summer,2012,June,5,Thursday,Workingday,Clear,0.48,0.4697,0.82,0.0896,0,34,34,34,207,34,3,1,2,312,0,717,14261,3,34
2012-06-07,summer,2012,June,6,Thursday,Workingday,Clear,0.46,0.4545,0.88,0.1045,5,165,170,170,207,170,3,3,2,332,0,725,55132,3,170
2012-06-07,summer,2012,June,7,Thursday,Workingday,Clear,0.5,0.4848,0.82,0.1642,20,506,526,526,207,526,3,4,2,342,0,727,154171,3,526
2012-06-07,summer,2012,June,8,Thursday,Workingday,Clear,0.52,0.5,0.77,0.0,20,661,681,681,207,681,3,4,3,343,2,727,261001,3,681
2012-06-07,summer,2012,June,9,Thursday,Workingday,Clear,0.58,0.5455,0.68,0.0,37,300,337,337,207,337,3,4,3,343,0,727,159438,3,337
2012-06-07,summer,2012,June,10,Thursday,Workingday,Clear,0.6,0.6061,0.64,0.0896,56,154,210,210,207,210,3,3,3,333,0,727,126257,3,210
2012-06-07,summer,2012,June,11,Thursday,Workingday,Clear,0.66,0.6212,0.47,0.2239,67,170,237,237,207,237,3,3,3,333,2,727,151320,3,237
2012-06-07,summer,2012,June,12,Thursday,Workingday,Clear,0.7,0.6364,0.42,0.0,62,274,336,336,207,336,3,4,4,344,2,728,184414,3,336
2012-06-07,summer,2012,June,13,Thursday,Workingday,Clear,0.7,0.6364,0.37,0.2836,65,250,315,315,207,315,3,4,4,344,2,729,184919,3,315
2012-06-07,summer,2012,June,14,Thursday,Workingday,Clear,0.72,0.6515,0.37,0.2537,67,198,265,265,207,265,3,3,4,334,2,729,175652,3,265
2012-06-07,summer,2012,June,15,Thursday,Workingday,Clear,0.74,0.6515,0.3,0.0,99,234,333,333,207,333,3,4,4,344,2,729,183149,3,333
2012-06-07,summer,2012,June,16,Thursday,Workingday,Clear,0.72,0.6515,0.34,0.2239,77,389,466,466,207,466,3,4,4,344,2,730,227748,3,466
2012-06-07,summer,2012,June,17,Thursday,Workingday,Clear,0.72,0.6515,0.34,0.2537,91,778,869,869,207,869,3,4,4,344,2,730,336860,3,869
2012-06-07,summer,2012,June,18,Thursday,Workingday,Clear,0.7,0.6364,0.34,0.2836,110,703,813,813,207,813,3,4,4,344,2,728,309772,3,813
2012-06-07,summer,2012,June,19,Thursday,Workingday,Clear,0.7,0.6364,0.34,0.2836,65,537,602,602,207,602,3,4,4,344,2,728,226789,3,602
2012-06-07,summer,2012,June,20,Thursday,Workingday,Clear,0.66,0.6212,0.36,0.2985,76,402,478,478,207,478,3,4,3,343,2,728,164550,3,478
2012-06-07,summer,2012,June,21,Thursday,Workingday,Clear,0.62,0.6212,0.41,0.3284,30,283,313,313,207,313,3,4,3,343,2,728,125445,3,313
2012-06-07,summer,2012,June,22,Thursday,Workingday,Clear,0.6,0.6212,0.46,0.1642,35,193,228,228,207,228,3,3,3,333,2,728,95612,3,228
2012-06-07,summer,2012,June,23,Thursday,Workingday,Clear,0.56,0.5303,0.52,0.1343,42,135,177,177,207,177,3,3,3,333,0,728,63941,3,177
2012-06-08,summer,2012,June,0,Friday,Workingday,Clear,0.56,0.5303,0.56,0.1642,18,59,77,77,206,77,3,2,3,323,0,726,39130,3,77
2012-06-08,summer,2012,June,1,Friday,Workingday,Clear,0.56,0.5303,0.56,0.1642,4,25,29,29,206,29,3,1,3,313,0,724,24164,3,29
2012-06-08,summer,2012,June,2,Friday,Workingday,Clear,0.56,0.5303,0.56,0.0,2,17,19,19,206,19,3,1,3,313,0,715,16352,3,19
2012-06-08,summer,2012,June,3,Friday,Workingday,Clear,0.54,0.5152,0.6,0.0896,0,8,8,8,206,8,3,1,3,313,0,697,8174,3,8
2012-06-08,summer,2012,June,4,Friday,Workingday,Clear,0.52,0.5,0.63,0.0,1,9,10,10,206,10,3,1,3,313,0,697,4428,3,10
2012-06-08,summer,2012,June,5,Friday,Workingday,Clear,0.5,0.4848,0.72,0.1045,1,28,29,29,206,29,3,1,2,312,0,717,14261,3,29
2012-06-08,summer,2012,June,6,Friday,Workingday,Clear,0.52,0.5,0.68,0.0896,8,131,139,139,206,139,3,2,3,323,0,725,55132,3,139
2012-06-08,summer,2012,June,7,Friday,Workingday,Clear,0.52,0.5,0.72,0.1045,19,409,428,428,206,428,3,4,3,343,0,727,154171,3,428
2012-06-08,summer,2012,June,8,Friday,Workingday,Clear,0.58,0.5455,0.6,0.0896,37,663,700,700,206,700,3,4,3,343,2,727,261001,3,700
2012-06-08,summer,2012,June,9,Friday,Workingday,Clear,0.62,0.6212,0.53,0.1642,47,335,382,382,206,382,3,4,3,343,2,727,159438,3,382
2012-06-08,summer,2012,June,10,Friday,Workingday,Clear,0.66,0.6212,0.47,0.2537,62,187,249,249,206,249,3,3,3,333,2,727,126257,3,249
2012-06-08,summer,2012,June,11,Friday,Workingday,Clear,0.7,0.6364,0.42,0.2537,65,199,264,264,206,264,3,3,4,334,2,727,151320,3,264
2012-06-08,summer,2012,June,12,Friday,Workingday,Clear,0.72,0.6515,0.39,0.3284,89,280,369,369,206,369,3,4,4,344,2,728,184414,3,369
2012-06-08,summer,2012,June,13,Friday,Workingday,Clear,0.74,0.6515,0.37,0.2537,129,287,416,416,206,416,3,4,4,344,2,729,184919,3,416
2012-06-08,summer,2012,June,14,Friday,Workingday,Clear,0.76,0.6667,0.31,0.3881,128,245,373,373,206,373,3,4,4,344,2,729,175652,3,373
2012-06-08,summer,2012,June,15,Friday,Workingday,Clear,0.76,0.6667,0.29,0.2836,98,299,397,397,206,397,3,4,4,344,2,729,183149,3,397
2012-06-08,summer,2012,June,16,Friday,Workingday,Clear,0.76,0.6667,0.29,0.2985,111,412,523,523,206,523,3,4,4,344,2,730,227748,3,523
2012-06-08,summer,2012,June,17,Friday,Workingday,Clear,0.76,0.6667,0.29,0.194,114,679,793,793,206,793,3,4,4,344,2,730,336860,3,793
2012-06-08,summer,2012,June,18,Friday,Workingday,Clear,0.76,0.6667,0.27,0.2239,147,576,723,723,206,723,3,4,4,344,2,728,309772,3,723
2012-06-08,summer,2012,June,19,Friday,Workingday,Clear,0.74,0.6515,0.3,0.2239,95,460,555,555,206,555,3,4,4,344,2,728,226789,3,555
2012-06-08,summer,2012,June,20,Friday,Workingday,Clear,0.72,0.6515,0.32,0.1343,117,291,408,408,206,408,3,4,4,344,2,728,164550,3,408
2012-06-08,summer,2012,June,21,Friday,Workingday,Clear,0.7,0.6364,0.37,0.1343,83,256,339,339,206,339,3,4,4,344,2,728,125445,3,339
2012-06-08,summer,2012,June,22,Friday,Workingday,Clear,0.68,0.6364,0.41,0.1045,61,230,291,291,206,291,3,4,4,344,2,728,95612,3,291
2012-06-08,summer,2012,June,23,Friday,Workingday,Clear,0.64,0.6212,0.57,0.1642,52,163,215,215,206,215,3,3,3,333,2,728,63941,3,215
2012-06-09,summer,2012,June,0,Saturday,Holiday,Clear,0.64,0.6212,0.53,0.1045,54,152,206,206,205,206,3,3,3,333,2,726,39130,3,206
2012-06-09,summer,2012,June,1,Saturday,Holiday,Clear,0.64,0.6212,0.53,0.0896,34,89,123,123,205,123,3,2,3,323,0,724,24164,3,123
2012-06-09,summer,2012,June,2,Saturday,Holiday,Clear,0.64,0.6212,0.5,0.2239,21,68,89,89,205,89,3,2,3,323,0,715,16352,3,89
2012-06-09,summer,2012,June,3,Saturday,Holiday,Clear,0.62,0.6212,0.57,0.0,12,28,40,40,205,40,3,1,3,313,0,697,8174,3,40
2012-06-09,summer,2012,June,4,Saturday,Holiday,Clear,0.62,0.6212,0.57,0.0,2,6,8,8,205,8,3,1,3,313,0,697,4428,3,8
2012-06-09,summer,2012,June,5,Saturday,Holiday,Clear,0.6,0.6212,0.56,0.1045,4,15,19,19,205,19,3,1,3,313,0,717,14261,3,19
2012-06-09,summer,2012,June,6,Saturday,Holiday,Clear,0.56,0.5303,0.64,0.1045,17,63,80,80,205,80,3,2,3,323,0,725,55132,3,80
2012-06-09,summer,2012,June,7,Saturday,Holiday,Clear,0.58,0.5455,0.64,0.1045,26,61,87,87,205,87,3,2,3,323,0,727,154171,3,87
2012-06-09,summer,2012,June,8,Saturday,Holiday,Clear,0.62,0.6061,0.61,0.1045,42,202,244,244,205,244,3,3,3,333,0,727,261001,3,244
2012-06-09,summer,2012,June,9,Saturday,Holiday,Clear,0.64,0.6212,0.57,0.1642,99,241,340,340,205,340,3,4,3,343,2,727,159438,3,340
2012-06-09,summer,2012,June,10,Saturday,Holiday,Clear,0.7,0.6515,0.51,0.1045,168,298,466,466,205,466,3,4,4,344,2,727,126257,3,466
2012-06-09,summer,2012,June,11,Saturday,Holiday,Clear,0.76,0.6667,0.35,0.0,218,351,569,569,205,569,3,4,4,344,2,727,151320,3,569
2012-06-09,summer,2012,June,12,Saturday,Holiday,Clear,0.8,0.697,0.29,0.2537,196,335,531,531,205,531,3,4,4,344,2,728,184414,3,531
2012-06-09,summer,2012,June,13,Saturday,Holiday,Clear,0.82,0.697,0.24,0.2836,236,349,585,585,205,585,3,4,4,344,2,729,184919,3,585
2012-06-09,summer,2012,June,14,Saturday,Holiday,Clear,0.82,0.697,0.23,0.194,239,354,593,593,205,593,3,4,4,344,2,729,175652,3,593
2012-06-09,summer,2012,June,15,Saturday,Holiday,Clear,0.84,0.7121,0.2,0.2985,218,337,555,555,205,555,3,4,4,344,2,729,183149,3,555
2012-06-09,summer,2012,June,16,Saturday,Holiday,Clear,0.82,0.697,0.24,0.194,219,315,534,534,205,534,3,4,4,344,2,730,227748,3,534
2012-06-09,summer,2012,June,17,Saturday,Holiday,Clear,0.84,0.7121,0.24,0.0,238,257,495,495,205,495,3,4,4,344,2,730,336860,3,495
2012-06-09,summer,2012,June,18,Saturday,Holiday,Clear,0.82,0.697,0.24,0.2239,175,276,451,451,205,451,3,4,4,344,2,728,309772,3,451
2012-06-09,summer,2012,June,19,Saturday,Holiday,Clear,0.8,0.697,0.29,0.1642,128,232,360,360,205,360,3,4,4,344,2,728,226789,3,360
2012-06-09,summer,2012,June,20,Saturday,Holiday,Clear,0.76,0.6667,0.35,0.2239,125,238,363,363,205,363,3,4,4,344,2,728,164550,3,363
2012-06-09,summer,2012,June,21,Saturday,Holiday,Clear,0.74,0.6515,0.4,0.194,105,211,316,316,205,316,3,4,4,344,2,728,125445,3,316
2012-06-09,summer,2012,June,22,Saturday,Holiday,Clear,0.7,0.6515,0.58,0.1642,63,151,214,214,205,214,3,3,4,334,2,728,95612,3,214
2012-06-09,summer,2012,June,23,Saturday,Holiday,Clear,0.68,0.6364,0.61,0.1642,69,161,230,230,205,230,3,3,4,334,2,728,63941,3,230
2012-06-10,summer,2012,June,0,Sunday,Holiday,Clear,0.66,0.6212,0.69,0.1045,33,125,158,158,204,158,3,3,3,333,0,726,39130,3,158
2012-06-10,summer,2012,June,1,Sunday,Holiday,Clear,0.64,0.6061,0.73,0.1343,32,84,116,116,204,116,3,2,3,323,0,724,24164,3,116
2012-06-10,summer,2012,June,2,Sunday,Holiday,Clear,0.64,0.6061,0.69,0.1343,17,56,73,73,204,73,3,2,3,323,0,715,16352,3,73
2012-06-10,summer,2012,June,3,Sunday,Holiday,Clear,0.64,0.6061,0.73,0.1045,6,23,29,29,204,29,3,1,3,313,0,697,8174,3,29
2012-06-10,summer,2012,June,4,Sunday,Holiday,Clear,0.62,0.5909,0.78,0.0896,1,9,10,10,204,10,3,1,3,313,0,697,4428,3,10
2012-06-10,summer,2012,June,5,Sunday,Holiday,Clear,0.62,0.6061,0.69,0.0896,3,10,13,13,204,13,3,1,3,313,0,717,14261,3,13
2012-06-10,summer,2012,June,6,Sunday,Holiday,Clear,0.62,0.5909,0.73,0.0,3,27,30,30,204,30,3,1,3,313,0,725,55132,3,30
2012-06-10,summer,2012,June,7,Sunday,Holiday,Clear,0.6,0.5758,0.78,0.1045,21,41,62,62,204,62,3,2,3,323,0,727,154171,3,62
2012-06-10,summer,2012,June,8,Sunday,Holiday,Clear,0.64,0.6061,0.73,0.0896,59,122,181,181,204,181,3,3,3,333,0,727,261001,3,181
2012-06-10,summer,2012,June,9,Sunday,Holiday,Clear,0.7,0.6515,0.58,0.0,91,175,266,266,204,266,3,3,4,334,2,727,159438,3,266
2012-06-10,summer,2012,June,10,Sunday,Holiday,Clear,0.76,0.6818,0.4,0.1045,148,265,413,413,204,413,3,4,4,344,2,727,126257,3,413
2012-06-10,summer,2012,June,11,Sunday,Holiday,Clear,0.76,0.6818,0.45,0.0896,184,315,499,499,204,499,3,4,4,344,2,727,151320,3,499
2012-06-10,summer,2012,June,12,Sunday,Holiday,Clear,0.82,0.7121,0.3,0.0,173,329,502,502,204,502,3,4,4,344,2,728,184414,3,502
2012-06-10,summer,2012,June,13,Sunday,Holiday,Clear,0.84,0.7273,0.28,0.1343,204,288,492,492,204,492,3,4,4,344,2,729,184919,3,492
2012-06-10,summer,2012,June,14,Sunday,Holiday,Clear,0.84,0.7273,0.3,0.1343,186,314,500,500,204,500,3,4,4,344,2,729,175652,3,500
2012-06-10,summer,2012,June,15,Sunday,Holiday,Clear,0.84,0.7273,0.3,0.2239,159,316,475,475,204,475,3,4,4,344,2,729,183149,3,475
2012-06-10,summer,2012,June,16,Sunday,Holiday,Clear,0.84,0.7424,0.36,0.2836,173,335,508,508,204,508,3,4,4,344,2,730,227748,3,508
2012-06-10,summer,2012,June,17,Sunday,Holiday,Clear,0.82,0.7424,0.41,0.2836,184,337,521,521,204,521,3,4,4,344,2,730,336860,3,521
2012-06-10,summer,2012,June,18,Sunday,Holiday,Clear,0.82,0.7273,0.38,0.2239,164,326,490,490,204,490,3,4,4,344,2,728,309772,3,490
2012-06-10,summer,2012,June,19,Sunday,Holiday,Clear,0.82,0.7121,0.28,0.2836,115,260,375,375,204,375,3,4,4,344,2,728,226789,3,375
2012-06-10,summer,2012,June,20,Sunday,Holiday,Clear,0.76,0.6818,0.48,0.1642,113,250,363,363,204,363,3,4,4,344,2,728,164550,3,363
2012-06-10,summer,2012,June,21,Sunday,Holiday,Clear,0.72,0.6818,0.62,0.1642,83,170,253,253,204,253,3,3,4,334,2,728,125445,3,253
2012-06-10,summer,2012,June,22,Sunday,Holiday,Clear,0.7,0.6515,0.65,0.1642,42,117,159,159,204,159,3,3,4,334,0,728,95612,3,159
2012-06-10,summer,2012,June,23,Sunday,Holiday,Clear,0.72,0.6667,0.58,0.1045,30,80,110,110,204,110,3,2,4,324,0,728,63941,3,110
2012-06-11,summer,2012,June,0,Monday,Workingday,Clear,0.7,0.6515,0.65,0.1045,8,33,41,41,203,41,3,2,4,324,0,726,39130,3,41
2012-06-11,summer,2012,June,1,Monday,Workingday,Clear,0.66,0.6212,0.74,0.1642,9,15,24,24,203,24,3,1,3,313,0,724,24164,3,24
2012-06-11,summer,2012,June,2,Monday,Workingday,Clear,0.66,0.6212,0.74,0.1045,5,12,17,17,203,17,3,1,3,313,0,715,16352,3,17
2012-06-11,summer,2012,June,3,Monday,Workingday,Clear,0.64,0.5909,0.78,0.1045,2,4,6,6,203,6,3,1,3,313,0,697,8174,3,6
2012-06-11,summer,2012,June,4,Monday,Workingday,Clear,0.64,0.5909,0.78,0.1343,0,7,7,7,203,7,3,1,3,313,0,697,4428,3,7
2012-06-11,summer,2012,June,5,Monday,Workingday,Clear,0.64,0.5909,0.78,0.1343,1,36,37,37,203,37,3,1,3,313,0,717,14261,3,37
2012-06-11,summer,2012,June,6,Monday,Workingday,Clear,0.62,0.5758,0.83,0.1045,8,136,144,144,203,144,3,3,3,333,0,725,55132,3,144
2012-06-11,summer,2012,June,7,Monday,Workingday,Clear,0.64,0.5909,0.78,0.1045,25,478,503,503,203,503,3,4,3,343,2,727,154171,3,503
2012-06-11,summer,2012,June,8,Monday,Workingday,Clear,0.66,0.6212,0.74,0.1343,38,613,651,651,203,651,3,4,3,343,2,727,261001,3,651
2012-06-11,summer,2012,June,9,Monday,Workingday,Clear,0.7,0.6515,0.65,0.1343,57,259,316,316,203,316,3,4,4,344,2,727,159438,3,316
2012-06-11,summer,2012,June,10,Monday,Workingday,Clear,0.72,0.6818,0.62,0.1642,52,95,147,147,203,147,3,3,4,334,0,727,126257,3,147
2012-06-11,summer,2012,June,11,Monday,Workingday,Mist,0.76,0.6818,0.48,0.2239,59,143,202,202,203,202,3,3,4,334,2,727,151320,3,202
2012-06-11,summer,2012,June,12,Monday,Workingday,Mist,0.8,0.7273,0.43,0.194,63,198,261,261,203,261,3,3,4,334,2,728,184414,3,261
2012-06-11,summer,2012,June,13,Monday,Workingday,Mist,0.8,0.7121,0.41,0.2985,63,185,248,248,203,248,3,3,4,334,2,729,184919,3,248
2012-06-11,summer,2012,June,14,Monday,Workingday,Mist,0.82,0.7273,0.34,0.2836,66,193,259,259,203,259,3,3,4,334,2,729,175652,3,259
2012-06-11,summer,2012,June,15,Monday,Workingday,Clear,0.8,0.7121,0.41,0.3582,72,187,259,259,203,259,3,3,4,334,2,729,183149,3,259
2012-06-11,summer,2012,June,16,Monday,Workingday,Mist,0.8,0.7121,0.41,0.4179,87,340,427,427,203,427,3,4,4,344,2,730,227748,3,427
2012-06-11,summer,2012,June,17,Monday,Workingday,Mist,0.8,0.7121,0.41,0.3582,85,715,800,800,203,800,3,4,4,344,2,730,336860,3,800
2012-06-11,summer,2012,June,18,Monday,Workingday,Mist,0.8,0.7273,0.43,0.2985,105,726,831,831,203,831,3,4,4,344,2,728,309772,3,831
2012-06-11,summer,2012,June,19,Monday,Workingday,Mist,0.76,0.6818,0.48,0.3284,89,507,596,596,203,596,3,4,4,344,2,728,226789,3,596
2012-06-11,summer,2012,June,20,Monday,Workingday,Mist,0.74,0.6667,0.48,0.2239,61,333,394,394,203,394,3,4,4,344,2,728,164550,3,394
2012-06-11,summer,2012,June,21,Monday,Workingday,Mist,0.72,0.6667,0.58,0.194,32,218,250,250,203,250,3,3,4,334,2,728,125445,3,250
2012-06-11,summer,2012,June,22,Monday,Workingday,Mist,0.72,0.6667,0.58,0.194,22,142,164,164,203,164,3,3,4,334,0,728,95612,3,164
2012-06-11,summer,2012,June,23,Monday,Workingday,Mist,0.7,0.6515,0.58,0.2239,8,72,80,80,203,80,3,2,4,324,0,728,63941,3,80
2012-06-12,summer,2012,June,0,Tuesday,Workingday,Mist,0.7,0.6515,0.58,0.2239,2,26,28,28,202,28,3,1,4,314,0,726,39130,3,28
2012-06-12,summer,2012,June,1,Tuesday,Workingday,Mist,0.68,0.6364,0.65,0.1642,5,11,16,16,202,16,3,1,4,314,0,724,24164,3,16
2012-06-12,summer,2012,June,2,Tuesday,Workingday,Mist,0.68,0.6364,0.65,0.194,0,6,6,6,202,6,3,1,4,314,0,715,16352,3,6
2012-06-12,summer,2012,June,3,Tuesday,Workingday,Mist,0.66,0.6212,0.69,0.2537,3,9,12,12,202,12,3,1,3,313,0,697,8174,3,12
2012-06-12,summer,2012,June,4,Tuesday,Workingday,Light Snow,0.6,0.5455,0.88,0.1642,0,4,4,4,202,4,3,1,3,313,0,697,4428,3,4
2012-06-12,summer,2012,June,5,Tuesday,Workingday,Light Snow,0.6,0.5455,0.88,0.1343,1,28,29,29,202,29,3,1,3,313,0,717,14261,3,29
2012-06-12,summer,2012,June,6,Tuesday,Workingday,Mist,0.6,0.5455,0.88,0.1343,6,130,136,136,202,136,3,2,3,323,0,725,55132,3,136
2012-06-12,summer,2012,June,7,Tuesday,Workingday,Light Snow,0.62,0.5606,0.88,0.2537,16,287,303,303,202,303,3,4,3,343,0,727,154171,3,303
2012-06-12,summer,2012,June,8,Tuesday,Workingday,Mist,0.62,0.5606,0.88,0.2239,15,598,613,613,202,613,3,4,3,343,2,727,261001,3,613
2012-06-12,summer,2012,June,9,Tuesday,Workingday,Mist,0.64,0.5758,0.89,0.2836,31,254,285,285,202,285,3,4,3,343,0,727,159438,3,285
2012-06-12,summer,2012,June,10,Tuesday,Workingday,Light Snow,0.64,0.5758,0.89,0.2836,29,96,125,125,202,125,3,2,3,323,0,727,126257,3,125
2012-06-12,summer,2012,June,11,Tuesday,Workingday,Light Snow,0.66,0.6061,0.83,0.3582,8,57,65,65,202,65,3,2,3,323,0,727,151320,3,65
2012-06-12,summer,2012,June,12,Tuesday,Workingday,Light Snow,0.66,0.6061,0.83,0.2537,19,76,95,95,202,95,3,2,3,323,0,728,184414,3,95
2012-06-12,summer,2012,June,13,Tuesday,Workingday,Light Snow,0.66,0.6061,0.83,0.194,11,48,59,59,202,59,3,2,3,323,0,729,184919,3,59
2012-06-12,summer,2012,June,14,Tuesday,Workingday,Light Snow,0.64,0.5758,0.89,0.2537,12,48,60,60,202,60,3,2,3,323,0,729,175652,3,60
2012-06-12,summer,2012,June,15,Tuesday,Workingday,Light Snow,0.66,0.5909,0.89,0.194,22,94,116,116,202,116,3,2,3,323,0,729,183149,3,116
2012-06-12,summer,2012,June,16,Tuesday,Workingday,Mist,0.66,0.5909,0.89,0.2836,30,209,239,239,202,239,3,3,3,333,0,730,227748,3,239
2012-06-12,summer,2012,June,17,Tuesday,Workingday,Mist,0.66,0.5909,0.89,0.2836,56,625,681,681,202,681,3,4,3,343,2,730,336860,3,681
2012-06-12,summer,2012,June,18,Tuesday,Workingday,Clear,0.68,0.6364,0.83,0.194,57,596,653,653,202,653,3,4,4,344,2,728,309772,3,653
2012-06-12,summer,2012,June,19,Tuesday,Workingday,Clear,0.68,0.6364,0.83,0.194,47,444,491,491,202,491,3,4,4,344,2,728,226789,3,491
2012-06-12,summer,2012,June,20,Tuesday,Workingday,Clear,0.68,0.6364,0.83,0.194,36,350,386,386,202,386,3,4,4,344,0,728,164550,3,386
2012-06-12,summer,2012,June,21,Tuesday,Workingday,Clear,0.68,0.6364,0.83,0.1045,41,233,274,274,202,274,3,3,4,334,0,728,125445,3,274
2012-06-12,summer,2012,June,22,Tuesday,Workingday,Clear,0.66,0.5909,0.94,0.1045,19,188,207,207,202,207,3,3,3,333,0,728,95612,3,207
2012-06-12,summer,2012,June,23,Tuesday,Workingday,Light Snow,0.66,0.5909,0.94,0.2239,11,78,89,89,202,89,3,2,3,323,0,728,63941,3,89
2012-06-13,summer,2012,June,0,Wednesday,Workingday,Mist,0.66,0.5909,0.94,0.194,7,27,34,34,201,34,3,1,3,313,0,726,39130,3,34
2012-06-13,summer,2012,June,1,Wednesday,Workingday,Clear,0.64,0.5909,0.78,0.0,7,21,28,28,201,28,3,1,3,313,0,724,24164,3,28
2012-06-13,summer,2012,June,2,Wednesday,Workingday,Clear,0.62,0.5758,0.83,0.1343,0,4,4,4,201,4,3,1,3,313,0,715,16352,3,4
2012-06-13,summer,2012,June,3,Wednesday,Workingday,Clear,0.62,0.5758,0.83,0.194,1,7,8,8,201,8,3,1,3,313,0,697,8174,3,8
2012-06-13,summer,2012,June,4,Wednesday,Workingday,Clear,0.6,0.5606,0.83,0.1343,1,9,10,10,201,10,3,1,3,313,0,697,4428,3,10
2012-06-13,summer,2012,June,5,Wednesday,Workingday,Clear,0.6,0.5606,0.83,0.194,2,38,40,40,201,40,3,1,3,313,0,717,14261,3,40
2012-06-13,summer,2012,June,6,Wednesday,Workingday,Clear,0.6,0.5606,0.83,0.2239,6,188,194,194,201,194,3,3,3,333,0,725,55132,3,194
2012-06-13,summer,2012,June,7,Wednesday,Workingday,Clear,0.6,0.5606,0.83,0.2985,25,480,505,505,201,505,3,4,3,343,2,727,154171,3,505
2012-06-13,summer,2012,June,8,Wednesday,Workingday,Mist,0.62,0.5909,0.73,0.5224,41,672,713,713,201,713,3,4,3,343,2,727,261001,3,713
2012-06-13,summer,2012,June,9,Wednesday,Workingday,Mist,0.64,0.6061,0.69,0.5821,54,298,352,352,201,352,3,4,3,343,2,727,159438,3,352
2012-06-13,summer,2012,June,10,Wednesday,Workingday,Mist,0.64,0.6061,0.65,0.4179,64,134,198,198,201,198,3,3,3,333,2,727,126257,3,198
2012-06-13,summer,2012,June,11,Wednesday,Workingday,Mist,0.66,0.6212,0.54,0.4478,64,182,246,246,201,246,3,3,3,333,2,727,151320,3,246
2012-06-13,summer,2012,June,12,Wednesday,Workingday,Mist,0.68,0.6364,0.44,0.4179,93,241,334,334,201,334,3,4,4,344,2,728,184414,3,334
2012-06-13,summer,2012,June,13,Wednesday,Workingday,Mist,0.7,0.6364,0.45,0.3881,52,203,255,255,201,255,3,3,4,334,2,729,184919,3,255
2012-06-13,summer,2012,June,14,Wednesday,Workingday,Mist,0.72,0.6515,0.37,0.4179,98,222,320,320,201,320,3,4,4,344,2,729,175652,3,320
2012-06-13,summer,2012,June,15,Wednesday,Workingday,Clear,0.72,0.6515,0.32,0.4925,65,216,281,281,201,281,3,3,4,334,2,729,183149,3,281
2012-06-13,summer,2012,June,16,Wednesday,Workingday,Clear,0.72,0.6515,0.3,0.4925,72,320,392,392,201,392,3,4,4,344,2,730,227748,3,392
2012-06-13,summer,2012,June,17,Wednesday,Workingday,Clear,0.72,0.6515,0.32,0.4925,75,782,857,857,201,857,3,4,4,344,2,730,336860,3,857
2012-06-13,summer,2012,June,18,Wednesday,Workingday,Clear,0.72,0.6515,0.32,0.4478,104,640,744,744,201,744,3,4,4,344,2,728,309772,3,744
2012-06-13,summer,2012,June,19,Wednesday,Workingday,Clear,0.7,0.6364,0.34,0.3881,123,548,671,671,201,671,3,4,4,344,2,728,226789,3,671
2012-06-13,summer,2012,June,20,Wednesday,Workingday,Clear,0.68,0.6364,0.36,0.4179,86,362,448,448,201,448,3,4,4,344,2,728,164550,3,448
2012-06-13,summer,2012,June,21,Wednesday,Workingday,Clear,0.64,0.6212,0.44,0.3582,79,317,396,396,201,396,3,4,3,343,2,728,125445,3,396
2012-06-13,summer,2012,June,22,Wednesday,Workingday,Clear,0.62,0.6212,0.5,0.2985,29,209,238,238,201,238,3,3,3,333,2,728,95612,3,238
2012-06-13,summer,2012,June,23,Wednesday,Workingday,Clear,0.62,0.6212,0.5,0.2836,25,128,153,153,201,153,3,3,3,333,2,728,63941,3,153
2012-06-14,summer,2012,June,0,Thursday,Workingday,Clear,0.6,0.6212,0.53,0.2985,3,45,48,48,200,48,3,2,3,323,0,726,39130,3,48
2012-06-14,summer,2012,June,1,Thursday,Workingday,Clear,0.6,0.6212,0.56,0.2239,4,17,21,21,200,21,3,1,3,313,0,724,24164,3,21
2012-06-14,summer,2012,June,2,Thursday,Workingday,Mist,0.62,0.6212,0.53,0.2537,1,8,9,9,200,9,3,1,3,313,0,715,16352,3,9
2012-06-14,summer,2012,June,3,Thursday,Workingday,Mist,0.62,0.6212,0.53,0.2836,1,4,5,5,200,5,3,1,3,313,0,697,8174,3,5
2012-06-14,summer,2012,June,4,Thursday,Workingday,Mist,0.6,0.6212,0.56,0.2537,0,6,6,6,200,6,3,1,3,313,0,697,4428,3,6
2012-06-14,summer,2012,June,5,Thursday,Workingday,Mist,0.6,0.6212,0.56,0.2537,0,40,40,40,200,40,3,1,3,313,0,717,14261,3,40
2012-06-14,summer,2012,June,6,Thursday,Workingday,Clear,0.58,0.5455,0.6,0.2836,12,169,181,181,200,181,3,3,3,333,0,725,55132,3,181
2012-06-14,summer,2012,June,7,Thursday,Workingday,Clear,0.6,0.6061,0.6,0.2836,26,480,506,506,200,506,3,4,3,343,2,727,154171,3,506
2012-06-14,summer,2012,June,8,Thursday,Workingday,Clear,0.6,0.6061,0.64,0.3284,37,682,719,719,200,719,3,4,3,343,2,727,261001,3,719
2012-06-14,summer,2012,June,9,Thursday,Workingday,Clear,0.62,0.6061,0.61,0.2239,45,312,357,357,200,357,3,4,3,343,2,727,159438,3,357
2012-06-14,summer,2012,June,10,Thursday,Workingday,Clear,0.64,0.6061,0.65,0.4179,47,132,179,179,200,179,3,3,3,333,2,727,126257,3,179
2012-06-14,summer,2012,June,11,Thursday,Workingday,Clear,0.66,0.6212,0.57,0.2537,60,168,228,228,200,228,3,3,3,333,2,727,151320,3,228
2012-06-14,summer,2012,June,12,Thursday,Workingday,Mist,0.66,0.6212,0.61,0.2239,55,210,265,265,200,265,3,3,3,333,2,728,184414,3,265
2012-06-14,summer,2012,June,13,Thursday,Workingday,Clear,0.68,0.6364,0.57,0.1642,71,213,284,284,200,284,3,4,4,344,2,729,184919,3,284
2012-06-14,summer,2012,June,14,Thursday,Workingday,Clear,0.7,0.6515,0.54,0.2836,84,214,298,298,200,298,3,4,4,344,2,729,175652,3,298
2012-06-14,summer,2012,June,15,Thursday,Workingday,Clear,0.74,0.6667,0.48,0.2985,111,213,324,324,200,324,3,4,4,344,2,729,183149,3,324
2012-06-14,summer,2012,June,16,Thursday,Workingday,Clear,0.72,0.6667,0.51,0.2836,70,368,438,438,200,438,3,4,4,344,2,730,227748,3,438
2012-06-14,summer,2012,June,17,Thursday,Workingday,Clear,0.72,0.6667,0.48,0.2239,117,750,867,867,200,867,3,4,4,344,2,730,336860,3,867
2012-06-14,summer,2012,June,18,Thursday,Workingday,Clear,0.74,0.6667,0.42,0.194,107,716,823,823,200,823,3,4,4,344,2,728,309772,3,823
2012-06-14,summer,2012,June,19,Thursday,Workingday,Clear,0.7,0.6515,0.48,0.2537,96,483,579,579,200,579,3,4,4,344,2,728,226789,3,579
2012-06-14,summer,2012,June,20,Thursday,Workingday,Clear,0.66,0.6212,0.65,0.2537,84,351,435,435,200,435,3,4,3,343,2,728,164550,3,435
2012-06-14,summer,2012,June,21,Thursday,Workingday,Clear,0.64,0.6061,0.65,0.1642,67,270,337,337,200,337,3,4,3,343,2,728,125445,3,337
2012-06-14,summer,2012,June,22,Thursday,Workingday,Mist,0.64,0.6061,0.65,0.2239,46,196,242,242,200,242,3,3,3,333,0,728,95612,3,242
2012-06-14,summer,2012,June,23,Thursday,Workingday,Mist,0.62,0.6061,0.69,0.1642,36,136,172,172,200,172,3,3,3,333,0,728,63941,3,172
2012-06-15,summer,2012,June,0,Friday,Workingday,Clear,0.6,0.5909,0.73,0.1642,26,68,94,94,199,94,3,2,3,323,0,726,39130,3,94
2012-06-15,summer,2012,June,1,Friday,Workingday,Clear,0.58,0.5455,0.78,0.194,9,42,51,51,199,51,3,2,3,323,0,724,24164,3,51
2012-06-15,summer,2012,June,2,Friday,Workingday,Clear,0.56,0.5303,0.83,0.1045,0,15,15,15,199,15,3,1,3,313,0,715,16352,3,15
2012-06-15,summer,2012,June,3,Friday,Workingday,Clear,0.56,0.5303,0.83,0.1642,2,3,5,5,199,5,3,1,3,313,0,697,8174,3,5
2012-06-15,summer,2012,June,4,Friday,Workingday,Clear,0.56,0.5303,0.83,0.1642,1,13,14,14,199,14,3,1,3,313,0,697,4428,3,14
2012-06-15,summer,2012,June,5,Friday,Workingday,Clear,0.54,0.5152,0.88,0.1045,2,31,33,33,199,33,3,1,3,313,0,717,14261,3,33
2012-06-15,summer,2012,June,6,Friday,Workingday,Clear,0.54,0.5152,0.83,0.1343,9,142,151,151,199,151,3,3,3,333,0,725,55132,3,151
2012-06-15,summer,2012,June,7,Friday,Workingday,Clear,0.56,0.5303,0.83,0.1642,17,413,430,430,199,430,3,4,3,343,0,727,154171,3,430
2012-06-15,summer,2012,June,8,Friday,Workingday,Clear,0.6,0.5909,0.69,0.1642,44,609,653,653,199,653,3,4,3,343,2,727,261001,3,653
2012-06-15,summer,2012,June,9,Friday,Workingday,Clear,0.62,0.6061,0.65,0.1642,58,308,366,366,199,366,3,4,3,343,2,727,159438,3,366
2012-06-15,summer,2012,June,10,Friday,Workingday,Clear,0.64,0.6212,0.57,0.1642,56,160,216,216,199,216,3,3,3,333,2,727,126257,3,216
2012-06-15,summer,2012,June,11,Friday,Workingday,Clear,0.66,0.6212,0.5,0.194,106,180,286,286,199,286,3,4,3,343,2,727,151320,3,286
2012-06-15,summer,2012,June,12,Friday,Workingday,Clear,0.7,0.6364,0.45,0.1642,111,292,403,403,199,403,3,4,4,344,2,728,184414,3,403
2012-06-15,summer,2012,June,13,Friday,Workingday,Clear,0.7,0.6364,0.42,0.2537,121,272,393,393,199,393,3,4,4,344,2,729,184919,3,393
2012-06-15,summer,2012,June,14,Friday,Workingday,Clear,0.72,0.6515,0.39,0.194,121,255,376,376,199,376,3,4,4,344,2,729,175652,3,376
2012-06-15,summer,2012,June,15,Friday,Workingday,Clear,0.72,0.6515,0.39,0.194,107,270,377,377,199,377,3,4,4,344,2,729,183149,3,377
2012-06-15,summer,2012,June,16,Friday,Workingday,Clear,0.72,0.6515,0.37,0.194,132,426,558,558,199,558,3,4,4,344,2,730,227748,3,558
2012-06-15,summer,2012,June,17,Friday,Workingday,Clear,0.74,0.6515,0.37,0.2836,125,698,823,823,199,823,3,4,4,344,2,730,336860,3,823
2012-06-15,summer,2012,June,18,Friday,Workingday,Clear,0.72,0.6515,0.39,0.2239,121,572,693,693,199,693,3,4,4,344,2,728,309772,3,693
2012-06-15,summer,2012,June,19,Friday,Workingday,Clear,0.7,0.6364,0.42,0.1642,98,369,467,467,199,467,3,4,4,344,2,728,226789,3,467
2012-06-15,summer,2012,June,20,Friday,Workingday,Clear,0.68,0.6364,0.44,0.194,89,296,385,385,199,385,3,4,4,344,2,728,164550,3,385
2012-06-15,summer,2012,June,21,Friday,Workingday,Clear,0.66,0.6212,0.5,0.1045,83,250,333,333,199,333,3,4,3,343,2,728,125445,3,333
2012-06-15,summer,2012,June,22,Friday,Workingday,Clear,0.64,0.6212,0.53,0.1343,79,242,321,321,199,321,3,4,3,343,2,728,95612,3,321
2012-06-15,summer,2012,June,23,Friday,Workingday,Clear,0.62,0.6212,0.53,0.2537,46,176,222,222,199,222,3,3,3,333,2,728,63941,3,222
2012-06-16,summer,2012,June,0,Saturday,Holiday,Clear,0.58,0.5455,0.56,0.1343,25,112,137,137,198,137,3,2,3,323,0,726,39130,3,137
2012-06-16,summer,2012,June,1,Saturday,Holiday,Clear,0.56,0.5303,0.56,0.0,16,79,95,95,198,95,3,2,3,323,0,724,24164,3,95
2012-06-16,summer,2012,June,2,Saturday,Holiday,Clear,0.58,0.5455,0.53,0.0,12,55,67,67,198,67,3,2,3,323,0,715,16352,3,67
2012-06-16,summer,2012,June,3,Saturday,Holiday,Clear,0.56,0.5303,0.6,0.0896,8,19,27,27,198,27,3,1,3,313,0,697,8174,3,27
2012-06-16,summer,2012,June,4,Saturday,Holiday,Clear,0.54,0.5152,0.68,0.1343,3,5,8,8,198,8,3,1,3,313,0,697,4428,3,8
2012-06-16,summer,2012,June,5,Saturday,Holiday,Clear,0.54,0.5152,0.68,0.1045,2,21,23,23,198,23,3,1,3,313,0,717,14261,3,23
2012-06-16,summer,2012,June,6,Saturday,Holiday,Clear,0.54,0.5152,0.68,0.194,11,36,47,47,198,47,3,2,3,323,0,725,55132,3,47
2012-06-16,summer,2012,June,7,Saturday,Holiday,Clear,0.54,0.5152,0.68,0.194,10,68,78,78,198,78,3,2,3,323,0,727,154171,3,78
2012-06-16,summer,2012,June,8,Saturday,Holiday,Clear,0.58,0.5455,0.64,0.1642,47,157,204,204,198,204,3,3,3,333,0,727,261001,3,204
2012-06-16,summer,2012,June,9,Saturday,Holiday,Clear,0.6,0.6061,0.6,0.0896,88,279,367,367,198,367,3,4,3,343,2,727,159438,3,367
2012-06-16,summer,2012,June,10,Saturday,Holiday,Clear,0.64,0.6212,0.47,0.194,139,296,435,435,198,435,3,4,3,343,2,727,126257,3,435
2012-06-16,summer,2012,June,11,Saturday,Holiday,Clear,0.66,0.6212,0.39,0.1642,213,353,566,566,198,566,3,4,3,343,2,727,151320,3,566
2012-06-16,summer,2012,June,12,Saturday,Holiday,Clear,0.68,0.6364,0.41,0.1045,254,349,603,603,198,603,3,4,4,344,2,728,184414,3,603
2012-06-16,summer,2012,June,13,Saturday,Holiday,Clear,0.72,0.6515,0.34,0.1642,293,324,617,617,198,617,3,4,4,344,2,729,184919,3,617
2012-06-16,summer,2012,June,14,Saturday,Holiday,Clear,0.72,0.6515,0.37,0.2239,264,309,573,573,198,573,3,4,4,344,2,729,175652,3,573
2012-06-16,summer,2012,June,15,Saturday,Holiday,Clear,0.74,0.6515,0.35,0.2537,295,288,583,583,198,583,3,4,4,344,2,729,183149,3,583
2012-06-16,summer,2012,June,16,Saturday,Holiday,Mist,0.72,0.6515,0.37,0.1045,238,304,542,542,198,542,3,4,4,344,2,730,227748,3,542
2012-06-16,summer,2012,June,17,Saturday,Holiday,Mist,0.72,0.6515,0.37,0.2537,244,349,593,593,198,593,3,4,4,344,2,730,336860,3,593
2012-06-16,summer,2012,June,18,Saturday,Holiday,Mist,0.72,0.6515,0.37,0.2239,256,315,571,571,198,571,3,4,4,344,2,728,309772,3,571
2012-06-16,summer,2012,June,19,Saturday,Holiday,Mist,0.7,0.6364,0.42,0.194,184,277,461,461,198,461,3,4,4,344,2,728,226789,3,461
2012-06-16,summer,2012,June,20,Saturday,Holiday,Mist,0.66,0.6212,0.47,0.194,123,229,352,352,198,352,3,4,3,343,2,728,164550,3,352
2012-06-16,summer,2012,June,21,Saturday,Holiday,Mist,0.64,0.6212,0.5,0.2239,98,192,290,290,198,290,3,4,3,343,2,728,125445,3,290
2012-06-16,summer,2012,June,22,Saturday,Holiday,Clear,0.62,0.6212,0.53,0.2985,91,189,280,280,198,280,3,3,3,333,2,728,95612,3,280
2012-06-16,summer,2012,June,23,Saturday,Holiday,Clear,0.6,0.6212,0.53,0.2985,49,134,183,183,198,183,3,3,3,333,2,728,63941,3,183
2012-06-17,summer,2012,June,0,Sunday,Holiday,Clear,0.56,0.5303,0.56,0.1343,31,117,148,148,197,148,3,3,3,333,0,726,39130,3,148
2012-06-17,summer,2012,June,1,Sunday,Holiday,Clear,0.56,0.5303,0.6,0.1642,21,67,88,88,197,88,3,2,3,323,0,724,24164,3,88
2012-06-17,summer,2012,June,2,Sunday,Holiday,Clear,0.56,0.5303,0.56,0.0896,19,55,74,74,197,74,3,2,3,323,0,715,16352,3,74
2012-06-17,summer,2012,June,3,Sunday,Holiday,Clear,0.54,0.5152,0.64,0.1045,6,22,28,28,197,28,3,1,3,313,0,697,8174,3,28
2012-06-17,summer,2012,June,4,Sunday,Holiday,Clear,0.54,0.5152,0.64,0.0896,2,16,18,18,197,18,3,1,3,313,0,697,4428,3,18
2012-06-17,summer,2012,June,5,Sunday,Holiday,Clear,0.54,0.5152,0.68,0.1343,4,13,17,17,197,17,3,1,3,313,0,717,14261,3,17
2012-06-17,summer,2012,June,6,Sunday,Holiday,Clear,0.52,0.5,0.72,0.1045,7,16,23,23,197,23,3,1,3,313,0,725,55132,3,23
2012-06-17,summer,2012,June,7,Sunday,Holiday,Clear,0.52,0.5,0.72,0.0896,18,30,48,48,197,48,3,2,3,323,0,727,154171,3,48
2012-06-17,summer,2012,June,8,Sunday,Holiday,Clear,0.56,0.5303,0.68,0.2537,24,95,119,119,197,119,3,2,3,323,0,727,261001,3,119
2012-06-17,summer,2012,June,9,Sunday,Holiday,Clear,0.56,0.5303,0.68,0.1642,91,183,274,274,197,274,3,3,3,333,2,727,159438,3,274
2012-06-17,summer,2012,June,10,Sunday,Holiday,Clear,0.58,0.5455,0.64,0.0,148,288,436,436,197,436,3,4,3,343,2,727,126257,3,436
2012-06-17,summer,2012,June,11,Sunday,Holiday,Clear,0.62,0.6212,0.57,0.1045,196,350,546,546,197,546,3,4,3,343,2,727,151320,3,546
2012-06-17,summer,2012,June,12,Sunday,Holiday,Clear,0.62,0.6212,0.57,0.0,260,355,615,615,197,615,3,4,3,343,2,728,184414,3,615
2012-06-17,summer,2012,June,13,Sunday,Holiday,Clear,0.64,0.6212,0.53,0.1642,267,347,614,614,197,614,3,4,3,343,2,729,184919,3,614
2012-06-17,summer,2012,June,14,Sunday,Holiday,Clear,0.64,0.6212,0.53,0.0,255,327,582,582,197,582,3,4,3,343,2,729,175652,3,582
2012-06-17,summer,2012,June,15,Sunday,Holiday,Clear,0.66,0.6212,0.5,0.2239,203,260,463,463,197,463,3,4,3,343,2,729,183149,3,463
2012-06-17,summer,2012,June,16,Sunday,Holiday,Clear,0.66,0.6212,0.54,0.2985,240,340,580,580,197,580,3,4,3,343,2,730,227748,3,580
2012-06-17,summer,2012,June,17,Sunday,Holiday,Clear,0.64,0.6212,0.57,0.2239,232,361,593,593,197,593,3,4,3,343,2,730,336860,3,593
2012-06-17,summer,2012,June,18,Sunday,Holiday,Clear,0.64,0.6212,0.53,0.194,203,310,513,513,197,513,3,4,3,343,2,728,309772,3,513
2012-06-17,summer,2012,June,19,Sunday,Holiday,Clear,0.64,0.6212,0.53,0.1642,146,244,390,390,197,390,3,4,3,343,2,728,226789,3,390
2012-06-17,summer,2012,June,20,Sunday,Holiday,Clear,0.62,0.6212,0.57,0.194,101,201,302,302,197,302,3,4,3,343,2,728,164550,3,302
2012-06-17,summer,2012,June,21,Sunday,Holiday,Clear,0.62,0.6212,0.57,0.194,76,170,246,246,197,246,3,3,3,333,2,728,125445,3,246
2012-06-17,summer,2012,June,22,Sunday,Holiday,Clear,0.6,0.6061,0.6,0.194,55,98,153,153,197,153,3,3,3,333,0,728,95612,3,153
2012-06-17,summer,2012,June,23,Sunday,Holiday,Clear,0.58,0.5455,0.64,0.194,29,79,108,108,197,108,3,2,3,323,0,728,63941,3,108
2012-06-18,summer,2012,June,0,Monday,Workingday,Clear,0.56,0.5303,0.73,0.2537,12,28,40,40,196,40,3,1,3,313,0,726,39130,3,40
2012-06-18,summer,2012,June,1,Monday,Workingday,Clear,0.54,0.5152,0.77,0.2239,9,5,14,14,196,14,3,1,3,313,0,724,24164,3,14
2012-06-18,summer,2012,June,2,Monday,Workingday,Clear,0.54,0.5152,0.77,0.2239,3,6,9,9,196,9,3,1,3,313,0,715,16352,3,9
2012-06-18,summer,2012,June,3,Monday,Workingday,Mist,0.52,0.5,0.83,0.2239,1,3,4,4,196,4,3,1,3,313,0,697,8174,3,4
2012-06-18,summer,2012,June,4,Monday,Workingday,Mist,0.54,0.5152,0.77,0.194,0,9,9,9,196,9,3,1,3,313,0,697,4428,3,9
2012-06-18,summer,2012,June,5,Monday,Workingday,Light Snow,0.52,0.5,0.83,0.1343,1,22,23,23,196,23,3,1,3,313,0,717,14261,3,23
2012-06-18,summer,2012,June,6,Monday,Workingday,Light Snow,0.52,0.5,0.88,0.1343,0,37,37,37,196,37,3,1,3,313,0,725,55132,3,37
2012-06-18,summer,2012,June,7,Monday,Workingday,Light Snow,0.52,0.5,0.94,0.2239,10,135,145,145,196,145,3,3,3,333,0,727,154171,3,145
2012-06-18,summer,2012,June,8,Monday,Workingday,Mist,0.54,0.5152,0.83,0.194,27,447,474,474,196,474,3,4,3,343,0,727,261001,3,474
2012-06-18,summer,2012,June,9,Monday,Workingday,Mist,0.54,0.5152,0.83,0.2239,28,222,250,250,196,250,3,3,3,333,0,727,159438,3,250
2012-06-18,summer,2012,June,10,Monday,Workingday,Light Snow,0.54,0.5152,0.88,0.1045,13,78,91,91,196,91,3,2,3,323,0,727,126257,3,91
2012-06-18,summer,2012,June,11,Monday,Workingday,Mist,0.54,0.5152,0.88,0.1642,25,96,121,121,196,121,3,2,3,323,0,727,151320,3,121
2012-06-18,summer,2012,June,12,Monday,Workingday,Light Snow,0.56,0.5303,0.78,0.1343,29,139,168,168,196,168,3,3,3,333,0,728,184414,3,168
2012-06-18,summer,2012,June,13,Monday,Workingday,Mist,0.58,0.5455,0.73,0.1343,51,174,225,225,196,225,3,3,3,333,0,729,184919,3,225
2012-06-18,summer,2012,June,14,Monday,Workingday,Mist,0.58,0.5455,0.68,0.194,59,160,219,219,196,219,3,3,3,333,0,729,175652,3,219
2012-06-18,summer,2012,June,15,Monday,Workingday,Mist,0.6,0.5909,0.69,0.194,61,176,237,237,196,237,3,3,3,333,0,729,183149,3,237
2012-06-18,summer,2012,June,16,Monday,Workingday,Mist,0.6,0.5909,0.73,0.194,53,279,332,332,196,332,3,4,3,343,0,730,227748,3,332
2012-06-18,summer,2012,June,17,Monday,Workingday,Mist,0.6,0.5909,0.73,0.194,54,669,723,723,196,723,3,4,3,343,2,730,336860,3,723
2012-06-18,summer,2012,June,18,Monday,Workingday,Mist,0.62,0.6061,0.69,0.1642,47,595,642,642,196,642,3,4,3,343,2,728,309772,3,642
2012-06-18,summer,2012,June,19,Monday,Workingday,Mist,0.62,0.5909,0.73,0.0896,52,411,463,463,196,463,3,4,3,343,2,728,226789,3,463
2012-06-18,summer,2012,June,20,Monday,Workingday,Mist,0.62,0.5909,0.73,0.1343,45,317,362,362,196,362,3,4,3,343,0,728,164550,3,362
2012-06-18,summer,2012,June,21,Monday,Workingday,Mist,0.62,0.5909,0.73,0.1045,35,238,273,273,196,273,3,3,3,333,0,728,125445,3,273
2012-06-18,summer,2012,June,22,Monday,Workingday,Mist,0.62,0.5909,0.73,0.1642,21,143,164,164,196,164,3,3,3,333,0,728,95612,3,164
2012-06-18,summer,2012,June,23,Monday,Workingday,Light Snow,0.6,0.5758,0.78,0.194,17,57,74,74,196,74,3,2,3,323,0,728,63941,3,74
2012-06-19,summer,2012,June,0,Tuesday,Workingday,Mist,0.6,0.5758,0.78,0.1642,5,30,35,35,195,35,3,1,3,313,0,726,39130,3,35
2012-06-19,summer,2012,June,1,Tuesday,Workingday,Mist,0.6,0.5758,0.78,0.1642,1,13,14,14,195,14,3,1,3,313,0,724,24164,3,14
2012-06-19,summer,2012,June,2,Tuesday,Workingday,Mist,0.6,0.5758,0.78,0.1343,1,14,15,15,195,15,3,1,3,313,0,715,16352,3,15
2012-06-19,summer,2012,June,3,Tuesday,Workingday,Mist,0.6,0.5758,0.78,0.1045,1,7,8,8,195,8,3,1,3,313,0,697,8174,3,8
2012-06-19,summer,2012,June,4,Tuesday,Workingday,Mist,0.6,0.5758,0.78,0.1343,1,9,10,10,195,10,3,1,3,313,0,697,4428,3,10
2012-06-19,summer,2012,June,5,Tuesday,Workingday,Mist,0.6,0.5758,0.78,0.194,3,34,37,37,195,37,3,1,3,313,0,717,14261,3,37
2012-06-19,summer,2012,June,6,Tuesday,Workingday,Mist,0.6,0.5758,0.78,0.1045,9,152,161,161,195,161,3,3,3,333,0,725,55132,3,161
2012-06-19,summer,2012,June,7,Tuesday,Workingday,Mist,0.6,0.5758,0.78,0.1343,18,462,480,480,195,480,3,4,3,343,0,727,154171,3,480
2012-06-19,summer,2012,June,8,Tuesday,Workingday,Mist,0.6,0.5758,0.78,0.1642,40,633,673,673,195,673,3,4,3,343,2,727,261001,3,673
2012-06-19,summer,2012,June,9,Tuesday,Workingday,Clear,0.64,0.6061,0.73,0.0896,40,288,328,328,195,328,3,4,3,343,0,727,159438,3,328
2012-06-19,summer,2012,June,10,Tuesday,Workingday,Clear,0.64,0.6061,0.73,0.0896,44,136,180,180,195,180,3,3,3,333,0,727,126257,3,180
2012-06-19,summer,2012,June,11,Tuesday,Workingday,Clear,0.66,0.6212,0.69,0.1343,56,174,230,230,195,230,3,3,3,333,0,727,151320,3,230
2012-06-19,summer,2012,June,12,Tuesday,Workingday,Clear,0.7,0.6515,0.65,0.0896,70,222,292,292,195,292,3,4,4,344,2,728,184414,3,292
2012-06-19,summer,2012,June,13,Tuesday,Workingday,Clear,0.74,0.6818,0.58,0.1343,69,203,272,272,195,272,3,3,4,334,2,729,184919,3,272
2012-06-19,summer,2012,June,14,Tuesday,Workingday,Clear,0.76,0.7121,0.58,0.1045,61,166,227,227,195,227,3,3,4,334,2,729,175652,3,227
2012-06-19,summer,2012,June,15,Tuesday,Workingday,Clear,0.78,0.7424,0.59,0.1642,72,187,259,259,195,259,3,3,4,334,2,729,183149,3,259
2012-06-19,summer,2012,June,16,Tuesday,Workingday,Clear,0.8,0.7576,0.55,0.2239,48,286,334,334,195,334,3,4,4,344,2,730,227748,3,334
2012-06-19,summer,2012,June,17,Tuesday,Workingday,Clear,0.8,0.7576,0.55,0.194,86,725,811,811,195,811,3,4,4,344,2,730,336860,3,811
2012-06-19,summer,2012,June,18,Tuesday,Workingday,Clear,0.8,0.7576,0.55,0.1642,91,704,795,795,195,795,3,4,4,344,2,728,309772,3,795
2012-06-19,summer,2012,June,19,Tuesday,Workingday,Clear,0.8,0.7727,0.59,0.2239,82,432,514,514,195,514,3,4,4,344,2,728,226789,3,514
2012-06-19,summer,2012,June,20,Tuesday,Workingday,Clear,0.8,0.7576,0.55,0.2537,59,399,458,458,195,458,3,4,4,344,2,728,164550,3,458
2012-06-19,summer,2012,June,21,Tuesday,Workingday,Clear,0.76,0.7121,0.62,0.1642,37,239,276,276,195,276,3,3,4,334,2,728,125445,3,276
2012-06-19,summer,2012,June,22,Tuesday,Workingday,Clear,0.72,0.697,0.79,0.0896,51,240,291,291,195,291,3,4,4,344,0,728,95612,3,291
2012-06-19,summer,2012,June,23,Tuesday,Workingday,Clear,0.72,0.697,0.79,0.1343,23,102,125,125,195,125,3,2,4,324,0,728,63941,3,125
2012-06-20,summer,2012,June,0,Wednesday,Workingday,Clear,0.7,0.6667,0.79,0.194,5,48,53,53,194,53,3,2,4,324,0,726,39130,3,53
2012-06-20,summer,2012,June,1,Wednesday,Workingday,Clear,0.68,0.6364,0.79,0.194,7,20,27,27,194,27,3,1,4,314,0,724,24164,3,27
2012-06-20,summer,2012,June,2,Wednesday,Workingday,Clear,0.66,0.6061,0.83,0.1642,1,5,6,6,194,6,3,1,3,313,0,715,16352,3,6
2012-06-20,summer,2012,June,3,Wednesday,Workingday,Clear,0.66,0.6061,0.83,0.1343,2,6,8,8,194,8,3,1,3,313,0,697,8174,3,8
2012-06-20,summer,2012,June,4,Wednesday,Workingday,Clear,0.66,0.6061,0.83,0.0896,1,6,7,7,194,7,3,1,3,313,0,697,4428,3,7
2012-06-20,summer,2012,June,5,Wednesday,Workingday,Clear,0.66,0.6061,0.83,0.0896,2,37,39,39,194,39,3,1,3,313,0,717,14261,3,39
2012-06-20,summer,2012,June,6,Wednesday,Workingday,Mist,0.64,0.5758,0.89,0.0896,9,156,165,165,194,165,3,3,3,333,0,725,55132,3,165
2012-06-20,summer,2012,June,7,Wednesday,Workingday,Mist,0.66,0.5909,0.89,0.0,20,444,464,464,194,464,3,4,3,343,0,727,154171,3,464
2012-06-20,summer,2012,June,8,Wednesday,Workingday,Mist,0.7,0.6667,0.79,0.1045,43,600,643,643,194,643,3,4,4,344,2,727,261001,3,643
2012-06-20,summer,2012,June,9,Wednesday,Workingday,Mist,0.72,0.697,0.74,0.0,40,276,316,316,194,316,3,4,4,344,0,727,159438,3,316
2012-06-20,summer,2012,June,10,Wednesday,Workingday,Clear,0.82,0.7727,0.52,0.1343,41,126,167,167,194,167,3,3,4,334,2,727,126257,3,167
2012-06-20,summer,2012,June,11,Wednesday,Workingday,Clear,0.84,0.7879,0.49,0.194,54,134,188,188,194,188,3,3,4,334,2,727,151320,3,188
2012-06-20,summer,2012,June,12,Wednesday,Workingday,Clear,0.86,0.803,0.47,0.1642,30,150,180,180,194,180,3,3,4,334,2,728,184414,3,180
2012-06-20,summer,2012,June,13,Wednesday,Workingday,Clear,0.86,0.7879,0.44,0.1045,48,163,211,211,194,211,3,3,4,334,2,729,184919,3,211
2012-06-20,summer,2012,June,14,Wednesday,Workingday,Clear,0.88,0.803,0.39,0.194,56,134,190,190,194,190,3,3,4,334,2,729,175652,3,190
2012-06-20,summer,2012,June,15,Wednesday,Workingday,Clear,0.9,0.8182,0.35,0.0,36,143,179,179,194,179,3,3,4,334,2,729,183149,3,179
2012-06-20,summer,2012,June,16,Wednesday,Workingday,Clear,0.9,0.8182,0.35,0.1045,51,284,335,335,194,335,3,4,4,344,2,730,227748,3,335
2012-06-20,summer,2012,June,17,Wednesday,Workingday,Clear,0.9,0.8182,0.37,0.0,80,611,691,691,194,691,3,4,4,344,2,730,336860,3,691
2012-06-20,summer,2012,June,18,Wednesday,Workingday,Clear,0.9,0.8182,0.37,0.0,81,591,672,672,194,672,3,4,4,344,2,728,309772,3,672
2012-06-20,summer,2012,June,19,Wednesday,Workingday,Clear,0.88,0.7879,0.37,0.2537,90,449,539,539,194,539,3,4,4,344,2,728,226789,3,539
2012-06-20,summer,2012,June,20,Wednesday,Workingday,Clear,0.86,0.7727,0.39,0.2239,81,326,407,407,194,407,3,4,4,344,2,728,164550,3,407
2012-06-20,summer,2012,June,21,Wednesday,Workingday,Clear,0.84,0.7576,0.44,0.0896,42,302,344,344,194,344,3,4,4,344,2,728,125445,3,344
2012-06-20,summer,2012,June,22,Wednesday,Workingday,Clear,0.82,0.7576,0.46,0.1045,31,226,257,257,194,257,3,3,4,334,2,728,95612,3,257
2012-06-20,summer,2012,June,23,Wednesday,Workingday,Clear,0.78,0.7424,0.59,0.1045,21,102,123,123,194,123,3,2,4,324,0,728,63941,3,123
2012-06-21,fall,2012,June,0,Thursday,Workingday,Clear,0.74,0.697,0.7,0.0896,16,53,69,69,193,69,3,2,4,324,0,726,39130,3,69
2012-06-21,fall,2012,June,1,Thursday,Workingday,Clear,0.72,0.697,0.79,0.1343,2,16,18,18,193,18,3,1,4,314,0,724,24164,3,18
2012-06-21,fall,2012,June,2,Thursday,Workingday,Clear,0.72,0.697,0.79,0.1045,11,7,18,18,193,18,3,1,4,314,0,715,16352,3,18
2012-06-21,fall,2012,June,3,Thursday,Workingday,Clear,0.72,0.697,0.74,0.0,3,8,11,11,193,11,3,1,4,314,0,697,8174,3,11
2012-06-21,fall,2012,June,4,Thursday,Workingday,Clear,0.7,0.6667,0.84,0.0896,1,11,12,12,193,12,3,1,4,314,0,697,4428,3,12
2012-06-21,fall,2012,June,5,Thursday,Workingday,Clear,0.7,0.6667,0.84,0.1045,3,37,40,40,193,40,3,1,4,314,0,717,14261,3,40
2012-06-21,fall,2012,June,6,Thursday,Workingday,Mist,0.7,0.6667,0.84,0.0896,3,147,150,150,193,150,3,3,4,334,0,725,55132,3,150
2012-06-21,fall,2012,June,7,Thursday,Workingday,Mist,0.7,0.6667,0.84,0.0896,26,437,463,463,193,463,3,4,4,344,0,727,154171,3,463
2012-06-21,fall,2012,June,8,Thursday,Workingday,Clear,0.74,0.697,0.7,0.0,27,563,590,590,193,590,3,4,4,344,2,727,261001,3,590
2012-06-21,fall,2012,June,9,Thursday,Workingday,Clear,0.8,0.7576,0.55,0.194,32,224,256,256,193,256,3,3,4,334,2,727,159438,3,256
2012-06-21,fall,2012,June,10,Thursday,Workingday,Clear,0.84,0.7879,0.49,0.1045,36,114,150,150,193,150,3,3,4,334,2,727,126257,3,150
2012-06-21,fall,2012,June,11,Thursday,Workingday,Clear,0.86,0.7879,0.41,0.1343,40,121,161,161,193,161,3,3,4,334,2,727,151320,3,161
2012-06-21,fall,2012,June,12,Thursday,Workingday,Clear,0.9,0.8182,0.35,0.194,33,182,215,215,193,215,3,3,4,334,2,728,184414,3,215
2012-06-21,fall,2012,June,13,Thursday,Workingday,Clear,0.9,0.8182,0.35,0.0,31,141,172,172,193,172,3,3,4,334,2,729,184919,3,172
2012-06-21,fall,2012,June,14,Thursday,Workingday,Clear,0.88,0.7879,0.37,0.1642,27,149,176,176,193,176,3,3,4,334,2,729,175652,3,176
2012-06-21,fall,2012,June,15,Thursday,Workingday,Clear,0.92,0.8333,0.33,0.1642,40,154,194,194,193,194,3,3,4,334,2,729,183149,3,194
2012-06-21,fall,2012,June,16,Thursday,Workingday,Clear,0.9,0.8182,0.35,0.1343,37,283,320,320,193,320,3,4,4,344,2,730,227748,3,320
2012-06-21,fall,2012,June,17,Thursday,Workingday,Clear,0.88,0.7879,0.37,0.0,80,535,615,615,193,615,3,4,4,344,2,730,336860,3,615
2012-06-21,fall,2012,June,18,Thursday,Workingday,Clear,0.86,0.7879,0.41,0.194,78,562,640,640,193,640,3,4,4,344,2,728,309772,3,640
2012-06-21,fall,2012,June,19,Thursday,Workingday,Clear,0.88,0.803,0.39,0.2239,84,415,499,499,193,499,3,4,4,344,2,728,226789,3,499
2012-06-21,fall,2012,June,20,Thursday,Workingday,Clear,0.86,0.7879,0.44,0.194,79,357,436,436,193,436,3,4,4,344,2,728,164550,3,436
2012-06-21,fall,2012,June,21,Thursday,Workingday,Clear,0.82,0.7727,0.52,0.194,55,256,311,311,193,311,3,4,4,344,2,728,125445,3,311
2012-06-21,fall,2012,June,22,Thursday,Workingday,Clear,0.8,0.7879,0.63,0.1642,22,221,243,243,193,243,3,3,4,334,2,728,95612,3,243
2012-06-21,fall,2012,June,23,Thursday,Workingday,Clear,0.8,0.7727,0.59,0.0896,12,134,146,146,193,146,3,3,4,334,0,728,63941,3,146
2012-06-22,fall,2012,June,0,Friday,Workingday,Mist,0.76,0.7273,0.7,0.1045,16,77,93,93,192,93,3,2,4,324,0,726,39130,3,93
2012-06-22,fall,2012,June,1,Friday,Workingday,Clear,0.76,0.7424,0.75,0.1642,3,28,31,31,192,31,3,1,4,314,0,724,24164,3,31
2012-06-22,fall,2012,June,2,Friday,Workingday,Clear,0.74,0.7121,0.79,0.0,0,12,12,12,192,12,3,1,4,314,0,715,16352,3,12
2012-06-22,fall,2012,June,3,Friday,Workingday,Clear,0.74,0.7121,0.79,0.0,1,6,7,7,192,7,3,1,4,314,0,697,8174,3,7
2012-06-22,fall,2012,June,4,Friday,Workingday,Mist,0.76,0.7273,0.66,0.0,3,7,10,10,192,10,3,1,4,314,0,697,4428,3,10
2012-06-22,fall,2012,June,5,Friday,Workingday,Mist,0.74,0.697,0.66,0.0896,3,35,38,38,192,38,3,1,4,314,0,717,14261,3,38
2012-06-22,fall,2012,June,6,Friday,Workingday,Mist,0.74,0.697,0.66,0.0,4,118,122,122,192,122,3,2,4,324,0,725,55132,3,122
2012-06-22,fall,2012,June,7,Friday,Workingday,Clear,0.74,0.6818,0.58,0.1642,19,340,359,359,192,359,3,4,4,344,2,727,154171,3,359
2012-06-22,fall,2012,June,8,Friday,Workingday,Clear,0.76,0.697,0.55,0.1343,49,564,613,613,192,613,3,4,4,344,2,727,261001,3,613
2012-06-22,fall,2012,June,9,Friday,Workingday,Clear,0.76,0.7121,0.58,0.2239,55,278,333,333,192,333,3,4,4,344,2,727,159438,3,333
2012-06-22,fall,2012,June,10,Friday,Workingday,Clear,0.8,0.7424,0.52,0.3582,52,133,185,185,192,185,3,3,4,334,2,727,126257,3,185
2012-06-22,fall,2012,June,11,Friday,Workingday,Clear,0.8,0.7424,0.49,0.1642,76,160,236,236,192,236,3,3,4,334,2,727,151320,3,236
2012-06-22,fall,2012,June,12,Friday,Workingday,Clear,0.84,0.7879,0.49,0.1343,63,191,254,254,192,254,3,3,4,334,2,728,184414,3,254
2012-06-22,fall,2012,June,13,Friday,Workingday,Clear,0.88,0.803,0.39,0.2239,72,228,300,300,192,300,3,4,4,344,2,729,184919,3,300
2012-06-22,fall,2012,June,14,Friday,Workingday,Clear,0.88,0.803,0.39,0.2239,65,198,263,263,192,263,3,3,4,334,2,729,175652,3,263
2012-06-22,fall,2012,June,15,Friday,Workingday,Clear,0.9,0.8182,0.35,0.3582,72,212,284,284,192,284,3,4,4,344,2,729,183149,3,284
2012-06-22,fall,2012,June,16,Friday,Workingday,Clear,0.9,0.803,0.31,0.2239,67,313,380,380,192,380,3,4,4,344,2,730,227748,3,380
2012-06-22,fall,2012,June,17,Friday,Workingday,Mist,0.82,0.7273,0.38,0.1642,95,551,646,646,192,646,3,4,4,344,2,730,336860,3,646
2012-06-22,fall,2012,June,18,Friday,Workingday,Mist,0.8,0.7576,0.55,0.194,62,443,505,505,192,505,3,4,4,344,2,728,309772,3,505
2012-06-22,fall,2012,June,19,Friday,Workingday,Mist,0.76,0.697,0.55,0.5224,45,317,362,362,192,362,3,4,4,344,2,728,226789,3,362
2012-06-22,fall,2012,June,20,Friday,Workingday,Mist,0.76,0.697,0.55,0.5224,31,171,202,202,192,202,3,3,4,334,2,728,164550,3,202
2012-06-22,fall,2012,June,21,Friday,Workingday,Light Snow,0.68,0.6364,0.65,0.2836,40,177,217,217,192,217,3,3,4,334,2,728,125445,3,217
2012-06-22,fall,2012,June,22,Friday,Workingday,Clear,0.68,0.6364,0.69,0.1343,42,155,197,197,192,197,3,3,4,334,0,728,95612,3,197
2012-06-22,fall,2012,June,23,Friday,Workingday,Mist,0.66,0.6212,0.74,0.0,29,145,174,174,192,174,3,3,3,333,0,728,63941,3,174
2012-06-23,fall,2012,June,0,Saturday,Holiday,Clear,0.64,0.5758,0.83,0.0,14,102,116,116,191,116,3,2,3,323,0,726,39130,3,116
2012-06-23,fall,2012,June,1,Saturday,Holiday,Clear,0.66,0.6061,0.78,0.1343,16,107,123,123,191,123,3,2,3,323,0,724,24164,3,123
2012-06-23,fall,2012,June,2,Saturday,Holiday,Mist,0.64,0.5758,0.83,0.194,18,75,93,93,191,93,3,2,3,323,0,715,16352,3,93
2012-06-23,fall,2012,June,3,Saturday,Holiday,Mist,0.64,0.5758,0.83,0.0896,10,32,42,42,191,42,3,2,3,323,0,697,8174,3,42
2012-06-23,fall,2012,June,4,Saturday,Holiday,Mist,0.64,0.5758,0.83,0.1642,6,13,19,19,191,19,3,1,3,313,0,697,4428,3,19
2012-06-23,fall,2012,June,5,Saturday,Holiday,Mist,0.64,0.5758,0.83,0.194,1,11,12,12,191,12,3,1,3,313,0,717,14261,3,12
2012-06-23,fall,2012,June,6,Saturday,Holiday,Clear,0.64,0.5758,0.83,0.0896,10,37,47,47,191,47,3,2,3,323,0,725,55132,3,47
2012-06-23,fall,2012,June,7,Saturday,Holiday,Clear,0.64,0.5758,0.83,0.1642,19,59,78,78,191,78,3,2,3,323,0,727,154171,3,78
2012-06-23,fall,2012,June,8,Saturday,Holiday,Clear,0.68,0.6364,0.69,0.2239,34,133,167,167,191,167,3,3,4,334,0,727,261001,3,167
2012-06-23,fall,2012,June,9,Saturday,Holiday,Clear,0.72,0.6818,0.62,0.194,85,247,332,332,191,332,3,4,4,344,2,727,159438,3,332
2012-06-23,fall,2012,June,10,Saturday,Holiday,Clear,0.74,0.6818,0.55,0.194,177,317,494,494,191,494,3,4,4,344,2,727,126257,3,494
2012-06-23,fall,2012,June,11,Saturday,Holiday,Clear,0.76,0.6818,0.48,0.2239,167,349,516,516,191,516,3,4,4,344,2,727,151320,3,516
2012-06-23,fall,2012,June,12,Saturday,Holiday,Clear,0.8,0.7273,0.43,0.194,203,399,602,602,191,602,3,4,4,344,2,728,184414,3,602
2012-06-23,fall,2012,June,13,Saturday,Holiday,Clear,0.82,0.7273,0.34,0.194,226,338,564,564,191,564,3,4,4,344,2,729,184919,3,564
2012-06-23,fall,2012,June,14,Saturday,Holiday,Clear,0.78,0.6818,0.33,0.2537,238,371,609,609,191,609,3,4,4,344,2,729,175652,3,609
2012-06-23,fall,2012,June,15,Saturday,Holiday,Clear,0.84,0.7273,0.3,0.3284,217,266,483,483,191,483,3,4,4,344,2,729,183149,3,483
2012-06-23,fall,2012,June,16,Saturday,Holiday,Clear,0.84,0.7121,0.26,0.2985,196,317,513,513,191,513,3,4,4,344,2,730,227748,3,513
2012-06-23,fall,2012,June,17,Saturday,Holiday,Clear,0.82,0.7121,0.26,0.2537,214,316,530,530,191,530,3,4,4,344,2,730,336860,3,530
2012-06-23,fall,2012,June,18,Saturday,Holiday,Clear,0.82,0.7121,0.26,0.2985,194,287,481,481,191,481,3,4,4,344,2,728,309772,3,481
2012-06-23,fall,2012,June,19,Saturday,Holiday,Clear,0.8,0.697,0.27,0.194,185,240,425,425,191,425,3,4,4,344,2,728,226789,3,425
2012-06-23,fall,2012,June,20,Saturday,Holiday,Clear,0.78,0.6818,0.31,0.194,158,228,386,386,191,386,3,4,4,344,2,728,164550,3,386
2012-06-23,fall,2012,June,21,Saturday,Holiday,Clear,0.76,0.6667,0.33,0.1343,99,223,322,322,191,322,3,4,4,344,2,728,125445,3,322
2012-06-23,fall,2012,June,22,Saturday,Holiday,Clear,0.74,0.6515,0.37,0.1045,101,178,279,279,191,279,3,3,4,334,2,728,95612,3,279
2012-06-23,fall,2012,June,23,Saturday,Holiday,Clear,0.72,0.6515,0.44,0.0,69,156,225,225,191,225,3,3,4,334,2,728,63941,3,225
2012-06-24,fall,2012,June,0,Sunday,Holiday,Clear,0.7,0.6515,0.51,0.0,31,132,163,163,190,163,3,3,4,334,0,726,39130,3,163
2012-06-24,fall,2012,June,1,Sunday,Holiday,Mist,0.68,0.6364,0.54,0.0896,39,88,127,127,190,127,3,2,4,324,0,724,24164,3,127
2012-06-24,fall,2012,June,2,Sunday,Holiday,Mist,0.68,0.6364,0.51,0.0,34,80,114,114,190,114,3,2,4,324,0,715,16352,3,114
2012-06-24,fall,2012,June,3,Sunday,Holiday,Mist,0.66,0.6212,0.65,0.0896,19,41,60,60,190,60,3,2,3,323,0,697,8174,3,60
2012-06-24,fall,2012,June,4,Sunday,Holiday,Mist,0.66,0.6212,0.65,0.0,4,9,13,13,190,13,3,1,3,313,0,697,4428,3,13
2012-06-24,fall,2012,June,5,Sunday,Holiday,Clear,0.62,0.6061,0.69,0.1343,1,7,8,8,190,8,3,1,3,313,0,717,14261,3,8
2012-06-24,fall,2012,June,6,Sunday,Holiday,Clear,0.64,0.6061,0.65,0.1642,6,19,25,25,190,25,3,1,3,313,0,725,55132,3,25
2012-06-24,fall,2012,June,7,Sunday,Holiday,Clear,0.64,0.6061,0.69,0.1045,23,48,71,71,190,71,3,2,3,323,0,727,154171,3,71
2012-06-24,fall,2012,June,8,Sunday,Holiday,Clear,0.7,0.6515,0.58,0.0,38,103,141,141,190,141,3,2,4,324,0,727,261001,3,141
2012-06-24,fall,2012,June,9,Sunday,Holiday,Clear,0.72,0.6667,0.51,0.0,63,169,232,232,190,232,3,3,4,334,2,727,159438,3,232
2012-06-24,fall,2012,June,10,Sunday,Holiday,Clear,0.76,0.6818,0.4,0.0,161,291,452,452,190,452,3,4,4,344,2,727,126257,3,452
2012-06-24,fall,2012,June,11,Sunday,Holiday,Clear,0.76,0.6818,0.4,0.1343,215,291,506,506,190,506,3,4,4,344,2,727,151320,3,506
2012-06-24,fall,2012,June,12,Sunday,Holiday,Clear,0.8,0.697,0.33,0.2239,227,329,556,556,190,556,3,4,4,344,2,728,184414,3,556
2012-06-24,fall,2012,June,13,Sunday,Holiday,Clear,0.8,0.697,0.33,0.2836,237,348,585,585,190,585,3,4,4,344,2,729,184919,3,585
2012-06-24,fall,2012,June,14,Sunday,Holiday,Clear,0.84,0.7273,0.3,0.2985,253,298,551,551,190,551,3,4,4,344,2,729,175652,3,551
2012-06-24,fall,2012,June,15,Sunday,Holiday,Clear,0.86,0.7424,0.28,0.2239,197,290,487,487,190,487,3,4,4,344,2,729,183149,3,487
2012-06-24,fall,2012,June,16,Sunday,Holiday,Clear,0.84,0.7273,0.3,0.2537,181,280,461,461,190,461,3,4,4,344,2,730,227748,3,461
2012-06-24,fall,2012,June,17,Sunday,Holiday,Clear,0.84,0.7273,0.32,0.2537,203,329,532,532,190,532,3,4,4,344,2,730,336860,3,532
2012-06-24,fall,2012,June,18,Sunday,Holiday,Clear,0.82,0.7273,0.34,0.2537,186,348,534,534,190,534,3,4,4,344,2,728,309772,3,534
2012-06-24,fall,2012,June,19,Sunday,Holiday,Clear,0.8,0.7121,0.38,0.2985,176,247,423,423,190,423,3,4,4,344,2,728,226789,3,423
2012-06-24,fall,2012,June,20,Sunday,Holiday,Clear,0.78,0.697,0.46,0.2537,108,224,332,332,190,332,3,4,4,344,2,728,164550,3,332
2012-06-24,fall,2012,June,21,Sunday,Holiday,Clear,0.76,0.697,0.55,0.2239,76,177,253,253,190,253,3,3,4,334,2,728,125445,3,253
2012-06-24,fall,2012,June,22,Sunday,Holiday,Clear,0.74,0.6818,0.55,0.1045,53,125,178,178,190,178,3,3,4,334,2,728,95612,3,178
2012-06-24,fall,2012,June,23,Sunday,Holiday,Clear,0.74,0.6818,0.58,0.1045,20,67,87,87,190,87,3,2,4,324,0,728,63941,3,87
2012-06-25,fall,2012,June,0,Monday,Workingday,Clear,0.72,0.6818,0.62,0.2537,31,37,68,68,189,68,3,2,4,324,0,726,39130,3,68
2012-06-25,fall,2012,June,1,Monday,Workingday,Clear,0.7,0.6515,0.65,0.2239,11,20,31,31,189,31,3,1,4,314,0,724,24164,3,31
2012-06-25,fall,2012,June,2,Monday,Workingday,Clear,0.7,0.6515,0.7,0.2239,4,10,14,14,189,14,3,1,4,314,0,715,16352,3,14
2012-06-25,fall,2012,June,3,Monday,Workingday,Clear,0.68,0.6364,0.69,0.2537,1,4,5,5,189,5,3,1,4,314,0,697,8174,3,5
2012-06-25,fall,2012,June,4,Monday,Workingday,Clear,0.66,0.6061,0.78,0.2537,0,4,4,4,189,4,3,1,3,313,0,697,4428,3,4
2012-06-25,fall,2012,June,5,Monday,Workingday,Clear,0.66,0.6212,0.74,0.1642,1,42,43,43,189,43,3,2,3,323,0,717,14261,3,43
2012-06-25,fall,2012,June,6,Monday,Workingday,Clear,0.64,0.5909,0.78,0.1642,11,147,158,158,189,158,3,3,3,333,0,725,55132,3,158
2012-06-25,fall,2012,June,7,Monday,Workingday,Clear,0.66,0.6212,0.74,0.2239,30,455,485,485,189,485,3,4,3,343,2,727,154171,3,485
2012-06-25,fall,2012,June,8,Monday,Workingday,Clear,0.66,0.6212,0.69,0.194,53,555,608,608,189,608,3,4,3,343,2,727,261001,3,608
2012-06-25,fall,2012,June,9,Monday,Workingday,Clear,0.7,0.6515,0.65,0.194,37,231,268,268,189,268,3,3,4,334,2,727,159438,3,268
2012-06-25,fall,2012,June,10,Monday,Workingday,Clear,0.76,0.697,0.55,0.1642,58,126,184,184,189,184,3,3,4,334,2,727,126257,3,184
2012-06-25,fall,2012,June,11,Monday,Workingday,Clear,0.8,0.7273,0.43,0.3284,54,127,181,181,189,181,3,3,4,334,2,727,151320,3,181
2012-06-25,fall,2012,June,12,Monday,Workingday,Mist,0.76,0.6818,0.45,0.2985,74,196,270,270,189,270,3,3,4,334,2,728,184414,3,270
2012-06-25,fall,2012,June,13,Monday,Workingday,Clear,0.72,0.6667,0.51,0.2985,79,181,260,260,189,260,3,3,4,334,2,729,184919,3,260
2012-06-25,fall,2012,June,14,Monday,Workingday,Clear,0.78,0.697,0.43,0.2537,90,161,251,251,189,251,3,3,4,334,2,729,175652,3,251
2012-06-25,fall,2012,June,15,Monday,Workingday,Clear,0.78,0.6818,0.38,0.4627,65,168,233,233,189,233,3,3,4,334,2,729,183149,3,233
2012-06-25,fall,2012,June,16,Monday,Workingday,Clear,0.8,0.697,0.31,0.3881,104,310,414,414,189,414,3,4,4,344,2,730,227748,3,414
2012-06-25,fall,2012,June,17,Monday,Workingday,Clear,0.8,0.6818,0.24,0.4627,76,757,833,833,189,833,3,4,4,344,2,730,336860,3,833
2012-06-25,fall,2012,June,18,Monday,Workingday,Clear,0.76,0.6667,0.27,0.4478,100,691,791,791,189,791,3,4,4,344,2,728,309772,3,791
2012-06-25,fall,2012,June,19,Monday,Workingday,Clear,0.74,0.6515,0.27,0.4627,74,508,582,582,189,582,3,4,4,344,2,728,226789,3,582
2012-06-25,fall,2012,June,20,Monday,Workingday,Clear,0.72,0.6515,0.3,0.4478,100,375,475,475,189,475,3,4,4,344,2,728,164550,3,475
2012-06-25,fall,2012,June,21,Monday,Workingday,Clear,0.68,0.6212,0.3,0.3284,50,281,331,331,189,331,3,4,3,343,2,728,125445,3,331
2012-06-25,fall,2012,June,22,Monday,Workingday,Clear,0.66,0.6212,0.29,0.3881,21,166,187,187,189,187,3,3,3,333,2,728,95612,3,187
2012-06-25,fall,2012,June,23,Monday,Workingday,Clear,0.64,0.6212,0.33,0.3284,15,88,103,103,189,103,3,2,3,323,2,728,63941,3,103
2012-06-26,fall,2012,June,0,Tuesday,Workingday,Clear,0.62,0.6212,0.33,0.3284,8,29,37,37,188,37,3,1,3,313,2,726,39130,3,37
2012-06-26,fall,2012,June,1,Tuesday,Workingday,Clear,0.6,0.6212,0.35,0.3881,11,19,30,30,188,30,3,1,3,313,2,724,24164,3,30
2012-06-26,fall,2012,June,2,Tuesday,Workingday,Clear,0.56,0.5303,0.43,0.2836,2,7,9,9,188,9,3,1,3,313,1,715,16352,3,9
2012-06-26,fall,2012,June,3,Tuesday,Workingday,Clear,0.54,0.5152,0.45,0.2836,2,7,9,9,188,9,3,1,3,313,1,697,8174,3,9
2012-06-26,fall,2012,June,4,Tuesday,Workingday,Clear,0.54,0.5152,0.45,0.2985,1,9,10,10,188,10,3,1,3,313,1,697,4428,3,10
2012-06-26,fall,2012,June,5,Tuesday,Workingday,Clear,0.52,0.5,0.48,0.3881,3,36,39,39,188,39,3,1,3,313,1,717,14261,3,39
2012-06-26,fall,2012,June,6,Tuesday,Workingday,Clear,0.52,0.5,0.52,0.2985,12,176,188,188,188,188,3,3,3,333,1,725,55132,3,188
2012-06-26,fall,2012,June,7,Tuesday,Workingday,Clear,0.52,0.5,0.52,0.3582,21,531,552,552,188,552,3,4,3,343,2,727,154171,3,552
2012-06-26,fall,2012,June,8,Tuesday,Workingday,Clear,0.56,0.5303,0.49,0.3284,34,622,656,656,188,656,3,4,3,343,2,727,261001,3,656
2012-06-26,fall,2012,June,9,Tuesday,Workingday,Clear,0.58,0.5455,0.46,0.4179,30,298,328,328,188,328,3,4,3,343,2,727,159438,3,328
2012-06-26,fall,2012,June,10,Tuesday,Workingday,Clear,0.62,0.6212,0.41,0.3582,37,153,190,190,188,190,3,3,3,333,2,727,126257,3,190
2012-06-26,fall,2012,June,11,Tuesday,Workingday,Clear,0.64,0.6212,0.36,0.4179,46,189,235,235,188,235,3,3,3,333,2,727,151320,3,235
2012-06-26,fall,2012,June,12,Tuesday,Workingday,Clear,0.66,0.6212,0.34,0.4478,80,228,308,308,188,308,3,4,3,343,2,728,184414,3,308
2012-06-26,fall,2012,June,13,Tuesday,Workingday,Clear,0.7,0.6364,0.3,0.4627,74,232,306,306,188,306,3,4,4,344,2,729,184919,3,306
2012-06-26,fall,2012,June,14,Tuesday,Workingday,Clear,0.7,0.6364,0.3,0.4627,81,186,267,267,188,267,3,3,4,334,2,729,175652,3,267
2012-06-26,fall,2012,June,15,Tuesday,Workingday,Clear,0.72,0.6515,0.28,0.4627,88,229,317,317,188,317,3,4,4,344,2,729,183149,3,317
2012-06-26,fall,2012,June,16,Tuesday,Workingday,Clear,0.72,0.6364,0.26,0.4925,67,349,416,416,188,416,3,4,4,344,2,730,227748,3,416
2012-06-26,fall,2012,June,17,Tuesday,Workingday,Clear,0.72,0.6515,0.28,0.4179,104,796,900,900,188,900,3,4,4,344,2,730,336860,3,900
2012-06-26,fall,2012,June,18,Tuesday,Workingday,Clear,0.72,0.6515,0.28,0.3582,105,719,824,824,188,824,3,4,4,344,2,728,309772,3,824
2012-06-26,fall,2012,June,19,Tuesday,Workingday,Clear,0.72,0.6515,0.28,0.2239,83,529,612,612,188,612,3,4,4,344,2,728,226789,3,612
2012-06-26,fall,2012,June,20,Tuesday,Workingday,Clear,0.7,0.6364,0.3,0.2836,88,417,505,505,188,505,3,4,4,344,2,728,164550,3,505
2012-06-26,fall,2012,June,21,Tuesday,Workingday,Clear,0.68,0.6364,0.34,0.194,61,267,328,328,188,328,3,4,4,344,2,728,125445,3,328
2012-06-26,fall,2012,June,22,Tuesday,Workingday,Clear,0.66,0.6212,0.34,0.2537,26,219,245,245,188,245,3,3,3,333,2,728,95612,3,245
2012-06-26,fall,2012,June,23,Tuesday,Workingday,Clear,0.62,0.6212,0.41,0.1343,13,118,131,131,188,131,3,2,3,323,0,728,63941,3,131
2012-06-27,fall,2012,June,0,Wednesday,Workingday,Clear,0.62,0.6212,0.41,0.194,15,39,54,54,187,54,3,2,3,323,0,726,39130,3,54
2012-06-27,fall,2012,June,1,Wednesday,Workingday,Clear,0.6,0.6212,0.43,0.1642,5,18,23,23,187,23,3,1,3,313,0,724,24164,3,23
2012-06-27,fall,2012,June,2,Wednesday,Workingday,Clear,0.56,0.5303,0.49,0.1343,2,12,14,14,187,14,3,1,3,313,0,715,16352,3,14
2012-06-27,fall,2012,June,3,Wednesday,Workingday,Clear,0.58,0.5455,0.46,0.0896,1,7,8,8,187,8,3,1,3,313,0,697,8174,3,8
2012-06-27,fall,2012,June,4,Wednesday,Workingday,Clear,0.6,0.6212,0.4,0.2537,0,11,11,11,187,11,3,1,3,313,0,697,4428,3,11
2012-06-27,fall,2012,June,5,Wednesday,Workingday,Clear,0.6,0.6212,0.43,0.2836,2,34,36,36,187,36,3,1,3,313,0,717,14261,3,36
2012-06-27,fall,2012,June,6,Wednesday,Workingday,Clear,0.58,0.5455,0.46,0.2836,7,193,200,200,187,200,3,3,3,333,2,725,55132,3,200
2012-06-27,fall,2012,June,7,Wednesday,Workingday,Clear,0.6,0.6212,0.43,0.3582,29,498,527,527,187,527,3,4,3,343,2,727,154171,3,527
2012-06-27,fall,2012,June,8,Wednesday,Workingday,Clear,0.62,0.6212,0.43,0.3284,49,638,687,687,187,687,3,4,3,343,2,727,261001,3,687
2012-06-27,fall,2012,June,9,Wednesday,Workingday,Clear,0.66,0.6212,0.41,0.3582,29,253,282,282,187,282,3,4,3,343,2,727,159438,3,282
2012-06-27,fall,2012,June,10,Wednesday,Workingday,Clear,0.7,0.6364,0.37,0.2537,34,138,172,172,187,172,3,3,4,334,2,727,126257,3,172
2012-06-27,fall,2012,June,11,Wednesday,Workingday,Clear,0.74,0.6515,0.3,0.3284,64,145,209,209,187,209,3,3,4,334,2,727,151320,3,209
2012-06-27,fall,2012,June,12,Wednesday,Workingday,Clear,0.76,0.6667,0.29,0.2985,77,245,322,322,187,322,3,4,4,344,2,728,184414,3,322
2012-06-27,fall,2012,June,13,Wednesday,Workingday,Clear,0.8,0.697,0.27,0.3284,77,244,321,321,187,321,3,4,4,344,2,729,184919,3,321
2012-06-27,fall,2012,June,14,Wednesday,Workingday,Clear,0.8,0.6818,0.24,0.3582,78,192,270,270,187,270,3,3,4,334,2,729,175652,3,270
2012-06-27,fall,2012,June,15,Wednesday,Workingday,Clear,0.8,0.697,0.26,0.4627,61,188,249,249,187,249,3,3,4,334,2,729,183149,3,249
2012-06-27,fall,2012,June,16,Wednesday,Workingday,Clear,0.82,0.697,0.24,0.4478,55,337,392,392,187,392,3,4,4,344,2,730,227748,3,392
2012-06-27,fall,2012,June,17,Wednesday,Workingday,Clear,0.82,0.697,0.24,0.3881,113,730,843,843,187,843,3,4,4,344,2,730,336860,3,843
2012-06-27,fall,2012,June,18,Wednesday,Workingday,Clear,0.8,0.697,0.27,0.3284,85,719,804,804,187,804,3,4,4,344,2,728,309772,3,804
2012-06-27,fall,2012,June,19,Wednesday,Workingday,Clear,0.78,0.6818,0.29,0.3284,101,542,643,643,187,643,3,4,4,344,2,728,226789,3,643
2012-06-27,fall,2012,June,20,Wednesday,Workingday,Clear,0.76,0.6667,0.31,0.194,76,369,445,445,187,445,3,4,4,344,2,728,164550,3,445
2012-06-27,fall,2012,June,21,Wednesday,Workingday,Clear,0.74,0.6515,0.35,0.1343,54,313,367,367,187,367,3,4,4,344,2,728,125445,3,367
2012-06-27,fall,2012,June,22,Wednesday,Workingday,Clear,0.72,0.6515,0.39,0.0896,52,245,297,297,187,297,3,4,4,344,2,728,95612,3,297
2012-06-27,fall,2012,June,23,Wednesday,Workingday,Clear,0.68,0.6364,0.47,0.1343,11,148,159,159,187,159,3,3,4,334,0,728,63941,3,159
2012-06-28,fall,2012,June,0,Thursday,Workingday,Clear,0.66,0.6212,0.5,0.1045,2,52,54,54,186,54,3,2,3,323,0,726,39130,3,54
2012-06-28,fall,2012,June,1,Thursday,Workingday,Clear,0.66,0.6212,0.54,0.0,11,14,25,25,186,25,3,1,3,313,0,724,24164,3,25
2012-06-28,fall,2012,June,2,Thursday,Workingday,Clear,0.66,0.6212,0.5,0.0896,1,12,13,13,186,13,3,1,3,313,0,715,16352,3,13
2012-06-28,fall,2012,June,3,Thursday,Workingday,Clear,0.66,0.6212,0.5,0.0896,1,6,7,7,186,7,3,1,3,313,0,697,8174,3,7
2012-06-28,fall,2012,June,4,Thursday,Workingday,Clear,0.62,0.6061,0.61,0.1045,0,11,11,11,186,11,3,1,3,313,0,697,4428,3,11
2012-06-28,fall,2012,June,5,Thursday,Workingday,Clear,0.62,0.6212,0.57,0.0896,8,39,47,47,186,47,3,2,3,323,0,717,14261,3,47
2012-06-28,fall,2012,June,6,Thursday,Workingday,Clear,0.62,0.6212,0.57,0.0896,8,185,193,193,186,193,3,3,3,333,0,725,55132,3,193
2012-06-28,fall,2012,June,7,Thursday,Workingday,Clear,0.62,0.6061,0.61,0.1045,24,484,508,508,186,508,3,4,3,343,2,727,154171,3,508
2012-06-28,fall,2012,June,8,Thursday,Workingday,Clear,0.66,0.6212,0.5,0.1343,40,577,617,617,186,617,3,4,3,343,2,727,261001,3,617
2012-06-28,fall,2012,June,9,Thursday,Workingday,Clear,0.7,0.6515,0.54,0.1642,33,318,351,351,186,351,3,4,4,344,2,727,159438,3,351
2012-06-28,fall,2012,June,10,Thursday,Workingday,Clear,0.74,0.6667,0.48,0.194,40,144,184,184,186,184,3,3,4,334,2,727,126257,3,184
2012-06-28,fall,2012,June,11,Thursday,Workingday,Clear,0.8,0.697,0.31,0.194,41,170,211,211,186,211,3,3,4,334,2,727,151320,3,211
2012-06-28,fall,2012,June,12,Thursday,Workingday,Clear,0.84,0.7121,0.26,0.2836,49,227,276,276,186,276,3,3,4,334,2,728,184414,3,276
2012-06-28,fall,2012,June,13,Thursday,Workingday,Clear,0.86,0.7424,0.26,0.2239,31,205,236,236,186,236,3,3,4,334,2,729,184919,3,236
2012-06-28,fall,2012,June,14,Thursday,Workingday,Clear,0.86,0.7273,0.25,0.3284,66,188,254,254,186,254,3,3,4,334,2,729,175652,3,254
2012-06-28,fall,2012,June,15,Thursday,Workingday,Clear,0.86,0.7273,0.25,0.3284,24,195,219,219,186,219,3,3,4,334,2,729,183149,3,219
2012-06-28,fall,2012,June,16,Thursday,Workingday,Clear,0.88,0.7424,0.23,0.194,56,331,387,387,186,387,3,4,4,344,2,730,227748,3,387
2012-06-28,fall,2012,June,17,Thursday,Workingday,Clear,0.88,0.7424,0.22,0.194,71,634,705,705,186,705,3,4,4,344,2,730,336860,3,705
2012-06-28,fall,2012,June,18,Thursday,Workingday,Clear,0.86,0.7273,0.25,0.2239,100,597,697,697,186,697,3,4,4,344,2,728,309772,3,697
2012-06-28,fall,2012,June,19,Thursday,Workingday,Clear,0.84,0.7273,0.3,0.2985,79,492,571,571,186,571,3,4,4,344,2,728,226789,3,571
2012-06-28,fall,2012,June,20,Thursday,Workingday,Clear,0.82,0.7273,0.34,0.194,71,399,470,470,186,470,3,4,4,344,2,728,164550,3,470
2012-06-28,fall,2012,June,21,Thursday,Workingday,Clear,0.76,0.697,0.55,0.194,89,309,398,398,186,398,3,4,4,344,2,728,125445,3,398
2012-06-28,fall,2012,June,22,Thursday,Workingday,Clear,0.76,0.697,0.52,0.1642,50,224,274,274,186,274,3,3,4,334,2,728,95612,3,274
2012-06-28,fall,2012,June,23,Thursday,Workingday,Clear,0.74,0.6667,0.48,0.1343,26,145,171,171,186,171,3,3,4,334,2,728,63941,3,171
2012-06-29,fall,2012,June,0,Friday,Workingday,Clear,0.74,0.6667,0.48,0.1343,24,90,114,114,185,114,3,2,4,324,0,726,39130,3,114
2012-06-29,fall,2012,June,1,Friday,Workingday,Clear,0.74,0.6667,0.51,0.1642,9,33,42,42,185,42,3,2,4,324,0,724,24164,3,42
2012-06-29,fall,2012,June,2,Friday,Workingday,Clear,0.72,0.6667,0.58,0.194,3,15,18,18,185,18,3,1,4,314,0,715,16352,3,18
2012-06-29,fall,2012,June,3,Friday,Workingday,Clear,0.72,0.6667,0.58,0.194,3,5,8,8,185,8,3,1,4,314,0,697,8174,3,8
2012-06-29,fall,2012,June,4,Friday,Workingday,Clear,0.7,0.6515,0.65,0.1642,1,9,10,10,185,10,3,1,4,314,0,697,4428,3,10
2012-06-29,fall,2012,June,5,Friday,Workingday,Clear,0.7,0.6515,0.61,0.1045,6,39,45,45,185,45,3,2,4,324,0,717,14261,3,45
2012-06-29,fall,2012,June,6,Friday,Workingday,Mist,0.7,0.6515,0.61,0.1642,15,148,163,163,185,163,3,3,4,334,0,725,55132,3,163
2012-06-29,fall,2012,June,7,Friday,Workingday,Clear,0.7,0.6515,0.61,0.1045,19,361,380,380,185,380,3,4,4,344,2,727,154171,3,380
2012-06-29,fall,2012,June,8,Friday,Workingday,Mist,0.74,0.6818,0.55,0.1045,48,576,624,624,185,624,3,4,4,344,2,727,261001,3,624
2012-06-29,fall,2012,June,9,Friday,Workingday,Clear,0.76,0.697,0.55,0.1642,39,261,300,300,185,300,3,4,4,344,2,727,159438,3,300
2012-06-29,fall,2012,June,10,Friday,Workingday,Clear,0.9,0.8333,0.39,0.2985,32,139,171,171,185,171,3,3,4,334,2,727,126257,3,171
2012-06-29,fall,2012,June,11,Friday,Workingday,Mist,0.9,0.8485,0.42,0.2836,51,137,188,188,185,188,3,3,4,334,2,727,151320,3,188
2012-06-29,fall,2012,June,12,Friday,Workingday,Mist,0.92,0.8788,0.4,0.2537,53,173,226,226,185,226,3,3,4,334,2,728,184414,3,226
2012-06-29,fall,2012,June,13,Friday,Workingday,Clear,0.94,0.8788,0.38,0.194,45,194,239,239,185,239,3,3,4,334,2,729,184919,3,239
2012-06-29,fall,2012,June,14,Friday,Workingday,Clear,0.96,0.9091,0.36,0.2239,49,184,233,233,185,233,3,3,4,334,2,729,175652,3,233
2012-06-29,fall,2012,June,15,Friday,Workingday,Clear,0.96,0.9091,0.36,0.0,47,183,230,230,185,230,3,3,4,334,2,729,183149,3,230
2012-06-29,fall,2012,June,16,Friday,Workingday,Clear,0.96,0.9091,0.36,0.0,59,292,351,351,185,351,3,4,4,344,2,730,227748,3,351
2012-06-29,fall,2012,June,17,Friday,Workingday,Clear,0.98,0.9242,0.34,0.194,82,457,539,539,185,539,3,4,4,344,2,730,336860,3,539
2012-06-29,fall,2012,June,18,Friday,Workingday,Clear,0.96,0.8636,0.31,0.0,50,414,464,464,185,464,3,4,4,344,2,728,309772,3,464
2012-06-29,fall,2012,June,19,Friday,Workingday,Clear,0.9,0.8788,0.47,0.194,60,303,363,363,185,363,3,4,4,344,2,728,226789,3,363
2012-06-29,fall,2012,June,20,Friday,Workingday,Clear,0.92,0.8939,0.42,0.2537,53,255,308,308,185,308,3,4,4,344,2,728,164550,3,308
2012-06-29,fall,2012,June,21,Friday,Workingday,Mist,0.86,0.8333,0.53,0.194,41,195,236,236,185,236,3,3,4,334,2,728,125445,3,236
2012-06-29,fall,2012,June,22,Friday,Workingday,Light Snow,0.82,0.8333,0.63,0.194,34,129,163,163,185,163,3,3,4,334,2,728,95612,3,163
2012-06-29,fall,2012,June,23,Friday,Workingday,Light Snow,0.82,0.8333,0.63,0.194,6,42,48,48,185,48,3,2,4,324,0,728,63941,3,48
2012-06-30,fall,2012,June,0,Saturday,Holiday,Light Snow,0.64,0.5758,0.89,0.1642,4,65,69,69,184,69,3,2,3,323,0,726,39130,3,69
2012-06-30,fall,2012,June,1,Saturday,Holiday,Light Snow,0.64,0.5758,0.89,0.2239,3,55,58,58,184,58,3,2,3,323,0,724,24164,3,58
2012-06-30,fall,2012,June,2,Saturday,Holiday,Mist,0.64,0.5758,0.89,0.0,7,54,61,61,184,61,3,2,3,323,0,715,16352,3,61
2012-06-30,fall,2012,June,3,Saturday,Holiday,Mist,0.64,0.5758,0.89,0.0,3,20,23,23,184,23,3,1,3,313,0,697,8174,3,23
2012-06-30,fall,2012,June,4,Saturday,Holiday,Mist,0.62,0.5455,0.94,0.0,3,15,18,18,184,18,3,1,3,313,0,697,4428,3,18
2012-06-30,fall,2012,June,5,Saturday,Holiday,Clear,0.64,0.5758,0.89,0.1642,3,7,10,10,184,10,3,1,3,313,0,717,14261,3,10
2012-06-30,fall,2012,June,6,Saturday,Holiday,Clear,0.64,0.5758,0.89,0.1642,6,36,42,42,184,42,3,2,3,323,0,725,55132,3,42
2012-06-30,fall,2012,June,7,Saturday,Holiday,Clear,0.64,0.5758,0.89,0.1642,10,82,92,92,184,92,3,2,3,323,0,727,154171,3,92
2012-06-30,fall,2012,June,8,Saturday,Holiday,Clear,0.64,0.5758,0.89,0.1642,26,168,194,194,184,194,3,3,3,333,0,727,261001,3,194
2012-06-30,fall,2012,June,9,Saturday,Holiday,Clear,0.64,0.5758,0.89,0.1642,41,234,275,275,184,275,3,3,3,333,0,727,159438,3,275
2012-06-30,fall,2012,June,10,Saturday,Holiday,Clear,0.88,0.7727,0.3,0.2537,96,308,404,404,184,404,3,4,4,344,2,727,126257,3,404
2012-06-30,fall,2012,June,11,Saturday,Holiday,Clear,0.88,0.7727,0.3,0.2537,102,350,452,452,184,452,3,4,4,344,2,727,151320,3,452
2012-06-30,fall,2012,June,12,Saturday,Holiday,Clear,0.88,0.7727,0.3,0.2537,143,328,471,471,184,471,3,4,4,344,2,728,184414,3,471
2012-06-30,fall,2012,June,13,Saturday,Holiday,Clear,0.88,0.7727,0.3,0.2537,105,323,428,428,184,428,3,4,4,344,2,729,184919,3,428
2012-06-30,fall,2012,June,14,Saturday,Holiday,Clear,0.88,0.7727,0.3,0.2537,114,295,409,409,184,409,3,4,4,344,2,729,175652,3,409
2012-06-30,fall,2012,June,15,Saturday,Holiday,Clear,0.88,0.7727,0.3,0.2537,117,287,404,404,184,404,3,4,4,344,2,729,183149,3,404
2012-06-30,fall,2012,June,16,Saturday,Holiday,Clear,0.9,0.7879,0.29,0.1642,109,264,373,373,184,373,3,4,4,344,2,730,227748,3,373
2012-06-30,fall,2012,June,17,Saturday,Holiday,Clear,0.88,0.7727,0.32,0.1343,131,231,362,362,184,362,3,4,4,344,2,730,336860,3,362
2012-06-30,fall,2012,June,18,Saturday,Holiday,Clear,0.88,0.7879,0.35,0.0,91,248,339,339,184,339,3,4,4,344,2,728,309772,3,339
2012-06-30,fall,2012,June,19,Saturday,Holiday,Clear,0.84,0.7576,0.44,0.2537,134,240,374,374,184,374,3,4,4,344,2,728,226789,3,374
2012-06-30,fall,2012,June,20,Saturday,Holiday,Clear,0.82,0.7727,0.52,0.1642,88,204,292,292,184,292,3,4,4,344,2,728,164550,3,292
2012-06-30,fall,2012,June,21,Saturday,Holiday,Clear,0.82,0.7727,0.52,0.1642,48,165,213,213,184,213,3,3,4,334,2,728,125445,3,213
2012-06-30,fall,2012,June,22,Saturday,Holiday,Clear,0.78,0.7424,0.62,0.1642,38,134,172,172,184,172,3,3,4,334,0,728,95612,3,172
2012-06-30,fall,2012,June,23,Saturday,Holiday,Clear,0.78,0.7424,0.62,0.0896,33,119,152,152,184,152,3,3,4,334,0,728,63941,3,152
2012-07-01,fall,2012,July,0,Sunday,Holiday,Clear,0.76,0.7273,0.66,0.0,27,122,149,149,183,149,3,3,4,334,0,726,39130,3,149
2012-07-01,fall,2012,July,1,Sunday,Holiday,Clear,0.74,0.697,0.7,0.1343,12,81,93,93,183,93,3,2,4,324,0,724,24164,3,93
2012-07-01,fall,2012,July,2,Sunday,Holiday,Clear,0.72,0.697,0.74,0.0896,21,69,90,90,183,90,3,2,4,324,0,715,16352,3,90
2012-07-01,fall,2012,July,3,Sunday,Holiday,Clear,0.72,0.7121,0.84,0.1343,6,27,33,33,183,33,3,1,4,314,0,697,8174,3,33
2012-07-01,fall,2012,July,4,Sunday,Holiday,Clear,0.7,0.6667,0.79,0.194,0,4,4,4,183,4,3,1,4,314,0,697,4428,3,4
2012-07-01,fall,2012,July,5,Sunday,Holiday,Clear,0.68,0.6364,0.79,0.1045,3,7,10,10,183,10,3,1,4,314,0,717,14261,3,10
2012-07-01,fall,2012,July,6,Sunday,Holiday,Clear,0.7,0.6667,0.79,0.0896,8,19,27,27,183,27,3,1,4,314,0,725,55132,3,27
2012-07-01,fall,2012,July,7,Sunday,Holiday,Clear,0.74,0.697,0.7,0.0,13,37,50,50,183,50,3,2,4,324,0,727,154171,3,50
2012-07-01,fall,2012,July,8,Sunday,Holiday,Clear,0.78,0.7424,0.62,0.1045,36,106,142,142,183,142,3,2,4,324,0,727,261001,3,142
2012-07-01,fall,2012,July,9,Sunday,Holiday,Clear,0.82,0.7879,0.56,0.0,51,168,219,219,183,219,3,3,4,334,2,727,159438,3,219
2012-07-01,fall,2012,July,10,Sunday,Holiday,Clear,0.86,0.7879,0.44,0.2985,98,268,366,366,183,366,3,4,4,344,2,727,126257,3,366
2012-07-01,fall,2012,July,11,Sunday,Holiday,Clear,0.88,0.803,0.39,0.2239,121,256,377,377,183,377,3,4,4,344,2,727,151320,3,377
2012-07-01,fall,2012,July,12,Sunday,Holiday,Clear,0.9,0.8182,0.37,0.2239,114,319,433,433,183,433,3,4,4,344,2,728,184414,3,433
2012-07-01,fall,2012,July,13,Sunday,Holiday,Clear,0.92,0.8333,0.33,0.2537,111,309,420,420,183,420,3,4,4,344,2,729,184919,3,420
2012-07-01,fall,2012,July,14,Sunday,Holiday,Clear,0.92,0.8333,0.33,0.2537,98,346,444,444,183,444,3,4,4,344,2,729,175652,3,444
2012-07-01,fall,2012,July,15,Sunday,Holiday,Clear,0.9,0.8182,0.37,0.2836,101,244,345,345,183,345,3,4,4,344,2,729,183149,3,345
2012-07-01,fall,2012,July,16,Sunday,Holiday,Clear,0.92,0.8333,0.33,0.2985,85,228,313,313,183,313,3,4,4,344,2,730,227748,3,313
2012-07-01,fall,2012,July,17,Sunday,Holiday,Clear,0.92,0.803,0.26,0.2985,90,323,413,413,183,413,3,4,4,344,2,730,336860,3,413
2012-07-01,fall,2012,July,18,Sunday,Holiday,Clear,0.88,0.7727,0.32,0.3582,95,275,370,370,183,370,3,4,4,344,2,728,309772,3,370
2012-07-01,fall,2012,July,19,Sunday,Holiday,Clear,0.84,0.7424,0.39,0.1343,103,279,382,382,183,382,3,4,4,344,2,728,226789,3,382
2012-07-01,fall,2012,July,20,Sunday,Holiday,Clear,0.84,0.7424,0.39,0.1343,88,244,332,332,183,332,3,4,4,344,2,728,164550,3,332
2012-07-01,fall,2012,July,21,Sunday,Holiday,Clear,0.84,0.7424,0.39,0.1343,77,181,258,258,183,258,3,3,4,334,2,728,125445,3,258
2012-07-01,fall,2012,July,22,Sunday,Holiday,Clear,0.82,0.7424,0.43,0.1343,41,110,151,151,183,151,3,3,4,334,2,728,95612,3,151
2012-07-01,fall,2012,July,23,Sunday,Holiday,Light Snow,0.78,0.7121,0.52,0.1642,22,88,110,110,183,110,3,2,4,324,0,728,63941,3,110
2012-07-02,fall,2012,July,0,Monday,Workingday,Mist,0.76,0.7121,0.58,0.2239,12,31,43,43,182,43,4,2,4,424,0,726,39130,4,43
2012-07-02,fall,2012,July,1,Monday,Workingday,Mist,0.76,0.7121,0.58,0.194,3,14,17,17,182,17,4,1,4,414,0,724,24164,4,17
2012-07-02,fall,2012,July,2,Monday,Workingday,Mist,0.74,0.6667,0.51,0.2537,1,14,15,15,182,15,4,1,4,414,0,715,16352,4,15
2012-07-02,fall,2012,July,3,Monday,Workingday,Mist,0.72,0.6667,0.54,0.4179,0,5,5,5,182,5,4,1,4,414,0,697,8174,4,5
2012-07-02,fall,2012,July,4,Monday,Workingday,Mist,0.72,0.6667,0.54,0.2985,2,10,12,12,182,12,4,1,4,414,0,697,4428,4,12
2012-07-02,fall,2012,July,5,Monday,Workingday,Mist,0.72,0.6667,0.51,0.0,3,37,40,40,182,40,4,1,4,414,0,717,14261,4,40
2012-07-02,fall,2012,July,6,Monday,Workingday,Clear,0.7,0.6515,0.58,0.1045,4,132,136,136,182,136,4,2,4,424,0,725,55132,4,136
2012-07-02,fall,2012,July,7,Monday,Workingday,Clear,0.74,0.6667,0.51,0.1045,8,390,398,398,182,398,4,4,4,444,2,727,154171,4,398
2012-07-02,fall,2012,July,8,Monday,Workingday,Clear,0.76,0.697,0.52,0.194,20,548,568,568,182,568,4,4,4,444,2,727,261001,4,568
2012-07-02,fall,2012,July,9,Monday,Workingday,Clear,0.78,0.697,0.46,0.2537,56,239,295,295,182,295,4,4,4,444,2,727,159438,4,295
2012-07-02,fall,2012,July,10,Monday,Workingday,Clear,0.8,0.7273,0.43,0.2537,70,104,174,174,182,174,4,3,4,434,2,727,126257,4,174
2012-07-02,fall,2012,July,11,Monday,Workingday,Clear,0.84,0.7273,0.28,0.2985,67,134,201,201,182,201,4,3,4,434,2,727,151320,4,201
2012-07-02,fall,2012,July,12,Monday,Workingday,Clear,0.84,0.7273,0.32,0.194,74,183,257,257,182,257,4,3,4,434,2,728,184414,4,257
2012-07-02,fall,2012,July,13,Monday,Workingday,Clear,0.86,0.7576,0.34,0.2239,74,162,236,236,182,236,4,3,4,434,2,729,184919,4,236
2012-07-02,fall,2012,July,14,Monday,Workingday,Clear,0.86,0.7576,0.34,0.2239,79,151,230,230,182,230,4,3,4,434,2,729,175652,4,230
2012-07-02,fall,2012,July,15,Monday,Workingday,Clear,0.84,0.7424,0.36,0.194,59,175,234,234,182,234,4,3,4,434,2,729,183149,4,234
2012-07-02,fall,2012,July,16,Monday,Workingday,Clear,0.84,0.7424,0.36,0.2836,61,304,365,365,182,365,4,4,4,444,2,730,227748,4,365
2012-07-02,fall,2012,July,17,Monday,Workingday,Clear,0.84,0.7273,0.32,0.1343,82,665,747,747,182,747,4,4,4,444,2,730,336860,4,747
2012-07-02,fall,2012,July,18,Monday,Workingday,Clear,0.84,0.7273,0.32,0.1642,72,658,730,730,182,730,4,4,4,444,2,728,309772,4,730
2012-07-02,fall,2012,July,19,Monday,Workingday,Clear,0.78,0.697,0.43,0.1343,71,510,581,581,182,581,4,4,4,444,2,728,226789,4,581
2012-07-02,fall,2012,July,20,Monday,Workingday,Clear,0.78,0.697,0.43,0.1343,38,357,395,395,182,395,4,4,4,444,2,728,164550,4,395
2012-07-02,fall,2012,July,21,Monday,Workingday,Clear,0.76,0.6818,0.45,0.1343,17,241,258,258,182,258,4,3,4,434,2,728,125445,4,258
2012-07-02,fall,2012,July,22,Monday,Workingday,Clear,0.74,0.6667,0.51,0.1642,19,169,188,188,182,188,4,3,4,434,2,728,95612,4,188
2012-07-02,fall,2012,July,23,Monday,Workingday,Clear,0.74,0.6667,0.51,0.1045,12,90,102,102,182,102,4,2,4,424,0,728,63941,4,102
2012-07-03,fall,2012,July,0,Tuesday,Workingday,Clear,0.72,0.6667,0.54,0.0,9,44,53,53,181,53,4,2,4,424,0,726,39130,4,53
2012-07-03,fall,2012,July,1,Tuesday,Workingday,Clear,0.72,0.6667,0.58,0.0,5,9,14,14,181,14,4,1,4,414,0,724,24164,4,14
2012-07-03,fall,2012,July,2,Tuesday,Workingday,Clear,0.72,0.6667,0.58,0.0,2,8,10,10,181,10,4,1,4,414,0,715,16352,4,10
2012-07-03,fall,2012,July,3,Tuesday,Workingday,Clear,0.7,0.6515,0.65,0.1343,0,2,2,2,181,2,4,1,4,414,0,697,8174,4,2
2012-07-03,fall,2012,July,4,Tuesday,Workingday,Clear,0.68,0.6364,0.65,0.1045,0,6,6,6,181,6,4,1,4,414,0,697,4428,4,6
2012-07-03,fall,2012,July,5,Tuesday,Workingday,Clear,0.7,0.6515,0.61,0.0,2,33,35,35,181,35,4,1,4,414,0,717,14261,4,35
2012-07-03,fall,2012,July,6,Tuesday,Workingday,Clear,0.7,0.6515,0.65,0.1343,5,149,154,154,181,154,4,3,4,434,0,725,55132,4,154
2012-07-03,fall,2012,July,7,Tuesday,Workingday,Clear,0.74,0.6818,0.58,0.0,21,462,483,483,181,483,4,4,4,444,2,727,154171,4,483
2012-07-03,fall,2012,July,8,Tuesday,Workingday,Clear,0.74,0.6818,0.62,0.0896,42,604,646,646,181,646,4,4,4,444,2,727,261001,4,646
2012-07-03,fall,2012,July,9,Tuesday,Workingday,Clear,0.8,0.7424,0.49,0.1642,46,226,272,272,181,272,4,3,4,434,2,727,159438,4,272
2012-07-03,fall,2012,July,10,Tuesday,Workingday,Clear,0.82,0.7424,0.43,0.2239,56,153,209,209,181,209,4,3,4,434,2,727,126257,4,209
2012-07-03,fall,2012,July,11,Tuesday,Workingday,Clear,0.86,0.7576,0.34,0.194,66,151,217,217,181,217,4,3,4,434,2,727,151320,4,217
2012-07-03,fall,2012,July,12,Tuesday,Workingday,Clear,0.88,0.7576,0.28,0.194,74,198,272,272,181,272,4,3,4,434,2,728,184414,4,272
2012-07-03,fall,2012,July,13,Tuesday,Workingday,Clear,0.9,0.7727,0.25,0.1343,80,203,283,283,181,283,4,4,4,444,2,729,184919,4,283
2012-07-03,fall,2012,July,14,Tuesday,Workingday,Clear,0.9,0.7727,0.25,0.194,69,241,310,310,181,310,4,4,4,444,2,729,175652,4,310
2012-07-03,fall,2012,July,15,Tuesday,Workingday,Mist,0.9,0.7727,0.24,0.0,71,330,401,401,181,401,4,4,4,444,2,729,183149,4,401
2012-07-03,fall,2012,July,16,Tuesday,Workingday,Mist,0.9,0.7727,0.24,0.194,90,437,527,527,181,527,4,4,4,444,2,730,227748,4,527
2012-07-03,fall,2012,July,17,Tuesday,Workingday,Mist,0.86,0.7424,0.3,0.1642,102,620,722,722,181,722,4,4,4,444,2,730,336860,4,722
2012-07-03,fall,2012,July,18,Tuesday,Workingday,Mist,0.86,0.7424,0.3,0.0,85,542,627,627,181,627,4,4,4,444,2,728,309772,4,627
2012-07-03,fall,2012,July,19,Tuesday,Workingday,Mist,0.84,0.7424,0.36,0.1343,66,431,497,497,181,497,4,4,4,444,2,728,226789,4,497
2012-07-03,fall,2012,July,20,Tuesday,Workingday,Light Snow,0.76,0.697,0.55,0.4925,80,296,376,376,181,376,4,4,4,444,2,728,164550,4,376
2012-07-03,fall,2012,July,21,Tuesday,Workingday,Mist,0.7,0.6515,0.7,0.2836,36,160,196,196,181,196,4,3,4,434,0,728,125445,4,196
2012-07-03,fall,2012,July,22,Tuesday,Workingday,Clear,0.68,0.6364,0.79,0.194,26,151,177,177,181,177,4,3,4,434,0,728,95612,4,177
2012-07-03,fall,2012,July,23,Tuesday,Workingday,Clear,0.66,0.6061,0.83,0.0,19,152,171,171,181,171,4,3,3,433,0,728,63941,4,171
2012-07-04,fall,2012,July,0,Wednesday,Holiday,Clear,0.68,0.6364,0.79,0.0896,19,140,159,159,180,159,4,3,4,434,0,726,39130,4,159
2012-07-04,fall,2012,July,1,Wednesday,Holiday,Clear,0.68,0.6364,0.74,0.0,27,96,123,123,180,123,4,2,4,424,0,724,24164,4,123
2012-07-04,fall,2012,July,2,Wednesday,Holiday,Clear,0.66,0.6061,0.83,0.1343,27,66,93,93,180,93,4,2,3,423,0,715,16352,4,93
2012-07-04,fall,2012,July,3,Wednesday,Holiday,Clear,0.68,0.6364,0.74,0.194,9,23,32,32,180,32,4,1,4,414,0,697,8174,4,32
2012-07-04,fall,2012,July,4,Wednesday,Holiday,Clear,0.68,0.6364,0.69,0.2537,5,11,16,16,180,16,4,1,4,414,0,697,4428,4,16
2012-07-04,fall,2012,July,5,Wednesday,Holiday,Clear,0.66,0.6212,0.69,0.0,5,14,19,19,180,19,4,1,3,413,0,717,14261,4,19
2012-07-04,fall,2012,July,6,Wednesday,Holiday,Clear,0.66,0.6212,0.69,0.0,9,23,32,32,180,32,4,1,3,413,0,725,55132,4,32
2012-07-04,fall,2012,July,7,Wednesday,Holiday,Clear,0.68,0.6364,0.65,0.0,10,62,72,72,180,72,4,2,4,424,0,727,154171,4,72
2012-07-04,fall,2012,July,8,Wednesday,Holiday,Clear,0.7,0.6515,0.61,0.1045,43,110,153,153,180,153,4,3,4,434,0,727,261001,4,153
2012-07-04,fall,2012,July,9,Wednesday,Holiday,Clear,0.76,0.697,0.52,0.0,90,203,293,293,180,293,4,4,4,444,2,727,159438,4,293
2012-07-04,fall,2012,July,10,Wednesday,Holiday,Clear,0.8,0.7273,0.46,0.0,143,304,447,447,180,447,4,4,4,444,2,727,126257,4,447
2012-07-04,fall,2012,July,11,Wednesday,Holiday,Clear,0.82,0.7576,0.46,0.1343,164,321,485,485,180,485,4,4,4,444,2,727,151320,4,485
2012-07-04,fall,2012,July,12,Wednesday,Holiday,Clear,0.86,0.7879,0.41,0.2239,164,330,494,494,180,494,4,4,4,444,2,728,184414,4,494
2012-07-04,fall,2012,July,13,Wednesday,Holiday,Clear,0.9,0.8182,0.35,0.0,177,322,499,499,180,499,4,4,4,444,2,729,184919,4,499
2012-07-04,fall,2012,July,14,Wednesday,Holiday,Clear,0.9,0.8182,0.37,0.1642,190,357,547,547,180,547,4,4,4,444,2,729,175652,4,547
2012-07-04,fall,2012,July,15,Wednesday,Holiday,Clear,0.92,0.8485,0.35,0.2985,155,299,454,454,180,454,4,4,4,444,2,729,183149,4,454
2012-07-04,fall,2012,July,16,Wednesday,Holiday,Clear,0.92,0.8485,0.35,0.2537,163,226,389,389,180,389,4,4,4,444,2,730,227748,4,389
2012-07-04,fall,2012,July,17,Wednesday,Holiday,Clear,0.92,0.8485,0.35,0.2985,161,253,414,414,180,414,4,4,4,444,2,730,336860,4,414
2012-07-04,fall,2012,July,18,Wednesday,Holiday,Clear,0.9,0.8485,0.42,0.194,159,271,430,430,180,430,4,4,4,444,2,728,309772,4,430
2012-07-04,fall,2012,July,19,Wednesday,Holiday,Clear,0.86,0.803,0.47,0.2239,177,255,432,432,180,432,4,4,4,444,2,728,226789,4,432
2012-07-04,fall,2012,July,20,Wednesday,Holiday,Clear,0.86,0.803,0.47,0.2239,237,314,551,551,180,551,4,4,4,444,2,728,164550,4,551
2012-07-04,fall,2012,July,21,Wednesday,Holiday,Clear,0.84,0.803,0.53,0.1343,222,362,584,584,180,584,4,4,4,444,2,728,125445,4,584
2012-07-04,fall,2012,July,22,Wednesday,Holiday,Clear,0.82,0.7879,0.56,0.2239,175,327,502,502,180,502,4,4,4,444,2,728,95612,4,502
2012-07-04,fall,2012,July,23,Wednesday,Holiday,Mist,0.78,0.697,0.43,0.0896,31,152,183,183,180,183,4,3,4,434,2,728,63941,4,183
2012-07-05,fall,2012,July,0,Thursday,Workingday,Clear,0.74,0.6667,0.51,0.1045,17,71,88,88,179,88,4,2,4,424,0,726,39130,4,88
2012-07-05,fall,2012,July,1,Thursday,Workingday,Clear,0.74,0.6667,0.51,0.2836,6,24,30,30,179,30,4,1,4,414,0,724,24164,4,30
2012-07-05,fall,2012,July,2,Thursday,Workingday,Clear,0.74,0.6667,0.51,0.0,4,14,18,18,179,18,4,1,4,414,0,715,16352,4,18
2012-07-05,fall,2012,July,3,Thursday,Workingday,Clear,0.72,0.6667,0.54,0.194,2,5,7,7,179,7,4,1,4,414,0,697,8174,4,7
2012-07-05,fall,2012,July,4,Thursday,Workingday,Clear,0.72,0.6667,0.58,0.0,0,7,7,7,179,7,4,1,4,414,0,697,4428,4,7
2012-07-05,fall,2012,July,5,Thursday,Workingday,Clear,0.72,0.6818,0.62,0.0,1,28,29,29,179,29,4,1,4,414,0,717,14261,4,29
2012-07-05,fall,2012,July,6,Thursday,Workingday,Clear,0.72,0.6667,0.58,0.0,3,130,133,133,179,133,4,2,4,424,0,725,55132,4,133
2012-07-05,fall,2012,July,7,Thursday,Workingday,Clear,0.76,0.697,0.55,0.0,27,316,343,343,179,343,4,4,4,444,2,727,154171,4,343
2012-07-05,fall,2012,July,8,Thursday,Workingday,Clear,0.8,0.7424,0.49,0.1343,36,514,550,550,179,550,4,4,4,444,2,727,261001,4,550
2012-07-05,fall,2012,July,9,Thursday,Workingday,Clear,0.84,0.7879,0.49,0.2985,47,246,293,293,179,293,4,4,4,444,2,727,159438,4,293
2012-07-05,fall,2012,July,10,Thursday,Workingday,Clear,0.86,0.7879,0.44,0.3582,69,117,186,186,179,186,4,3,4,434,2,727,126257,4,186
2012-07-05,fall,2012,July,11,Thursday,Workingday,Clear,0.9,0.8182,0.35,0.2985,107,137,244,244,179,244,4,3,4,434,2,727,151320,4,244
2012-07-05,fall,2012,July,12,Thursday,Workingday,Clear,0.9,0.8182,0.35,0.3582,88,188,276,276,179,276,4,3,4,434,2,728,184414,4,276
2012-07-05,fall,2012,July,13,Thursday,Workingday,Clear,0.92,0.8333,0.33,0.2239,129,181,310,310,179,310,4,4,4,444,2,729,184919,4,310
2012-07-05,fall,2012,July,14,Thursday,Workingday,Clear,0.92,0.8333,0.33,0.3284,87,154,241,241,179,241,4,3,4,434,2,729,175652,4,241
2012-07-05,fall,2012,July,15,Thursday,Workingday,Clear,0.92,0.8333,0.33,0.3582,71,183,254,254,179,254,4,3,4,434,2,729,183149,4,254
2012-07-05,fall,2012,July,16,Thursday,Workingday,Clear,0.92,0.8333,0.33,0.2537,109,324,433,433,179,433,4,4,4,444,2,730,227748,4,433
2012-07-05,fall,2012,July,17,Thursday,Workingday,Clear,0.92,0.8485,0.35,0.1642,114,575,689,689,179,689,4,4,4,444,2,730,336860,4,689
2012-07-05,fall,2012,July,18,Thursday,Workingday,Mist,0.9,0.8333,0.39,0.3284,96,511,607,607,179,607,4,4,4,444,2,728,309772,4,607
2012-07-05,fall,2012,July,19,Thursday,Workingday,Mist,0.88,0.803,0.39,0.2537,128,375,503,503,179,503,4,4,4,444,2,728,226789,4,503
2012-07-05,fall,2012,July,20,Thursday,Workingday,Mist,0.86,0.7879,0.41,0.2239,78,243,321,321,179,321,4,4,4,444,2,728,164550,4,321
2012-07-05,fall,2012,July,21,Thursday,Workingday,Clear,0.84,0.7727,0.47,0.194,91,232,323,323,179,323,4,4,4,444,2,728,125445,4,323
2012-07-05,fall,2012,July,22,Thursday,Workingday,Clear,0.82,0.803,0.59,0.1343,63,162,225,225,179,225,4,3,4,434,2,728,95612,4,225
2012-07-05,fall,2012,July,23,Thursday,Workingday,Clear,0.8,0.7576,0.55,0.1642,32,99,131,131,179,131,4,2,4,424,2,728,63941,4,131
2012-07-06,fall,2012,July,0,Friday,Workingday,Clear,0.78,0.7424,0.62,0.1343,39,63,102,102,178,102,4,2,4,424,0,726,39130,4,102
2012-07-06,fall,2012,July,1,Friday,Workingday,Clear,0.78,0.7273,0.55,0.2239,7,22,29,29,178,29,4,1,4,414,0,724,24164,4,29
2012-07-06,fall,2012,July,2,Friday,Workingday,Clear,0.76,0.7121,0.62,0.1343,4,13,17,17,178,17,4,1,4,414,0,715,16352,4,17
2012-07-06,fall,2012,July,3,Friday,Workingday,Mist,0.74,0.697,0.7,0.194,1,6,7,7,178,7,4,1,4,414,0,697,8174,4,7
2012-07-06,fall,2012,July,4,Friday,Workingday,Clear,0.74,0.697,0.66,0.2239,2,4,6,6,178,6,4,1,4,414,0,697,4428,4,6
2012-07-06,fall,2012,July,5,Friday,Workingday,Clear,0.74,0.697,0.66,0.194,4,31,35,35,178,35,4,1,4,414,0,717,14261,4,35
2012-07-06,fall,2012,July,6,Friday,Workingday,Clear,0.74,0.697,0.66,0.194,4,127,131,131,178,131,4,2,4,424,0,725,55132,4,131
2012-07-06,fall,2012,July,7,Friday,Workingday,Clear,0.78,0.697,0.46,0.1343,20,333,353,353,178,353,4,4,4,444,2,727,154171,4,353
2012-07-06,fall,2012,July,8,Friday,Workingday,Clear,0.8,0.7121,0.41,0.1642,28,557,585,585,178,585,4,4,4,444,2,727,261001,4,585
2012-07-06,fall,2012,July,9,Friday,Workingday,Clear,0.82,0.7273,0.36,0.1343,55,249,304,304,178,304,4,4,4,444,2,727,159438,4,304
2012-07-06,fall,2012,July,10,Friday,Workingday,Clear,0.86,0.7424,0.3,0.0,80,130,210,210,178,210,4,3,4,434,2,727,126257,4,210
2012-07-06,fall,2012,July,11,Friday,Workingday,Clear,0.84,0.7273,0.32,0.0896,92,141,233,233,178,233,4,3,4,434,2,727,151320,4,233
2012-07-06,fall,2012,July,12,Friday,Workingday,Clear,0.88,0.7576,0.28,0.1045,111,220,331,331,178,331,4,4,4,444,2,728,184414,4,331
2012-07-06,fall,2012,July,13,Friday,Workingday,Clear,0.9,0.7879,0.27,0.1045,99,194,293,293,178,293,4,4,4,444,2,729,184919,4,293
2012-07-06,fall,2012,July,14,Friday,Workingday,Clear,0.9,0.803,0.31,0.1642,91,184,275,275,178,275,4,3,4,434,2,729,175652,4,275
2012-07-06,fall,2012,July,15,Friday,Workingday,Clear,0.92,0.8182,0.29,0.194,79,206,285,285,178,285,4,4,4,444,2,729,183149,4,285
2012-07-06,fall,2012,July,16,Friday,Workingday,Clear,0.92,0.8182,0.29,0.1045,69,300,369,369,178,369,4,4,4,444,2,730,227748,4,369
2012-07-06,fall,2012,July,17,Friday,Workingday,Clear,0.92,0.8182,0.29,0.0,90,486,576,576,178,576,4,4,4,444,2,730,336860,4,576
2012-07-06,fall,2012,July,18,Friday,Workingday,Clear,0.9,0.803,0.33,0.2537,106,454,560,560,178,560,4,4,4,444,2,728,309772,4,560
2012-07-06,fall,2012,July,19,Friday,Workingday,Clear,0.88,0.7879,0.35,0.2239,112,306,418,418,178,418,4,4,4,444,2,728,226789,4,418
2012-07-06,fall,2012,July,20,Friday,Workingday,Clear,0.86,0.7727,0.39,0.1045,91,245,336,336,178,336,4,4,4,444,2,728,164550,4,336
2012-07-06,fall,2012,July,21,Friday,Workingday,Clear,0.82,0.7727,0.52,0.1343,77,223,300,300,178,300,4,4,4,444,2,728,125445,4,300
2012-07-06,fall,2012,July,22,Friday,Workingday,Clear,0.8,0.7576,0.55,0.194,78,210,288,288,178,288,4,4,4,444,2,728,95612,4,288
2012-07-06,fall,2012,July,23,Friday,Workingday,Clear,0.8,0.7879,0.63,0.1045,27,137,164,164,178,164,4,3,4,434,0,728,63941,4,164
2012-07-07,fall,2012,July,0,Saturday,Holiday,Clear,0.78,0.7576,0.66,0.1343,35,115,150,150,177,150,4,3,4,434,0,726,39130,4,150
2012-07-07,fall,2012,July,1,Saturday,Holiday,Clear,0.76,0.7273,0.7,0.1642,16,55,71,71,177,71,4,2,4,424,0,724,24164,4,71
2012-07-07,fall,2012,July,2,Saturday,Holiday,Clear,0.76,0.7424,0.72,0.1642,11,47,58,58,177,58,4,2,4,424,0,715,16352,4,58
2012-07-07,fall,2012,July,3,Saturday,Holiday,Clear,0.74,0.7121,0.74,0.1343,12,19,31,31,177,31,4,1,4,414,0,697,8174,4,31
2012-07-07,fall,2012,July,4,Saturday,Holiday,Clear,0.74,0.7121,0.74,0.1642,3,13,16,16,177,16,4,1,4,414,0,697,4428,4,16
2012-07-07,fall,2012,July,5,Saturday,Holiday,Clear,0.74,0.7121,0.74,0.194,2,12,14,14,177,14,4,1,4,414,0,717,14261,4,14
2012-07-07,fall,2012,July,6,Saturday,Holiday,Clear,0.74,0.7121,0.74,0.1045,4,27,31,31,177,31,4,1,4,414,0,725,55132,4,31
2012-07-07,fall,2012,July,7,Saturday,Holiday,Clear,0.78,0.7576,0.66,0.1045,8,63,71,71,177,71,4,2,4,424,0,727,154171,4,71
2012-07-07,fall,2012,July,8,Saturday,Holiday,Clear,0.82,0.8333,0.63,0.194,32,120,152,152,177,152,4,3,4,434,2,727,261001,4,152
2012-07-07,fall,2012,July,9,Saturday,Holiday,Clear,0.84,0.8333,0.59,0.1642,69,187,256,256,177,256,4,3,4,434,2,727,159438,4,256
2012-07-07,fall,2012,July,10,Saturday,Holiday,Clear,0.92,0.8636,0.37,0.2239,100,225,325,325,177,325,4,4,4,444,2,727,126257,4,325
2012-07-07,fall,2012,July,11,Saturday,Holiday,Clear,0.94,0.8788,0.38,0.194,122,245,367,367,177,367,4,4,4,444,2,727,151320,4,367
2012-07-07,fall,2012,July,12,Saturday,Holiday,Clear,0.96,0.8636,0.31,0.3582,124,218,342,342,177,342,4,4,4,444,2,728,184414,4,342
2012-07-07,fall,2012,July,13,Saturday,Holiday,Mist,0.96,0.8636,0.31,0.2537,116,244,360,360,177,360,4,4,4,444,2,729,184919,4,360
2012-07-07,fall,2012,July,14,Saturday,Holiday,Mist,0.96,0.8636,0.3,0.1343,105,203,308,308,177,308,4,4,4,444,2,729,175652,4,308
2012-07-07,fall,2012,July,15,Saturday,Holiday,Clear,0.96,0.8485,0.26,0.0,113,193,306,306,177,306,4,4,4,444,2,729,183149,4,306
2012-07-07,fall,2012,July,16,Saturday,Holiday,Clear,1.0,0.8636,0.19,0.1642,102,192,294,294,177,294,4,4,4,444,2,730,227748,4,294
2012-07-07,fall,2012,July,17,Saturday,Holiday,Clear,0.96,0.8485,0.26,0.1343,103,176,279,279,177,279,4,3,4,434,2,730,336860,4,279
2012-07-07,fall,2012,July,18,Saturday,Holiday,Clear,0.94,0.8333,0.29,0.0896,83,194,277,277,177,277,4,3,4,434,2,728,309772,4,277
2012-07-07,fall,2012,July,19,Saturday,Holiday,Clear,0.92,0.8333,0.33,0.1343,68,219,287,287,177,287,4,4,4,444,2,728,226789,4,287
2012-07-07,fall,2012,July,20,Saturday,Holiday,Clear,0.9,0.8182,0.37,0.1642,79,197,276,276,177,276,4,3,4,434,2,728,164550,4,276
2012-07-07,fall,2012,July,21,Saturday,Holiday,Clear,0.88,0.7879,0.37,0.194,51,150,201,201,177,201,4,3,4,434,2,728,125445,4,201
2012-07-07,fall,2012,July,22,Saturday,Holiday,Clear,0.84,0.8333,0.59,0.194,56,164,220,220,177,220,4,3,4,434,2,728,95612,4,220
2012-07-07,fall,2012,July,23,Saturday,Holiday,Clear,0.84,0.8182,0.56,0.1642,34,114,148,148,177,148,4,3,4,434,2,728,63941,4,148
2012-07-08,fall,2012,July,0,Sunday,Holiday,Clear,0.82,0.7879,0.56,0.1343,22,125,147,147,176,147,4,3,4,434,2,726,39130,4,147
2012-07-08,fall,2012,July,1,Sunday,Holiday,Clear,0.82,0.7879,0.56,0.1045,25,99,124,124,176,124,4,2,4,424,0,724,24164,4,124
2012-07-08,fall,2012,July,2,Sunday,Holiday,Clear,0.82,0.7727,0.52,0.1045,11,59,70,70,176,70,4,2,4,424,0,715,16352,4,70
2012-07-08,fall,2012,July,3,Sunday,Holiday,Clear,0.8,0.7727,0.59,0.1045,1,34,35,35,176,35,4,1,4,414,0,697,8174,4,35
2012-07-08,fall,2012,July,4,Sunday,Holiday,Clear,0.78,0.7576,0.66,0.1045,2,11,13,13,176,13,4,1,4,414,0,697,4428,4,13
2012-07-08,fall,2012,July,5,Sunday,Holiday,Clear,0.78,0.7424,0.62,0.0,1,5,6,6,176,6,4,1,4,414,0,717,14261,4,6
2012-07-08,fall,2012,July,6,Sunday,Holiday,Clear,0.78,0.7727,0.7,0.1343,5,16,21,21,176,21,4,1,4,414,0,725,55132,4,21
2012-07-08,fall,2012,July,7,Sunday,Holiday,Clear,0.8,0.803,0.66,0.0,19,33,52,52,176,52,4,2,4,424,0,727,154171,4,52
2012-07-08,fall,2012,July,8,Sunday,Holiday,Clear,0.84,0.803,0.53,0.1343,35,95,130,130,176,130,4,2,4,424,2,727,261001,4,130
2012-07-08,fall,2012,July,9,Sunday,Holiday,Clear,0.86,0.8182,0.5,0.1045,70,172,242,242,176,242,4,3,4,434,2,727,159438,4,242
2012-07-08,fall,2012,July,10,Sunday,Holiday,Clear,0.9,0.8636,0.45,0.0,85,234,319,319,176,319,4,4,4,444,2,727,126257,4,319
2012-07-08,fall,2012,July,11,Sunday,Holiday,Clear,0.92,0.8939,0.42,0.2985,120,269,389,389,176,389,4,4,4,444,2,727,151320,4,389
2012-07-08,fall,2012,July,12,Sunday,Holiday,Clear,0.92,0.8939,0.42,0.194,105,271,376,376,176,376,4,4,4,444,2,728,184414,4,376
2012-07-08,fall,2012,July,13,Sunday,Holiday,Clear,0.94,0.8788,0.38,0.2537,118,219,337,337,176,337,4,4,4,444,2,729,184919,4,337
2012-07-08,fall,2012,July,14,Sunday,Holiday,Clear,0.96,0.9091,0.36,0.1642,77,235,312,312,176,312,4,4,4,444,2,729,175652,4,312
2012-07-08,fall,2012,July,15,Sunday,Holiday,Light Snow,0.92,0.8939,0.42,0.2836,80,218,298,298,176,298,4,4,4,444,2,729,183149,4,298
2012-07-08,fall,2012,July,16,Sunday,Holiday,Mist,0.8,0.803,0.66,0.2239,65,226,291,291,176,291,4,4,4,444,2,730,227748,4,291
2012-07-08,fall,2012,July,17,Sunday,Holiday,Clear,0.78,0.7424,0.59,0.0,68,202,270,270,176,270,4,3,4,434,2,730,336860,4,270
2012-07-08,fall,2012,July,18,Sunday,Holiday,Clear,0.78,0.7424,0.62,0.1045,54,199,253,253,176,253,4,3,4,434,2,728,309772,4,253
2012-07-08,fall,2012,July,19,Sunday,Holiday,Clear,0.78,0.7424,0.62,0.1642,66,184,250,250,176,250,4,3,4,434,2,728,226789,4,250
2012-07-08,fall,2012,July,20,Sunday,Holiday,Clear,0.76,0.7273,0.7,0.0896,79,206,285,285,176,285,4,4,4,444,2,728,164550,4,285
2012-07-08,fall,2012,July,21,Sunday,Holiday,Clear,0.76,0.7273,0.7,0.1343,58,149,207,207,176,207,4,3,4,434,0,728,125445,4,207
2012-07-08,fall,2012,July,22,Sunday,Holiday,Light Snow,0.74,0.697,0.7,0.0896,12,110,122,122,176,122,4,2,4,424,0,728,95612,4,122
2012-07-08,fall,2012,July,23,Sunday,Holiday,Light Snow,0.68,0.6364,0.83,0.0896,25,98,123,123,176,123,4,2,4,424,0,728,63941,4,123
2012-07-09,fall,2012,July,0,Monday,Workingday,Mist,0.68,0.6364,0.89,0.0896,6,33,39,39,175,39,4,1,4,414,0,726,39130,4,39
2012-07-09,fall,2012,July,1,Monday,Workingday,Light Snow,0.7,0.6667,0.89,0.1045,5,13,18,18,175,18,4,1,4,414,0,724,24164,4,18
2012-07-09,fall,2012,July,2,Monday,Workingday,Light Snow,0.7,0.6667,0.89,0.194,1,4,5,5,175,5,4,1,4,414,0,715,16352,4,5
2012-07-09,fall,2012,July,3,Monday,Workingday,Light Snow,0.7,0.6667,0.89,0.194,0,5,5,5,175,5,4,1,4,414,0,697,8174,4,5
2012-07-09,fall,2012,July,4,Monday,Workingday,Light Snow,0.66,0.5909,0.89,0.3881,1,1,2,2,175,2,4,1,3,413,0,697,4428,4,2
2012-07-09,fall,2012,July,5,Monday,Workingday,Mist,0.66,0.6061,0.83,0.2239,1,27,28,28,175,28,4,1,3,413,0,717,14261,4,28
2012-07-09,fall,2012,July,6,Monday,Workingday,Light Snow,0.64,0.5758,0.89,0.2537,6,86,92,92,175,92,4,2,3,423,0,725,55132,4,92
2012-07-09,fall,2012,July,7,Monday,Workingday,Light Snow,0.66,0.6061,0.83,0.2239,7,223,230,230,175,230,4,3,3,433,0,727,154171,4,230
2012-07-09,fall,2012,July,8,Monday,Workingday,Mist,0.66,0.6061,0.83,0.1642,26,429,455,455,175,455,4,4,3,443,0,727,261001,4,455
2012-07-09,fall,2012,July,9,Monday,Workingday,Mist,0.66,0.6061,0.83,0.1642,38,325,363,363,175,363,4,4,3,443,0,727,159438,4,363
2012-07-09,fall,2012,July,10,Monday,Workingday,Mist,0.66,0.6061,0.83,0.194,58,117,175,175,175,175,4,3,3,433,0,727,126257,4,175
2012-07-09,fall,2012,July,11,Monday,Workingday,Mist,0.72,0.6818,0.62,0.1343,72,144,216,216,175,216,4,3,4,434,2,727,151320,4,216
2012-07-09,fall,2012,July,12,Monday,Workingday,Mist,0.74,0.6818,0.58,0.1343,61,205,266,266,175,266,4,3,4,434,2,728,184414,4,266
2012-07-09,fall,2012,July,13,Monday,Workingday,Mist,0.76,0.697,0.55,0.2537,67,188,255,255,175,255,4,3,4,434,2,729,184919,4,255
2012-07-09,fall,2012,July,14,Monday,Workingday,Mist,0.74,0.6818,0.55,0.2537,58,184,242,242,175,242,4,3,4,434,2,729,175652,4,242
2012-07-09,fall,2012,July,15,Monday,Workingday,Mist,0.76,0.6818,0.45,0.2239,66,214,280,280,175,280,4,3,4,434,2,729,183149,4,280
2012-07-09,fall,2012,July,16,Monday,Workingday,Clear,0.78,0.697,0.4,0.2836,88,325,413,413,175,413,4,4,4,444,2,730,227748,4,413
2012-07-09,fall,2012,July,17,Monday,Workingday,Clear,0.78,0.697,0.4,0.1642,108,741,849,849,175,849,4,4,4,444,2,730,336860,4,849
2012-07-09,fall,2012,July,18,Monday,Workingday,Clear,0.76,0.6818,0.48,0.1343,82,790,872,872,175,872,4,4,4,444,2,728,309772,4,872
2012-07-09,fall,2012,July,19,Monday,Workingday,Clear,0.74,0.6818,0.55,0.1642,88,543,631,631,175,631,4,4,4,444,2,728,226789,4,631
2012-07-09,fall,2012,July,20,Monday,Workingday,Mist,0.74,0.6818,0.55,0.1045,69,378,447,447,175,447,4,4,4,444,2,728,164550,4,447
2012-07-09,fall,2012,July,21,Monday,Workingday,Mist,0.74,0.6818,0.55,0.0896,33,298,331,331,175,331,4,4,4,444,2,728,125445,4,331
2012-07-09,fall,2012,July,22,Monday,Workingday,Mist,0.72,0.6667,0.58,0.1045,35,189,224,224,175,224,4,3,4,434,0,728,95612,4,224
2012-07-09,fall,2012,July,23,Monday,Workingday,Mist,0.7,0.6515,0.65,0.1045,22,109,131,131,175,131,4,2,4,424,0,728,63941,4,131
2012-07-10,fall,2012,July,0,Tuesday,Workingday,Clear,0.7,0.6515,0.7,0.0896,16,53,69,69,174,69,4,2,4,424,0,726,39130,4,69
2012-07-10,fall,2012,July,1,Tuesday,Workingday,Clear,0.7,0.6667,0.74,0.1343,0,15,15,15,174,15,4,1,4,414,0,724,24164,4,15
2012-07-10,fall,2012,July,2,Tuesday,Workingday,Clear,0.7,0.6667,0.74,0.1343,1,15,16,16,174,16,4,1,4,414,0,715,16352,4,16
2012-07-10,fall,2012,July,3,Tuesday,Workingday,Clear,0.68,0.6364,0.79,0.0,0,3,3,3,174,3,4,1,4,414,0,697,8174,4,3
2012-07-10,fall,2012,July,4,Tuesday,Workingday,Clear,0.68,0.6364,0.79,0.1343,0,4,4,4,174,4,4,1,4,414,0,697,4428,4,4
2012-07-10,fall,2012,July,5,Tuesday,Workingday,Clear,0.66,0.6061,0.83,0.1343,3,39,42,42,174,42,4,2,3,423,0,717,14261,4,42
2012-07-10,fall,2012,July,6,Tuesday,Workingday,Mist,0.68,0.6364,0.79,0.1045,4,183,187,187,174,187,4,3,4,434,0,725,55132,4,187
2012-07-10,fall,2012,July,7,Tuesday,Workingday,Mist,0.7,0.6667,0.74,0.1045,31,489,520,520,174,520,4,4,4,444,2,727,154171,4,520
2012-07-10,fall,2012,July,8,Tuesday,Workingday,Clear,0.72,0.697,0.74,0.1343,34,615,649,649,174,649,4,4,4,444,2,727,261001,4,649
2012-07-10,fall,2012,July,9,Tuesday,Workingday,Clear,0.74,0.697,0.66,0.1343,47,284,331,331,174,331,4,4,4,444,2,727,159438,4,331
2012-07-10,fall,2012,July,10,Tuesday,Workingday,Clear,0.76,0.7121,0.62,0.194,56,134,190,190,174,190,4,3,4,434,2,727,126257,4,190
2012-07-10,fall,2012,July,11,Tuesday,Workingday,Clear,0.8,0.7273,0.46,0.194,92,157,249,249,174,249,4,3,4,434,2,727,151320,4,249
2012-07-10,fall,2012,July,12,Tuesday,Workingday,Clear,0.8,0.7121,0.41,0.1343,69,203,272,272,174,272,4,3,4,434,2,728,184414,4,272
2012-07-10,fall,2012,July,13,Tuesday,Workingday,Clear,0.82,0.7273,0.38,0.194,77,203,280,280,174,280,4,3,4,434,2,729,184919,4,280
2012-07-10,fall,2012,July,14,Tuesday,Workingday,Clear,0.82,0.7273,0.38,0.1642,71,171,242,242,174,242,4,3,4,434,2,729,175652,4,242
2012-07-10,fall,2012,July,15,Tuesday,Workingday,Clear,0.8,0.7121,0.41,0.2239,77,188,265,265,174,265,4,3,4,434,2,729,183149,4,265
2012-07-10,fall,2012,July,16,Tuesday,Workingday,Clear,0.8,0.7273,0.43,0.2239,89,346,435,435,174,435,4,4,4,444,2,730,227748,4,435
2012-07-10,fall,2012,July,17,Tuesday,Workingday,Clear,0.78,0.7121,0.49,0.194,103,769,872,872,174,872,4,4,4,444,2,730,336860,4,872
2012-07-10,fall,2012,July,18,Tuesday,Workingday,Light Snow,0.7,0.6667,0.74,0.2239,70,749,819,819,174,819,4,4,4,444,2,728,309772,4,819
2012-07-10,fall,2012,July,19,Tuesday,Workingday,Light Snow,0.7,0.6667,0.74,0.2239,55,359,414,414,174,414,4,4,4,444,2,728,226789,4,414
2012-07-10,fall,2012,July,20,Tuesday,Workingday,Light Snow,0.64,0.5758,0.83,0.2239,9,75,84,84,174,84,4,2,3,423,0,728,164550,4,84
2012-07-10,fall,2012,July,21,Tuesday,Workingday,Light Snow,0.64,0.5758,0.89,0.1045,7,83,90,90,174,90,4,2,3,423,0,728,125445,4,90
2012-07-10,fall,2012,July,22,Tuesday,Workingday,Mist,0.64,0.5758,0.83,0.1343,14,125,139,139,174,139,4,2,3,423,0,728,95612,4,139
2012-07-10,fall,2012,July,23,Tuesday,Workingday,Mist,0.64,0.5758,0.89,0.1045,29,74,103,103,174,103,4,2,3,423,0,728,63941,4,103
2012-07-11,fall,2012,July,0,Wednesday,Workingday,Mist,0.66,0.6061,0.83,0.1343,6,38,44,44,173,44,4,2,3,423,0,726,39130,4,44
2012-07-11,fall,2012,July,1,Wednesday,Workingday,Clear,0.64,0.5758,0.89,0.0,3,11,14,14,173,14,4,1,3,413,0,724,24164,4,14
2012-07-11,fall,2012,July,2,Wednesday,Workingday,Clear,0.64,0.5758,0.89,0.0,0,5,5,5,173,5,4,1,3,413,0,715,16352,4,5
2012-07-11,fall,2012,July,3,Wednesday,Workingday,Clear,0.64,0.5758,0.89,0.1343,0,5,5,5,173,5,4,1,3,413,0,697,8174,4,5
2012-07-11,fall,2012,July,4,Wednesday,Workingday,Clear,0.64,0.5758,0.89,0.1343,1,6,7,7,173,7,4,1,3,413,0,697,4428,4,7
2012-07-11,fall,2012,July,5,Wednesday,Workingday,Clear,0.64,0.5758,0.89,0.0,5,36,41,41,173,41,4,2,3,423,0,717,14261,4,41
2012-07-11,fall,2012,July,6,Wednesday,Workingday,Clear,0.64,0.5758,0.89,0.1343,17,168,185,185,173,185,4,3,3,433,0,725,55132,4,185
2012-07-11,fall,2012,July,7,Wednesday,Workingday,Mist,0.66,0.6061,0.83,0.1045,26,471,497,497,173,497,4,4,3,443,0,727,154171,4,497
2012-07-11,fall,2012,July,8,Wednesday,Workingday,Mist,0.68,0.6364,0.79,0.1642,30,644,674,674,173,674,4,4,4,444,2,727,261001,4,674
2012-07-11,fall,2012,July,9,Wednesday,Workingday,Mist,0.7,0.6667,0.74,0.1343,30,298,328,328,173,328,4,4,4,444,0,727,159438,4,328
2012-07-11,fall,2012,July,10,Wednesday,Workingday,Mist,0.72,0.6818,0.62,0.1343,47,148,195,195,173,195,4,3,4,434,0,727,126257,4,195
2012-07-11,fall,2012,July,11,Wednesday,Workingday,Mist,0.76,0.7121,0.58,0.1343,56,173,229,229,173,229,4,3,4,434,2,727,151320,4,229
2012-07-11,fall,2012,July,12,Wednesday,Workingday,Mist,0.78,0.697,0.43,0.0,69,223,292,292,173,292,4,4,4,444,2,728,184414,4,292
2012-07-11,fall,2012,July,13,Wednesday,Workingday,Mist,0.8,0.7121,0.42,0.1642,65,208,273,273,173,273,4,3,4,434,2,729,184919,4,273
2012-07-11,fall,2012,July,14,Wednesday,Workingday,Clear,0.8,0.7121,0.41,0.2239,66,175,241,241,173,241,4,3,4,434,2,729,175652,4,241
2012-07-11,fall,2012,July,15,Wednesday,Workingday,Clear,0.8,0.7121,0.41,0.2537,56,220,276,276,173,276,4,3,4,434,2,729,183149,4,276
2012-07-11,fall,2012,July,16,Wednesday,Workingday,Clear,0.8,0.7121,0.38,0.194,53,358,411,411,173,411,4,4,4,444,2,730,227748,4,411
2012-07-11,fall,2012,July,17,Wednesday,Workingday,Clear,0.8,0.697,0.31,0.2239,90,740,830,830,173,830,4,4,4,444,2,730,336860,4,830
2012-07-11,fall,2012,July,18,Wednesday,Workingday,Clear,0.78,0.6818,0.38,0.2537,79,735,814,814,173,814,4,4,4,444,2,728,309772,4,814
2012-07-11,fall,2012,July,19,Wednesday,Workingday,Clear,0.74,0.6667,0.48,0.2239,73,560,633,633,173,633,4,4,4,444,2,728,226789,4,633
2012-07-11,fall,2012,July,20,Wednesday,Workingday,Clear,0.74,0.6667,0.51,0.1642,73,410,483,483,173,483,4,4,4,444,2,728,164550,4,483
2012-07-11,fall,2012,July,21,Wednesday,Workingday,Clear,0.72,0.6667,0.58,0.2239,69,322,391,391,173,391,4,4,4,444,2,728,125445,4,391
2012-07-11,fall,2012,July,22,Wednesday,Workingday,Clear,0.72,0.6667,0.58,0.2537,41,203,244,244,173,244,4,3,4,434,2,728,95612,4,244
2012-07-11,fall,2012,July,23,Wednesday,Workingday,Mist,0.7,0.6515,0.58,0.2537,20,132,152,152,173,152,4,3,4,434,0,728,63941,4,152
2012-07-12,fall,2012,July,0,Thursday,Workingday,Mist,0.68,0.6364,0.61,0.0,1,55,56,56,172,56,4,2,4,424,0,726,39130,4,56
2012-07-12,fall,2012,July,1,Thursday,Workingday,Mist,0.66,0.6212,0.61,0.0,0,21,21,21,172,21,4,1,3,413,0,724,24164,4,21
2012-07-12,fall,2012,July,2,Thursday,Workingday,Mist,0.66,0.6212,0.65,0.0896,0,9,9,9,172,9,4,1,3,413,0,715,16352,4,9
2012-07-12,fall,2012,July,3,Thursday,Workingday,Clear,0.64,0.6061,0.69,0.1045,0,10,10,10,172,10,4,1,3,413,0,697,8174,4,10
2012-07-12,fall,2012,July,4,Thursday,Workingday,Clear,0.64,0.6061,0.73,0.1045,0,5,5,5,172,5,4,1,3,413,0,697,4428,4,5
2012-07-12,fall,2012,July,5,Thursday,Workingday,Clear,0.62,0.5909,0.73,0.1045,4,40,44,44,172,44,4,2,3,423,0,717,14261,4,44
2012-07-12,fall,2012,July,6,Thursday,Workingday,Clear,0.64,0.6061,0.73,0.0896,7,171,178,178,172,178,4,3,3,433,0,725,55132,4,178
2012-07-12,fall,2012,July,7,Thursday,Workingday,Clear,0.64,0.6061,0.73,0.1343,32,480,512,512,172,512,4,4,3,443,2,727,154171,4,512
2012-07-12,fall,2012,July,8,Thursday,Workingday,Clear,0.68,0.6364,0.65,0.1343,49,653,702,702,172,702,4,4,4,444,2,727,261001,4,702
2012-07-12,fall,2012,July,9,Thursday,Workingday,Clear,0.72,0.6667,0.58,0.1045,42,285,327,327,172,327,4,4,4,444,2,727,159438,4,327
2012-07-12,fall,2012,July,10,Thursday,Workingday,Clear,0.74,0.6667,0.48,0.1642,69,145,214,214,172,214,4,3,4,434,2,727,126257,4,214
2012-07-12,fall,2012,July,11,Thursday,Workingday,Clear,0.76,0.6818,0.45,0.1045,49,166,215,215,172,215,4,3,4,434,2,727,151320,4,215
2012-07-12,fall,2012,July,12,Thursday,Workingday,Clear,0.78,0.6818,0.35,0.1343,71,221,292,292,172,292,4,4,4,444,2,728,184414,4,292
2012-07-12,fall,2012,July,13,Thursday,Workingday,Clear,0.8,0.697,0.33,0.2239,52,225,277,277,172,277,4,3,4,434,2,729,184919,4,277
2012-07-12,fall,2012,July,14,Thursday,Workingday,Clear,0.78,0.6818,0.33,0.2239,42,167,209,209,172,209,4,3,4,434,2,729,175652,4,209
2012-07-12,fall,2012,July,15,Thursday,Workingday,Clear,0.8,0.7121,0.36,0.194,63,208,271,271,172,271,4,3,4,434,2,729,183149,4,271
2012-07-12,fall,2012,July,16,Thursday,Workingday,Clear,0.8,0.7121,0.36,0.194,69,370,439,439,172,439,4,4,4,444,2,730,227748,4,439
2012-07-12,fall,2012,July,17,Thursday,Workingday,Clear,0.76,0.6818,0.43,0.2239,91,704,795,795,172,795,4,4,4,444,2,730,336860,4,795
2012-07-12,fall,2012,July,18,Thursday,Workingday,Clear,0.76,0.6818,0.45,0.1343,86,739,825,825,172,825,4,4,4,444,2,728,309772,4,825
2012-07-12,fall,2012,July,19,Thursday,Workingday,Clear,0.74,0.6667,0.48,0.2239,97,532,629,629,172,629,4,4,4,444,2,728,226789,4,629
2012-07-12,fall,2012,July,20,Thursday,Workingday,Clear,0.74,0.6667,0.48,0.2239,75,439,514,514,172,514,4,4,4,444,2,728,164550,4,514
2012-07-12,fall,2012,July,21,Thursday,Workingday,Clear,0.72,0.6667,0.48,0.2239,44,329,373,373,172,373,4,4,4,444,2,728,125445,4,373
2012-07-12,fall,2012,July,22,Thursday,Workingday,Clear,0.72,0.6667,0.51,0.1642,56,262,318,318,172,318,4,4,4,444,2,728,95612,4,318
2012-07-12,fall,2012,July,23,Thursday,Workingday,Mist,0.7,0.6515,0.51,0.2239,33,178,211,211,172,211,4,3,4,434,2,728,63941,4,211
2012-07-13,fall,2012,July,0,Friday,Workingday,Mist,0.7,0.6515,0.54,0.1642,19,76,95,95,171,95,4,2,4,424,0,726,39130,4,95
2012-07-13,fall,2012,July,1,Friday,Workingday,Mist,0.68,0.6364,0.54,0.1045,17,42,59,59,171,59,4,2,4,424,0,724,24164,4,59
2012-07-13,fall,2012,July,2,Friday,Workingday,Mist,0.66,0.6212,0.61,0.0896,2,15,17,17,171,17,4,1,3,413,0,715,16352,4,17
2012-07-13,fall,2012,July,3,Friday,Workingday,Mist,0.68,0.6364,0.61,0.0,2,7,9,9,171,9,4,1,4,414,0,697,8174,4,9
2012-07-13,fall,2012,July,4,Friday,Workingday,Mist,0.66,0.6212,0.61,0.0,0,11,11,11,171,11,4,1,3,413,0,697,4428,4,11
2012-07-13,fall,2012,July,5,Friday,Workingday,Mist,0.66,0.6364,0.56,0.0896,4,30,34,34,171,34,4,1,4,414,0,717,14261,4,34
2012-07-13,fall,2012,July,6,Friday,Workingday,Mist,0.7,0.6515,0.54,0.0,7,120,127,127,171,127,4,2,4,424,0,725,55132,4,127
2012-07-13,fall,2012,July,7,Friday,Workingday,Mist,0.7,0.6515,0.54,0.0,27,353,380,380,171,380,4,4,4,444,2,727,154171,4,380
2012-07-13,fall,2012,July,8,Friday,Workingday,Mist,0.7,0.6515,0.54,0.0,53,660,713,713,171,713,4,4,4,444,2,727,261001,4,713
2012-07-13,fall,2012,July,9,Friday,Workingday,Mist,0.72,0.6667,0.51,0.0,70,344,414,414,171,414,4,4,4,444,2,727,159438,4,414
2012-07-13,fall,2012,July,10,Friday,Workingday,Mist,0.74,0.6667,0.48,0.0,78,190,268,268,171,268,4,3,4,434,2,727,126257,4,268
2012-07-13,fall,2012,July,11,Friday,Workingday,Mist,0.76,0.6818,0.45,0.1343,68,220,288,288,171,288,4,4,4,444,2,727,151320,4,288
2012-07-13,fall,2012,July,12,Friday,Workingday,Mist,0.76,0.6818,0.4,0.1045,125,254,379,379,171,379,4,4,4,444,2,728,184414,4,379
2012-07-13,fall,2012,July,13,Friday,Workingday,Mist,0.8,0.7121,0.38,0.1343,100,274,374,374,171,374,4,4,4,444,2,729,184919,4,374
2012-07-13,fall,2012,July,14,Friday,Workingday,Mist,0.8,0.7121,0.38,0.0,120,249,369,369,171,369,4,4,4,444,2,729,175652,4,369
2012-07-13,fall,2012,July,15,Friday,Workingday,Mist,0.8,0.7121,0.36,0.1045,92,261,353,353,171,353,4,4,4,444,2,729,183149,4,353
2012-07-13,fall,2012,July,16,Friday,Workingday,Mist,0.8,0.7121,0.36,0.2239,111,381,492,492,171,492,4,4,4,444,2,730,227748,4,492
2012-07-13,fall,2012,July,17,Friday,Workingday,Mist,0.8,0.7121,0.36,0.1642,138,697,835,835,171,835,4,4,4,444,2,730,336860,4,835
2012-07-13,fall,2012,July,18,Friday,Workingday,Clear,0.78,0.697,0.46,0.194,108,523,631,631,171,631,4,4,4,444,2,728,309772,4,631
2012-07-13,fall,2012,July,19,Friday,Workingday,Clear,0.74,0.6667,0.51,0.1642,103,385,488,488,171,488,4,4,4,444,2,728,226789,4,488
2012-07-13,fall,2012,July,20,Friday,Workingday,Clear,0.74,0.6667,0.48,0.1343,95,294,389,389,171,389,4,4,4,444,2,728,164550,4,389
2012-07-13,fall,2012,July,21,Friday,Workingday,Clear,0.72,0.6667,0.54,0.0,76,223,299,299,171,299,4,4,4,444,2,728,125445,4,299
2012-07-13,fall,2012,July,22,Friday,Workingday,Clear,0.74,0.6667,0.45,0.0,59,204,263,263,171,263,4,3,4,434,2,728,95612,4,263
2012-07-13,fall,2012,July,23,Friday,Workingday,Mist,0.72,0.6515,0.45,0.1343,37,175,212,212,171,212,4,3,4,434,2,728,63941,4,212
2012-07-14,fall,2012,July,0,Saturday,Holiday,Mist,0.72,0.6667,0.48,0.0896,35,156,191,191,170,191,4,3,4,434,2,726,39130,4,191
2012-07-14,fall,2012,July,1,Saturday,Holiday,Mist,0.7,0.6515,0.51,0.1045,13,105,118,118,170,118,4,2,4,424,0,724,24164,4,118
2012-07-14,fall,2012,July,2,Saturday,Holiday,Mist,0.7,0.6515,0.54,0.1045,10,91,101,101,170,101,4,2,4,424,0,715,16352,4,101
2012-07-14,fall,2012,July,3,Saturday,Holiday,Mist,0.7,0.6515,0.54,0.1045,9,31,40,40,170,40,4,1,4,414,0,697,8174,4,40
2012-07-14,fall,2012,July,4,Saturday,Holiday,Light Snow,0.66,0.6212,0.61,0.1045,3,6,9,9,170,9,4,1,3,413,0,697,4428,4,9
2012-07-14,fall,2012,July,5,Saturday,Holiday,Mist,0.64,0.6061,0.73,0.1045,0,5,5,5,170,5,4,1,3,413,0,717,14261,4,5
2012-07-14,fall,2012,July,6,Saturday,Holiday,Mist,0.64,0.5909,0.78,0.0896,6,29,35,35,170,35,4,1,3,413,0,725,55132,4,35
2012-07-14,fall,2012,July,7,Saturday,Holiday,Clear,0.64,0.5909,0.78,0.2836,7,41,48,48,170,48,4,2,3,423,0,727,154171,4,48
2012-07-14,fall,2012,July,8,Saturday,Holiday,Clear,0.62,0.5909,0.78,0.2836,33,118,151,151,170,151,4,3,3,433,0,727,261001,4,151
2012-07-14,fall,2012,July,9,Saturday,Holiday,Clear,0.66,0.6212,0.74,0.194,82,200,282,282,170,282,4,4,3,443,2,727,159438,4,282
2012-07-14,fall,2012,July,10,Saturday,Holiday,Mist,0.72,0.6818,0.7,0.0896,123,278,401,401,170,401,4,4,4,444,2,727,126257,4,401
2012-07-14,fall,2012,July,11,Saturday,Holiday,Mist,0.72,0.6818,0.7,0.1045,143,296,439,439,170,439,4,4,4,444,2,727,151320,4,439
2012-07-14,fall,2012,July,12,Saturday,Holiday,Mist,0.74,0.697,0.66,0.0896,181,318,499,499,170,499,4,4,4,444,2,728,184414,4,499
2012-07-14,fall,2012,July,13,Saturday,Holiday,Mist,0.76,0.7121,0.62,0.0896,219,372,591,591,170,591,4,4,4,444,2,729,184919,4,591
2012-07-14,fall,2012,July,14,Saturday,Holiday,Clear,0.8,0.7576,0.55,0.1045,269,363,632,632,170,632,4,4,4,444,2,729,175652,4,632
2012-07-14,fall,2012,July,15,Saturday,Holiday,Clear,0.8,0.7576,0.55,0.1642,243,317,560,560,170,560,4,4,4,444,2,729,183149,4,560
2012-07-14,fall,2012,July,16,Saturday,Holiday,Mist,0.72,0.697,0.79,0.3582,226,340,566,566,170,566,4,4,4,444,2,730,227748,4,566
2012-07-14,fall,2012,July,17,Saturday,Holiday,Light Snow,0.7,0.6667,0.79,0.1642,199,259,458,458,170,458,4,4,4,444,2,730,336860,4,458
2012-07-14,fall,2012,July,18,Saturday,Holiday,Clear,0.72,0.697,0.79,0.1343,108,243,351,351,170,351,4,4,4,444,2,728,309772,4,351
2012-07-14,fall,2012,July,19,Saturday,Holiday,Clear,0.72,0.7121,0.84,0.0896,156,275,431,431,170,431,4,4,4,444,2,728,226789,4,431
2012-07-14,fall,2012,July,20,Saturday,Holiday,Clear,0.72,0.7121,0.84,0.0896,101,255,356,356,170,356,4,4,4,444,2,728,164550,4,356
2012-07-14,fall,2012,July,21,Saturday,Holiday,Clear,0.7,0.6667,0.84,0.2239,69,200,269,269,170,269,4,3,4,434,0,728,125445,4,269
2012-07-14,fall,2012,July,22,Saturday,Holiday,Clear,0.7,0.6667,0.79,0.194,65,160,225,225,170,225,4,3,4,434,0,728,95612,4,225
2012-07-14,fall,2012,July,23,Saturday,Holiday,Mist,0.68,0.6364,0.83,0.0896,55,156,211,211,170,211,4,3,4,434,0,728,63941,4,211
2012-07-15,fall,2012,July,0,Sunday,Holiday,Clear,0.68,0.6364,0.89,0.1642,40,147,187,187,169,187,4,3,4,434,0,726,39130,4,187
2012-07-15,fall,2012,July,1,Sunday,Holiday,Mist,0.68,0.6364,0.89,0.1343,49,119,168,168,169,168,4,3,4,434,0,724,24164,4,168
2012-07-15,fall,2012,July,2,Sunday,Holiday,Mist,0.68,0.6364,0.89,0.1642,29,86,115,115,169,115,4,2,4,424,0,715,16352,4,115
2012-07-15,fall,2012,July,3,Sunday,Holiday,Mist,0.68,0.6364,0.89,0.1642,15,42,57,57,169,57,4,2,4,424,0,697,8174,4,57
2012-07-15,fall,2012,July,4,Sunday,Holiday,Mist,0.68,0.6364,0.89,0.1045,8,11,19,19,169,19,4,1,4,414,0,697,4428,4,19
2012-07-15,fall,2012,July,5,Sunday,Holiday,Clear,0.68,0.6364,0.89,0.1343,2,7,9,9,169,9,4,1,4,414,0,717,14261,4,9
2012-07-15,fall,2012,July,6,Sunday,Holiday,Clear,0.68,0.6364,0.83,0.1343,6,9,15,15,169,15,4,1,4,414,0,725,55132,4,15
2012-07-15,fall,2012,July,7,Sunday,Holiday,Clear,0.7,0.6667,0.79,0.0896,17,30,47,47,169,47,4,2,4,424,0,727,154171,4,47
2012-07-15,fall,2012,July,8,Sunday,Holiday,Mist,0.7,0.6667,0.84,0.1343,37,96,133,133,169,133,4,2,4,424,0,727,261001,4,133
2012-07-15,fall,2012,July,9,Sunday,Holiday,Mist,0.72,0.697,0.79,0.0,58,163,221,221,169,221,4,3,4,434,0,727,159438,4,221
2012-07-15,fall,2012,July,10,Sunday,Holiday,Clear,0.76,0.7273,0.66,0.1343,141,241,382,382,169,382,4,4,4,444,2,727,126257,4,382
2012-07-15,fall,2012,July,11,Sunday,Holiday,Clear,0.82,0.7727,0.52,0.1642,170,281,451,451,169,451,4,4,4,444,2,727,151320,4,451
2012-07-15,fall,2012,July,12,Sunday,Holiday,Clear,0.84,0.7727,0.47,0.1045,153,336,489,489,169,489,4,4,4,444,2,728,184414,4,489
2012-07-15,fall,2012,July,13,Sunday,Holiday,Clear,0.86,0.7879,0.41,0.1045,171,309,480,480,169,480,4,4,4,444,2,729,184919,4,480
2012-07-15,fall,2012,July,14,Sunday,Holiday,Clear,0.9,0.8182,0.37,0.2537,162,314,476,476,169,476,4,4,4,444,2,729,175652,4,476
2012-07-15,fall,2012,July,15,Sunday,Holiday,Clear,0.86,0.803,0.47,0.1343,182,307,489,489,169,489,4,4,4,444,2,729,183149,4,489
2012-07-15,fall,2012,July,16,Sunday,Holiday,Clear,0.86,0.7879,0.41,0.2239,152,343,495,495,169,495,4,4,4,444,2,730,227748,4,495
2012-07-15,fall,2012,July,17,Sunday,Holiday,Clear,0.8,0.7727,0.59,0.4925,122,314,436,436,169,436,4,4,4,444,2,730,336860,4,436
2012-07-15,fall,2012,July,18,Sunday,Holiday,Light Snow,0.72,0.697,0.79,0.3582,84,228,312,312,169,312,4,4,4,444,2,728,309772,4,312
2012-07-15,fall,2012,July,19,Sunday,Holiday,Clear,0.72,0.7121,0.84,0.2239,109,203,312,312,169,312,4,4,4,444,2,728,226789,4,312
2012-07-15,fall,2012,July,20,Sunday,Holiday,Clear,0.72,0.697,0.79,0.2537,95,199,294,294,169,294,4,4,4,444,2,728,164550,4,294
2012-07-15,fall,2012,July,21,Sunday,Holiday,Clear,0.72,0.697,0.79,0.0896,59,164,223,223,169,223,4,3,4,434,0,728,125445,4,223
2012-07-15,fall,2012,July,22,Sunday,Holiday,Clear,0.72,0.697,0.74,0.1045,34,96,130,130,169,130,4,2,4,424,0,728,95612,4,130
2012-07-15,fall,2012,July,23,Sunday,Holiday,Clear,0.72,0.697,0.79,0.1343,25,66,91,91,169,91,4,2,4,424,0,728,63941,4,91
2012-07-16,fall,2012,July,0,Monday,Workingday,Light Snow,0.72,0.697,0.79,0.1045,11,32,43,43,168,43,4,2,4,424,0,726,39130,4,43
2012-07-16,fall,2012,July,1,Monday,Workingday,Mist,0.7,0.6667,0.74,0.194,1,10,11,11,168,11,4,1,4,414,0,724,24164,4,11
2012-07-16,fall,2012,July,2,Monday,Workingday,Clear,0.7,0.6667,0.74,0.1045,4,11,15,15,168,15,4,1,4,414,0,715,16352,4,15
2012-07-16,fall,2012,July,3,Monday,Workingday,Clear,0.68,0.6364,0.79,0.0896,2,4,6,6,168,6,4,1,4,414,0,697,8174,4,6
2012-07-16,fall,2012,July,4,Monday,Workingday,Clear,0.68,0.6364,0.79,0.1045,1,11,12,12,168,12,4,1,4,414,0,697,4428,4,12
2012-07-16,fall,2012,July,5,Monday,Workingday,Clear,0.66,0.6061,0.78,0.1045,10,40,50,50,168,50,4,2,3,423,0,717,14261,4,50
2012-07-16,fall,2012,July,6,Monday,Workingday,Clear,0.68,0.6364,0.79,0.1343,8,132,140,140,168,140,4,2,4,424,0,725,55132,4,140
2012-07-16,fall,2012,July,7,Monday,Workingday,Clear,0.72,0.6818,0.7,0.0896,24,459,483,483,168,483,4,4,4,444,2,727,154171,4,483
2012-07-16,fall,2012,July,8,Monday,Workingday,Clear,0.74,0.697,0.66,0.1045,48,619,667,667,168,667,4,4,4,444,2,727,261001,4,667
2012-07-16,fall,2012,July,9,Monday,Workingday,Clear,0.76,0.7121,0.62,0.1642,51,297,348,348,168,348,4,4,4,444,2,727,159438,4,348
2012-07-16,fall,2012,July,10,Monday,Workingday,Clear,0.8,0.7727,0.59,0.0,69,117,186,186,168,186,4,3,4,434,2,727,126257,4,186
2012-07-16,fall,2012,July,11,Monday,Workingday,Clear,0.84,0.803,0.53,0.2239,57,125,182,182,168,182,4,3,4,434,2,727,151320,4,182
2012-07-16,fall,2012,July,12,Monday,Workingday,Clear,0.84,0.7879,0.49,0.1343,79,158,237,237,168,237,4,3,4,434,2,728,184414,4,237
2012-07-16,fall,2012,July,13,Monday,Workingday,Clear,0.84,0.7879,0.49,0.2836,63,176,239,239,168,239,4,3,4,434,2,729,184919,4,239
2012-07-16,fall,2012,July,14,Monday,Workingday,Clear,0.88,0.8182,0.42,0.1045,53,159,212,212,168,212,4,3,4,434,2,729,175652,4,212
2012-07-16,fall,2012,July,15,Monday,Workingday,Clear,0.86,0.803,0.47,0.2537,61,176,237,237,168,237,4,3,4,434,2,729,183149,4,237
2012-07-16,fall,2012,July,16,Monday,Workingday,Light Snow,0.76,0.7273,0.66,0.5821,77,309,386,386,168,386,4,4,4,444,2,730,227748,4,386
2012-07-16,fall,2012,July,17,Monday,Workingday,Light Snow,0.76,0.7273,0.66,0.5821,86,669,755,755,168,755,4,4,4,444,2,730,336860,4,755
2012-07-16,fall,2012,July,18,Monday,Workingday,Clear,0.84,0.803,0.53,0.0,97,697,794,794,168,794,4,4,4,444,2,728,309772,4,794
2012-07-16,fall,2012,July,19,Monday,Workingday,Clear,0.8,0.7879,0.63,0.1343,92,503,595,595,168,595,4,4,4,444,2,728,226789,4,595
2012-07-16,fall,2012,July,20,Monday,Workingday,Clear,0.8,0.7727,0.59,0.1343,66,388,454,454,168,454,4,4,4,444,2,728,164550,4,454
2012-07-16,fall,2012,July,21,Monday,Workingday,Clear,0.76,0.7273,0.66,0.1343,45,283,328,328,168,328,4,4,4,444,2,728,125445,4,328
2012-07-16,fall,2012,July,22,Monday,Workingday,Clear,0.76,0.7121,0.62,0.0896,56,228,284,284,168,284,4,4,4,444,2,728,95612,4,284
2012-07-16,fall,2012,July,23,Monday,Workingday,Clear,0.74,0.7121,0.74,0.0896,27,139,166,166,168,166,4,3,4,434,0,728,63941,4,166
2012-07-17,fall,2012,July,0,Tuesday,Workingday,Clear,0.72,0.7121,0.84,0.1045,10,43,53,53,167,53,4,2,4,424,0,726,39130,4,53
2012-07-17,fall,2012,July,1,Tuesday,Workingday,Clear,0.74,0.697,0.7,0.0,4,21,25,25,167,25,4,1,4,414,0,724,24164,4,25
2012-07-17,fall,2012,July,2,Tuesday,Workingday,Clear,0.72,0.6818,0.7,0.0896,1,6,7,7,167,7,4,1,4,414,0,715,16352,4,7
2012-07-17,fall,2012,July,3,Tuesday,Workingday,Clear,0.72,0.6818,0.66,0.0,0,3,3,3,167,3,4,1,4,414,0,697,8174,4,3
2012-07-17,fall,2012,July,4,Tuesday,Workingday,Clear,0.72,0.6818,0.62,0.0,0,7,7,7,167,7,4,1,4,414,0,697,4428,4,7
2012-07-17,fall,2012,July,5,Tuesday,Workingday,Clear,0.68,0.6364,0.74,0.0896,7,31,38,38,167,38,4,1,4,414,0,717,14261,4,38
2012-07-17,fall,2012,July,6,Tuesday,Workingday,Clear,0.72,0.6818,0.66,0.1045,16,197,213,213,167,213,4,3,4,434,0,725,55132,4,213
2012-07-17,fall,2012,July,7,Tuesday,Workingday,Mist,0.74,0.697,0.7,0.0,26,500,526,526,167,526,4,4,4,444,2,727,154171,4,526
2012-07-17,fall,2012,July,8,Tuesday,Workingday,Mist,0.8,0.7576,0.55,0.0,43,618,661,661,167,661,4,4,4,444,2,727,261001,4,661
2012-07-17,fall,2012,July,9,Tuesday,Workingday,Mist,0.82,0.7727,0.49,0.2239,32,288,320,320,167,320,4,4,4,444,2,727,159438,4,320
2012-07-17,fall,2012,July,10,Tuesday,Workingday,Mist,0.84,0.7879,0.49,0.194,37,122,159,159,167,159,4,3,4,434,2,727,126257,4,159
2012-07-17,fall,2012,July,11,Tuesday,Workingday,Mist,0.86,0.803,0.47,0.0,60,146,206,206,167,206,4,3,4,434,2,727,151320,4,206
2012-07-17,fall,2012,July,12,Tuesday,Workingday,Mist,0.9,0.8182,0.35,0.0,80,174,254,254,167,254,4,3,4,434,2,728,184414,4,254
2012-07-17,fall,2012,July,13,Tuesday,Workingday,Clear,0.92,0.8182,0.31,0.194,53,168,221,221,167,221,4,3,4,434,2,729,184919,4,221
2012-07-17,fall,2012,July,14,Tuesday,Workingday,Clear,0.94,0.8333,0.29,0.2537,54,160,214,214,167,214,4,3,4,434,2,729,175652,4,214
2012-07-17,fall,2012,July,15,Tuesday,Workingday,Clear,0.92,0.8182,0.31,0.1642,57,187,244,244,167,244,4,3,4,434,2,729,183149,4,244
2012-07-17,fall,2012,July,16,Tuesday,Workingday,Clear,0.92,0.8182,0.29,0.1642,64,317,381,381,167,381,4,4,4,444,2,730,227748,4,381
2012-07-17,fall,2012,July,17,Tuesday,Workingday,Clear,0.92,0.8182,0.29,0.0,95,675,770,770,167,770,4,4,4,444,2,730,336860,4,770
2012-07-17,fall,2012,July,18,Tuesday,Workingday,Clear,0.9,0.803,0.33,0.194,60,712,772,772,167,772,4,4,4,444,2,728,309772,4,772
2012-07-17,fall,2012,July,19,Tuesday,Workingday,Clear,0.88,0.7879,0.35,0.2537,69,478,547,547,167,547,4,4,4,444,2,728,226789,4,547
2012-07-17,fall,2012,July,20,Tuesday,Workingday,Clear,0.86,0.7576,0.34,0.1642,52,375,427,427,167,427,4,4,4,444,2,728,164550,4,427
2012-07-17,fall,2012,July,21,Tuesday,Workingday,Clear,0.82,0.7727,0.52,0.1343,50,283,333,333,167,333,4,4,4,444,2,728,125445,4,333
2012-07-17,fall,2012,July,22,Tuesday,Workingday,Clear,0.8,0.7576,0.55,0.2239,29,215,244,244,167,244,4,3,4,434,2,728,95612,4,244
2012-07-17,fall,2012,July,23,Tuesday,Workingday,Clear,0.78,0.7424,0.59,0.194,22,139,161,161,167,161,4,3,4,434,0,728,63941,4,161
2012-07-18,fall,2012,July,0,Wednesday,Workingday,Clear,0.76,0.7273,0.66,0.1642,8,45,53,53,166,53,4,2,4,424,0,726,39130,4,53
2012-07-18,fall,2012,July,1,Wednesday,Workingday,Clear,0.76,0.7273,0.66,0.1045,2,14,16,16,166,16,4,1,4,414,0,724,24164,4,16
2012-07-18,fall,2012,July,2,Wednesday,Workingday,Clear,0.74,0.697,0.66,0.1343,3,5,8,8,166,8,4,1,4,414,0,715,16352,4,8
2012-07-18,fall,2012,July,3,Wednesday,Workingday,Clear,0.74,0.697,0.66,0.1343,2,2,4,4,166,4,4,1,4,414,0,697,8174,4,4
2012-07-18,fall,2012,July,4,Wednesday,Workingday,Clear,0.72,0.6818,0.7,0.1343,0,6,6,6,166,6,4,1,4,414,0,697,4428,4,6
2012-07-18,fall,2012,July,5,Wednesday,Workingday,Clear,0.72,0.6818,0.7,0.1642,5,41,46,46,166,46,4,2,4,424,0,717,14261,4,46
2012-07-18,fall,2012,July,6,Wednesday,Workingday,Clear,0.72,0.6818,0.7,0.1642,10,152,162,162,166,162,4,3,4,434,0,725,55132,4,162
2012-07-18,fall,2012,July,7,Wednesday,Workingday,Clear,0.74,0.697,0.66,0.1642,23,472,495,495,166,495,4,4,4,444,2,727,154171,4,495
2012-07-18,fall,2012,July,8,Wednesday,Workingday,Clear,0.78,0.7424,0.62,0.1045,55,624,679,679,166,679,4,4,4,444,2,727,261001,4,679
2012-07-18,fall,2012,July,9,Wednesday,Workingday,Clear,0.82,0.7879,0.56,0.0,44,253,297,297,166,297,4,4,4,444,2,727,159438,4,297
2012-07-18,fall,2012,July,10,Wednesday,Workingday,Clear,0.9,0.8485,0.42,0.194,39,99,138,138,166,138,4,2,4,424,2,727,126257,4,138
2012-07-18,fall,2012,July,11,Wednesday,Workingday,Clear,0.9,0.8485,0.42,0.0,47,136,183,183,166,183,4,3,4,434,2,727,151320,4,183
2012-07-18,fall,2012,July,12,Wednesday,Workingday,Clear,0.92,0.8636,0.37,0.1343,36,166,202,202,166,202,4,3,4,434,2,728,184414,4,202
2012-07-18,fall,2012,July,13,Wednesday,Workingday,Clear,0.94,0.8485,0.33,0.0,49,154,203,203,166,203,4,3,4,434,2,729,184919,4,203
2012-07-18,fall,2012,July,14,Wednesday,Workingday,Clear,0.94,0.8788,0.38,0.3284,54,116,170,170,166,170,4,3,4,434,2,729,175652,4,170
2012-07-18,fall,2012,July,15,Wednesday,Workingday,Light Snow,0.92,0.8485,0.35,0.3582,42,152,194,194,166,194,4,3,4,434,2,729,183149,4,194
2012-07-18,fall,2012,July,16,Wednesday,Workingday,Clear,0.74,0.697,0.66,0.2537,34,190,224,224,166,224,4,3,4,434,2,730,227748,4,224
2012-07-18,fall,2012,July,17,Wednesday,Workingday,Clear,0.74,0.697,0.7,0.2537,35,335,370,370,166,370,4,4,4,444,2,730,336860,4,370
2012-07-18,fall,2012,July,18,Wednesday,Workingday,Mist,0.76,0.7121,0.62,0.1343,63,580,643,643,166,643,4,4,4,444,2,728,309772,4,643
2012-07-18,fall,2012,July,19,Wednesday,Workingday,Mist,0.76,0.7121,0.62,0.1045,78,438,516,516,166,516,4,4,4,444,2,728,226789,4,516
2012-07-18,fall,2012,July,20,Wednesday,Workingday,Clear,0.74,0.6818,0.62,0.0896,56,310,366,366,166,366,4,4,4,444,2,728,164550,4,366
2012-07-18,fall,2012,July,21,Wednesday,Workingday,Clear,0.76,0.7121,0.62,0.0,53,266,319,319,166,319,4,4,4,444,2,728,125445,4,319
2012-07-18,fall,2012,July,22,Wednesday,Workingday,Clear,0.76,0.7121,0.58,0.0896,42,246,288,288,166,288,4,4,4,444,2,728,95612,4,288
2012-07-18,fall,2012,July,23,Wednesday,Workingday,Clear,0.76,0.7121,0.58,0.0896,19,112,131,131,166,131,4,2,4,424,0,728,63941,4,131
2012-07-19,fall,2012,July,0,Thursday,Workingday,Clear,0.74,0.697,0.66,0.0896,16,50,66,66,165,66,4,2,4,424,0,726,39130,4,66
2012-07-19,fall,2012,July,1,Thursday,Workingday,Clear,0.74,0.697,0.66,0.0896,6,19,25,25,165,25,4,1,4,414,0,724,24164,4,25
2012-07-19,fall,2012,July,2,Thursday,Workingday,Clear,0.72,0.6818,0.7,0.194,0,7,7,7,165,7,4,1,4,414,0,715,16352,4,7
2012-07-19,fall,2012,July,3,Thursday,Workingday,Clear,0.72,0.6818,0.7,0.1045,1,4,5,5,165,5,4,1,4,414,0,697,8174,4,5
2012-07-19,fall,2012,July,4,Thursday,Workingday,Clear,0.72,0.6818,0.7,0.1045,0,8,8,8,165,8,4,1,4,414,0,697,4428,4,8
2012-07-19,fall,2012,July,5,Thursday,Workingday,Mist,0.72,0.6818,0.7,0.1045,5,35,40,40,165,40,4,1,4,414,0,717,14261,4,40
2012-07-19,fall,2012,July,6,Thursday,Workingday,Clear,0.72,0.6818,0.66,0.1343,8,144,152,152,165,152,4,3,4,434,0,725,55132,4,152
2012-07-19,fall,2012,July,7,Thursday,Workingday,Clear,0.74,0.6818,0.58,0.2836,23,450,473,473,165,473,4,4,4,444,2,727,154171,4,473
2012-07-19,fall,2012,July,8,Thursday,Workingday,Clear,0.76,0.7121,0.58,0.2537,32,625,657,657,165,657,4,4,4,444,2,727,261001,4,657
2012-07-19,fall,2012,July,9,Thursday,Workingday,Mist,0.76,0.7121,0.58,0.2836,36,282,318,318,165,318,4,4,4,444,2,727,159438,4,318
2012-07-19,fall,2012,July,10,Thursday,Workingday,Clear,0.76,0.7121,0.58,0.194,41,157,198,198,165,198,4,3,4,434,2,727,126257,4,198
2012-07-19,fall,2012,July,11,Thursday,Workingday,Clear,0.8,0.7576,0.55,0.1045,54,162,216,216,165,216,4,3,4,434,2,727,151320,4,216
2012-07-19,fall,2012,July,12,Thursday,Workingday,Clear,0.84,0.7879,0.49,0.2836,59,215,274,274,165,274,4,3,4,434,2,728,184414,4,274
2012-07-19,fall,2012,July,13,Thursday,Workingday,Clear,0.84,0.7727,0.47,0.1343,74,180,254,254,165,254,4,3,4,434,2,729,184919,4,254
2012-07-19,fall,2012,July,14,Thursday,Workingday,Clear,0.86,0.7879,0.44,0.0896,46,151,197,197,165,197,4,3,4,434,2,729,175652,4,197
2012-07-19,fall,2012,July,15,Thursday,Workingday,Clear,0.84,0.7727,0.47,0.0896,66,226,292,292,165,292,4,4,4,444,2,729,183149,4,292
2012-07-19,fall,2012,July,16,Thursday,Workingday,Clear,0.84,0.7727,0.47,0.0896,70,288,358,358,165,358,4,4,4,444,2,730,227748,4,358
2012-07-19,fall,2012,July,17,Thursday,Workingday,Clear,0.86,0.7879,0.41,0.0,93,678,771,771,165,771,4,4,4,444,2,730,336860,4,771
2012-07-19,fall,2012,July,18,Thursday,Workingday,Clear,0.86,0.7879,0.41,0.194,93,684,777,777,165,777,4,4,4,444,2,728,309772,4,777
2012-07-19,fall,2012,July,19,Thursday,Workingday,Clear,0.84,0.7576,0.44,0.2537,53,480,533,533,165,533,4,4,4,444,2,728,226789,4,533
2012-07-19,fall,2012,July,20,Thursday,Workingday,Clear,0.82,0.7727,0.49,0.1642,65,440,505,505,165,505,4,4,4,444,2,728,164550,4,505
2012-07-19,fall,2012,July,21,Thursday,Workingday,Light Snow,0.66,0.5909,0.89,0.2537,38,294,332,332,165,332,4,4,3,443,0,728,125445,4,332
2012-07-19,fall,2012,July,22,Thursday,Workingday,Light Snow,0.66,0.5909,0.89,0.2537,6,62,68,68,165,68,4,2,3,423,0,728,95612,4,68
2012-07-19,fall,2012,July,23,Thursday,Workingday,Light Snow,0.66,0.5909,0.89,0.2239,3,62,65,65,165,65,4,2,3,423,0,728,63941,4,65
2012-07-20,fall,2012,July,0,Friday,Workingday,Light Snow,0.66,0.5909,0.89,0.0896,2,32,34,34,164,34,4,1,3,413,0,726,39130,4,34
2012-07-20,fall,2012,July,1,Friday,Workingday,Clear,0.66,0.5909,0.89,0.1343,2,9,11,11,164,11,4,1,3,413,0,724,24164,4,11
2012-07-20,fall,2012,July,2,Friday,Workingday,Mist,0.66,0.5909,0.89,0.0896,5,14,19,19,164,19,4,1,3,413,0,715,16352,4,19
2012-07-20,fall,2012,July,3,Friday,Workingday,Mist,0.66,0.5909,0.89,0.1045,7,29,36,36,164,36,4,1,3,413,0,697,8174,4,36
2012-07-20,fall,2012,July,4,Friday,Workingday,Mist,0.66,0.5909,0.89,0.1642,3,6,9,9,164,9,4,1,3,413,0,697,4428,4,9
2012-07-20,fall,2012,July,5,Friday,Workingday,Mist,0.66,0.5909,0.89,0.1343,2,40,42,42,164,42,4,2,3,423,0,717,14261,4,42
2012-07-20,fall,2012,July,6,Friday,Workingday,Mist,0.66,0.5909,0.89,0.1642,3,123,126,126,164,126,4,2,3,423,0,725,55132,4,126
2012-07-20,fall,2012,July,7,Friday,Workingday,Mist,0.66,0.5909,0.89,0.194,14,346,360,360,164,360,4,4,3,443,0,727,154171,4,360
2012-07-20,fall,2012,July,8,Friday,Workingday,Mist,0.68,0.6364,0.83,0.1642,39,652,691,691,164,691,4,4,4,444,2,727,261001,4,691
2012-07-20,fall,2012,July,9,Friday,Workingday,Mist,0.7,0.6667,0.79,0.1343,45,328,373,373,164,373,4,4,4,444,0,727,159438,4,373
2012-07-20,fall,2012,July,10,Friday,Workingday,Mist,0.7,0.6667,0.79,0.1642,51,182,233,233,164,233,4,3,4,434,0,727,126257,4,233
2012-07-20,fall,2012,July,11,Friday,Workingday,Light Snow,0.72,0.697,0.74,0.194,51,161,212,212,164,212,4,3,4,434,0,727,151320,4,212
2012-07-20,fall,2012,July,12,Friday,Workingday,Light Snow,0.68,0.6364,0.83,0.1642,41,233,274,274,164,274,4,3,4,434,0,728,184414,4,274
2012-07-20,fall,2012,July,13,Friday,Workingday,Light Snow,0.68,0.6364,0.83,0.1045,20,136,156,156,164,156,4,3,4,434,0,729,184919,4,156
2012-07-20,fall,2012,July,14,Friday,Workingday,Light Snow,0.7,0.6667,0.84,0.1642,53,176,229,229,164,229,4,3,4,434,0,729,175652,4,229
2012-07-20,fall,2012,July,15,Friday,Workingday,Mist,0.7,0.6667,0.84,0.2985,47,169,216,216,164,216,4,3,4,434,0,729,183149,4,216
2012-07-20,fall,2012,July,16,Friday,Workingday,Mist,0.68,0.6364,0.83,0.3284,70,366,436,436,164,436,4,4,4,444,2,730,227748,4,436
2012-07-20,fall,2012,July,17,Friday,Workingday,Mist,0.66,0.5909,0.89,0.4179,95,620,715,715,164,715,4,4,3,443,2,730,336860,4,715
2012-07-20,fall,2012,July,18,Friday,Workingday,Mist,0.66,0.6061,0.78,0.3284,73,549,622,622,164,622,4,4,3,443,2,728,309772,4,622
2012-07-20,fall,2012,July,19,Friday,Workingday,Mist,0.64,0.5758,0.83,0.2836,44,358,402,402,164,402,4,4,3,443,2,728,226789,4,402
2012-07-20,fall,2012,July,20,Friday,Workingday,Light Snow,0.64,0.5758,0.83,0.3881,35,216,251,251,164,251,4,3,3,433,0,728,164550,4,251
2012-07-20,fall,2012,July,21,Friday,Workingday,Light Snow,0.62,0.5758,0.83,0.3284,14,108,122,122,164,122,4,2,3,423,0,728,125445,4,122
2012-07-20,fall,2012,July,22,Friday,Workingday,Mist,0.62,0.5758,0.83,0.194,13,122,135,135,164,135,4,2,3,423,0,728,95612,4,135
2012-07-20,fall,2012,July,23,Friday,Workingday,Mist,0.62,0.5758,0.83,0.2836,18,148,166,166,164,166,4,3,3,433,0,728,63941,4,166
2012-07-21,fall,2012,July,0,Saturday,Holiday,Light Snow,0.62,0.5758,0.83,0.2836,11,92,103,103,163,103,4,2,3,423,0,726,39130,4,103
2012-07-21,fall,2012,July,1,Saturday,Holiday,Mist,0.62,0.5758,0.83,0.2537,10,62,72,72,163,72,4,2,3,423,0,724,24164,4,72
2012-07-21,fall,2012,July,2,Saturday,Holiday,Light Snow,0.6,0.5455,0.88,0.2836,5,55,60,60,163,60,4,2,3,423,0,715,16352,4,60
2012-07-21,fall,2012,July,3,Saturday,Holiday,Light Snow,0.6,0.5455,0.88,0.2537,7,18,25,25,163,25,4,1,3,413,0,697,8174,4,25
2012-07-21,fall,2012,July,4,Saturday,Holiday,Light Snow,0.58,0.5455,0.88,0.2836,11,5,16,16,163,16,4,1,3,413,0,697,4428,4,16
2012-07-21,fall,2012,July,5,Saturday,Holiday,Light Snow,0.58,0.5455,0.88,0.2537,7,10,17,17,163,17,4,1,3,413,0,717,14261,4,17
2012-07-21,fall,2012,July,6,Saturday,Holiday,Light Snow,0.58,0.5455,0.88,0.2537,3,12,15,15,163,15,4,1,3,413,0,725,55132,4,15
2012-07-21,fall,2012,July,7,Saturday,Holiday,Mist,0.58,0.5455,0.88,0.2537,8,29,37,37,163,37,4,1,3,413,0,727,154171,4,37
2012-07-21,fall,2012,July,8,Saturday,Holiday,Mist,0.58,0.5455,0.83,0.2537,18,94,112,112,163,112,4,2,3,423,0,727,261001,4,112
2012-07-21,fall,2012,July,9,Saturday,Holiday,Mist,0.58,0.5455,0.83,0.194,32,175,207,207,163,207,4,3,3,433,0,727,159438,4,207
2012-07-21,fall,2012,July,10,Saturday,Holiday,Light Snow,0.58,0.5455,0.88,0.2537,49,219,268,268,163,268,4,3,3,433,0,727,126257,4,268
2012-07-21,fall,2012,July,11,Saturday,Holiday,Mist,0.6,0.5606,0.83,0.2537,80,225,305,305,163,305,4,4,3,443,0,727,151320,4,305
2012-07-21,fall,2012,July,12,Saturday,Holiday,Light Snow,0.6,0.5606,0.83,0.2239,156,301,457,457,163,457,4,4,3,443,2,728,184414,4,457
2012-07-21,fall,2012,July,13,Saturday,Holiday,Light Snow,0.6,0.5606,0.83,0.1642,106,248,354,354,163,354,4,4,3,443,2,729,184919,4,354
2012-07-21,fall,2012,July,14,Saturday,Holiday,Mist,0.6,0.5455,0.88,0.2537,121,222,343,343,163,343,4,4,3,443,2,729,175652,4,343
2012-07-21,fall,2012,July,15,Saturday,Holiday,Light Snow,0.6,0.5455,0.88,0.2537,148,232,380,380,163,380,4,4,3,443,2,729,183149,4,380
2012-07-21,fall,2012,July,16,Saturday,Holiday,Light Snow,0.6,0.5455,0.88,0.194,130,196,326,326,163,326,4,4,3,443,2,730,227748,4,326
2012-07-21,fall,2012,July,17,Saturday,Holiday,Light Snow,0.6,0.5455,0.88,0.1642,92,149,241,241,163,241,4,3,3,433,0,730,336860,4,241
2012-07-21,fall,2012,July,18,Saturday,Holiday,Mist,0.6,0.5455,0.88,0.194,51,126,177,177,163,177,4,3,3,433,0,728,309772,4,177
2012-07-21,fall,2012,July,19,Saturday,Holiday,Mist,0.6,0.5455,0.88,0.1642,67,171,238,238,163,238,4,3,3,433,0,728,226789,4,238
2012-07-21,fall,2012,July,20,Saturday,Holiday,Light Snow,0.6,0.5455,0.88,0.1642,51,163,214,214,163,214,4,3,3,433,0,728,164550,4,214
2012-07-21,fall,2012,July,21,Saturday,Holiday,Mist,0.6,0.5455,0.88,0.1642,29,134,163,163,163,163,4,3,3,433,0,728,125445,4,163
2012-07-21,fall,2012,July,22,Saturday,Holiday,Mist,0.6,0.5455,0.88,0.1045,40,140,180,180,163,180,4,3,3,433,0,728,95612,4,180
2012-07-21,fall,2012,July,23,Saturday,Holiday,Mist,0.6,0.5455,0.88,0.0,32,117,149,149,163,149,4,3,3,433,0,728,63941,4,149
2012-07-22,fall,2012,July,0,Sunday,Holiday,Mist,0.6,0.5455,0.88,0.1045,17,96,113,113,162,113,4,2,3,423,0,726,39130,4,113
2012-07-22,fall,2012,July,1,Sunday,Holiday,Mist,0.6,0.5455,0.88,0.1642,31,99,130,130,162,130,4,2,3,423,0,724,24164,4,130
2012-07-22,fall,2012,July,2,Sunday,Holiday,Mist,0.6,0.5455,0.88,0.1045,32,90,122,122,162,122,4,2,3,423,0,715,16352,4,122
2012-07-22,fall,2012,July,3,Sunday,Holiday,Mist,0.6,0.5455,0.88,0.1045,13,30,43,43,162,43,4,2,3,423,0,697,8174,4,43
2012-07-22,fall,2012,July,4,Sunday,Holiday,Clear,0.6,0.5455,0.88,0.0,6,10,16,16,162,16,4,1,3,413,0,697,4428,4,16
2012-07-22,fall,2012,July,5,Sunday,Holiday,Clear,0.6,0.5455,0.88,0.0,0,6,6,6,162,6,4,1,3,413,0,717,14261,4,6
2012-07-22,fall,2012,July,6,Sunday,Holiday,Mist,0.62,0.5758,0.83,0.0896,5,14,19,19,162,19,4,1,3,413,0,725,55132,4,19
2012-07-22,fall,2012,July,7,Sunday,Holiday,Mist,0.62,0.5758,0.83,0.0,13,25,38,38,162,38,4,1,3,413,0,727,154171,4,38
2012-07-22,fall,2012,July,8,Sunday,Holiday,Mist,0.64,0.5909,0.78,0.0,31,122,153,153,162,153,4,3,3,433,0,727,261001,4,153
2012-07-22,fall,2012,July,9,Sunday,Holiday,Mist,0.66,0.6212,0.69,0.0,79,179,258,258,162,258,4,3,3,433,0,727,159438,4,258
2012-07-22,fall,2012,July,10,Sunday,Holiday,Mist,0.66,0.6212,0.74,0.0,114,265,379,379,162,379,4,4,3,443,2,727,126257,4,379
2012-07-22,fall,2012,July,11,Sunday,Holiday,Mist,0.66,0.6212,0.74,0.0,191,314,505,505,162,505,4,4,3,443,2,727,151320,4,505
2012-07-22,fall,2012,July,12,Sunday,Holiday,Mist,0.7,0.6515,0.7,0.1045,178,326,504,504,162,504,4,4,4,444,2,728,184414,4,504
2012-07-22,fall,2012,July,13,Sunday,Holiday,Mist,0.7,0.6515,0.65,0.0896,238,388,626,626,162,626,4,4,4,444,2,729,184919,4,626
2012-07-22,fall,2012,July,14,Sunday,Holiday,Clear,0.72,0.6818,0.66,0.1045,256,360,616,616,162,616,4,4,4,444,2,729,175652,4,616
2012-07-22,fall,2012,July,15,Sunday,Holiday,Clear,0.72,0.6818,0.66,0.1045,254,370,624,624,162,624,4,4,4,444,2,729,183149,4,624
2012-07-22,fall,2012,July,16,Sunday,Holiday,Clear,0.74,0.697,0.66,0.1045,245,383,628,628,162,628,4,4,4,444,2,730,227748,4,628
2012-07-22,fall,2012,July,17,Sunday,Holiday,Clear,0.74,0.697,0.66,0.2239,188,368,556,556,162,556,4,4,4,444,2,730,336860,4,556
2012-07-22,fall,2012,July,18,Sunday,Holiday,Clear,0.74,0.697,0.66,0.1642,173,342,515,515,162,515,4,4,4,444,2,728,309772,4,515
2012-07-22,fall,2012,July,19,Sunday,Holiday,Clear,0.72,0.6818,0.7,0.1642,180,342,522,522,162,522,4,4,4,444,2,728,226789,4,522
2012-07-22,fall,2012,July,20,Sunday,Holiday,Clear,0.7,0.6667,0.74,0.1642,124,254,378,378,162,378,4,4,4,444,2,728,164550,4,378
2012-07-22,fall,2012,July,21,Sunday,Holiday,Clear,0.7,0.6667,0.79,0.1045,88,257,345,345,162,345,4,4,4,444,2,728,125445,4,345
2012-07-22,fall,2012,July,22,Sunday,Holiday,Clear,0.7,0.6667,0.74,0.194,55,136,191,191,162,191,4,3,4,434,0,728,95612,4,191
2012-07-22,fall,2012,July,23,Sunday,Holiday,Clear,0.68,0.6364,0.79,0.1642,33,90,123,123,162,123,4,2,4,424,0,728,63941,4,123
2012-07-23,fall,2012,July,0,Monday,Workingday,Clear,0.66,0.5909,0.89,0.0896,11,36,47,47,161,47,4,2,3,423,0,726,39130,4,47
2012-07-23,fall,2012,July,1,Monday,Workingday,Clear,0.66,0.5909,0.89,0.194,7,20,27,27,161,27,4,1,3,413,0,724,24164,4,27
2012-07-23,fall,2012,July,2,Monday,Workingday,Mist,0.66,0.5909,0.94,0.0896,3,14,17,17,161,17,4,1,3,413,0,715,16352,4,17
2012-07-23,fall,2012,July,3,Monday,Workingday,Mist,0.66,0.5909,0.94,0.0896,0,2,2,2,161,2,4,1,3,413,0,697,8174,4,2
2012-07-23,fall,2012,July,4,Monday,Workingday,Mist,0.66,0.5909,0.94,0.1343,0,8,8,8,161,8,4,1,3,413,0,697,4428,4,8
2012-07-23,fall,2012,July,5,Monday,Workingday,Mist,0.66,0.5909,0.94,0.1343,3,48,51,51,161,51,4,2,3,423,0,717,14261,4,51
2012-07-23,fall,2012,July,6,Monday,Workingday,Mist,0.68,0.6364,0.89,0.0896,9,148,157,157,161,157,4,3,4,434,0,725,55132,4,157
2012-07-23,fall,2012,July,7,Monday,Workingday,Clear,0.7,0.6667,0.84,0.1343,17,404,421,421,161,421,4,4,4,444,0,727,154171,4,421
2012-07-23,fall,2012,July,8,Monday,Workingday,Clear,0.72,0.697,0.79,0.1045,47,691,738,738,161,738,4,4,4,444,2,727,261001,4,738
2012-07-23,fall,2012,July,9,Monday,Workingday,Mist,0.74,0.7121,0.74,0.1343,57,288,345,345,161,345,4,4,4,444,2,727,159438,4,345
2012-07-23,fall,2012,July,10,Monday,Workingday,Mist,0.78,0.7424,0.62,0.0,63,137,200,200,161,200,4,3,4,434,0,727,126257,4,200
2012-07-23,fall,2012,July,11,Monday,Workingday,Mist,0.8,0.7424,0.52,0.1642,69,129,198,198,161,198,4,3,4,434,2,727,151320,4,198
2012-07-23,fall,2012,July,12,Monday,Workingday,Mist,0.8,0.7424,0.52,0.1642,109,205,314,314,161,314,4,4,4,444,2,728,184414,4,314
2012-07-23,fall,2012,July,13,Monday,Workingday,Mist,0.8,0.7424,0.52,0.1045,64,176,240,240,161,240,4,3,4,434,2,729,184919,4,240
2012-07-23,fall,2012,July,14,Monday,Workingday,Mist,0.78,0.7424,0.59,0.1642,82,189,271,271,161,271,4,3,4,434,2,729,175652,4,271
2012-07-23,fall,2012,July,15,Monday,Workingday,Clear,0.8,0.7576,0.55,0.194,76,205,281,281,161,281,4,3,4,434,2,729,183149,4,281
2012-07-23,fall,2012,July,16,Monday,Workingday,Clear,0.82,0.7727,0.52,0.1343,111,346,457,457,161,457,4,4,4,444,2,730,227748,4,457
2012-07-23,fall,2012,July,17,Monday,Workingday,Clear,0.82,0.7727,0.52,0.1343,87,760,847,847,161,847,4,4,4,444,2,730,336860,4,847
2012-07-23,fall,2012,July,18,Monday,Workingday,Clear,0.82,0.7576,0.46,0.1045,69,672,741,741,161,741,4,4,4,444,2,728,309772,4,741
2012-07-23,fall,2012,July,19,Monday,Workingday,Clear,0.8,0.7424,0.52,0.2537,94,488,582,582,161,582,4,4,4,444,2,728,226789,4,582
2012-07-23,fall,2012,July,20,Monday,Workingday,Clear,0.76,0.7121,0.62,0.1642,56,347,403,403,161,403,4,4,4,444,2,728,164550,4,403
2012-07-23,fall,2012,July,21,Monday,Workingday,Clear,0.76,0.7121,0.62,0.194,45,251,296,296,161,296,4,4,4,444,2,728,125445,4,296
2012-07-23,fall,2012,July,22,Monday,Workingday,Clear,0.74,0.6818,0.62,0.194,40,169,209,209,161,209,4,3,4,434,2,728,95612,4,209
2012-07-23,fall,2012,July,23,Monday,Workingday,Clear,0.72,0.6818,0.66,0.1642,16,98,114,114,161,114,4,2,4,424,0,728,63941,4,114
2012-07-24,fall,2012,July,0,Tuesday,Workingday,Clear,0.7,0.6667,0.74,0.1343,12,52,64,64,160,64,4,2,4,424,0,726,39130,4,64
2012-07-24,fall,2012,July,1,Tuesday,Workingday,Clear,0.68,0.6364,0.79,0.1642,7,10,17,17,160,17,4,1,4,414,0,724,24164,4,17
2012-07-24,fall,2012,July,2,Tuesday,Workingday,Clear,0.66,0.6061,0.83,0.1642,6,10,16,16,160,16,4,1,3,413,0,715,16352,4,16
2012-07-24,fall,2012,July,3,Tuesday,Workingday,Clear,0.66,0.6061,0.83,0.1642,1,5,6,6,160,6,4,1,3,413,0,697,8174,4,6
2012-07-24,fall,2012,July,4,Tuesday,Workingday,Clear,0.66,0.6061,0.83,0.0896,0,6,6,6,160,6,4,1,3,413,0,697,4428,4,6
2012-07-24,fall,2012,July,5,Tuesday,Workingday,Clear,0.66,0.6061,0.83,0.1045,5,45,50,50,160,50,4,2,3,423,0,717,14261,4,50
2012-07-24,fall,2012,July,6,Tuesday,Workingday,Clear,0.66,0.6061,0.83,0.1343,17,173,190,190,160,190,4,3,3,433,0,725,55132,4,190
2012-07-24,fall,2012,July,7,Tuesday,Workingday,Clear,0.7,0.6667,0.74,0.1642,24,492,516,516,160,516,4,4,4,444,2,727,154171,4,516
2012-07-24,fall,2012,July,8,Tuesday,Workingday,Clear,0.74,0.697,0.7,0.194,49,694,743,743,160,743,4,4,4,444,2,727,261001,4,743
2012-07-24,fall,2012,July,9,Tuesday,Workingday,Clear,0.84,0.803,0.53,0.0,40,299,339,339,160,339,4,4,4,444,2,727,159438,4,339
2012-07-24,fall,2012,July,10,Tuesday,Workingday,Clear,0.82,0.7879,0.56,0.2985,62,156,218,218,160,218,4,3,4,434,2,727,126257,4,218
2012-07-24,fall,2012,July,11,Tuesday,Workingday,Mist,0.84,0.803,0.53,0.3284,45,156,201,201,160,201,4,3,4,434,2,727,151320,4,201
2012-07-24,fall,2012,July,12,Tuesday,Workingday,Mist,0.82,0.7879,0.56,0.2239,60,169,229,229,160,229,4,3,4,434,2,728,184414,4,229
2012-07-24,fall,2012,July,13,Tuesday,Workingday,Mist,0.84,0.803,0.53,0.2985,73,200,273,273,160,273,4,3,4,434,2,729,184919,4,273
2012-07-24,fall,2012,July,14,Tuesday,Workingday,Mist,0.84,0.803,0.53,0.2239,48,196,244,244,160,244,4,3,4,434,2,729,175652,4,244
2012-07-24,fall,2012,July,15,Tuesday,Workingday,Clear,0.82,0.7727,0.49,0.2985,73,212,285,285,160,285,4,4,4,444,2,729,183149,4,285
2012-07-24,fall,2012,July,16,Tuesday,Workingday,Clear,0.8,0.7576,0.55,0.2985,86,369,455,455,160,455,4,4,4,444,2,730,227748,4,455
2012-07-24,fall,2012,July,17,Tuesday,Workingday,Clear,0.8,0.7424,0.52,0.3284,94,775,869,869,160,869,4,4,4,444,2,730,336860,4,869
2012-07-24,fall,2012,July,18,Tuesday,Workingday,Clear,0.76,0.7121,0.62,0.3284,110,767,877,877,160,877,4,4,4,444,2,728,309772,4,877
2012-07-24,fall,2012,July,19,Tuesday,Workingday,Clear,0.76,0.7121,0.62,0.1642,109,523,632,632,160,632,4,4,4,444,2,728,226789,4,632
2012-07-24,fall,2012,July,20,Tuesday,Workingday,Clear,0.74,0.697,0.66,0.1642,85,438,523,523,160,523,4,4,4,444,2,728,164550,4,523
2012-07-24,fall,2012,July,21,Tuesday,Workingday,Clear,0.74,0.697,0.66,0.2239,53,325,378,378,160,378,4,4,4,444,2,728,125445,4,378
2012-07-24,fall,2012,July,22,Tuesday,Workingday,Clear,0.74,0.697,0.66,0.2537,43,226,269,269,160,269,4,3,4,434,2,728,95612,4,269
2012-07-24,fall,2012,July,23,Tuesday,Workingday,Clear,0.74,0.6818,0.58,0.3284,38,154,192,192,160,192,4,3,4,434,2,728,63941,4,192
2012-07-25,fall,2012,July,0,Wednesday,Workingday,Clear,0.72,0.6667,0.58,0.2985,9,57,66,66,159,66,4,2,4,424,0,726,39130,4,66
2012-07-25,fall,2012,July,1,Wednesday,Workingday,Clear,0.7,0.6515,0.58,0.194,2,26,28,28,159,28,4,1,4,414,0,724,24164,4,28
2012-07-25,fall,2012,July,2,Wednesday,Workingday,Clear,0.68,0.6364,0.61,0.2239,1,11,12,12,159,12,4,1,4,414,0,715,16352,4,12
2012-07-25,fall,2012,July,3,Wednesday,Workingday,Clear,0.66,0.6212,0.65,0.2239,1,11,12,12,159,12,4,1,3,413,0,697,8174,4,12
2012-07-25,fall,2012,July,4,Wednesday,Workingday,Clear,0.64,0.6061,0.65,0.2239,0,4,4,4,159,4,4,1,3,413,0,697,4428,4,4
2012-07-25,fall,2012,July,5,Wednesday,Workingday,Clear,0.64,0.6061,0.65,0.1642,5,54,59,59,159,59,4,2,3,423,0,717,14261,4,59
2012-07-25,fall,2012,July,6,Wednesday,Workingday,Clear,0.64,0.6061,0.65,0.194,11,179,190,190,159,190,4,3,3,433,0,725,55132,4,190
2012-07-25,fall,2012,July,7,Wednesday,Workingday,Clear,0.66,0.6212,0.5,0.3284,34,473,507,507,159,507,4,4,3,443,2,727,154171,4,507
2012-07-25,fall,2012,July,8,Wednesday,Workingday,Clear,0.7,0.6364,0.42,0.2537,43,745,788,788,159,788,4,4,4,444,2,727,261001,4,788
2012-07-25,fall,2012,July,9,Wednesday,Workingday,Clear,0.72,0.6515,0.37,0.2985,65,277,342,342,159,342,4,4,4,444,2,727,159438,4,342
2012-07-25,fall,2012,July,10,Wednesday,Workingday,Clear,0.74,0.6515,0.37,0.0,68,163,231,231,159,231,4,3,4,434,2,727,126257,4,231
2012-07-25,fall,2012,July,11,Wednesday,Workingday,Clear,0.76,0.6667,0.33,0.0,79,202,281,281,159,281,4,3,4,434,2,727,151320,4,281
2012-07-25,fall,2012,July,12,Wednesday,Workingday,Clear,0.76,0.6667,0.33,0.0,77,233,310,310,159,310,4,4,4,444,2,728,184414,4,310
2012-07-25,fall,2012,July,13,Wednesday,Workingday,Clear,0.78,0.6818,0.31,0.1642,81,231,312,312,159,312,4,4,4,444,2,729,184919,4,312
2012-07-25,fall,2012,July,14,Wednesday,Workingday,Clear,0.8,0.697,0.29,0.1343,88,159,247,247,159,247,4,3,4,434,2,729,175652,4,247
2012-07-25,fall,2012,July,15,Wednesday,Workingday,Clear,0.78,0.6818,0.31,0.0896,94,223,317,317,159,317,4,4,4,444,2,729,183149,4,317
2012-07-25,fall,2012,July,16,Wednesday,Workingday,Clear,0.8,0.697,0.29,0.1642,91,393,484,484,159,484,4,4,4,444,2,730,227748,4,484
2012-07-25,fall,2012,July,17,Wednesday,Workingday,Clear,0.8,0.697,0.31,0.0,130,783,913,913,159,913,4,4,4,444,2,730,336860,4,913
2012-07-25,fall,2012,July,18,Wednesday,Workingday,Clear,0.8,0.697,0.27,0.1343,104,787,891,891,159,891,4,4,4,444,2,728,309772,4,891
2012-07-25,fall,2012,July,19,Wednesday,Workingday,Clear,0.76,0.6667,0.33,0.1343,116,582,698,698,159,698,4,4,4,444,2,728,226789,4,698
2012-07-25,fall,2012,July,20,Wednesday,Workingday,Clear,0.74,0.6515,0.4,0.1642,106,461,567,567,159,567,4,4,4,444,2,728,164550,4,567
2012-07-25,fall,2012,July,21,Wednesday,Workingday,Clear,0.72,0.6515,0.45,0.1343,71,326,397,397,159,397,4,4,4,444,2,728,125445,4,397
2012-07-25,fall,2012,July,22,Wednesday,Workingday,Clear,0.7,0.6515,0.58,0.1343,55,223,278,278,159,278,4,3,4,434,2,728,95612,4,278
2012-07-25,fall,2012,July,23,Wednesday,Workingday,Clear,0.68,0.6364,0.57,0.2985,52,187,239,239,159,239,4,3,4,434,2,728,63941,4,239
2012-07-26,fall,2012,July,0,Thursday,Workingday,Clear,0.66,0.6212,0.65,0.194,27,65,92,92,158,92,4,2,3,423,0,726,39130,4,92
2012-07-26,fall,2012,July,1,Thursday,Workingday,Clear,0.66,0.6212,0.65,0.2239,6,23,29,29,158,29,4,1,3,413,0,724,24164,4,29
2012-07-26,fall,2012,July,2,Thursday,Workingday,Clear,0.66,0.6212,0.69,0.2537,5,16,21,21,158,21,4,1,3,413,0,715,16352,4,21
2012-07-26,fall,2012,July,3,Thursday,Workingday,Clear,0.66,0.6212,0.69,0.2239,0,8,8,8,158,8,4,1,3,413,0,697,8174,4,8
2012-07-26,fall,2012,July,4,Thursday,Workingday,Clear,0.66,0.6212,0.74,0.194,0,4,4,4,158,4,4,1,3,413,0,697,4428,4,4
2012-07-26,fall,2012,July,5,Thursday,Workingday,Clear,0.66,0.6212,0.74,0.194,2,40,42,42,158,42,4,2,3,423,0,717,14261,4,42
2012-07-26,fall,2012,July,6,Thursday,Workingday,Clear,0.66,0.6061,0.78,0.2537,16,165,181,181,158,181,4,3,3,433,0,725,55132,4,181
2012-07-26,fall,2012,July,7,Thursday,Workingday,Clear,0.7,0.6667,0.74,0.2537,17,478,495,495,158,495,4,4,4,444,2,727,154171,4,495
2012-07-26,fall,2012,July,8,Thursday,Workingday,Mist,0.7,0.6667,0.74,0.2537,49,680,729,729,158,729,4,4,4,444,2,727,261001,4,729
2012-07-26,fall,2012,July,9,Thursday,Workingday,Mist,0.72,0.6818,0.7,0.1343,55,289,344,344,158,344,4,4,4,444,2,727,159438,4,344
2012-07-26,fall,2012,July,10,Thursday,Workingday,Clear,0.74,0.697,0.7,0.2239,79,143,222,222,158,222,4,3,4,434,2,727,126257,4,222
2012-07-26,fall,2012,July,11,Thursday,Workingday,Clear,0.8,0.803,0.66,0.2239,69,143,212,212,158,212,4,3,4,434,2,727,151320,4,212
2012-07-26,fall,2012,July,12,Thursday,Workingday,Clear,0.84,0.8182,0.56,0.2537,73,206,279,279,158,279,4,3,4,434,2,728,184414,4,279
2012-07-26,fall,2012,July,13,Thursday,Workingday,Clear,0.86,0.8333,0.53,0.2985,53,189,242,242,158,242,4,3,4,434,2,729,184919,4,242
2012-07-26,fall,2012,July,14,Thursday,Workingday,Clear,0.9,0.8788,0.47,0.2537,62,151,213,213,158,213,4,3,4,434,2,729,175652,4,213
2012-07-26,fall,2012,July,15,Thursday,Workingday,Clear,0.92,0.8939,0.42,0.2985,65,173,238,238,158,238,4,3,4,434,2,729,183149,4,238
2012-07-26,fall,2012,July,16,Thursday,Workingday,Clear,0.94,0.8788,0.38,0.3881,62,312,374,374,158,374,4,4,4,444,2,730,227748,4,374
2012-07-26,fall,2012,July,17,Thursday,Workingday,Clear,0.9,0.8636,0.45,0.4179,110,628,738,738,158,738,4,4,4,444,2,730,336860,4,738
2012-07-26,fall,2012,July,18,Thursday,Workingday,Clear,0.92,0.8788,0.4,0.3582,73,615,688,688,158,688,4,4,4,444,2,728,309772,4,688
2012-07-26,fall,2012,July,19,Thursday,Workingday,Clear,0.9,0.8636,0.45,0.3284,80,534,614,614,158,614,4,4,4,444,2,728,226789,4,614
2012-07-26,fall,2012,July,20,Thursday,Workingday,Clear,0.86,0.8182,0.5,0.2537,47,399,446,446,158,446,4,4,4,444,2,728,164550,4,446
2012-07-26,fall,2012,July,21,Thursday,Workingday,Clear,0.8,0.7424,0.49,0.6119,35,236,271,271,158,271,4,3,4,434,2,728,125445,4,271
2012-07-26,fall,2012,July,22,Thursday,Workingday,Clear,0.8,0.7424,0.49,0.6119,33,201,234,234,158,234,4,3,4,434,2,728,95612,4,234
2012-07-26,fall,2012,July,23,Thursday,Workingday,Clear,0.72,0.6818,0.7,0.1343,18,127,145,145,158,145,4,3,4,434,0,728,63941,4,145
2012-07-27,fall,2012,July,0,Friday,Workingday,Clear,0.72,0.6818,0.7,0.0,14,83,97,97,157,97,4,2,4,424,0,726,39130,4,97
2012-07-27,fall,2012,July,1,Friday,Workingday,Clear,0.72,0.6818,0.7,0.1045,12,42,54,54,157,54,4,2,4,424,0,724,24164,4,54
2012-07-27,fall,2012,July,2,Friday,Workingday,Clear,0.7,0.6667,0.79,0.1343,8,18,26,26,157,26,4,1,4,414,0,715,16352,4,26
2012-07-27,fall,2012,July,3,Friday,Workingday,Clear,0.7,0.6667,0.74,0.1642,3,9,12,12,157,12,4,1,4,414,0,697,8174,4,12
2012-07-27,fall,2012,July,4,Friday,Workingday,Clear,0.7,0.6667,0.79,0.0,3,5,8,8,157,8,4,1,4,414,0,697,4428,4,8
2012-07-27,fall,2012,July,5,Friday,Workingday,Clear,0.7,0.6667,0.84,0.0,3,34,37,37,157,37,4,1,4,414,0,717,14261,4,37
2012-07-27,fall,2012,July,6,Friday,Workingday,Clear,0.7,0.6667,0.79,0.0,10,129,139,139,157,139,4,2,4,424,0,725,55132,4,139
2012-07-27,fall,2012,July,7,Friday,Workingday,Clear,0.72,0.6818,0.7,0.194,13,397,410,410,157,410,4,4,4,444,2,727,154171,4,410
2012-07-27,fall,2012,July,8,Friday,Workingday,Clear,0.76,0.7273,0.66,0.0896,34,642,676,676,157,676,4,4,4,444,2,727,261001,4,676
2012-07-27,fall,2012,July,9,Friday,Workingday,Clear,0.82,0.7727,0.49,0.2836,34,329,363,363,157,363,4,4,4,444,2,727,159438,4,363
2012-07-27,fall,2012,July,10,Friday,Workingday,Clear,0.84,0.7727,0.47,0.0,85,146,231,231,157,231,4,3,4,434,2,727,126257,4,231
2012-07-27,fall,2012,July,11,Friday,Workingday,Clear,0.84,0.7727,0.47,0.3284,67,184,251,251,157,251,4,3,4,434,2,727,151320,4,251
2012-07-27,fall,2012,July,12,Friday,Workingday,Clear,0.84,0.7879,0.49,0.3582,92,207,299,299,157,299,4,4,4,444,2,728,184414,4,299
2012-07-27,fall,2012,July,13,Friday,Workingday,Clear,0.84,0.7727,0.47,0.2836,83,231,314,314,157,314,4,4,4,444,2,729,184919,4,314
2012-07-27,fall,2012,July,14,Friday,Workingday,Clear,0.86,0.803,0.47,0.2985,105,221,326,326,157,326,4,4,4,444,2,729,175652,4,326
2012-07-27,fall,2012,July,15,Friday,Workingday,Clear,0.86,0.7879,0.41,0.2239,81,242,323,323,157,323,4,4,4,444,2,729,183149,4,323
2012-07-27,fall,2012,July,16,Friday,Workingday,Clear,0.84,0.7727,0.47,0.2239,80,419,499,499,157,499,4,4,4,444,2,730,227748,4,499
2012-07-27,fall,2012,July,17,Friday,Workingday,Clear,0.86,0.7879,0.41,0.2836,101,598,699,699,157,699,4,4,4,444,2,730,336860,4,699
2012-07-27,fall,2012,July,18,Friday,Workingday,Clear,0.82,0.7576,0.46,0.1642,100,522,622,622,157,622,4,4,4,444,2,728,309772,4,622
2012-07-27,fall,2012,July,19,Friday,Workingday,Clear,0.82,0.7727,0.52,0.194,93,423,516,516,157,516,4,4,4,444,2,728,226789,4,516
2012-07-27,fall,2012,July,20,Friday,Workingday,Clear,0.78,0.7424,0.59,0.1045,85,269,354,354,157,354,4,4,4,444,2,728,164550,4,354
2012-07-27,fall,2012,July,21,Friday,Workingday,Clear,0.78,0.7424,0.59,0.1045,71,189,260,260,157,260,4,3,4,434,2,728,125445,4,260
2012-07-27,fall,2012,July,22,Friday,Workingday,Clear,0.78,0.7424,0.59,0.1343,48,151,199,199,157,199,4,3,4,434,2,728,95612,4,199
2012-07-27,fall,2012,July,23,Friday,Workingday,Clear,0.76,0.7273,0.66,0.0,34,155,189,189,157,189,4,3,4,434,0,728,63941,4,189
2012-07-28,fall,2012,July,0,Saturday,Holiday,Clear,0.74,0.6818,0.62,0.1343,21,170,191,191,156,191,4,3,4,434,0,726,39130,4,191
2012-07-28,fall,2012,July,1,Saturday,Holiday,Clear,0.72,0.6818,0.7,0.0896,11,69,80,80,156,80,4,2,4,424,0,724,24164,4,80
2012-07-28,fall,2012,July,2,Saturday,Holiday,Clear,0.72,0.6818,0.7,0.0,14,76,90,90,156,90,4,2,4,424,0,715,16352,4,90
2012-07-28,fall,2012,July,3,Saturday,Holiday,Clear,0.72,0.6818,0.7,0.0,10,33,43,43,156,43,4,2,4,424,0,697,8174,4,43
2012-07-28,fall,2012,July,4,Saturday,Holiday,Clear,0.7,0.6667,0.79,0.194,1,10,11,11,156,11,4,1,4,414,0,697,4428,4,11
2012-07-28,fall,2012,July,5,Saturday,Holiday,Clear,0.68,0.6364,0.79,0.1642,4,10,14,14,156,14,4,1,4,414,0,717,14261,4,14
2012-07-28,fall,2012,July,6,Saturday,Holiday,Clear,0.7,0.6515,0.7,0.1045,10,40,50,50,156,50,4,2,4,424,0,725,55132,4,50
2012-07-28,fall,2012,July,7,Saturday,Holiday,Clear,0.72,0.6818,0.7,0.1343,18,58,76,76,156,76,4,2,4,424,0,727,154171,4,76
2012-07-28,fall,2012,July,8,Saturday,Holiday,Clear,0.74,0.697,0.66,0.1642,36,127,163,163,156,163,4,3,4,434,0,727,261001,4,163
2012-07-28,fall,2012,July,9,Saturday,Holiday,Clear,0.78,0.7424,0.59,0.1045,110,227,337,337,156,337,4,4,4,444,2,727,159438,4,337
2012-07-28,fall,2012,July,10,Saturday,Holiday,Clear,0.82,0.7727,0.52,0.2239,129,266,395,395,156,395,4,4,4,444,2,727,126257,4,395
2012-07-28,fall,2012,July,11,Saturday,Holiday,Clear,0.84,0.7424,0.39,0.2239,162,295,457,457,156,457,4,4,4,444,2,727,151320,4,457
2012-07-28,fall,2012,July,12,Saturday,Holiday,Clear,0.84,0.7576,0.41,0.2239,157,330,487,487,156,487,4,4,4,444,2,728,184414,4,487
2012-07-28,fall,2012,July,13,Saturday,Holiday,Clear,0.86,0.7879,0.41,0.2836,173,325,498,498,156,498,4,4,4,444,2,729,184919,4,498
2012-07-28,fall,2012,July,14,Saturday,Holiday,Clear,0.86,0.7727,0.39,0.2537,186,308,494,494,156,494,4,4,4,444,2,729,175652,4,494
2012-07-28,fall,2012,July,15,Saturday,Holiday,Clear,0.88,0.7727,0.32,0.2836,206,291,497,497,156,497,4,4,4,444,2,729,183149,4,497
2012-07-28,fall,2012,July,16,Saturday,Holiday,Clear,0.86,0.7727,0.39,0.2239,208,279,487,487,156,487,4,4,4,444,2,730,227748,4,487
2012-07-28,fall,2012,July,17,Saturday,Holiday,Clear,0.82,0.7576,0.46,0.194,199,280,479,479,156,479,4,4,4,444,2,730,336860,4,479
2012-07-28,fall,2012,July,18,Saturday,Holiday,Clear,0.82,0.7424,0.43,0.2836,151,330,481,481,156,481,4,4,4,444,2,728,309772,4,481
2012-07-28,fall,2012,July,19,Saturday,Holiday,Clear,0.68,0.6364,0.83,0.0,115,223,338,338,156,338,4,4,4,444,0,728,226789,4,338
2012-07-28,fall,2012,July,20,Saturday,Holiday,Clear,0.66,0.6061,0.83,0.2239,79,154,233,233,156,233,4,3,3,433,0,728,164550,4,233
2012-07-28,fall,2012,July,21,Saturday,Holiday,Clear,0.66,0.6061,0.78,0.0896,94,206,300,300,156,300,4,4,3,443,0,728,125445,4,300
2012-07-28,fall,2012,July,22,Saturday,Holiday,Clear,0.66,0.6061,0.78,0.0896,88,188,276,276,156,276,4,3,3,433,0,728,95612,4,276
2012-07-28,fall,2012,July,23,Saturday,Holiday,Clear,0.66,0.6061,0.83,0.0896,52,156,208,208,156,208,4,3,3,433,0,728,63941,4,208
2012-07-29,fall,2012,July,0,Sunday,Holiday,Clear,0.66,0.5909,0.89,0.1343,59,129,188,188,155,188,4,3,3,433,0,726,39130,4,188
2012-07-29,fall,2012,July,1,Sunday,Holiday,Clear,0.66,0.6061,0.83,0.1045,49,109,158,158,155,158,4,3,3,433,0,724,24164,4,158
2012-07-29,fall,2012,July,2,Sunday,Holiday,Clear,0.66,0.6212,0.74,0.1343,33,79,112,112,155,112,4,2,3,423,0,715,16352,4,112
2012-07-29,fall,2012,July,3,Sunday,Holiday,Clear,0.66,0.6212,0.69,0.2239,18,37,55,55,155,55,4,2,3,423,0,697,8174,4,55
2012-07-29,fall,2012,July,4,Sunday,Holiday,Clear,0.64,0.6061,0.69,0.194,2,11,13,13,155,13,4,1,3,413,0,697,4428,4,13
2012-07-29,fall,2012,July,5,Sunday,Holiday,Clear,0.62,0.5909,0.78,0.194,3,14,17,17,155,17,4,1,3,413,0,717,14261,4,17
2012-07-29,fall,2012,July,6,Sunday,Holiday,Clear,0.64,0.6061,0.73,0.1642,6,12,18,18,155,18,4,1,3,413,0,725,55132,4,18
2012-07-29,fall,2012,July,7,Sunday,Holiday,Clear,0.66,0.6212,0.69,0.2537,4,36,40,40,155,40,4,1,3,413,0,727,154171,4,40
2012-07-29,fall,2012,July,8,Sunday,Holiday,Clear,0.7,0.6515,0.65,0.2239,37,90,127,127,155,127,4,2,4,424,0,727,261001,4,127
2012-07-29,fall,2012,July,9,Sunday,Holiday,Clear,0.72,0.6818,0.62,0.2537,64,162,226,226,155,226,4,3,4,434,2,727,159438,4,226
2012-07-29,fall,2012,July,10,Sunday,Holiday,Clear,0.74,0.6818,0.62,0.0,123,258,381,381,155,381,4,4,4,444,2,727,126257,4,381
2012-07-29,fall,2012,July,11,Sunday,Holiday,Clear,0.76,0.697,0.55,0.2239,183,326,509,509,155,509,4,4,4,444,2,727,151320,4,509
2012-07-29,fall,2012,July,12,Sunday,Holiday,Clear,0.76,0.697,0.55,0.3284,154,357,511,511,155,511,4,4,4,444,2,728,184414,4,511
2012-07-29,fall,2012,July,13,Sunday,Holiday,Clear,0.8,0.7424,0.49,0.2239,181,302,483,483,155,483,4,4,4,444,2,729,184919,4,483
2012-07-29,fall,2012,July,14,Sunday,Holiday,Clear,0.8,0.7273,0.46,0.194,231,291,522,522,155,522,4,4,4,444,2,729,175652,4,522
2012-07-29,fall,2012,July,15,Sunday,Holiday,Clear,0.8,0.7273,0.43,0.1343,195,306,501,501,155,501,4,4,4,444,2,729,183149,4,501
2012-07-29,fall,2012,July,16,Sunday,Holiday,Clear,0.8,0.7273,0.43,0.1343,191,330,521,521,155,521,4,4,4,444,2,730,227748,4,521
2012-07-29,fall,2012,July,17,Sunday,Holiday,Clear,0.82,0.7424,0.41,0.1642,164,367,531,531,155,531,4,4,4,444,2,730,336860,4,531
2012-07-29,fall,2012,July,18,Sunday,Holiday,Clear,0.8,0.7121,0.41,0.2985,117,302,419,419,155,419,4,4,4,444,2,728,309772,4,419
2012-07-29,fall,2012,July,19,Sunday,Holiday,Clear,0.76,0.697,0.55,0.1642,143,300,443,443,155,443,4,4,4,444,2,728,226789,4,443
2012-07-29,fall,2012,July,20,Sunday,Holiday,Clear,0.74,0.697,0.66,0.1045,75,228,303,303,155,303,4,4,4,444,2,728,164550,4,303
2012-07-29,fall,2012,July,21,Sunday,Holiday,Clear,0.72,0.6818,0.7,0.1343,72,199,271,271,155,271,4,3,4,434,2,728,125445,4,271
2012-07-29,fall,2012,July,22,Sunday,Holiday,Clear,0.7,0.6515,0.7,0.1045,31,117,148,148,155,148,4,3,4,434,0,728,95612,4,148
2012-07-29,fall,2012,July,23,Sunday,Holiday,Clear,0.7,0.6515,0.7,0.0,18,82,100,100,155,100,4,2,4,424,0,728,63941,4,100
2012-07-30,fall,2012,July,0,Monday,Workingday,Clear,0.7,0.6667,0.74,0.0896,12,46,58,58,154,58,4,2,4,424,0,726,39130,4,58
2012-07-30,fall,2012,July,1,Monday,Workingday,Clear,0.7,0.6667,0.74,0.0,4,15,19,19,154,19,4,1,4,414,0,724,24164,4,19
2012-07-30,fall,2012,July,2,Monday,Workingday,Clear,0.68,0.6364,0.74,0.0,2,6,8,8,154,8,4,1,4,414,0,715,16352,4,8
2012-07-30,fall,2012,July,3,Monday,Workingday,Clear,0.66,0.6061,0.83,0.0,0,3,3,3,154,3,4,1,3,413,0,697,8174,4,3
2012-07-30,fall,2012,July,4,Monday,Workingday,Clear,0.66,0.6061,0.83,0.0,0,5,5,5,154,5,4,1,3,413,0,697,4428,4,5
2012-07-30,fall,2012,July,5,Monday,Workingday,Clear,0.66,0.6061,0.83,0.1045,4,43,47,47,154,47,4,2,3,423,0,717,14261,4,47
2012-07-30,fall,2012,July,6,Monday,Workingday,Clear,0.66,0.6061,0.83,0.1642,6,155,161,161,154,161,4,3,3,433,0,725,55132,4,161
2012-07-30,fall,2012,July,7,Monday,Workingday,Clear,0.7,0.6667,0.79,0.0896,14,455,469,469,154,469,4,4,4,444,0,727,154171,4,469
2012-07-30,fall,2012,July,8,Monday,Workingday,Mist,0.72,0.697,0.74,0.1045,31,720,751,751,154,751,4,4,4,444,2,727,261001,4,751
2012-07-30,fall,2012,July,9,Monday,Workingday,Mist,0.74,0.697,0.7,0.0,34,259,293,293,154,293,4,4,4,444,0,727,159438,4,293
2012-07-30,fall,2012,July,10,Monday,Workingday,Mist,0.74,0.697,0.66,0.2239,54,135,189,189,154,189,4,3,4,434,2,727,126257,4,189
2012-07-30,fall,2012,July,11,Monday,Workingday,Mist,0.78,0.7273,0.55,0.1343,69,146,215,215,154,215,4,3,4,434,2,727,151320,4,215
2012-07-30,fall,2012,July,12,Monday,Workingday,Mist,0.76,0.7121,0.58,0.1045,77,201,278,278,154,278,4,3,4,434,2,728,184414,4,278
2012-07-30,fall,2012,July,13,Monday,Workingday,Clear,0.8,0.7424,0.49,0.1642,57,169,226,226,154,226,4,3,4,434,2,729,184919,4,226
2012-07-30,fall,2012,July,14,Monday,Workingday,Clear,0.8,0.7424,0.49,0.2239,87,167,254,254,154,254,4,3,4,434,2,729,175652,4,254
2012-07-30,fall,2012,July,15,Monday,Workingday,Clear,0.8,0.7424,0.49,0.2537,51,185,236,236,154,236,4,3,4,434,2,729,183149,4,236
2012-07-30,fall,2012,July,16,Monday,Workingday,Clear,0.8,0.7424,0.49,0.2836,88,337,425,425,154,425,4,4,4,444,2,730,227748,4,425
2012-07-30,fall,2012,July,17,Monday,Workingday,Clear,0.76,0.697,0.55,0.3284,62,765,827,827,154,827,4,4,4,444,2,730,336860,4,827
2012-07-30,fall,2012,July,18,Monday,Workingday,Clear,0.76,0.7121,0.58,0.4179,77,735,812,812,154,812,4,4,4,444,2,728,309772,4,812
2012-07-30,fall,2012,July,19,Monday,Workingday,Clear,0.82,0.7727,0.52,0.1642,81,584,665,665,154,665,4,4,4,444,2,728,226789,4,665
2012-07-30,fall,2012,July,20,Monday,Workingday,Clear,0.72,0.6818,0.7,0.2239,78,384,462,462,154,462,4,4,4,444,2,728,164550,4,462
2012-07-30,fall,2012,July,21,Monday,Workingday,Clear,0.72,0.6818,0.7,0.194,71,251,322,322,154,322,4,4,4,444,2,728,125445,4,322
2012-07-30,fall,2012,July,22,Monday,Workingday,Mist,0.7,0.6667,0.74,0.2239,47,183,230,230,154,230,4,3,4,434,0,728,95612,4,230
2012-07-30,fall,2012,July,23,Monday,Workingday,Clear,0.7,0.6667,0.74,0.194,34,116,150,150,154,150,4,3,4,434,0,728,63941,4,150
2012-07-31,fall,2012,July,0,Tuesday,Workingday,Clear,0.68,0.6364,0.79,0.1343,11,27,38,38,153,38,4,1,4,414,0,726,39130,4,38
2012-07-31,fall,2012,July,1,Tuesday,Workingday,Clear,0.66,0.6061,0.83,0.1343,3,18,21,21,153,21,4,1,3,413,0,724,24164,4,21
2012-07-31,fall,2012,July,2,Tuesday,Workingday,Clear,0.66,0.6061,0.83,0.1343,0,8,8,8,153,8,4,1,3,413,0,715,16352,4,8
2012-07-31,fall,2012,July,3,Tuesday,Workingday,Clear,0.66,0.6061,0.83,0.0896,1,5,6,6,153,6,4,1,3,413,0,697,8174,4,6
2012-07-31,fall,2012,July,4,Tuesday,Workingday,Clear,0.66,0.6061,0.83,0.0896,0,6,6,6,153,6,4,1,3,413,0,697,4428,4,6
2012-07-31,fall,2012,July,5,Tuesday,Workingday,Clear,0.66,0.6061,0.83,0.1642,5,40,45,45,153,45,4,2,3,423,0,717,14261,4,45
2012-07-31,fall,2012,July,6,Tuesday,Workingday,Clear,0.64,0.5758,0.89,0.1642,2,192,194,194,153,194,4,3,3,433,0,725,55132,4,194
2012-07-31,fall,2012,July,7,Tuesday,Workingday,Clear,0.68,0.6364,0.83,0.2239,21,492,513,513,153,513,4,4,4,444,2,727,154171,4,513
2012-07-31,fall,2012,July,8,Tuesday,Workingday,Clear,0.7,0.6667,0.79,0.1343,30,730,760,760,153,760,4,4,4,444,2,727,261001,4,760
2012-07-31,fall,2012,July,9,Tuesday,Workingday,Clear,0.72,0.6818,0.7,0.1045,31,302,333,333,153,333,4,4,4,444,0,727,159438,4,333
2012-07-31,fall,2012,July,10,Tuesday,Workingday,Clear,0.72,0.6818,0.66,0.0,73,154,227,227,153,227,4,3,4,434,0,727,126257,4,227
2012-07-31,fall,2012,July,11,Tuesday,Workingday,Clear,0.76,0.7121,0.58,0.0,54,170,224,224,153,224,4,3,4,434,2,727,151320,4,224
2012-07-31,fall,2012,July,12,Tuesday,Workingday,Clear,0.8,0.7273,0.46,0.0,50,198,248,248,153,248,4,3,4,434,2,728,184414,4,248
2012-07-31,fall,2012,July,13,Tuesday,Workingday,Clear,0.8,0.7576,0.55,0.2836,69,219,288,288,153,288,4,4,4,444,2,729,184919,4,288
2012-07-31,fall,2012,July,14,Tuesday,Workingday,Clear,0.8,0.7576,0.55,0.2836,72,188,260,260,153,260,4,3,4,434,2,729,175652,4,260
2012-07-31,fall,2012,July,15,Tuesday,Workingday,Clear,0.76,0.7121,0.62,0.1343,29,115,144,144,153,144,4,3,4,434,0,729,183149,4,144
2012-07-31,fall,2012,July,16,Tuesday,Workingday,Clear,0.76,0.7121,0.58,0.2239,66,336,402,402,153,402,4,4,4,444,2,730,227748,4,402
2012-07-31,fall,2012,July,17,Tuesday,Workingday,Clear,0.78,0.7121,0.52,0.2239,94,726,820,820,153,820,4,4,4,444,2,730,336860,4,820
2012-07-31,fall,2012,July,18,Tuesday,Workingday,Clear,0.76,0.697,0.55,0.2836,99,758,857,857,153,857,4,4,4,444,2,728,309772,4,857
2012-07-31,fall,2012,July,19,Tuesday,Workingday,Light Snow,0.74,0.6818,0.62,0.3582,90,524,614,614,153,614,4,4,4,444,2,728,226789,4,614
2012-07-31,fall,2012,July,20,Tuesday,Workingday,Light Snow,0.7,0.6515,0.7,0.194,55,397,452,452,153,452,4,4,4,444,2,728,164550,4,452
2012-07-31,fall,2012,July,21,Tuesday,Workingday,Clear,0.68,0.6364,0.79,0.194,60,292,352,352,153,352,4,4,4,444,2,728,125445,4,352
2012-07-31,fall,2012,July,22,Tuesday,Workingday,Clear,0.68,0.6364,0.74,0.2537,33,224,257,257,153,257,4,3,4,434,0,728,95612,4,257
2012-07-31,fall,2012,July,23,Tuesday,Workingday,Mist,0.66,0.6061,0.83,0.1642,20,127,147,147,153,147,4,3,3,433,0,728,63941,4,147
2012-08-01,fall,2012,August,0,Wednesday,Workingday,Clear,0.68,0.6364,0.79,0.1642,3,44,47,47,152,47,4,2,4,424,0,726,39130,4,47
2012-08-01,fall,2012,August,1,Wednesday,Workingday,Clear,0.66,0.6061,0.83,0.0896,5,28,33,33,152,33,4,1,3,413,0,724,24164,4,33
2012-08-01,fall,2012,August,2,Wednesday,Workingday,Clear,0.64,0.5758,0.83,0.1045,0,13,13,13,152,13,4,1,3,413,0,715,16352,4,13
2012-08-01,fall,2012,August,3,Wednesday,Workingday,Clear,0.64,0.5758,0.83,0.1045,0,7,7,7,152,7,4,1,3,413,0,697,8174,4,7
2012-08-01,fall,2012,August,4,Wednesday,Workingday,Mist,0.64,0.5909,0.78,0.1343,1,3,4,4,152,4,4,1,3,413,0,697,4428,4,4
2012-08-01,fall,2012,August,5,Wednesday,Workingday,Mist,0.64,0.5909,0.78,0.1343,3,46,49,49,152,49,4,2,3,423,0,717,14261,4,49
2012-08-01,fall,2012,August,6,Wednesday,Workingday,Clear,0.64,0.5909,0.78,0.1343,6,179,185,185,152,185,4,3,3,433,0,725,55132,4,185
2012-08-01,fall,2012,August,7,Wednesday,Workingday,Mist,0.64,0.5758,0.83,0.1343,19,468,487,487,152,487,4,4,3,443,0,727,154171,4,487
2012-08-01,fall,2012,August,8,Wednesday,Workingday,Mist,0.66,0.6061,0.78,0.194,32,649,681,681,152,681,4,4,3,443,2,727,261001,4,681
2012-08-01,fall,2012,August,9,Wednesday,Workingday,Mist,0.68,0.6364,0.74,0.0896,34,316,350,350,152,350,4,4,4,444,0,727,159438,4,350
2012-08-01,fall,2012,August,10,Wednesday,Workingday,Clear,0.72,0.6818,0.66,0.0896,61,175,236,236,152,236,4,3,4,434,0,727,126257,4,236
2012-08-01,fall,2012,August,11,Wednesday,Workingday,Clear,0.76,0.7121,0.58,0.0896,54,180,234,234,152,234,4,3,4,434,2,727,151320,4,234
2012-08-01,fall,2012,August,12,Wednesday,Workingday,Clear,0.8,0.7424,0.49,0.1045,75,209,284,284,152,284,4,4,4,444,2,728,184414,4,284
2012-08-01,fall,2012,August,13,Wednesday,Workingday,Clear,0.8,0.7424,0.52,0.1642,59,221,280,280,152,280,4,3,4,434,2,729,184919,4,280
2012-08-01,fall,2012,August,14,Wednesday,Workingday,Clear,0.82,0.7576,0.46,0.1642,88,175,263,263,152,263,4,3,4,434,2,729,175652,4,263
2012-08-01,fall,2012,August,15,Wednesday,Workingday,Clear,0.82,0.7576,0.46,0.1642,89,206,295,295,152,295,4,4,4,444,2,729,183149,4,295
2012-08-01,fall,2012,August,16,Wednesday,Workingday,Clear,0.8,0.7576,0.55,0.2836,93,386,479,479,152,479,4,4,4,444,2,730,227748,4,479
2012-08-01,fall,2012,August,17,Wednesday,Workingday,Clear,0.8,0.7424,0.49,0.1642,103,734,837,837,152,837,4,4,4,444,2,730,336860,4,837
2012-08-01,fall,2012,August,18,Wednesday,Workingday,Light Snow,0.76,0.7121,0.62,0.2239,105,786,891,891,152,891,4,4,4,444,2,728,309772,4,891
2012-08-01,fall,2012,August,19,Wednesday,Workingday,Clear,0.74,0.697,0.66,0.2537,88,564,652,652,152,652,4,4,4,444,2,728,226789,4,652
2012-08-01,fall,2012,August,20,Wednesday,Workingday,Clear,0.74,0.697,0.66,0.1642,65,448,513,513,152,513,4,4,4,444,2,728,164550,4,513
2012-08-01,fall,2012,August,21,Wednesday,Workingday,Clear,0.72,0.6818,0.7,0.1343,36,284,320,320,152,320,4,4,4,444,2,728,125445,4,320
2012-08-01,fall,2012,August,22,Wednesday,Workingday,Clear,0.72,0.6818,0.7,0.1045,37,251,288,288,152,288,4,4,4,444,0,728,95612,4,288
2012-08-01,fall,2012,August,23,Wednesday,Workingday,Clear,0.7,0.6667,0.74,0.0,18,134,152,152,152,152,4,3,4,434,0,728,63941,4,152
2012-08-02,fall,2012,August,0,Thursday,Workingday,Clear,0.7,0.6667,0.74,0.0,8,55,63,63,151,63,4,2,4,424,0,726,39130,4,63
2012-08-02,fall,2012,August,1,Thursday,Workingday,Clear,0.68,0.6364,0.79,0.1045,6,36,42,42,151,42,4,2,4,424,0,724,24164,4,42
2012-08-02,fall,2012,August,2,Thursday,Workingday,Clear,0.66,0.6061,0.83,0.0896,3,8,11,11,151,11,4,1,3,413,0,715,16352,4,11
2012-08-02,fall,2012,August,3,Thursday,Workingday,Clear,0.66,0.6061,0.83,0.0,0,6,6,6,151,6,4,1,3,413,0,697,8174,4,6
2012-08-02,fall,2012,August,4,Thursday,Workingday,Clear,0.66,0.6061,0.83,0.0,0,9,9,9,151,9,4,1,3,413,0,697,4428,4,9
2012-08-02,fall,2012,August,5,Thursday,Workingday,Clear,0.66,0.5909,0.89,0.1343,4,37,41,41,151,41,4,2,3,423,0,717,14261,4,41
2012-08-02,fall,2012,August,6,Thursday,Workingday,Clear,0.66,0.6061,0.83,0.0,6,177,183,183,151,183,4,3,3,433,0,725,55132,4,183
2012-08-02,fall,2012,August,7,Thursday,Workingday,Clear,0.7,0.6667,0.79,0.0,21,452,473,473,151,473,4,4,4,444,0,727,154171,4,473
2012-08-02,fall,2012,August,8,Thursday,Workingday,Clear,0.72,0.697,0.74,0.1045,21,718,739,739,151,739,4,4,4,444,2,727,261001,4,739
2012-08-02,fall,2012,August,9,Thursday,Workingday,Clear,0.76,0.7273,0.66,0.1045,31,312,343,343,151,343,4,4,4,444,2,727,159438,4,343
2012-08-02,fall,2012,August,10,Thursday,Workingday,Clear,0.8,0.7576,0.55,0.0,51,130,181,181,151,181,4,3,4,434,2,727,126257,4,181
2012-08-02,fall,2012,August,11,Thursday,Workingday,Clear,0.82,0.7727,0.52,0.1045,59,167,226,226,151,226,4,3,4,434,2,727,151320,4,226
2012-08-02,fall,2012,August,12,Thursday,Workingday,Clear,0.84,0.7576,0.44,0.1343,56,230,286,286,151,286,4,4,4,444,2,728,184414,4,286
2012-08-02,fall,2012,August,13,Thursday,Workingday,Clear,0.86,0.7879,0.44,0.2239,98,212,310,310,151,310,4,4,4,444,2,729,184919,4,310
2012-08-02,fall,2012,August,14,Thursday,Workingday,Clear,0.86,0.7879,0.41,0.1343,54,171,225,225,151,225,4,3,4,434,2,729,175652,4,225
2012-08-02,fall,2012,August,15,Thursday,Workingday,Clear,0.78,0.7424,0.62,0.4627,68,202,270,270,151,270,4,3,4,434,2,729,183149,4,270
2012-08-02,fall,2012,August,16,Thursday,Workingday,Clear,0.82,0.7576,0.46,0.194,71,335,406,406,151,406,4,4,4,444,2,730,227748,4,406
2012-08-02,fall,2012,August,17,Thursday,Workingday,Clear,0.82,0.7727,0.52,0.2537,90,775,865,865,151,865,4,4,4,444,2,730,336860,4,865
2012-08-02,fall,2012,August,18,Thursday,Workingday,Clear,0.8,0.7727,0.59,0.2239,86,681,767,767,151,767,4,4,4,444,2,728,309772,4,767
2012-08-02,fall,2012,August,19,Thursday,Workingday,Clear,0.8,0.7879,0.63,0.1642,98,509,607,607,151,607,4,4,4,444,2,728,226789,4,607
2012-08-02,fall,2012,August,20,Thursday,Workingday,Clear,0.78,0.7576,0.66,0.0,51,376,427,427,151,427,4,4,4,444,2,728,164550,4,427
2012-08-02,fall,2012,August,21,Thursday,Workingday,Clear,0.76,0.7273,0.66,0.2239,41,301,342,342,151,342,4,4,4,444,2,728,125445,4,342
2012-08-02,fall,2012,August,22,Thursday,Workingday,Clear,0.74,0.697,0.7,0.194,35,227,262,262,151,262,4,3,4,434,0,728,95612,4,262
2012-08-02,fall,2012,August,23,Thursday,Workingday,Clear,0.72,0.6818,0.7,0.2537,25,152,177,177,151,177,4,3,4,434,0,728,63941,4,177
2012-08-03,fall,2012,August,0,Friday,Workingday,Clear,0.72,0.6818,0.7,0.194,15,56,71,71,150,71,4,2,4,424,0,726,39130,4,71
2012-08-03,fall,2012,August,1,Friday,Workingday,Clear,0.7,0.6667,0.74,0.194,11,32,43,43,150,43,4,2,4,424,0,724,24164,4,43
2012-08-03,fall,2012,August,2,Friday,Workingday,Clear,0.68,0.6364,0.79,0.2239,0,14,14,14,150,14,4,1,4,414,0,715,16352,4,14
2012-08-03,fall,2012,August,3,Friday,Workingday,Clear,0.68,0.6364,0.79,0.2239,1,5,6,6,150,6,4,1,4,414,0,697,8174,4,6
2012-08-03,fall,2012,August,4,Friday,Workingday,Clear,0.66,0.6061,0.83,0.2537,1,11,12,12,150,12,4,1,3,413,0,697,4428,4,12
2012-08-03,fall,2012,August,5,Friday,Workingday,Clear,0.66,0.6061,0.83,0.1642,2,35,37,37,150,37,4,1,3,413,0,717,14261,4,37
2012-08-03,fall,2012,August,6,Friday,Workingday,Clear,0.66,0.6061,0.83,0.2239,5,158,163,163,150,163,4,3,3,433,0,725,55132,4,163
2012-08-03,fall,2012,August,7,Friday,Workingday,Clear,0.7,0.6667,0.74,0.1045,25,396,421,421,150,421,4,4,4,444,2,727,154171,4,421
2012-08-03,fall,2012,August,8,Friday,Workingday,Clear,0.72,0.6818,0.7,0.1343,32,636,668,668,150,668,4,4,4,444,2,727,261001,4,668
2012-08-03,fall,2012,August,9,Friday,Workingday,Mist,0.74,0.697,0.66,0.1045,69,327,396,396,150,396,4,4,4,444,2,727,159438,4,396
2012-08-03,fall,2012,August,10,Friday,Workingday,Mist,0.8,0.7424,0.52,0.194,82,167,249,249,150,249,4,3,4,434,2,727,126257,4,249
2012-08-03,fall,2012,August,11,Friday,Workingday,Mist,0.84,0.7879,0.49,0.2836,77,186,263,263,150,263,4,3,4,434,2,727,151320,4,263
2012-08-03,fall,2012,August,12,Friday,Workingday,Mist,0.86,0.8182,0.5,0.2985,95,243,338,338,150,338,4,4,4,444,2,728,184414,4,338
2012-08-03,fall,2012,August,13,Friday,Workingday,Mist,0.86,0.803,0.47,0.2836,98,247,345,345,150,345,4,4,4,444,2,729,184919,4,345
2012-08-03,fall,2012,August,14,Friday,Workingday,Mist,0.86,0.7879,0.44,0.2537,102,229,331,331,150,331,4,4,4,444,2,729,175652,4,331
2012-08-03,fall,2012,August,15,Friday,Workingday,Clear,0.88,0.8182,0.42,0.2537,112,268,380,380,150,380,4,4,4,444,2,729,183149,4,380
2012-08-03,fall,2012,August,16,Friday,Workingday,Mist,0.86,0.7879,0.41,0.2239,112,380,492,492,150,492,4,4,4,444,2,730,227748,4,492
2012-08-03,fall,2012,August,17,Friday,Workingday,Mist,0.84,0.803,0.53,0.2836,95,646,741,741,150,741,4,4,4,444,2,730,336860,4,741
2012-08-03,fall,2012,August,18,Friday,Workingday,Mist,0.82,0.803,0.59,0.2537,98,573,671,671,150,671,4,4,4,444,2,728,309772,4,671
2012-08-03,fall,2012,August,19,Friday,Workingday,Mist,0.8,0.7879,0.63,0.2239,81,388,469,469,150,469,4,4,4,444,2,728,226789,4,469
2012-08-03,fall,2012,August,20,Friday,Workingday,Mist,0.78,0.7576,0.66,0.2239,89,300,389,389,150,389,4,4,4,444,2,728,164550,4,389
2012-08-03,fall,2012,August,21,Friday,Workingday,Mist,0.76,0.7273,0.66,0.194,54,224,278,278,150,278,4,3,4,434,2,728,125445,4,278
2012-08-03,fall,2012,August,22,Friday,Workingday,Clear,0.76,0.7273,0.7,0.2537,46,156,202,202,150,202,4,3,4,434,2,728,95612,4,202
2012-08-03,fall,2012,August,23,Friday,Workingday,Clear,0.74,0.7121,0.79,0.1343,26,170,196,196,150,196,4,3,4,434,0,728,63941,4,196
2012-08-04,fall,2012,August,0,Saturday,Holiday,Clear,0.74,0.7121,0.79,0.1642,24,137,161,161,149,161,4,3,4,434,0,726,39130,4,161
2012-08-04,fall,2012,August,1,Saturday,Holiday,Clear,0.72,0.7121,0.84,0.194,23,99,122,122,149,122,4,2,4,424,0,724,24164,4,122
2012-08-04,fall,2012,August,2,Saturday,Holiday,Clear,0.72,0.7121,0.84,0.1343,20,64,84,84,149,84,4,2,4,424,0,715,16352,4,84
2012-08-04,fall,2012,August,3,Saturday,Holiday,Clear,0.72,0.7121,0.84,0.1343,11,19,30,30,149,30,4,1,4,414,0,697,8174,4,30
2012-08-04,fall,2012,August,4,Saturday,Holiday,Clear,0.72,0.697,0.79,0.194,2,11,13,13,149,13,4,1,4,414,0,697,4428,4,13
2012-08-04,fall,2012,August,5,Saturday,Holiday,Clear,0.7,0.6667,0.84,0.2239,1,16,17,17,149,17,4,1,4,414,0,717,14261,4,17
2012-08-04,fall,2012,August,6,Saturday,Holiday,Clear,0.7,0.6667,0.84,0.2239,12,37,49,49,149,49,4,2,4,424,0,725,55132,4,49
2012-08-04,fall,2012,August,7,Saturday,Holiday,Clear,0.72,0.697,0.77,0.1642,18,49,67,67,149,67,4,2,4,424,0,727,154171,4,67
2012-08-04,fall,2012,August,8,Saturday,Holiday,Clear,0.74,0.7273,0.72,0.194,49,132,181,181,149,181,4,3,4,434,0,727,261001,4,181
2012-08-04,fall,2012,August,9,Saturday,Holiday,Clear,0.78,0.7576,0.65,0.2239,61,217,278,278,149,278,4,3,4,434,2,727,159438,4,278
2012-08-04,fall,2012,August,10,Saturday,Holiday,Clear,0.82,0.7727,0.57,0.194,108,288,396,396,149,396,4,4,4,444,2,727,126257,4,396
2012-08-04,fall,2012,August,11,Saturday,Holiday,Clear,0.86,0.803,0.47,0.2537,155,315,470,470,149,470,4,4,4,444,2,727,151320,4,470
2012-08-04,fall,2012,August,12,Saturday,Holiday,Clear,0.86,0.7879,0.4,0.3582,222,325,547,547,149,547,4,4,4,444,2,728,184414,4,547
2012-08-04,fall,2012,August,13,Saturday,Holiday,Clear,0.88,0.8182,0.42,0.2985,195,332,527,527,149,527,4,4,4,444,2,729,184919,4,527
2012-08-04,fall,2012,August,14,Saturday,Holiday,Clear,0.88,0.803,0.4,0.3881,183,289,472,472,149,472,4,4,4,444,2,729,175652,4,472
2012-08-04,fall,2012,August,15,Saturday,Holiday,Clear,0.88,0.8182,0.42,0.4179,205,284,489,489,149,489,4,4,4,444,2,729,183149,4,489
2012-08-04,fall,2012,August,16,Saturday,Holiday,Clear,0.9,0.8182,0.39,0.2985,197,253,450,450,149,450,4,4,4,444,2,730,227748,4,450
2012-08-04,fall,2012,August,17,Saturday,Holiday,Clear,0.88,0.7879,0.37,0.2985,179,313,492,492,149,492,4,4,4,444,2,730,336860,4,492
2012-08-04,fall,2012,August,18,Saturday,Holiday,Clear,0.86,0.7879,0.41,0.3284,169,321,490,490,149,490,4,4,4,444,2,728,309772,4,490
2012-08-04,fall,2012,August,19,Saturday,Holiday,Clear,0.82,0.7727,0.52,0.3582,133,264,397,397,149,397,4,4,4,444,2,728,226789,4,397
2012-08-04,fall,2012,August,20,Saturday,Holiday,Clear,0.82,0.7727,0.52,0.2985,117,195,312,312,149,312,4,4,4,444,2,728,164550,4,312
2012-08-04,fall,2012,August,21,Saturday,Holiday,Clear,0.8,0.7727,0.59,0.2537,96,193,289,289,149,289,4,4,4,444,2,728,125445,4,289
2012-08-04,fall,2012,August,22,Saturday,Holiday,Clear,0.76,0.7273,0.66,0.2836,104,165,269,269,149,269,4,3,4,434,2,728,95612,4,269
2012-08-04,fall,2012,August,23,Saturday,Holiday,Clear,0.76,0.7273,0.66,0.2985,61,161,222,222,149,222,4,3,4,434,2,728,63941,4,222
2012-08-05,fall,2012,August,0,Sunday,Holiday,Clear,0.74,0.697,0.7,0.2836,32,121,153,153,148,153,4,3,4,434,0,726,39130,4,153
2012-08-05,fall,2012,August,1,Sunday,Holiday,Clear,0.74,0.697,0.7,0.2537,8,79,87,87,148,87,4,2,4,424,0,724,24164,4,87
2012-08-05,fall,2012,August,2,Sunday,Holiday,Clear,0.74,0.697,0.7,0.2985,5,68,73,73,148,73,4,2,4,424,0,715,16352,4,73
2012-08-05,fall,2012,August,3,Sunday,Holiday,Clear,0.72,0.697,0.74,0.2537,9,32,41,41,148,41,4,2,4,424,0,697,8174,4,41
2012-08-05,fall,2012,August,4,Sunday,Holiday,Clear,0.72,0.697,0.74,0.2537,3,11,14,14,148,14,4,1,4,414,0,697,4428,4,14
2012-08-05,fall,2012,August,5,Sunday,Holiday,Clear,0.72,0.697,0.74,0.2537,1,18,19,19,148,19,4,1,4,414,0,717,14261,4,19
2012-08-05,fall,2012,August,6,Sunday,Holiday,Clear,0.72,0.697,0.79,0.2537,7,12,19,19,148,19,4,1,4,414,0,725,55132,4,19
2012-08-05,fall,2012,August,7,Sunday,Holiday,Clear,0.74,0.7121,0.74,0.2985,18,50,68,68,148,68,4,2,4,424,0,727,154171,4,68
2012-08-05,fall,2012,August,8,Sunday,Holiday,Clear,0.76,0.7273,0.66,0.3284,27,81,108,108,148,108,4,2,4,424,0,727,261001,4,108
2012-08-05,fall,2012,August,9,Sunday,Holiday,Clear,0.8,0.7727,0.59,0.3582,61,168,229,229,148,229,4,3,4,434,2,727,159438,4,229
2012-08-05,fall,2012,August,10,Sunday,Holiday,Clear,0.8,0.7727,0.59,0.4179,111,253,364,364,148,364,4,4,4,444,2,727,126257,4,364
2012-08-05,fall,2012,August,11,Sunday,Holiday,Clear,0.82,0.7879,0.56,0.4179,155,282,437,437,148,437,4,4,4,444,2,727,151320,4,437
2012-08-05,fall,2012,August,12,Sunday,Holiday,Clear,0.86,0.803,0.47,0.5224,161,330,491,491,148,491,4,4,4,444,2,728,184414,4,491
2012-08-05,fall,2012,August,13,Sunday,Holiday,Clear,0.88,0.8182,0.44,0.4627,208,315,523,523,148,523,4,4,4,444,2,729,184919,4,523
2012-08-05,fall,2012,August,14,Sunday,Holiday,Clear,0.9,0.8485,0.42,0.4627,161,365,526,526,148,526,4,4,4,444,2,729,175652,4,526
2012-08-05,fall,2012,August,15,Sunday,Holiday,Clear,0.9,0.8182,0.37,0.5224,164,286,450,450,148,450,4,4,4,444,2,729,183149,4,450
2012-08-05,fall,2012,August,16,Sunday,Holiday,Clear,0.82,0.7576,0.46,0.2537,143,278,421,421,148,421,4,4,4,444,2,730,227748,4,421
2012-08-05,fall,2012,August,17,Sunday,Holiday,Clear,0.82,0.7576,0.46,0.2537,122,260,382,382,148,382,4,4,4,444,2,730,336860,4,382
2012-08-05,fall,2012,August,18,Sunday,Holiday,Light Snow,0.7,0.6667,0.74,0.1343,75,154,229,229,148,229,4,3,4,434,0,728,309772,4,229
2012-08-05,fall,2012,August,19,Sunday,Holiday,Clear,0.7,0.6667,0.84,0.2239,46,139,185,185,148,185,4,3,4,434,0,728,226789,4,185
2012-08-05,fall,2012,August,20,Sunday,Holiday,Clear,0.7,0.6667,0.84,0.1045,53,140,193,193,148,193,4,3,4,434,0,728,164550,4,193
2012-08-05,fall,2012,August,21,Sunday,Holiday,Clear,0.72,0.697,0.79,0.1045,51,157,208,208,148,208,4,3,4,434,0,728,125445,4,208
2012-08-05,fall,2012,August,22,Sunday,Holiday,Clear,0.72,0.697,0.79,0.0896,57,100,157,157,148,157,4,3,4,434,0,728,95612,4,157
2012-08-05,fall,2012,August,23,Sunday,Holiday,Mist,0.72,0.697,0.79,0.1642,29,58,87,87,148,87,4,2,4,424,0,728,63941,4,87
2012-08-06,fall,2012,August,0,Monday,Workingday,Mist,0.72,0.697,0.79,0.0,9,24,33,33,147,33,4,1,4,414,0,726,39130,4,33
2012-08-06,fall,2012,August,1,Monday,Workingday,Clear,0.72,0.697,0.79,0.0896,1,10,11,11,147,11,4,1,4,414,0,724,24164,4,11
2012-08-06,fall,2012,August,2,Monday,Workingday,Mist,0.72,0.697,0.79,0.1343,0,5,5,5,147,5,4,1,4,414,0,715,16352,4,5
2012-08-06,fall,2012,August,3,Monday,Workingday,Light Snow,0.72,0.697,0.79,0.0896,0,5,5,5,147,5,4,1,4,414,0,697,8174,4,5
2012-08-06,fall,2012,August,4,Monday,Workingday,Mist,0.72,0.697,0.74,0.1343,3,8,11,11,147,11,4,1,4,414,0,697,4428,4,11
2012-08-06,fall,2012,August,5,Monday,Workingday,Clear,0.7,0.6667,0.79,0.194,2,23,25,25,147,25,4,1,4,414,0,717,14261,4,25
2012-08-06,fall,2012,August,6,Monday,Workingday,Mist,0.7,0.6667,0.79,0.2239,4,137,141,141,147,141,4,2,4,424,0,725,55132,4,141
2012-08-06,fall,2012,August,7,Monday,Workingday,Light Snow,0.72,0.6818,0.7,0.194,14,393,407,407,147,407,4,4,4,444,2,727,154171,4,407
2012-08-06,fall,2012,August,8,Monday,Workingday,Mist,0.7,0.6667,0.79,0.0,27,578,605,605,147,605,4,4,4,444,2,727,261001,4,605
2012-08-06,fall,2012,August,9,Monday,Workingday,Light Snow,0.7,0.6667,0.79,0.1642,28,248,276,276,147,276,4,3,4,434,0,727,159438,4,276
2012-08-06,fall,2012,August,10,Monday,Workingday,Clear,0.74,0.697,0.7,0.2239,54,159,213,213,147,213,4,3,4,434,2,727,126257,4,213
2012-08-06,fall,2012,August,11,Monday,Workingday,Clear,0.76,0.7273,0.66,0.1343,108,152,260,260,147,260,4,3,4,434,2,727,151320,4,260
2012-08-06,fall,2012,August,12,Monday,Workingday,Mist,0.78,0.7273,0.55,0.0896,72,213,285,285,147,285,4,4,4,444,2,728,184414,4,285
2012-08-06,fall,2012,August,13,Monday,Workingday,Clear,0.8,0.7424,0.49,0.2239,85,204,289,289,147,289,4,4,4,444,2,729,184919,4,289
2012-08-06,fall,2012,August,14,Monday,Workingday,Clear,0.82,0.7576,0.46,0.0,99,188,287,287,147,287,4,4,4,444,2,729,175652,4,287
2012-08-06,fall,2012,August,15,Monday,Workingday,Clear,0.82,0.7576,0.46,0.1343,91,183,274,274,147,274,4,3,4,434,2,729,183149,4,274
2012-08-06,fall,2012,August,16,Monday,Workingday,Clear,0.84,0.7576,0.41,0.1045,88,363,451,451,147,451,4,4,4,444,2,730,227748,4,451
2012-08-06,fall,2012,August,17,Monday,Workingday,Clear,0.82,0.7424,0.41,0.0,112,746,858,858,147,858,4,4,4,444,2,730,336860,4,858
2012-08-06,fall,2012,August,18,Monday,Workingday,Clear,0.82,0.7424,0.41,0.1343,100,743,843,843,147,843,4,4,4,444,2,728,309772,4,843
2012-08-06,fall,2012,August,19,Monday,Workingday,Clear,0.78,0.7424,0.59,0.194,109,531,640,640,147,640,4,4,4,444,2,728,226789,4,640
2012-08-06,fall,2012,August,20,Monday,Workingday,Clear,0.76,0.7273,0.66,0.1642,89,368,457,457,147,457,4,4,4,444,2,728,164550,4,457
2012-08-06,fall,2012,August,21,Monday,Workingday,Clear,0.74,0.697,0.7,0.194,72,245,317,317,147,317,4,4,4,444,2,728,125445,4,317
2012-08-06,fall,2012,August,22,Monday,Workingday,Clear,0.74,0.697,0.7,0.0896,50,157,207,207,147,207,4,3,4,434,0,728,95612,4,207
2012-08-06,fall,2012,August,23,Monday,Workingday,Clear,0.72,0.697,0.74,0.194,16,97,113,113,147,113,4,2,4,424,0,728,63941,4,113
2012-08-07,fall,2012,August,0,Tuesday,Workingday,Clear,0.7,0.6667,0.84,0.194,15,32,47,47,146,47,4,2,4,424,0,726,39130,4,47
2012-08-07,fall,2012,August,1,Tuesday,Workingday,Clear,0.7,0.6667,0.84,0.1343,2,16,18,18,146,18,4,1,4,414,0,724,24164,4,18
2012-08-07,fall,2012,August,2,Tuesday,Workingday,Clear,0.7,0.6667,0.84,0.1343,6,7,13,13,146,13,4,1,4,414,0,715,16352,4,13
2012-08-07,fall,2012,August,3,Tuesday,Workingday,Clear,0.7,0.6667,0.84,0.0,0,6,6,6,146,6,4,1,4,414,0,697,8174,4,6
2012-08-07,fall,2012,August,4,Tuesday,Workingday,Clear,0.68,0.6364,0.83,0.1343,2,7,9,9,146,9,4,1,4,414,0,697,4428,4,9
2012-08-07,fall,2012,August,5,Tuesday,Workingday,Clear,0.7,0.6667,0.79,0.1045,3,33,36,36,146,36,4,1,4,414,0,717,14261,4,36
2012-08-07,fall,2012,August,6,Tuesday,Workingday,Mist,0.7,0.6667,0.79,0.194,3,176,179,179,146,179,4,3,4,434,0,725,55132,4,179
2012-08-07,fall,2012,August,7,Tuesday,Workingday,Mist,0.7,0.6667,0.74,0.1343,21,481,502,502,146,502,4,4,4,444,2,727,154171,4,502
2012-08-07,fall,2012,August,8,Tuesday,Workingday,Mist,0.7,0.6515,0.7,0.1642,41,664,705,705,146,705,4,4,4,444,2,727,261001,4,705
2012-08-07,fall,2012,August,9,Tuesday,Workingday,Mist,0.7,0.6667,0.74,0.1343,44,283,327,327,146,327,4,4,4,444,0,727,159438,4,327
2012-08-07,fall,2012,August,10,Tuesday,Workingday,Mist,0.74,0.697,0.7,0.1343,89,161,250,250,146,250,4,3,4,434,2,727,126257,4,250
2012-08-07,fall,2012,August,11,Tuesday,Workingday,Mist,0.76,0.7273,0.66,0.0896,84,130,214,214,146,214,4,3,4,434,2,727,151320,4,214
2012-08-07,fall,2012,August,12,Tuesday,Workingday,Mist,0.8,0.7576,0.55,0.1343,86,197,283,283,146,283,4,4,4,444,2,728,184414,4,283
2012-08-07,fall,2012,August,13,Tuesday,Workingday,Mist,0.8,0.7424,0.52,0.194,68,185,253,253,146,253,4,3,4,434,2,729,184919,4,253
2012-08-07,fall,2012,August,14,Tuesday,Workingday,Mist,0.82,0.7576,0.46,0.0,76,185,261,261,146,261,4,3,4,434,2,729,175652,4,261
2012-08-07,fall,2012,August,15,Tuesday,Workingday,Clear,0.8,0.7424,0.52,0.0,100,206,306,306,146,306,4,4,4,444,2,729,183149,4,306
2012-08-07,fall,2012,August,16,Tuesday,Workingday,Light Snow,0.76,0.7273,0.66,0.2836,101,344,445,445,146,445,4,4,4,444,2,730,227748,4,445
2012-08-07,fall,2012,August,17,Tuesday,Workingday,Mist,0.78,0.7424,0.62,0.1343,125,743,868,868,146,868,4,4,4,444,2,730,336860,4,868
2012-08-07,fall,2012,August,18,Tuesday,Workingday,Mist,0.76,0.7121,0.62,0.1642,103,711,814,814,146,814,4,4,4,444,2,728,309772,4,814
2012-08-07,fall,2012,August,19,Tuesday,Workingday,Mist,0.76,0.7273,0.66,0.1045,104,506,610,610,146,610,4,4,4,444,2,728,226789,4,610
2012-08-07,fall,2012,August,20,Tuesday,Workingday,Mist,0.74,0.697,0.7,0.1343,74,374,448,448,146,448,4,4,4,444,2,728,164550,4,448
2012-08-07,fall,2012,August,21,Tuesday,Workingday,Mist,0.72,0.697,0.74,0.0,70,247,317,317,146,317,4,4,4,444,0,728,125445,4,317
2012-08-07,fall,2012,August,22,Tuesday,Workingday,Clear,0.72,0.697,0.74,0.1045,43,181,224,224,146,224,4,3,4,434,0,728,95612,4,224
2012-08-07,fall,2012,August,23,Tuesday,Workingday,Clear,0.72,0.697,0.79,0.0,18,120,138,138,146,138,4,2,4,424,0,728,63941,4,138
2012-08-08,fall,2012,August,0,Wednesday,Workingday,Clear,0.7,0.6667,0.84,0.0,12,46,58,58,145,58,4,2,4,424,0,726,39130,4,58
2012-08-08,fall,2012,August,1,Wednesday,Workingday,Clear,0.72,0.697,0.79,0.0,3,20,23,23,145,23,4,1,4,414,0,724,24164,4,23
2012-08-08,fall,2012,August,2,Wednesday,Workingday,Clear,0.7,0.6667,0.84,0.0,1,5,6,6,145,6,4,1,4,414,0,715,16352,4,6
2012-08-08,fall,2012,August,3,Wednesday,Workingday,Clear,0.7,0.6667,0.84,0.0,1,6,7,7,145,7,4,1,4,414,0,697,8174,4,7
2012-08-08,fall,2012,August,4,Wednesday,Workingday,Clear,0.7,0.6667,0.84,0.0,1,6,7,7,145,7,4,1,4,414,0,697,4428,4,7
2012-08-08,fall,2012,August,5,Wednesday,Workingday,Mist,0.68,0.6364,0.89,0.1642,3,40,43,43,145,43,4,2,4,424,0,717,14261,4,43
2012-08-08,fall,2012,August,6,Wednesday,Workingday,Mist,0.7,0.6667,0.84,0.1642,4,169,173,173,145,173,4,3,4,434,0,725,55132,4,173
2012-08-08,fall,2012,August,7,Wednesday,Workingday,Mist,0.7,0.6667,0.84,0.1642,24,458,482,482,145,482,4,4,4,444,2,727,154171,4,482
2012-08-08,fall,2012,August,8,Wednesday,Workingday,Mist,0.74,0.7273,0.72,0.0896,48,689,737,737,145,737,4,4,4,444,2,727,261001,4,737
2012-08-08,fall,2012,August,9,Wednesday,Workingday,Mist,0.76,0.7273,0.66,0.0,33,308,341,341,145,341,4,4,4,444,2,727,159438,4,341
2012-08-08,fall,2012,August,10,Wednesday,Workingday,Mist,0.8,0.7424,0.52,0.1343,63,151,214,214,145,214,4,3,4,434,2,727,126257,4,214
2012-08-08,fall,2012,August,11,Wednesday,Workingday,Mist,0.8,0.7424,0.52,0.0,80,159,239,239,145,239,4,3,4,434,2,727,151320,4,239
2012-08-08,fall,2012,August,12,Wednesday,Workingday,Mist,0.8,0.7424,0.52,0.0,63,217,280,280,145,280,4,3,4,434,2,728,184414,4,280
2012-08-08,fall,2012,August,13,Wednesday,Workingday,Mist,0.8,0.7424,0.52,0.0,101,212,313,313,145,313,4,4,4,444,2,729,184919,4,313
2012-08-08,fall,2012,August,14,Wednesday,Workingday,Mist,0.8,0.7424,0.52,0.2537,63,173,236,236,145,236,4,3,4,434,2,729,175652,4,236
2012-08-08,fall,2012,August,15,Wednesday,Workingday,Mist,0.84,0.7576,0.44,0.194,110,168,278,278,145,278,4,3,4,434,2,729,183149,4,278
2012-08-08,fall,2012,August,16,Wednesday,Workingday,Mist,0.8,0.7424,0.49,0.2836,113,328,441,441,145,441,4,4,4,444,2,730,227748,4,441
2012-08-08,fall,2012,August,17,Wednesday,Workingday,Mist,0.8,0.7576,0.55,0.2836,107,751,858,858,145,858,4,4,4,444,2,730,336860,4,858
2012-08-08,fall,2012,August,18,Wednesday,Workingday,Mist,0.78,0.7273,0.55,0.1642,117,745,862,862,145,862,4,4,4,444,2,728,309772,4,862
2012-08-08,fall,2012,August,19,Wednesday,Workingday,Clear,0.76,0.7273,0.66,0.2239,119,567,686,686,145,686,4,4,4,444,2,728,226789,4,686
2012-08-08,fall,2012,August,20,Wednesday,Workingday,Clear,0.74,0.697,0.66,0.194,76,424,500,500,145,500,4,4,4,444,2,728,164550,4,500
2012-08-08,fall,2012,August,21,Wednesday,Workingday,Clear,0.74,0.697,0.66,0.1045,70,311,381,381,145,381,4,4,4,444,2,728,125445,4,381
2012-08-08,fall,2012,August,22,Wednesday,Workingday,Clear,0.72,0.697,0.74,0.1045,35,198,233,233,145,233,4,3,4,434,0,728,95612,4,233
2012-08-08,fall,2012,August,23,Wednesday,Workingday,Clear,0.72,0.6818,0.7,0.1343,16,120,136,136,145,136,4,2,4,424,0,728,63941,4,136
2012-08-09,fall,2012,August,0,Thursday,Workingday,Clear,0.72,0.697,0.74,0.194,16,51,67,67,144,67,4,2,4,424,0,726,39130,4,67
2012-08-09,fall,2012,August,1,Thursday,Workingday,Clear,0.7,0.6667,0.79,0.1343,5,23,28,28,144,28,4,1,4,414,0,724,24164,4,28
2012-08-09,fall,2012,August,2,Thursday,Workingday,Clear,0.7,0.6667,0.84,0.0896,2,12,14,14,144,14,4,1,4,414,0,715,16352,4,14
2012-08-09,fall,2012,August,3,Thursday,Workingday,Clear,0.68,0.6364,0.83,0.0896,1,5,6,6,144,6,4,1,4,414,0,697,8174,4,6
2012-08-09,fall,2012,August,4,Thursday,Workingday,Mist,0.68,0.6364,0.89,0.1343,0,10,10,10,144,10,4,1,4,414,0,697,4428,4,10
2012-08-09,fall,2012,August,5,Thursday,Workingday,Mist,0.66,0.5909,0.94,0.0,4,37,41,41,144,41,4,2,3,423,0,717,14261,4,41
2012-08-09,fall,2012,August,6,Thursday,Workingday,Clear,0.66,0.6061,0.83,0.1642,5,162,167,167,144,167,4,3,3,433,0,725,55132,4,167
2012-08-09,fall,2012,August,7,Thursday,Workingday,Mist,0.7,0.6667,0.84,0.1642,24,451,475,475,144,475,4,4,4,444,2,727,154171,4,475
2012-08-09,fall,2012,August,8,Thursday,Workingday,Clear,0.72,0.697,0.74,0.1045,28,670,698,698,144,698,4,4,4,444,2,727,261001,4,698
2012-08-09,fall,2012,August,9,Thursday,Workingday,Clear,0.76,0.7273,0.66,0.1642,54,299,353,353,144,353,4,4,4,444,2,727,159438,4,353
2012-08-09,fall,2012,August,10,Thursday,Workingday,Clear,0.8,0.7576,0.55,0.2239,72,133,205,205,144,205,4,3,4,434,2,727,126257,4,205
2012-08-09,fall,2012,August,11,Thursday,Workingday,Clear,0.84,0.7576,0.44,0.0,94,166,260,260,144,260,4,3,4,434,2,727,151320,4,260
2012-08-09,fall,2012,August,12,Thursday,Workingday,Clear,0.84,0.7576,0.44,0.1045,85,192,277,277,144,277,4,3,4,434,2,728,184414,4,277
2012-08-09,fall,2012,August,13,Thursday,Workingday,Clear,0.86,0.7879,0.41,0.1045,80,201,281,281,144,281,4,3,4,434,2,729,184919,4,281
2012-08-09,fall,2012,August,14,Thursday,Workingday,Clear,0.88,0.7727,0.32,0.2239,86,161,247,247,144,247,4,3,4,434,2,729,175652,4,247
2012-08-09,fall,2012,August,15,Thursday,Workingday,Clear,0.88,0.7727,0.32,0.2239,63,204,267,267,144,267,4,3,4,434,2,729,183149,4,267
2012-08-09,fall,2012,August,16,Thursday,Workingday,Clear,0.86,0.7727,0.39,0.2537,97,320,417,417,144,417,4,4,4,444,2,730,227748,4,417
2012-08-09,fall,2012,August,17,Thursday,Workingday,Clear,0.86,0.7576,0.36,0.2537,111,699,810,810,144,810,4,4,4,444,2,730,336860,4,810
2012-08-09,fall,2012,August,18,Thursday,Workingday,Mist,0.82,0.7576,0.46,0.2537,78,733,811,811,144,811,4,4,4,444,2,728,309772,4,811
2012-08-09,fall,2012,August,19,Thursday,Workingday,Clear,0.8,0.7576,0.55,0.194,90,533,623,623,144,623,4,4,4,444,2,728,226789,4,623
2012-08-09,fall,2012,August,20,Thursday,Workingday,Clear,0.7,0.6515,0.54,0.2836,91,387,478,478,144,478,4,4,4,444,2,728,164550,4,478
2012-08-09,fall,2012,August,21,Thursday,Workingday,Mist,0.7,0.6515,0.58,0.1642,50,286,336,336,144,336,4,4,4,444,2,728,125445,4,336
2012-08-09,fall,2012,August,22,Thursday,Workingday,Mist,0.66,0.6212,0.69,0.2239,41,218,259,259,144,259,4,3,3,433,0,728,95612,4,259
2012-08-09,fall,2012,August,23,Thursday,Workingday,Clear,0.66,0.6212,0.74,0.0,19,137,156,156,144,156,4,3,3,433,0,728,63941,4,156
2012-08-10,fall,2012,August,0,Friday,Workingday,Clear,0.7,0.6515,0.65,0.0896,17,68,85,85,143,85,4,2,4,424,0,726,39130,4,85
2012-08-10,fall,2012,August,1,Friday,Workingday,Clear,0.7,0.6515,0.65,0.1045,6,35,41,41,143,41,4,2,4,424,0,724,24164,4,41
2012-08-10,fall,2012,August,2,Friday,Workingday,Clear,0.7,0.6667,0.74,0.1642,6,14,20,20,143,20,4,1,4,414,0,715,16352,4,20
2012-08-10,fall,2012,August,3,Friday,Workingday,Mist,0.72,0.697,0.79,0.194,3,6,9,9,143,9,4,1,4,414,0,697,8174,4,9
2012-08-10,fall,2012,August,4,Friday,Workingday,Light Snow,0.7,0.6667,0.84,0.2836,0,7,7,7,143,7,4,1,4,414,0,697,4428,4,7
2012-08-10,fall,2012,August,5,Friday,Workingday,Light Snow,0.7,0.6667,0.84,0.2836,4,29,33,33,143,33,4,1,4,414,0,717,14261,4,33
2012-08-10,fall,2012,August,6,Friday,Workingday,Light Snow,0.64,0.5758,0.89,0.2985,3,41,44,44,143,44,4,2,3,423,0,725,55132,4,44
2012-08-10,fall,2012,August,7,Friday,Workingday,Light Snow,0.64,0.5758,0.89,0.1045,5,128,133,133,143,133,4,2,3,423,0,727,154171,4,133
2012-08-10,fall,2012,August,8,Friday,Workingday,Light Snow,0.62,0.5455,0.91,0.1642,7,112,119,119,143,119,4,2,3,423,0,727,261001,4,119
2012-08-10,fall,2012,August,9,Friday,Workingday,Mist,0.64,0.5758,0.89,0.0,21,199,220,220,143,220,4,3,3,433,0,727,159438,4,220
2012-08-10,fall,2012,August,10,Friday,Workingday,Clear,0.66,0.5909,0.89,0.1045,27,166,193,193,143,193,4,3,3,433,0,727,126257,4,193
2012-08-10,fall,2012,August,11,Friday,Workingday,Light Snow,0.68,0.6364,0.79,0.1343,73,178,251,251,143,251,4,3,4,434,0,727,151320,4,251
2012-08-10,fall,2012,August,12,Friday,Workingday,Mist,0.74,0.697,0.66,0.3582,75,240,315,315,143,315,4,4,4,444,2,728,184414,4,315
2012-08-10,fall,2012,August,13,Friday,Workingday,Mist,0.76,0.7121,0.58,0.3582,66,224,290,290,143,290,4,4,4,444,2,729,184919,4,290
2012-08-10,fall,2012,August,14,Friday,Workingday,Clear,0.76,0.7121,0.58,0.3582,71,236,307,307,143,307,4,4,4,444,2,729,175652,4,307
2012-08-10,fall,2012,August,15,Friday,Workingday,Clear,0.8,0.7424,0.52,0.4478,100,224,324,324,143,324,4,4,4,444,2,729,183149,4,324
2012-08-10,fall,2012,August,16,Friday,Workingday,Clear,0.78,0.7273,0.55,0.2985,96,371,467,467,143,467,4,4,4,444,2,730,227748,4,467
2012-08-10,fall,2012,August,17,Friday,Workingday,Clear,0.8,0.7424,0.52,0.2836,111,619,730,730,143,730,4,4,4,444,2,730,336860,4,730
2012-08-10,fall,2012,August,18,Friday,Workingday,Clear,0.76,0.7121,0.62,0.2985,88,552,640,640,143,640,4,4,4,444,2,728,309772,4,640
2012-08-10,fall,2012,August,19,Friday,Workingday,Clear,0.76,0.7121,0.62,0.2836,98,394,492,492,143,492,4,4,4,444,2,728,226789,4,492
2012-08-10,fall,2012,August,20,Friday,Workingday,Clear,0.74,0.697,0.66,0.2985,55,315,370,370,143,370,4,4,4,444,2,728,164550,4,370
2012-08-10,fall,2012,August,21,Friday,Workingday,Clear,0.74,0.697,0.66,0.2537,50,236,286,286,143,286,4,4,4,444,2,728,125445,4,286
2012-08-10,fall,2012,August,22,Friday,Workingday,Clear,0.72,0.697,0.74,0.2836,50,168,218,218,143,218,4,3,4,434,2,728,95612,4,218
2012-08-10,fall,2012,August,23,Friday,Workingday,Clear,0.72,0.6818,0.7,0.2836,33,159,192,192,143,192,4,3,4,434,0,728,63941,4,192
2012-08-11,fall,2012,August,0,Saturday,Holiday,Clear,0.7,0.6515,0.7,0.2836,38,142,180,180,142,180,4,3,4,434,0,726,39130,4,180
2012-08-11,fall,2012,August,1,Saturday,Holiday,Clear,0.66,0.6212,0.74,0.2239,32,84,116,116,142,116,4,2,3,423,0,724,24164,4,116
2012-08-11,fall,2012,August,2,Saturday,Holiday,Light Snow,0.64,0.5909,0.78,0.194,19,66,85,85,142,85,4,2,3,423,0,715,16352,4,85
2012-08-11,fall,2012,August,3,Saturday,Holiday,Light Snow,0.62,0.5758,0.83,0.1642,2,19,21,21,142,21,4,1,3,413,0,697,8174,4,21
2012-08-11,fall,2012,August,4,Saturday,Holiday,Clear,0.62,0.5758,0.83,0.1045,3,7,10,10,142,10,4,1,3,413,0,697,4428,4,10
2012-08-11,fall,2012,August,5,Saturday,Holiday,Clear,0.62,0.5606,0.88,0.1045,2,9,11,11,142,11,4,1,3,413,0,717,14261,4,11
2012-08-11,fall,2012,August,6,Saturday,Holiday,Mist,0.62,0.5606,0.88,0.1045,5,18,23,23,142,23,4,1,3,413,0,725,55132,4,23
2012-08-11,fall,2012,August,7,Saturday,Holiday,Clear,0.64,0.5758,0.83,0.0896,8,54,62,62,142,62,4,2,3,423,0,727,154171,4,62
2012-08-11,fall,2012,August,8,Saturday,Holiday,Clear,0.66,0.6061,0.83,0.1045,30,132,162,162,142,162,4,3,3,433,0,727,261001,4,162
2012-08-11,fall,2012,August,9,Saturday,Holiday,Clear,0.68,0.6364,0.79,0.194,54,217,271,271,142,271,4,3,4,434,0,727,159438,4,271
2012-08-11,fall,2012,August,10,Saturday,Holiday,Clear,0.72,0.6818,0.62,0.0896,125,282,407,407,142,407,4,4,4,444,2,727,126257,4,407
2012-08-11,fall,2012,August,11,Saturday,Holiday,Clear,0.74,0.697,0.66,0.1642,203,296,499,499,142,499,4,4,4,444,2,727,151320,4,499
2012-08-11,fall,2012,August,12,Saturday,Holiday,Clear,0.76,0.7121,0.58,0.2239,214,332,546,546,142,546,4,4,4,444,2,728,184414,4,546
2012-08-11,fall,2012,August,13,Saturday,Holiday,Clear,0.8,0.7424,0.49,0.3582,228,341,569,569,142,569,4,4,4,444,2,729,184919,4,569
2012-08-11,fall,2012,August,14,Saturday,Holiday,Clear,0.8,0.7424,0.49,0.2985,248,290,538,538,142,538,4,4,4,444,2,729,175652,4,538
2012-08-11,fall,2012,August,15,Saturday,Holiday,Clear,0.8,0.7273,0.46,0.2836,246,316,562,562,142,562,4,4,4,444,2,729,183149,4,562
2012-08-11,fall,2012,August,16,Saturday,Holiday,Clear,0.8,0.7273,0.46,0.2985,227,304,531,531,142,531,4,4,4,444,2,730,227748,4,531
2012-08-11,fall,2012,August,17,Saturday,Holiday,Light Snow,0.74,0.697,0.66,0.3582,220,292,512,512,142,512,4,4,4,444,2,730,336860,4,512
2012-08-11,fall,2012,August,18,Saturday,Holiday,Mist,0.7,0.6667,0.74,0.2985,107,193,300,300,142,300,4,4,4,444,2,728,309772,4,300
2012-08-11,fall,2012,August,19,Saturday,Holiday,Mist,0.66,0.5909,0.89,0.1045,97,178,275,275,142,275,4,3,3,433,0,728,226789,4,275
2012-08-11,fall,2012,August,20,Saturday,Holiday,Light Snow,0.66,0.5909,0.89,0.4179,31,129,160,160,142,160,4,3,3,433,0,728,164550,4,160
2012-08-11,fall,2012,August,21,Saturday,Holiday,Mist,0.66,0.5909,0.89,0.1642,26,102,128,128,142,128,4,2,3,423,0,728,125445,4,128
2012-08-11,fall,2012,August,22,Saturday,Holiday,Mist,0.66,0.5909,0.89,0.1642,40,128,168,168,142,168,4,3,3,433,0,728,95612,4,168
2012-08-11,fall,2012,August,23,Saturday,Holiday,Light Snow,0.66,0.6061,0.78,0.1642,42,121,163,163,142,163,4,3,3,433,0,728,63941,4,163
2012-08-12,fall,2012,August,0,Sunday,Holiday,Mist,0.64,0.6061,0.73,0.1343,24,96,120,120,141,120,4,2,3,423,0,726,39130,4,120
2012-08-12,fall,2012,August,1,Sunday,Holiday,Clear,0.62,0.5909,0.78,0.1343,21,92,113,113,141,113,4,2,3,423,0,724,24164,4,113
2012-08-12,fall,2012,August,2,Sunday,Holiday,Clear,0.64,0.6061,0.69,0.1343,19,67,86,86,141,86,4,2,3,423,0,715,16352,4,86
2012-08-12,fall,2012,August,3,Sunday,Holiday,Clear,0.62,0.5909,0.73,0.0896,11,37,48,48,141,48,4,2,3,423,0,697,8174,4,48
2012-08-12,fall,2012,August,4,Sunday,Holiday,Clear,0.64,0.6061,0.69,0.0896,2,8,10,10,141,10,4,1,3,413,0,697,4428,4,10
2012-08-12,fall,2012,August,5,Sunday,Holiday,Clear,0.64,0.6212,0.61,0.194,1,9,10,10,141,10,4,1,3,413,0,717,14261,4,10
2012-08-12,fall,2012,August,6,Sunday,Holiday,Clear,0.64,0.6061,0.65,0.1642,2,14,16,16,141,16,4,1,3,413,0,725,55132,4,16
2012-08-12,fall,2012,August,7,Sunday,Holiday,Clear,0.64,0.6061,0.65,0.1343,9,30,39,39,141,39,4,1,3,413,0,727,154171,4,39
2012-08-12,fall,2012,August,8,Sunday,Holiday,Clear,0.66,0.6212,0.54,0.2239,35,84,119,119,141,119,4,2,3,423,0,727,261001,4,119
2012-08-12,fall,2012,August,9,Sunday,Holiday,Clear,0.7,0.6515,0.48,0.2239,64,153,217,217,141,217,4,3,4,434,2,727,159438,4,217
2012-08-12,fall,2012,August,10,Sunday,Holiday,Clear,0.7,0.6515,0.51,0.1642,88,240,328,328,141,328,4,4,4,444,2,727,126257,4,328
2012-08-12,fall,2012,August,11,Sunday,Holiday,Clear,0.74,0.6667,0.42,0.1642,167,282,449,449,141,449,4,4,4,444,2,727,151320,4,449
2012-08-12,fall,2012,August,12,Sunday,Holiday,Clear,0.74,0.6667,0.42,0.194,163,342,505,505,141,505,4,4,4,444,2,728,184414,4,505
2012-08-12,fall,2012,August,13,Sunday,Holiday,Clear,0.78,0.697,0.4,0.0,178,365,543,543,141,543,4,4,4,444,2,729,184919,4,543
2012-08-12,fall,2012,August,14,Sunday,Holiday,Clear,0.76,0.6818,0.4,0.194,213,366,579,579,141,579,4,4,4,444,2,729,175652,4,579
2012-08-12,fall,2012,August,15,Sunday,Holiday,Clear,0.76,0.6818,0.4,0.1343,235,342,577,577,141,577,4,4,4,444,2,729,183149,4,577
2012-08-12,fall,2012,August,16,Sunday,Holiday,Clear,0.76,0.6818,0.4,0.1045,213,300,513,513,141,513,4,4,4,444,2,730,227748,4,513
2012-08-12,fall,2012,August,17,Sunday,Holiday,Clear,0.8,0.697,0.33,0.0,186,319,505,505,141,505,4,4,4,444,2,730,336860,4,505
2012-08-12,fall,2012,August,18,Sunday,Holiday,Clear,0.78,0.6818,0.35,0.1045,164,327,491,491,141,491,4,4,4,444,2,728,309772,4,491
2012-08-12,fall,2012,August,19,Sunday,Holiday,Clear,0.74,0.6515,0.4,0.1343,148,317,465,465,141,465,4,4,4,444,2,728,226789,4,465
2012-08-12,fall,2012,August,20,Sunday,Holiday,Clear,0.72,0.6515,0.45,0.0,96,204,300,300,141,300,4,4,4,444,2,728,164550,4,300
2012-08-12,fall,2012,August,21,Sunday,Holiday,Clear,0.72,0.6667,0.51,0.0896,78,142,220,220,141,220,4,3,4,434,2,728,125445,4,220
2012-08-12,fall,2012,August,22,Sunday,Holiday,Clear,0.7,0.6515,0.58,0.1343,40,141,181,181,141,181,4,3,4,434,0,728,95612,4,181
2012-08-12,fall,2012,August,23,Sunday,Holiday,Clear,0.68,0.6364,0.61,0.0,25,85,110,110,141,110,4,2,4,424,0,728,63941,4,110
2012-08-13,fall,2012,August,0,Monday,Workingday,Clear,0.66,0.6212,0.65,0.1045,14,33,47,47,140,47,4,2,3,423,0,726,39130,4,47
2012-08-13,fall,2012,August,1,Monday,Workingday,Clear,0.66,0.6212,0.65,0.0896,3,11,14,14,140,14,4,1,3,413,0,724,24164,4,14
2012-08-13,fall,2012,August,2,Monday,Workingday,Clear,0.64,0.6061,0.69,0.1045,1,8,9,9,140,9,4,1,3,413,0,715,16352,4,9
2012-08-13,fall,2012,August,3,Monday,Workingday,Clear,0.64,0.6061,0.69,0.0,1,5,6,6,140,6,4,1,3,413,0,697,8174,4,6
2012-08-13,fall,2012,August,4,Monday,Workingday,Clear,0.64,0.6061,0.69,0.1045,0,11,11,11,140,11,4,1,3,413,0,697,4428,4,11
2012-08-13,fall,2012,August,5,Monday,Workingday,Clear,0.64,0.6061,0.69,0.1045,3,33,36,36,140,36,4,1,3,413,0,717,14261,4,36
2012-08-13,fall,2012,August,6,Monday,Workingday,Clear,0.62,0.5909,0.73,0.0896,4,155,159,159,140,159,4,3,3,433,0,725,55132,4,159
2012-08-13,fall,2012,August,7,Monday,Workingday,Clear,0.66,0.6212,0.65,0.1343,11,425,436,436,140,436,4,4,3,443,2,727,154171,4,436
2012-08-13,fall,2012,August,8,Monday,Workingday,Mist,0.72,0.6667,0.51,0.0896,25,648,673,673,140,673,4,4,4,444,2,727,261001,4,673
2012-08-13,fall,2012,August,9,Monday,Workingday,Mist,0.74,0.6667,0.45,0.0,40,265,305,305,140,305,4,4,4,444,2,727,159438,4,305
2012-08-13,fall,2012,August,10,Monday,Workingday,Mist,0.76,0.6818,0.4,0.0,88,111,199,199,140,199,4,3,4,434,2,727,126257,4,199
2012-08-13,fall,2012,August,11,Monday,Workingday,Clear,0.76,0.6818,0.4,0.0896,94,151,245,245,140,245,4,3,4,434,2,727,151320,4,245
2012-08-13,fall,2012,August,12,Monday,Workingday,Clear,0.78,0.697,0.4,0.194,96,180,276,276,140,276,4,3,4,434,2,728,184414,4,276
2012-08-13,fall,2012,August,13,Monday,Workingday,Clear,0.78,0.697,0.4,0.1642,79,175,254,254,140,254,4,3,4,434,2,729,184919,4,254
2012-08-13,fall,2012,August,14,Monday,Workingday,Clear,0.8,0.697,0.33,0.1045,85,163,248,248,140,248,4,3,4,434,2,729,175652,4,248
2012-08-13,fall,2012,August,15,Monday,Workingday,Clear,0.82,0.7273,0.34,0.2239,80,194,274,274,140,274,4,3,4,434,2,729,183149,4,274
2012-08-13,fall,2012,August,16,Monday,Workingday,Clear,0.8,0.7121,0.36,0.0896,116,348,464,464,140,464,4,4,4,444,2,730,227748,4,464
2012-08-13,fall,2012,August,17,Monday,Workingday,Clear,0.8,0.7121,0.36,0.1642,102,716,818,818,140,818,4,4,4,444,2,730,336860,4,818
2012-08-13,fall,2012,August,18,Monday,Workingday,Clear,0.76,0.697,0.52,0.2836,103,709,812,812,140,812,4,4,4,444,2,728,309772,4,812
2012-08-13,fall,2012,August,19,Monday,Workingday,Clear,0.74,0.6818,0.58,0.1642,88,467,555,555,140,555,4,4,4,444,2,728,226789,4,555
2012-08-13,fall,2012,August,20,Monday,Workingday,Clear,0.74,0.6818,0.62,0.2239,58,374,432,432,140,432,4,4,4,444,2,728,164550,4,432
2012-08-13,fall,2012,August,21,Monday,Workingday,Clear,0.72,0.6818,0.66,0.194,44,246,290,290,140,290,4,4,4,444,2,728,125445,4,290
2012-08-13,fall,2012,August,22,Monday,Workingday,Clear,0.72,0.6818,0.62,0.3284,44,148,192,192,140,192,4,3,4,434,2,728,95612,4,192
2012-08-13,fall,2012,August,23,Monday,Workingday,Clear,0.7,0.6515,0.7,0.2239,28,100,128,128,140,128,4,2,4,424,0,728,63941,4,128
2012-08-14,fall,2012,August,0,Tuesday,Workingday,Clear,0.7,0.6667,0.74,0.2239,12,48,60,60,139,60,4,2,4,424,0,726,39130,4,60
2012-08-14,fall,2012,August,1,Tuesday,Workingday,Clear,0.68,0.6364,0.79,0.2537,8,19,27,27,139,27,4,1,4,414,0,724,24164,4,27
2012-08-14,fall,2012,August,2,Tuesday,Workingday,Mist,0.68,0.6364,0.83,0.194,2,9,11,11,139,11,4,1,4,414,0,715,16352,4,11
2012-08-14,fall,2012,August,3,Tuesday,Workingday,Mist,0.68,0.6364,0.83,0.194,0,3,3,3,139,3,4,1,4,414,0,697,8174,4,3
2012-08-14,fall,2012,August,4,Tuesday,Workingday,Mist,0.68,0.6364,0.83,0.194,0,5,5,5,139,5,4,1,4,414,0,697,4428,4,5
2012-08-14,fall,2012,August,5,Tuesday,Workingday,Mist,0.68,0.6364,0.89,0.194,1,35,36,36,139,36,4,1,4,414,0,717,14261,4,36
2012-08-14,fall,2012,August,6,Tuesday,Workingday,Light Snow,0.64,0.5758,0.83,0.194,1,63,64,64,139,64,4,2,3,423,0,725,55132,4,64
2012-08-14,fall,2012,August,7,Tuesday,Workingday,Mist,0.66,0.6061,0.83,0.0896,1,178,179,179,139,179,4,3,3,433,0,727,154171,4,179
2012-08-14,fall,2012,August,8,Tuesday,Workingday,Mist,0.66,0.5909,0.89,0.0896,27,591,618,618,139,618,4,4,3,443,2,727,261001,4,618
2012-08-14,fall,2012,August,9,Tuesday,Workingday,Mist,0.7,0.6667,0.74,0.0,48,354,402,402,139,402,4,4,4,444,0,727,159438,4,402
2012-08-14,fall,2012,August,10,Tuesday,Workingday,Clear,0.7,0.6667,0.79,0.1045,53,155,208,208,139,208,4,3,4,434,0,727,126257,4,208
2012-08-14,fall,2012,August,11,Tuesday,Workingday,Clear,0.74,0.6818,0.62,0.0,69,127,196,196,139,196,4,3,4,434,0,727,151320,4,196
2012-08-14,fall,2012,August,12,Tuesday,Workingday,Clear,0.78,0.7121,0.49,0.1343,93,207,300,300,139,300,4,4,4,444,2,728,184414,4,300
2012-08-14,fall,2012,August,13,Tuesday,Workingday,Clear,0.8,0.7273,0.46,0.0896,83,203,286,286,139,286,4,4,4,444,2,729,184919,4,286
2012-08-14,fall,2012,August,14,Tuesday,Workingday,Clear,0.82,0.7424,0.41,0.2239,80,175,255,255,139,255,4,3,4,434,2,729,175652,4,255
2012-08-14,fall,2012,August,15,Tuesday,Workingday,Clear,0.82,0.7576,0.46,0.2239,84,199,283,283,139,283,4,4,4,444,2,729,183149,4,283
2012-08-14,fall,2012,August,16,Tuesday,Workingday,Clear,0.82,0.7424,0.43,0.2239,95,363,458,458,139,458,4,4,4,444,2,730,227748,4,458
2012-08-14,fall,2012,August,17,Tuesday,Workingday,Light Snow,0.76,0.7273,0.66,0.2537,78,734,812,812,139,812,4,4,4,444,2,730,336860,4,812
2012-08-14,fall,2012,August,18,Tuesday,Workingday,Clear,0.76,0.7121,0.62,0.2836,97,757,854,854,139,854,4,4,4,444,2,728,309772,4,854
2012-08-14,fall,2012,August,19,Tuesday,Workingday,Clear,0.76,0.7273,0.66,0.194,94,533,627,627,139,627,4,4,4,444,2,728,226789,4,627
2012-08-14,fall,2012,August,20,Tuesday,Workingday,Clear,0.74,0.7121,0.74,0.2239,65,371,436,436,139,436,4,4,4,444,2,728,164550,4,436
2012-08-14,fall,2012,August,21,Tuesday,Workingday,Clear,0.74,0.6818,0.62,0.2239,56,252,308,308,139,308,4,4,4,444,2,728,125445,4,308
2012-08-14,fall,2012,August,22,Tuesday,Workingday,Clear,0.72,0.6818,0.66,0.0896,28,161,189,189,139,189,4,3,4,434,0,728,95612,4,189
2012-08-14,fall,2012,August,23,Tuesday,Workingday,Clear,0.72,0.6818,0.66,0.1642,53,114,167,167,139,167,4,3,4,434,0,728,63941,4,167
2012-08-15,fall,2012,August,0,Wednesday,Workingday,Clear,0.7,0.6515,0.61,0.194,8,52,60,60,138,60,4,2,4,424,0,726,39130,4,60
2012-08-15,fall,2012,August,1,Wednesday,Workingday,Clear,0.7,0.6515,0.61,0.0,6,31,37,37,138,37,4,1,4,414,0,724,24164,4,37
2012-08-15,fall,2012,August,2,Wednesday,Workingday,Clear,0.68,0.6364,0.65,0.0,1,7,8,8,138,8,4,1,4,414,0,715,16352,4,8
2012-08-15,fall,2012,August,3,Wednesday,Workingday,Clear,0.66,0.6212,0.74,0.1045,1,10,11,11,138,11,4,1,3,413,0,697,8174,4,11
2012-08-15,fall,2012,August,4,Wednesday,Workingday,Clear,0.64,0.5758,0.83,0.1045,0,4,4,4,138,4,4,1,3,413,0,697,4428,4,4
2012-08-15,fall,2012,August,5,Wednesday,Workingday,Clear,0.64,0.5909,0.78,0.1045,4,35,39,39,138,39,4,1,3,413,0,717,14261,4,39
2012-08-15,fall,2012,August,6,Wednesday,Workingday,Clear,0.64,0.5909,0.78,0.1045,12,160,172,172,138,172,4,3,3,433,0,725,55132,4,172
2012-08-15,fall,2012,August,7,Wednesday,Workingday,Mist,0.66,0.6212,0.69,0.194,25,467,492,492,138,492,4,4,3,443,2,727,154171,4,492
2012-08-15,fall,2012,August,8,Wednesday,Workingday,Mist,0.7,0.6515,0.65,0.2836,40,642,682,682,138,682,4,4,4,444,2,727,261001,4,682
2012-08-15,fall,2012,August,9,Wednesday,Workingday,Mist,0.72,0.6818,0.62,0.194,57,310,367,367,138,367,4,4,4,444,2,727,159438,4,367
2012-08-15,fall,2012,August,10,Wednesday,Workingday,Mist,0.72,0.6818,0.62,0.194,70,163,233,233,138,233,4,3,4,434,2,727,126257,4,233
2012-08-15,fall,2012,August,11,Wednesday,Workingday,Mist,0.74,0.6818,0.58,0.194,80,155,235,235,138,235,4,3,4,434,2,727,151320,4,235
2012-08-15,fall,2012,August,12,Wednesday,Workingday,Clear,0.74,0.6818,0.55,0.2239,77,230,307,307,138,307,4,4,4,444,2,728,184414,4,307
2012-08-15,fall,2012,August,13,Wednesday,Workingday,Mist,0.78,0.7121,0.49,0.194,88,206,294,294,138,294,4,4,4,444,2,729,184919,4,294
2012-08-15,fall,2012,August,14,Wednesday,Workingday,Mist,0.76,0.697,0.52,0.2985,94,161,255,255,138,255,4,3,4,434,2,729,175652,4,255
2012-08-15,fall,2012,August,15,Wednesday,Workingday,Clear,0.76,0.697,0.52,0.2537,70,196,266,266,138,266,4,3,4,434,2,729,183149,4,266
2012-08-15,fall,2012,August,16,Wednesday,Workingday,Clear,0.76,0.6818,0.48,0.194,91,340,431,431,138,431,4,4,4,444,2,730,227748,4,431
2012-08-15,fall,2012,August,17,Wednesday,Workingday,Clear,0.74,0.6818,0.55,0.2836,102,749,851,851,138,851,4,4,4,444,2,730,336860,4,851
2012-08-15,fall,2012,August,18,Wednesday,Workingday,Clear,0.74,0.6667,0.51,0.2239,80,768,848,848,138,848,4,4,4,444,2,728,309772,4,848
2012-08-15,fall,2012,August,19,Wednesday,Workingday,Clear,0.7,0.6515,0.61,0.1343,124,525,649,649,138,649,4,4,4,444,2,728,226789,4,649
2012-08-15,fall,2012,August,20,Wednesday,Workingday,Clear,0.7,0.6515,0.61,0.1343,72,355,427,427,138,427,4,4,4,444,2,728,164550,4,427
2012-08-15,fall,2012,August,21,Wednesday,Workingday,Clear,0.7,0.6515,0.61,0.194,49,266,315,315,138,315,4,4,4,444,2,728,125445,4,315
2012-08-15,fall,2012,August,22,Wednesday,Workingday,Clear,0.7,0.6515,0.61,0.1642,29,197,226,226,138,226,4,3,4,434,0,728,95612,4,226
2012-08-15,fall,2012,August,23,Wednesday,Workingday,Clear,0.68,0.6364,0.65,0.1045,18,120,138,138,138,138,4,2,4,424,0,728,63941,4,138
2012-08-16,fall,2012,August,0,Thursday,Workingday,Clear,0.66,0.6212,0.69,0.0,13,63,76,76,137,76,4,2,3,423,0,726,39130,4,76
2012-08-16,fall,2012,August,1,Thursday,Workingday,Clear,0.64,0.6061,0.73,0.0,3,18,21,21,137,21,4,1,3,413,0,724,24164,4,21
2012-08-16,fall,2012,August,2,Thursday,Workingday,Clear,0.64,0.6061,0.69,0.194,0,15,15,15,137,15,4,1,3,413,0,715,16352,4,15
2012-08-16,fall,2012,August,3,Thursday,Workingday,Clear,0.62,0.5909,0.73,0.2537,0,4,4,4,137,4,4,1,3,413,0,697,8174,4,4
2012-08-16,fall,2012,August,4,Thursday,Workingday,Clear,0.62,0.5909,0.73,0.2239,2,3,5,5,137,5,4,1,3,413,0,697,4428,4,5
2012-08-16,fall,2012,August,5,Thursday,Workingday,Clear,0.6,0.5758,0.78,0.1642,7,30,37,37,137,37,4,1,3,413,0,717,14261,4,37
2012-08-16,fall,2012,August,6,Thursday,Workingday,Clear,0.6,0.5758,0.78,0.1642,3,162,165,165,137,165,4,3,3,433,0,725,55132,4,165
2012-08-16,fall,2012,August,7,Thursday,Workingday,Clear,0.64,0.6061,0.69,0.2239,16,448,464,464,137,464,4,4,3,443,2,727,154171,4,464
2012-08-16,fall,2012,August,8,Thursday,Workingday,Clear,0.68,0.6364,0.61,0.194,33,649,682,682,137,682,4,4,4,444,2,727,261001,4,682
2012-08-16,fall,2012,August,9,Thursday,Workingday,Clear,0.72,0.6667,0.54,0.1045,41,296,337,337,137,337,4,4,4,444,2,727,159438,4,337
2012-08-16,fall,2012,August,10,Thursday,Workingday,Clear,0.74,0.6667,0.48,0.1343,78,121,199,199,137,199,4,3,4,434,2,727,126257,4,199
2012-08-16,fall,2012,August,11,Thursday,Workingday,Clear,0.76,0.6667,0.37,0.0896,83,191,274,274,137,274,4,3,4,434,2,727,151320,4,274
2012-08-16,fall,2012,August,12,Thursday,Workingday,Clear,0.8,0.697,0.33,0.1045,96,247,343,343,137,343,4,4,4,444,2,728,184414,4,343
2012-08-16,fall,2012,August,13,Thursday,Workingday,Clear,0.8,0.697,0.31,0.2239,81,219,300,300,137,300,4,4,4,444,2,729,184919,4,300
2012-08-16,fall,2012,August,14,Thursday,Workingday,Clear,0.82,0.7121,0.32,0.0,72,176,248,248,137,248,4,3,4,434,2,729,175652,4,248
2012-08-16,fall,2012,August,15,Thursday,Workingday,Clear,0.8,0.697,0.33,0.2537,63,197,260,260,137,260,4,3,4,434,2,729,183149,4,260
2012-08-16,fall,2012,August,16,Thursday,Workingday,Clear,0.82,0.7121,0.32,0.2239,79,340,419,419,137,419,4,4,4,444,2,730,227748,4,419
2012-08-16,fall,2012,August,17,Thursday,Workingday,Clear,0.82,0.7273,0.34,0.194,130,767,897,897,137,897,4,4,4,444,2,730,336860,4,897
2012-08-16,fall,2012,August,18,Thursday,Workingday,Clear,0.8,0.7121,0.36,0.0,109,723,832,832,137,832,4,4,4,444,2,728,309772,4,832
2012-08-16,fall,2012,August,19,Thursday,Workingday,Clear,0.76,0.6818,0.4,0.1045,119,558,677,677,137,677,4,4,4,444,2,728,226789,4,677
2012-08-16,fall,2012,August,20,Thursday,Workingday,Clear,0.76,0.6818,0.4,0.0896,100,414,514,514,137,514,4,4,4,444,2,728,164550,4,514
2012-08-16,fall,2012,August,21,Thursday,Workingday,Clear,0.74,0.6667,0.48,0.194,83,273,356,356,137,356,4,4,4,444,2,728,125445,4,356
2012-08-16,fall,2012,August,22,Thursday,Workingday,Clear,0.72,0.6667,0.51,0.1642,69,185,254,254,137,254,4,3,4,434,2,728,95612,4,254
2012-08-16,fall,2012,August,23,Thursday,Workingday,Clear,0.7,0.6515,0.54,0.1045,58,168,226,226,137,226,4,3,4,434,2,728,63941,4,226
2012-08-17,fall,2012,August,0,Friday,Workingday,Clear,0.68,0.2424,0.57,0.1642,21,67,88,88,136,88,4,2,1,421,1,726,39130,4,88
2012-08-17,fall,2012,August,1,Friday,Workingday,Clear,0.66,0.2424,0.65,0.1045,16,38,54,54,136,54,4,2,1,421,0,724,24164,4,54
2012-08-17,fall,2012,August,2,Friday,Workingday,Clear,0.66,0.2424,0.61,0.1343,4,15,19,19,136,19,4,1,1,411,0,715,16352,4,19
2012-08-17,fall,2012,August,3,Friday,Workingday,Clear,0.64,0.2424,0.65,0.1045,0,6,6,6,136,6,4,1,1,411,0,697,8174,4,6
2012-08-17,fall,2012,August,4,Friday,Workingday,Clear,0.64,0.2424,0.73,0.1642,0,9,9,9,136,9,4,1,1,411,0,697,4428,4,9
2012-08-17,fall,2012,August,5,Friday,Workingday,Clear,0.64,0.2424,0.73,0.1045,2,34,36,36,136,36,4,1,1,411,0,717,14261,4,36
2012-08-17,fall,2012,August,6,Friday,Workingday,Clear,0.62,0.2424,0.78,0.1343,6,151,157,157,136,157,4,3,1,431,0,725,55132,4,157
2012-08-17,fall,2012,August,7,Friday,Workingday,Clear,0.64,0.2424,0.73,0.1045,11,368,379,379,136,379,4,4,1,441,0,727,154171,4,379
2012-08-17,fall,2012,August,8,Friday,Workingday,Clear,0.68,0.2424,0.65,0.1343,43,625,668,668,136,668,4,4,1,441,2,727,261001,4,668
2012-08-17,fall,2012,August,9,Friday,Workingday,Clear,0.7,0.2424,0.58,0.1045,58,320,378,378,136,378,4,4,1,441,2,727,159438,4,378
2012-08-17,fall,2012,August,10,Friday,Workingday,Clear,0.74,0.2424,0.55,0.1642,82,149,231,231,136,231,4,3,1,431,2,727,126257,4,231
2012-08-17,fall,2012,August,11,Friday,Workingday,Clear,0.76,0.2424,0.52,0.2836,98,205,303,303,136,303,4,4,1,441,2,727,151320,4,303
2012-08-17,fall,2012,August,12,Friday,Workingday,Clear,0.82,0.2424,0.41,0.2239,110,255,365,365,136,365,4,4,1,441,2,728,184414,4,365
2012-08-17,fall,2012,August,13,Friday,Workingday,Clear,0.84,0.2424,0.36,0.3881,103,254,357,357,136,357,4,4,1,441,2,729,184919,4,357
2012-08-17,fall,2012,August,14,Friday,Workingday,Clear,0.86,0.2424,0.34,0.4179,128,200,328,328,136,328,4,4,1,441,2,729,175652,4,328
2012-08-17,fall,2012,August,15,Friday,Workingday,Clear,0.86,0.2424,0.3,0.4627,127,256,383,383,136,383,4,4,1,441,2,729,183149,4,383
2012-08-17,fall,2012,August,16,Friday,Workingday,Mist,0.84,0.2424,0.32,0.4478,116,372,488,488,136,488,4,4,1,441,2,730,227748,4,488
2012-08-17,fall,2012,August,17,Friday,Workingday,Clear,0.82,0.2424,0.36,0.3284,144,647,791,791,136,791,4,4,1,441,2,730,336860,4,791
2012-08-17,fall,2012,August,18,Friday,Workingday,Mist,0.82,0.2424,0.38,0.2537,108,561,669,669,136,669,4,4,1,441,2,728,309772,4,669
2012-08-17,fall,2012,August,19,Friday,Workingday,Mist,0.74,0.2424,0.55,0.3881,88,403,491,491,136,491,4,4,1,441,2,728,226789,4,491
2012-08-17,fall,2012,August,20,Friday,Workingday,Mist,0.72,0.2424,0.58,0.2239,97,262,359,359,136,359,4,4,1,441,2,728,164550,4,359
2012-08-17,fall,2012,August,21,Friday,Workingday,Mist,0.68,0.2424,0.69,0.2985,57,198,255,255,136,255,4,3,1,431,1,728,125445,4,255
2012-08-17,fall,2012,August,22,Friday,Workingday,Light Snow,0.66,0.2424,0.83,0.194,43,170,213,213,136,213,4,3,1,431,0,728,95612,4,213
2012-08-17,fall,2012,August,23,Friday,Workingday,Light Snow,0.64,0.2424,0.83,0.2239,21,100,121,121,136,121,4,2,1,421,0,728,63941,4,121
2012-08-18,fall,2012,August,0,Saturday,Holiday,Mist,0.64,0.5758,0.83,0.2239,6,99,105,105,135,105,4,2,3,423,0,726,39130,4,105
2012-08-18,fall,2012,August,1,Saturday,Holiday,Light Snow,0.62,0.5455,0.94,0.1642,14,78,92,92,135,92,4,2,3,423,0,724,24164,4,92
2012-08-18,fall,2012,August,2,Saturday,Holiday,Light Snow,0.62,0.5606,0.88,0.1642,4,39,43,43,135,43,4,2,3,423,0,715,16352,4,43
2012-08-18,fall,2012,August,3,Saturday,Holiday,Clear,0.62,0.5606,0.88,0.194,7,23,30,30,135,30,4,1,3,413,0,697,8174,4,30
2012-08-18,fall,2012,August,4,Saturday,Holiday,Clear,0.62,0.5909,0.73,0.2239,5,8,13,13,135,13,4,1,3,413,0,697,4428,4,13
2012-08-18,fall,2012,August,5,Saturday,Holiday,Clear,0.6,0.5758,0.78,0.2537,2,7,9,9,135,9,4,1,3,413,0,717,14261,4,9
2012-08-18,fall,2012,August,6,Saturday,Holiday,Clear,0.6,0.5606,0.83,0.2239,4,23,27,27,135,27,4,1,3,413,0,725,55132,4,27
2012-08-18,fall,2012,August,7,Saturday,Holiday,Clear,0.6,0.5606,0.83,0.2239,12,52,64,64,135,64,4,2,3,423,0,727,154171,4,64
2012-08-18,fall,2012,August,8,Saturday,Holiday,Clear,0.64,0.6061,0.69,0.2537,28,161,189,189,135,189,4,3,3,433,0,727,261001,4,189
2012-08-18,fall,2012,August,9,Saturday,Holiday,Clear,0.66,0.6212,0.65,0.2836,81,211,292,292,135,292,4,4,3,443,2,727,159438,4,292
2012-08-18,fall,2012,August,10,Saturday,Holiday,Clear,0.7,0.6515,0.54,0.1642,166,314,480,480,135,480,4,4,4,444,2,727,126257,4,480
2012-08-18,fall,2012,August,11,Saturday,Holiday,Clear,0.72,0.6667,0.51,0.0,180,356,536,536,135,536,4,4,4,444,2,727,151320,4,536
2012-08-18,fall,2012,August,12,Saturday,Holiday,Clear,0.76,0.6667,0.37,0.194,266,388,654,654,135,654,4,4,4,444,2,728,184414,4,654
2012-08-18,fall,2012,August,13,Saturday,Holiday,Clear,0.74,0.6515,0.4,0.194,289,355,644,644,135,644,4,4,4,444,2,729,184919,4,644
2012-08-18,fall,2012,August,14,Saturday,Holiday,Clear,0.76,0.6667,0.37,0.2836,242,356,598,598,135,598,4,4,4,444,2,729,175652,4,598
2012-08-18,fall,2012,August,15,Saturday,Holiday,Clear,0.76,0.6667,0.37,0.2239,250,346,596,596,135,596,4,4,4,444,2,729,183149,4,596
2012-08-18,fall,2012,August,16,Saturday,Holiday,Clear,0.76,0.6667,0.37,0.2537,287,354,641,641,135,641,4,4,4,444,2,730,227748,4,641
2012-08-18,fall,2012,August,17,Saturday,Holiday,Clear,0.76,0.6667,0.37,0.2239,256,379,635,635,135,635,4,4,4,444,2,730,336860,4,635
2012-08-18,fall,2012,August,18,Saturday,Holiday,Clear,0.74,0.6515,0.37,0.1642,225,329,554,554,135,554,4,4,4,444,2,728,309772,4,554
2012-08-18,fall,2012,August,19,Saturday,Holiday,Clear,0.7,0.6364,0.45,0.1642,164,324,488,488,135,488,4,4,4,444,2,728,226789,4,488
2012-08-18,fall,2012,August,20,Saturday,Holiday,Clear,0.7,0.6364,0.45,0.1045,99,242,341,341,135,341,4,4,4,444,2,728,164550,4,341
2012-08-18,fall,2012,August,21,Saturday,Holiday,Clear,0.66,0.6212,0.61,0.0,90,248,338,338,135,338,4,4,3,443,2,728,125445,4,338
2012-08-18,fall,2012,August,22,Saturday,Holiday,Clear,0.66,0.6212,0.61,0.0,90,171,261,261,135,261,4,3,3,433,2,728,95612,4,261
2012-08-18,fall,2012,August,23,Saturday,Holiday,Clear,0.64,0.6061,0.65,0.0896,60,175,235,235,135,235,4,3,3,433,0,728,63941,4,235
2012-08-19,fall,2012,August,0,Sunday,Holiday,Clear,0.66,0.6212,0.57,0.0896,44,143,187,187,134,187,4,3,3,433,0,726,39130,4,187
2012-08-19,fall,2012,August,1,Sunday,Holiday,Clear,0.64,0.6061,0.65,0.0,29,102,131,131,134,131,4,2,3,423,0,724,24164,4,131
2012-08-19,fall,2012,August,2,Sunday,Holiday,Mist,0.62,0.6061,0.69,0.0896,16,103,119,119,134,119,4,2,3,423,0,715,16352,4,119
2012-08-19,fall,2012,August,3,Sunday,Holiday,Mist,0.62,0.6061,0.61,0.1642,21,34,55,55,134,55,4,2,3,423,0,697,8174,4,55
2012-08-19,fall,2012,August,4,Sunday,Holiday,Mist,0.62,0.6061,0.65,0.1642,4,22,26,26,134,26,4,1,3,413,0,697,4428,4,26
2012-08-19,fall,2012,August,5,Sunday,Holiday,Mist,0.6,0.5909,0.73,0.1343,3,8,11,11,134,11,4,1,3,413,0,717,14261,4,11
2012-08-19,fall,2012,August,6,Sunday,Holiday,Mist,0.62,0.6061,0.69,0.1045,5,15,20,20,134,20,4,1,3,413,0,725,55132,4,20
2012-08-19,fall,2012,August,7,Sunday,Holiday,Mist,0.62,0.6061,0.69,0.1343,12,29,41,41,134,41,4,2,3,423,0,727,154171,4,41
2012-08-19,fall,2012,August,8,Sunday,Holiday,Mist,0.64,0.6061,0.69,0.1045,34,90,124,124,134,124,4,2,3,423,0,727,261001,4,124
2012-08-19,fall,2012,August,9,Sunday,Holiday,Mist,0.66,0.6212,0.74,0.0,86,184,270,270,134,270,4,3,3,433,0,727,159438,4,270
2012-08-19,fall,2012,August,10,Sunday,Holiday,Mist,0.68,0.6364,0.69,0.0,138,287,425,425,134,425,4,4,4,444,2,727,126257,4,425
2012-08-19,fall,2012,August,11,Sunday,Holiday,Light Snow,0.64,0.5909,0.78,0.1642,83,189,272,272,134,272,4,3,3,433,0,727,151320,4,272
2012-08-19,fall,2012,August,12,Sunday,Holiday,Light Snow,0.64,0.6061,0.73,0.0,112,186,298,298,134,298,4,4,3,443,2,728,184414,4,298
2012-08-19,fall,2012,August,13,Sunday,Holiday,Light Snow,0.64,0.5758,0.83,0.1343,50,112,162,162,134,162,4,3,3,433,0,729,184919,4,162
2012-08-19,fall,2012,August,14,Sunday,Holiday,Light Snow,0.64,0.6061,0.73,0.0,41,108,149,149,134,149,4,3,3,433,0,729,175652,4,149
2012-08-19,fall,2012,August,15,Sunday,Holiday,Mist,0.64,0.6061,0.65,0.0,89,187,276,276,134,276,4,3,3,433,2,729,183149,4,276
2012-08-19,fall,2012,August,16,Sunday,Holiday,Mist,0.66,0.6212,0.65,0.0,97,259,356,356,134,356,4,4,3,443,2,730,227748,4,356
2012-08-19,fall,2012,August,17,Sunday,Holiday,Mist,0.64,0.5909,0.78,0.1045,76,267,343,343,134,343,4,4,3,443,0,730,336860,4,343
2012-08-19,fall,2012,August,18,Sunday,Holiday,Mist,0.64,0.5909,0.78,0.1045,86,291,377,377,134,377,4,4,3,443,2,728,309772,4,377
2012-08-19,fall,2012,August,19,Sunday,Holiday,Mist,0.64,0.6061,0.73,0.1343,72,269,341,341,134,341,4,4,3,443,2,728,226789,4,341
2012-08-19,fall,2012,August,20,Sunday,Holiday,Mist,0.64,0.6061,0.73,0.194,61,213,274,274,134,274,4,3,3,433,0,728,164550,4,274
2012-08-19,fall,2012,August,21,Sunday,Holiday,Light Snow,0.62,0.5909,0.78,0.0896,36,154,190,190,134,190,4,3,3,433,0,728,125445,4,190
2012-08-19,fall,2012,August,22,Sunday,Holiday,Mist,0.62,0.5909,0.78,0.1642,6,50,56,56,134,56,4,2,3,423,0,728,95612,4,56
2012-08-19,fall,2012,August,23,Sunday,Holiday,Mist,0.62,0.5909,0.73,0.0,7,39,46,46,134,46,4,2,3,423,0,728,63941,4,46
2012-08-20,fall,2012,August,0,Monday,Workingday,Mist,0.6,0.5606,0.83,0.1045,1,25,26,26,133,26,4,1,3,413,0,726,39130,4,26
2012-08-20,fall,2012,August,1,Monday,Workingday,Clear,0.6,0.5606,0.83,0.1642,0,10,10,10,133,10,4,1,3,413,0,724,24164,4,10
2012-08-20,fall,2012,August,2,Monday,Workingday,Clear,0.6,0.5606,0.83,0.1642,0,5,5,5,133,5,4,1,3,413,0,715,16352,4,5
2012-08-20,fall,2012,August,3,Monday,Workingday,Clear,0.6,0.5455,0.88,0.1045,0,3,3,3,133,3,4,1,3,413,0,697,8174,4,3
2012-08-20,fall,2012,August,4,Monday,Workingday,Mist,0.6,0.5606,0.83,0.0896,0,7,7,7,133,7,4,1,3,413,0,697,4428,4,7
2012-08-20,fall,2012,August,5,Monday,Workingday,Mist,0.6,0.5606,0.83,0.0,2,35,37,37,133,37,4,1,3,413,0,717,14261,4,37
2012-08-20,fall,2012,August,6,Monday,Workingday,Mist,0.6,0.5758,0.78,0.1343,6,155,161,161,133,161,4,3,3,433,0,725,55132,4,161
2012-08-20,fall,2012,August,7,Monday,Workingday,Mist,0.62,0.5909,0.78,0.1343,15,427,442,442,133,442,4,4,3,443,0,727,154171,4,442
2012-08-20,fall,2012,August,8,Monday,Workingday,Mist,0.62,0.5909,0.73,0.1045,37,618,655,655,133,655,4,4,3,443,2,727,261001,4,655
2012-08-20,fall,2012,August,9,Monday,Workingday,Mist,0.64,0.6061,0.69,0.0,55,302,357,357,133,357,4,4,3,443,0,727,159438,4,357
2012-08-20,fall,2012,August,10,Monday,Workingday,Mist,0.64,0.6061,0.69,0.0896,69,124,193,193,133,193,4,3,3,433,0,727,126257,4,193
2012-08-20,fall,2012,August,11,Monday,Workingday,Clear,0.66,0.6212,0.65,0.1045,90,151,241,241,133,241,4,3,3,433,2,727,151320,4,241
2012-08-20,fall,2012,August,12,Monday,Workingday,Mist,0.66,0.6212,0.61,0.1045,66,216,282,282,133,282,4,4,3,443,2,728,184414,4,282
2012-08-20,fall,2012,August,13,Monday,Workingday,Clear,0.7,0.6515,0.58,0.1343,97,194,291,291,133,291,4,4,4,444,2,729,184919,4,291
2012-08-20,fall,2012,August,14,Monday,Workingday,Clear,0.72,0.6667,0.54,0.1642,87,188,275,275,133,275,4,3,4,434,2,729,175652,4,275
2012-08-20,fall,2012,August,15,Monday,Workingday,Clear,0.72,0.6667,0.54,0.2537,102,207,309,309,133,309,4,4,4,444,2,729,183149,4,309
2012-08-20,fall,2012,August,16,Monday,Workingday,Clear,0.72,0.6667,0.54,0.2537,103,357,460,460,133,460,4,4,4,444,2,730,227748,4,460
2012-08-20,fall,2012,August,17,Monday,Workingday,Clear,0.7,0.6515,0.58,0.2836,83,810,893,893,133,893,4,4,4,444,2,730,336860,4,893
2012-08-20,fall,2012,August,18,Monday,Workingday,Mist,0.62,0.5909,0.78,0.2537,89,726,815,815,133,815,4,4,3,443,2,728,309772,4,815
2012-08-20,fall,2012,August,19,Monday,Workingday,Mist,0.62,0.5909,0.78,0.194,33,266,299,299,133,299,4,4,3,443,0,728,226789,4,299
2012-08-20,fall,2012,August,20,Monday,Workingday,Mist,0.62,0.5758,0.83,0.2836,30,231,261,261,133,261,4,3,3,433,0,728,164550,4,261
2012-08-20,fall,2012,August,21,Monday,Workingday,Clear,0.6,0.5606,0.83,0.0,26,219,245,245,133,245,4,3,3,433,0,728,125445,4,245
2012-08-20,fall,2012,August,22,Monday,Workingday,Mist,0.6,0.5606,0.83,0.0,25,136,161,161,133,161,4,3,3,433,0,728,95612,4,161
2012-08-20,fall,2012,August,23,Monday,Workingday,Mist,0.6,0.5606,0.83,0.0,10,92,102,102,133,102,4,2,3,423,0,728,63941,4,102
2012-08-21,fall,2012,August,0,Tuesday,Workingday,Mist,0.6,0.5606,0.83,0.0896,7,52,59,59,132,59,4,2,3,423,0,726,39130,4,59
2012-08-21,fall,2012,August,1,Tuesday,Workingday,Mist,0.6,0.5606,0.83,0.1343,11,22,33,33,132,33,4,1,3,413,0,724,24164,4,33
2012-08-21,fall,2012,August,2,Tuesday,Workingday,Mist,0.58,0.5455,0.88,0.2836,1,7,8,8,132,8,4,1,3,413,0,715,16352,4,8
2012-08-21,fall,2012,August,3,Tuesday,Workingday,Clear,0.56,0.5303,0.88,0.0,0,3,3,3,132,3,4,1,3,413,0,697,8174,4,3
2012-08-21,fall,2012,August,4,Tuesday,Workingday,Clear,0.56,0.5303,0.88,0.0,0,4,4,4,132,4,4,1,3,413,0,697,4428,4,4
2012-08-21,fall,2012,August,5,Tuesday,Workingday,Clear,0.56,0.5303,0.83,0.0896,4,30,34,34,132,34,4,1,3,413,0,717,14261,4,34
2012-08-21,fall,2012,August,6,Tuesday,Workingday,Clear,0.56,0.5303,0.83,0.1045,5,164,169,169,132,169,4,3,3,433,0,725,55132,4,169
2012-08-21,fall,2012,August,7,Tuesday,Workingday,Clear,0.6,0.5758,0.78,0.1045,19,500,519,519,132,519,4,4,3,443,0,727,154171,4,519
2012-08-21,fall,2012,August,8,Tuesday,Workingday,Clear,0.6,0.5758,0.78,0.1343,27,696,723,723,132,723,4,4,3,443,2,727,261001,4,723
2012-08-21,fall,2012,August,9,Tuesday,Workingday,Clear,0.64,0.6061,0.69,0.0,47,281,328,328,132,328,4,4,3,443,0,727,159438,4,328
2012-08-21,fall,2012,August,10,Tuesday,Workingday,Clear,0.66,0.6212,0.61,0.1045,58,120,178,178,132,178,4,3,3,433,0,727,126257,4,178
2012-08-21,fall,2012,August,11,Tuesday,Workingday,Clear,0.7,0.6515,0.54,0.0,61,195,256,256,132,256,4,3,4,434,2,727,151320,4,256
2012-08-21,fall,2012,August,12,Tuesday,Workingday,Clear,0.72,0.6515,0.45,0.0,79,226,305,305,132,305,4,4,4,444,2,728,184414,4,305
2012-08-21,fall,2012,August,13,Tuesday,Workingday,Clear,0.74,0.6515,0.4,0.0,76,255,331,331,132,331,4,4,4,444,2,729,184919,4,331
2012-08-21,fall,2012,August,14,Tuesday,Workingday,Clear,0.76,0.6667,0.37,0.0896,110,192,302,302,132,302,4,4,4,444,2,729,175652,4,302
2012-08-21,fall,2012,August,15,Tuesday,Workingday,Clear,0.76,0.6667,0.37,0.0,76,226,302,302,132,302,4,4,4,444,2,729,183149,4,302
2012-08-21,fall,2012,August,16,Tuesday,Workingday,Clear,0.76,0.6667,0.37,0.0,109,358,467,467,132,467,4,4,4,444,2,730,227748,4,467
2012-08-21,fall,2012,August,17,Tuesday,Workingday,Clear,0.74,0.6667,0.51,0.2836,92,786,878,878,132,878,4,4,4,444,2,730,336860,4,878
2012-08-21,fall,2012,August,18,Tuesday,Workingday,Clear,0.72,0.6667,0.54,0.2239,93,532,625,625,132,625,4,4,4,444,2,728,309772,4,625
2012-08-21,fall,2012,August,19,Tuesday,Workingday,Light Snow,0.62,0.5909,0.73,0.1045,56,420,476,476,132,476,4,4,3,443,2,728,226789,4,476
2012-08-21,fall,2012,August,20,Tuesday,Workingday,Clear,0.64,0.6061,0.73,0.0,62,296,358,358,132,358,4,4,3,443,0,728,164550,4,358
2012-08-21,fall,2012,August,21,Tuesday,Workingday,Clear,0.64,0.6061,0.73,0.0,41,239,280,280,132,280,4,3,3,433,0,728,125445,4,280
2012-08-21,fall,2012,August,22,Tuesday,Workingday,Clear,0.64,0.5909,0.78,0.0,24,208,232,232,132,232,4,3,3,433,0,728,95612,4,232
2012-08-21,fall,2012,August,23,Tuesday,Workingday,Clear,0.62,0.5758,0.83,0.0,23,113,136,136,132,136,4,2,3,423,0,728,63941,4,136
2012-08-22,fall,2012,August,0,Wednesday,Workingday,Clear,0.62,0.5758,0.83,0.1045,9,46,55,55,131,55,4,2,3,423,0,726,39130,4,55
2012-08-22,fall,2012,August,1,Wednesday,Workingday,Clear,0.62,0.5909,0.78,0.0,1,20,21,21,131,21,4,1,3,413,0,724,24164,4,21
2012-08-22,fall,2012,August,2,Wednesday,Workingday,Clear,0.62,0.5909,0.78,0.0,7,10,17,17,131,17,4,1,3,413,0,715,16352,4,17
2012-08-22,fall,2012,August,3,Wednesday,Workingday,Clear,0.62,0.5909,0.78,0.0,0,7,7,7,131,7,4,1,3,413,0,697,8174,4,7
2012-08-22,fall,2012,August,4,Wednesday,Workingday,Clear,0.58,0.5455,0.83,0.1045,1,7,8,8,131,8,4,1,3,413,0,697,4428,4,8
2012-08-22,fall,2012,August,5,Wednesday,Workingday,Clear,0.6,0.5758,0.78,0.0,2,38,40,40,131,40,4,1,3,413,0,717,14261,4,40
2012-08-22,fall,2012,August,6,Wednesday,Workingday,Clear,0.62,0.5909,0.73,0.0,12,175,187,187,131,187,4,3,3,433,0,725,55132,4,187
2012-08-22,fall,2012,August,7,Wednesday,Workingday,Clear,0.62,0.5909,0.78,0.0,16,537,553,553,131,553,4,4,3,443,0,727,154171,4,553
2012-08-22,fall,2012,August,8,Wednesday,Workingday,Clear,0.64,0.6061,0.73,0.0896,37,703,740,740,131,740,4,4,3,443,2,727,261001,4,740
2012-08-22,fall,2012,August,9,Wednesday,Workingday,Clear,0.68,0.6364,0.65,0.0,41,335,376,376,131,376,4,4,4,444,2,727,159438,4,376
2012-08-22,fall,2012,August,10,Wednesday,Workingday,Clear,0.7,0.6515,0.61,0.0896,66,159,225,225,131,225,4,3,4,434,2,727,126257,4,225
2012-08-22,fall,2012,August,11,Wednesday,Workingday,Clear,0.72,0.6667,0.58,0.0896,71,196,267,267,131,267,4,3,4,434,2,727,151320,4,267
2012-08-22,fall,2012,August,12,Wednesday,Workingday,Clear,0.74,0.6667,0.51,0.0,59,253,312,312,131,312,4,4,4,444,2,728,184414,4,312
2012-08-22,fall,2012,August,13,Wednesday,Workingday,Clear,0.76,0.6818,0.48,0.1045,74,242,316,316,131,316,4,4,4,444,2,729,184919,4,316
2012-08-22,fall,2012,August,14,Wednesday,Workingday,Clear,0.76,0.6818,0.45,0.1045,82,184,266,266,131,266,4,3,4,434,2,729,175652,4,266
2012-08-22,fall,2012,August,15,Wednesday,Workingday,Clear,0.76,0.6818,0.48,0.1343,94,222,316,316,131,316,4,4,4,444,2,729,183149,4,316
2012-08-22,fall,2012,August,16,Wednesday,Workingday,Light Snow,0.74,0.6818,0.55,0.2239,102,358,460,460,131,460,4,4,4,444,2,730,227748,4,460
2012-08-22,fall,2012,August,17,Wednesday,Workingday,Light Snow,0.74,0.6818,0.55,0.2239,72,711,783,783,131,783,4,4,4,444,2,730,336860,4,783
2012-08-22,fall,2012,August,18,Wednesday,Workingday,Light Snow,0.66,0.6212,0.61,0.2239,91,592,683,683,131,683,4,4,3,443,2,728,309772,4,683
2012-08-22,fall,2012,August,19,Wednesday,Workingday,Mist,0.66,0.6212,0.74,0.0,56,524,580,580,131,580,4,4,3,443,2,728,226789,4,580
2012-08-22,fall,2012,August,20,Wednesday,Workingday,Clear,0.64,0.6061,0.73,0.194,59,332,391,391,131,391,4,4,3,443,2,728,164550,4,391
2012-08-22,fall,2012,August,21,Wednesday,Workingday,Clear,0.64,0.6061,0.73,0.0,60,291,351,351,131,351,4,4,3,443,0,728,125445,4,351
2012-08-22,fall,2012,August,22,Wednesday,Workingday,Clear,0.64,0.6061,0.73,0.0,55,226,281,281,131,281,4,3,3,433,0,728,95612,4,281
2012-08-22,fall,2012,August,23,Wednesday,Workingday,Clear,0.64,0.5758,0.83,0.0,27,113,140,140,131,140,4,2,3,423,0,728,63941,4,140
2012-08-23,fall,2012,August,0,Thursday,Workingday,Clear,0.64,0.5909,0.78,0.0,9,51,60,60,130,60,4,2,3,423,0,726,39130,4,60
2012-08-23,fall,2012,August,1,Thursday,Workingday,Clear,0.62,0.5758,0.83,0.0,10,15,25,25,130,25,4,1,3,413,0,724,24164,4,25
2012-08-23,fall,2012,August,2,Thursday,Workingday,Clear,0.62,0.5758,0.83,0.0,9,11,20,20,130,20,4,1,3,413,0,715,16352,4,20
2012-08-23,fall,2012,August,3,Thursday,Workingday,Clear,0.62,0.5758,0.83,0.0896,3,6,9,9,130,9,4,1,3,413,0,697,8174,4,9
2012-08-23,fall,2012,August,4,Thursday,Workingday,Clear,0.62,0.5758,0.83,0.0,0,6,6,6,130,6,4,1,3,413,0,697,4428,4,6
2012-08-23,fall,2012,August,5,Thursday,Workingday,Clear,0.62,0.5758,0.83,0.0,1,36,37,37,130,37,4,1,3,413,0,717,14261,4,37
2012-08-23,fall,2012,August,6,Thursday,Workingday,Mist,0.6,0.5455,0.88,0.0896,14,178,192,192,130,192,4,3,3,433,0,725,55132,4,192
2012-08-23,fall,2012,August,7,Thursday,Workingday,Mist,0.62,0.5758,0.83,0.0896,18,463,481,481,130,481,4,4,3,443,0,727,154171,4,481
2012-08-23,fall,2012,August,8,Thursday,Workingday,Mist,0.66,0.6212,0.74,0.0896,45,662,707,707,130,707,4,4,3,443,2,727,261001,4,707
2012-08-23,fall,2012,August,9,Thursday,Workingday,Mist,0.7,0.6515,0.7,0.0,58,354,412,412,130,412,4,4,4,444,2,727,159438,4,412
2012-08-23,fall,2012,August,10,Thursday,Workingday,Clear,0.74,0.6818,0.58,0.0896,76,157,233,233,130,233,4,3,4,434,2,727,126257,4,233
2012-08-23,fall,2012,August,11,Thursday,Workingday,Clear,0.76,0.6818,0.48,0.0896,86,192,278,278,130,278,4,3,4,434,2,727,151320,4,278
2012-08-23,fall,2012,August,12,Thursday,Workingday,Clear,0.78,0.6818,0.38,0.0,97,235,332,332,130,332,4,4,4,444,2,728,184414,4,332
2012-08-23,fall,2012,August,13,Thursday,Workingday,Clear,0.82,0.7273,0.38,0.0896,93,253,346,346,130,346,4,4,4,444,2,729,184919,4,346
2012-08-23,fall,2012,August,14,Thursday,Workingday,Clear,0.78,0.697,0.46,0.2239,114,191,305,305,130,305,4,4,4,444,2,729,175652,4,305
2012-08-23,fall,2012,August,15,Thursday,Workingday,Clear,0.78,0.697,0.46,0.1343,104,201,305,305,130,305,4,4,4,444,2,729,183149,4,305
2012-08-23,fall,2012,August,16,Thursday,Workingday,Clear,0.76,0.6818,0.48,0.1642,121,344,465,465,130,465,4,4,4,444,2,730,227748,4,465
2012-08-23,fall,2012,August,17,Thursday,Workingday,Clear,0.76,0.6818,0.45,0.2239,111,709,820,820,130,820,4,4,4,444,2,730,336860,4,820
2012-08-23,fall,2012,August,18,Thursday,Workingday,Clear,0.74,0.6667,0.48,0.2239,130,811,941,941,130,941,4,4,4,444,2,728,309772,4,941
2012-08-23,fall,2012,August,19,Thursday,Workingday,Clear,0.72,0.6667,0.51,0.0896,96,537,633,633,130,633,4,4,4,444,2,728,226789,4,633
2012-08-23,fall,2012,August,20,Thursday,Workingday,Clear,0.7,0.6515,0.61,0.1045,70,404,474,474,130,474,4,4,4,444,2,728,164550,4,474
2012-08-23,fall,2012,August,21,Thursday,Workingday,Clear,0.7,0.6515,0.61,0.1343,53,276,329,329,130,329,4,4,4,444,2,728,125445,4,329
2012-08-23,fall,2012,August,22,Thursday,Workingday,Mist,0.68,0.6364,0.61,0.1045,21,177,198,198,130,198,4,3,4,434,0,728,95612,4,198
2012-08-23,fall,2012,August,23,Thursday,Workingday,Mist,0.66,0.6212,0.69,0.0,24,133,157,157,130,157,4,3,3,433,0,728,63941,4,157
2012-08-24,fall,2012,August,0,Friday,Workingday,Mist,0.66,0.6212,0.69,0.0,27,84,111,111,129,111,4,2,3,423,0,726,39130,4,111
2012-08-24,fall,2012,August,1,Friday,Workingday,Mist,0.64,0.6061,0.73,0.0,5,37,42,42,129,42,4,2,3,423,0,724,24164,4,42
2012-08-24,fall,2012,August,2,Friday,Workingday,Clear,0.66,0.6212,0.69,0.0,1,15,16,16,129,16,4,1,3,413,0,715,16352,4,16
2012-08-24,fall,2012,August,3,Friday,Workingday,Clear,0.64,0.6061,0.73,0.0,2,6,8,8,129,8,4,1,3,413,0,697,8174,4,8
2012-08-24,fall,2012,August,4,Friday,Workingday,Mist,0.64,0.6061,0.73,0.0,2,6,8,8,129,8,4,1,3,413,0,697,4428,4,8
2012-08-24,fall,2012,August,5,Friday,Workingday,Clear,0.64,0.5909,0.78,0.0,1,37,38,38,129,38,4,1,3,413,0,717,14261,4,38
2012-08-24,fall,2012,August,6,Friday,Workingday,Mist,0.62,0.5758,0.83,0.0,9,142,151,151,129,151,4,3,3,433,0,725,55132,4,151
2012-08-24,fall,2012,August,7,Friday,Workingday,Mist,0.64,0.5909,0.78,0.0,13,412,425,425,129,425,4,4,3,443,0,727,154171,4,425
2012-08-24,fall,2012,August,8,Friday,Workingday,Mist,0.66,0.6212,0.74,0.0,41,703,744,744,129,744,4,4,3,443,2,727,261001,4,744
2012-08-24,fall,2012,August,9,Friday,Workingday,Mist,0.72,0.6667,0.58,0.0,58,331,389,389,129,389,4,4,4,444,2,727,159438,4,389
2012-08-24,fall,2012,August,10,Friday,Workingday,Mist,0.76,0.6818,0.48,0.0,78,184,262,262,129,262,4,3,4,434,2,727,126257,4,262
2012-08-24,fall,2012,August,11,Friday,Workingday,Mist,0.76,0.6818,0.48,0.1045,69,212,281,281,129,281,4,3,4,434,2,727,151320,4,281
2012-08-24,fall,2012,August,12,Friday,Workingday,Mist,0.76,0.6818,0.45,0.0896,95,276,371,371,129,371,4,4,4,444,2,728,184414,4,371
2012-08-24,fall,2012,August,13,Friday,Workingday,Mist,0.8,0.7121,0.41,0.1045,79,272,351,351,129,351,4,4,4,444,2,729,184919,4,351
2012-08-24,fall,2012,August,14,Friday,Workingday,Clear,0.78,0.697,0.43,0.1045,109,229,338,338,129,338,4,4,4,444,2,729,175652,4,338
2012-08-24,fall,2012,August,15,Friday,Workingday,Mist,0.76,0.6818,0.48,0.1343,99,251,350,350,129,350,4,4,4,444,2,729,183149,4,350
2012-08-24,fall,2012,August,16,Friday,Workingday,Mist,0.76,0.6818,0.48,0.1343,101,414,515,515,129,515,4,4,4,444,2,730,227748,4,515
2012-08-24,fall,2012,August,17,Friday,Workingday,Mist,0.74,0.6667,0.51,0.2239,117,695,812,812,129,812,4,4,4,444,2,730,336860,4,812
2012-08-24,fall,2012,August,18,Friday,Workingday,Mist,0.72,0.6818,0.62,0.194,109,627,736,736,129,736,4,4,4,444,2,728,309772,4,736
2012-08-24,fall,2012,August,19,Friday,Workingday,Mist,0.72,0.6667,0.58,0.1642,106,430,536,536,129,536,4,4,4,444,2,728,226789,4,536
2012-08-24,fall,2012,August,20,Friday,Workingday,Mist,0.7,0.6515,0.65,0.2239,66,297,363,363,129,363,4,4,4,444,2,728,164550,4,363
2012-08-24,fall,2012,August,21,Friday,Workingday,Mist,0.7,0.6515,0.61,0.1642,58,248,306,306,129,306,4,4,4,444,2,728,125445,4,306
2012-08-24,fall,2012,August,22,Friday,Workingday,Mist,0.7,0.6515,0.61,0.0,42,209,251,251,129,251,4,3,4,434,0,728,95612,4,251
2012-08-24,fall,2012,August,23,Friday,Workingday,Mist,0.68,0.6364,0.69,0.0896,38,140,178,178,129,178,4,3,4,434,0,728,63941,4,178
2012-08-25,fall,2012,August,0,Saturday,Holiday,Mist,0.7,0.6515,0.61,0.0,21,114,135,135,128,135,4,2,4,424,0,726,39130,4,135
2012-08-25,fall,2012,August,1,Saturday,Holiday,Mist,0.68,0.6364,0.69,0.0,15,100,115,115,128,115,4,2,4,424,0,724,24164,4,115
2012-08-25,fall,2012,August,2,Saturday,Holiday,Mist,0.66,0.6212,0.74,0.0896,18,61,79,79,128,79,4,2,3,423,0,715,16352,4,79
2012-08-25,fall,2012,August,3,Saturday,Holiday,Clear,0.66,0.6212,0.69,0.0896,7,31,38,38,128,38,4,1,3,413,0,697,8174,4,38
2012-08-25,fall,2012,August,4,Saturday,Holiday,Mist,0.66,0.6212,0.69,0.1045,3,9,12,12,128,12,4,1,3,413,0,697,4428,4,12
2012-08-25,fall,2012,August,5,Saturday,Holiday,Mist,0.64,0.6061,0.73,0.1642,4,10,14,14,128,14,4,1,3,413,0,717,14261,4,14
2012-08-25,fall,2012,August,6,Saturday,Holiday,Mist,0.64,0.5909,0.78,0.1642,5,25,30,30,128,30,4,1,3,413,0,725,55132,4,30
2012-08-25,fall,2012,August,7,Saturday,Holiday,Mist,0.64,0.5909,0.78,0.194,14,88,102,102,128,102,4,2,3,423,0,727,154171,4,102
2012-08-25,fall,2012,August,8,Saturday,Holiday,Mist,0.66,0.6212,0.74,0.2537,29,133,162,162,128,162,4,3,3,433,0,727,261001,4,162
2012-08-25,fall,2012,August,9,Saturday,Holiday,Mist,0.68,0.6364,0.69,0.2836,60,228,288,288,128,288,4,4,4,444,2,727,159438,4,288
2012-08-25,fall,2012,August,10,Saturday,Holiday,Mist,0.7,0.6515,0.65,0.2985,148,294,442,442,128,442,4,4,4,444,2,727,126257,4,442
2012-08-25,fall,2012,August,11,Saturday,Holiday,Mist,0.72,0.6818,0.62,0.2836,143,314,457,457,128,457,4,4,4,444,2,727,151320,4,457
2012-08-25,fall,2012,August,12,Saturday,Holiday,Light Snow,0.72,0.6667,0.54,0.3881,217,367,584,584,128,584,4,4,4,444,2,728,184414,4,584
2012-08-25,fall,2012,August,13,Saturday,Holiday,Mist,0.72,0.6667,0.51,0.3582,186,331,517,517,128,517,4,4,4,444,2,729,184919,4,517
2012-08-25,fall,2012,August,14,Saturday,Holiday,Light Snow,0.66,0.6212,0.65,0.2537,150,332,482,482,128,482,4,4,3,443,2,729,175652,4,482
2012-08-25,fall,2012,August,15,Saturday,Holiday,Mist,0.64,0.6061,0.73,0.3284,79,154,233,233,128,233,4,3,3,433,2,729,183149,4,233
2012-08-25,fall,2012,August,16,Saturday,Holiday,Mist,0.66,0.6212,0.74,0.2985,174,260,434,434,128,434,4,4,3,443,2,730,227748,4,434
2012-08-25,fall,2012,August,17,Saturday,Holiday,Mist,0.66,0.6212,0.74,0.3284,132,271,403,403,128,403,4,4,3,443,2,730,336860,4,403
2012-08-25,fall,2012,August,18,Saturday,Holiday,Mist,0.66,0.6212,0.69,0.4627,122,261,383,383,128,383,4,4,3,443,2,728,309772,4,383
2012-08-25,fall,2012,August,19,Saturday,Holiday,Mist,0.64,0.5909,0.78,0.2985,97,257,354,354,128,354,4,4,3,443,2,728,226789,4,354
2012-08-25,fall,2012,August,20,Saturday,Holiday,Light Snow,0.62,0.5758,0.83,0.2537,65,176,241,241,128,241,4,3,3,433,0,728,164550,4,241
2012-08-25,fall,2012,August,21,Saturday,Holiday,Clear,0.62,0.5758,0.83,0.3582,60,148,208,208,128,208,4,3,3,433,0,728,125445,4,208
2012-08-25,fall,2012,August,22,Saturday,Holiday,Clear,0.62,0.5758,0.83,0.3582,46,136,182,182,128,182,4,3,3,433,0,728,95612,4,182
2012-08-25,fall,2012,August,23,Saturday,Holiday,Mist,0.62,0.5758,0.83,0.2537,34,124,158,158,128,158,4,3,3,433,0,728,63941,4,158
2012-08-26,fall,2012,August,0,Sunday,Holiday,Clear,0.64,0.5758,0.89,0.2537,23,111,134,134,127,134,4,2,3,423,0,726,39130,4,134
2012-08-26,fall,2012,August,1,Sunday,Holiday,Clear,0.64,0.5758,0.89,0.194,18,116,134,134,127,134,4,2,3,423,0,724,24164,4,134
2012-08-26,fall,2012,August,2,Sunday,Holiday,Mist,0.64,0.5758,0.89,0.2239,12,104,116,116,127,116,4,2,3,423,0,715,16352,4,116
2012-08-26,fall,2012,August,3,Sunday,Holiday,Mist,0.64,0.5758,0.89,0.2537,11,42,53,53,127,53,4,2,3,423,0,697,8174,4,53
2012-08-26,fall,2012,August,4,Sunday,Holiday,Mist,0.64,0.5758,0.89,0.194,5,11,16,16,127,16,4,1,3,413,0,697,4428,4,16
2012-08-26,fall,2012,August,5,Sunday,Holiday,Clear,0.64,0.5758,0.89,0.194,3,13,16,16,127,16,4,1,3,413,0,717,14261,4,16
2012-08-26,fall,2012,August,6,Sunday,Holiday,Clear,0.62,0.5606,0.88,0.2985,5,16,21,21,127,21,4,1,3,413,0,725,55132,4,21
2012-08-26,fall,2012,August,7,Sunday,Holiday,Clear,0.64,0.5758,0.89,0.194,11,23,34,34,127,34,4,1,3,413,0,727,154171,4,34
2012-08-26,fall,2012,August,8,Sunday,Holiday,Clear,0.68,0.6364,0.79,0.2836,21,112,133,133,127,133,4,2,4,424,0,727,261001,4,133
2012-08-26,fall,2012,August,9,Sunday,Holiday,Clear,0.68,0.6364,0.79,0.2537,67,196,263,263,127,263,4,3,4,434,0,727,159438,4,263
2012-08-26,fall,2012,August,10,Sunday,Holiday,Clear,0.74,0.697,0.66,0.3881,127,258,385,385,127,385,4,4,4,444,2,727,126257,4,385
2012-08-26,fall,2012,August,11,Sunday,Holiday,Clear,0.74,0.697,0.66,0.3582,150,332,482,482,127,482,4,4,4,444,2,727,151320,4,482
2012-08-26,fall,2012,August,12,Sunday,Holiday,Light Snow,0.72,0.697,0.74,0.3582,225,401,626,626,127,626,4,4,4,444,2,728,184414,4,626
2012-08-26,fall,2012,August,13,Sunday,Holiday,Light Snow,0.66,0.6061,0.78,0.4179,166,375,541,541,127,541,4,4,3,443,2,729,184919,4,541
2012-08-26,fall,2012,August,14,Sunday,Holiday,Clear,0.64,0.5758,0.89,0.1045,125,252,377,377,127,377,4,4,3,443,2,729,175652,4,377
2012-08-26,fall,2012,August,15,Sunday,Holiday,Light Snow,0.64,0.5758,0.89,0.2836,132,259,391,391,127,391,4,4,3,443,2,729,183149,4,391
2012-08-26,fall,2012,August,16,Sunday,Holiday,Light Snow,0.64,0.5758,0.89,0.2836,57,116,173,173,127,173,4,3,3,433,0,730,227748,4,173
2012-08-26,fall,2012,August,17,Sunday,Holiday,Clear,0.64,0.5758,0.89,0.2239,61,172,233,233,127,233,4,3,3,433,0,730,336860,4,233
2012-08-26,fall,2012,August,18,Sunday,Holiday,Mist,0.64,0.5758,0.89,0.0896,77,187,264,264,127,264,4,3,3,433,0,728,309772,4,264
2012-08-26,fall,2012,August,19,Sunday,Holiday,Mist,0.64,0.5758,0.89,0.1642,80,212,292,292,127,292,4,4,3,443,0,728,226789,4,292
2012-08-26,fall,2012,August,20,Sunday,Holiday,Clear,0.64,0.5758,0.89,0.1642,40,171,211,211,127,211,4,3,3,433,0,728,164550,4,211
2012-08-26,fall,2012,August,21,Sunday,Holiday,Clear,0.64,0.5758,0.83,0.1343,26,140,166,166,127,166,4,3,3,433,0,728,125445,4,166
2012-08-26,fall,2012,August,22,Sunday,Holiday,Clear,0.62,0.5606,0.88,0.0896,20,94,114,114,127,114,4,2,3,423,0,728,95612,4,114
2012-08-26,fall,2012,August,23,Sunday,Holiday,Clear,0.62,0.5758,0.83,0.0896,21,59,80,80,127,80,4,2,3,423,0,728,63941,4,80
2012-08-27,fall,2012,August,0,Monday,Workingday,Clear,0.62,0.5758,0.83,0.0,4,28,32,32,126,32,4,1,3,413,0,726,39130,4,32
2012-08-27,fall,2012,August,1,Monday,Workingday,Clear,0.62,0.5606,0.88,0.0896,3,4,7,7,126,7,4,1,3,413,0,724,24164,4,7
2012-08-27,fall,2012,August,2,Monday,Workingday,Clear,0.62,0.5606,0.88,0.1343,0,8,8,8,126,8,4,1,3,413,0,715,16352,4,8
2012-08-27,fall,2012,August,3,Monday,Workingday,Clear,0.62,0.5606,0.88,0.0896,1,3,4,4,126,4,4,1,3,413,0,697,8174,4,4
2012-08-27,fall,2012,August,4,Monday,Workingday,Clear,0.62,0.5758,0.83,0.0,1,11,12,12,126,12,4,1,3,413,0,697,4428,4,12
2012-08-27,fall,2012,August,5,Monday,Workingday,Clear,0.62,0.5606,0.88,0.0,4,32,36,36,126,36,4,1,3,413,0,717,14261,4,36
2012-08-27,fall,2012,August,6,Monday,Workingday,Clear,0.62,0.5606,0.88,0.0,4,141,145,145,126,145,4,3,3,433,0,725,55132,4,145
2012-08-27,fall,2012,August,7,Monday,Workingday,Clear,0.66,0.6061,0.83,0.0,15,418,433,433,126,433,4,4,3,443,0,727,154171,4,433
2012-08-27,fall,2012,August,8,Monday,Workingday,Clear,0.66,0.6061,0.83,0.0896,29,670,699,699,126,699,4,4,3,443,2,727,261001,4,699
2012-08-27,fall,2012,August,9,Monday,Workingday,Clear,0.66,0.6061,0.83,0.1045,40,302,342,342,126,342,4,4,3,443,0,727,159438,4,342
2012-08-27,fall,2012,August,10,Monday,Workingday,Clear,0.72,0.697,0.74,0.1343,63,143,206,206,126,206,4,3,4,434,0,727,126257,4,206
2012-08-27,fall,2012,August,11,Monday,Workingday,Clear,0.74,0.697,0.66,0.194,47,182,229,229,126,229,4,3,4,434,2,727,151320,4,229
2012-08-27,fall,2012,August,12,Monday,Workingday,Clear,0.76,0.7121,0.62,0.0,69,214,283,283,126,283,4,4,4,444,2,728,184414,4,283
2012-08-27,fall,2012,August,13,Monday,Workingday,Clear,0.76,0.7121,0.57,0.1642,77,211,288,288,126,288,4,4,4,444,2,729,184919,4,288
2012-08-27,fall,2012,August,14,Monday,Workingday,Clear,0.8,0.7424,0.49,0.0896,66,180,246,246,126,246,4,3,4,434,2,729,175652,4,246
2012-08-27,fall,2012,August,15,Monday,Workingday,Clear,0.8,0.7576,0.55,0.2985,77,205,282,282,126,282,4,4,4,444,2,729,183149,4,282
2012-08-27,fall,2012,August,16,Monday,Workingday,Clear,0.8,0.7576,0.55,0.2537,77,367,444,444,126,444,4,4,4,444,2,730,227748,4,444
2012-08-27,fall,2012,August,17,Monday,Workingday,Clear,0.8,0.7273,0.46,0.2239,101,744,845,845,126,845,4,4,4,444,2,730,336860,4,845
2012-08-27,fall,2012,August,18,Monday,Workingday,Clear,0.78,0.7121,0.52,0.2537,83,751,834,834,126,834,4,4,4,444,2,728,309772,4,834
2012-08-27,fall,2012,August,19,Monday,Workingday,Clear,0.74,0.697,0.7,0.2239,74,499,573,573,126,573,4,4,4,444,2,728,226789,4,573
2012-08-27,fall,2012,August,20,Monday,Workingday,Clear,0.74,0.697,0.7,0.194,50,366,416,416,126,416,4,4,4,444,2,728,164550,4,416
2012-08-27,fall,2012,August,21,Monday,Workingday,Clear,0.72,0.697,0.74,0.194,39,239,278,278,126,278,4,3,4,434,0,728,125445,4,278
2012-08-27,fall,2012,August,22,Monday,Workingday,Clear,0.7,0.6667,0.84,0.194,30,131,161,161,126,161,4,3,4,434,0,728,95612,4,161
2012-08-27,fall,2012,August,23,Monday,Workingday,Clear,0.7,0.6667,0.84,0.1642,35,79,114,114,126,114,4,2,4,424,0,728,63941,4,114
2012-08-28,fall,2012,August,0,Tuesday,Workingday,Clear,0.7,0.6667,0.84,0.2537,9,29,38,38,125,38,4,1,4,414,0,726,39130,4,38
2012-08-28,fall,2012,August,1,Tuesday,Workingday,Clear,0.68,0.6364,0.89,0.194,4,17,21,21,125,21,4,1,4,414,0,724,24164,4,21
2012-08-28,fall,2012,August,2,Tuesday,Workingday,Clear,0.68,0.6364,0.83,0.2537,2,13,15,15,125,15,4,1,4,414,0,715,16352,4,15
2012-08-28,fall,2012,August,3,Tuesday,Workingday,Clear,0.66,0.5909,0.89,0.1343,0,4,4,4,125,4,4,1,3,413,0,697,8174,4,4
2012-08-28,fall,2012,August,4,Tuesday,Workingday,Clear,0.66,0.6061,0.83,0.1343,2,6,8,8,125,8,4,1,3,413,0,697,4428,4,8
2012-08-28,fall,2012,August,5,Tuesday,Workingday,Mist,0.66,0.6061,0.83,0.0896,3,39,42,42,125,42,4,2,3,423,0,717,14261,4,42
2012-08-28,fall,2012,August,6,Tuesday,Workingday,Mist,0.66,0.5909,0.89,0.1045,3,144,147,147,125,147,4,3,3,433,0,725,55132,4,147
2012-08-28,fall,2012,August,7,Tuesday,Workingday,Mist,0.66,0.6061,0.83,0.1045,14,255,269,269,125,269,4,3,3,433,0,727,154171,4,269
2012-08-28,fall,2012,August,8,Tuesday,Workingday,Mist,0.66,0.6212,0.85,0.1045,25,668,693,693,125,693,4,4,3,443,2,727,261001,4,693
2012-08-28,fall,2012,August,9,Tuesday,Workingday,Mist,0.7,0.6667,0.79,0.1642,44,351,395,395,125,395,4,4,4,444,2,727,159438,4,395
2012-08-28,fall,2012,August,10,Tuesday,Workingday,Clear,0.74,0.6818,0.62,0.2537,39,165,204,204,125,204,4,3,4,434,2,727,126257,4,204
2012-08-28,fall,2012,August,11,Tuesday,Workingday,Clear,0.78,0.7273,0.55,0.2537,47,171,218,218,125,218,4,3,4,434,2,727,151320,4,218
2012-08-28,fall,2012,August,12,Tuesday,Workingday,Clear,0.8,0.7424,0.49,0.2836,56,241,297,297,125,297,4,4,4,444,2,728,184414,4,297
2012-08-28,fall,2012,August,13,Tuesday,Workingday,Clear,0.82,0.7424,0.43,0.2985,56,232,288,288,125,288,4,4,4,444,2,729,184919,4,288
2012-08-28,fall,2012,August,14,Tuesday,Workingday,Clear,0.84,0.7424,0.38,0.3284,72,179,251,251,125,251,4,3,4,434,2,729,175652,4,251
2012-08-28,fall,2012,August,15,Tuesday,Workingday,Clear,0.82,0.7273,0.34,0.2985,59,258,317,317,125,317,4,4,4,444,2,729,183149,4,317
2012-08-28,fall,2012,August,16,Tuesday,Workingday,Clear,0.82,0.7121,0.33,0.3284,84,396,480,480,125,480,4,4,4,444,2,730,227748,4,480
2012-08-28,fall,2012,August,17,Tuesday,Workingday,Clear,0.8,0.697,0.35,0.3881,90,774,864,864,125,864,4,4,4,444,2,730,336860,4,864
2012-08-28,fall,2012,August,18,Tuesday,Workingday,Clear,0.78,0.697,0.4,0.2537,82,736,818,818,125,818,4,4,4,444,2,728,309772,4,818
2012-08-28,fall,2012,August,19,Tuesday,Workingday,Clear,0.74,0.6667,0.45,0.1642,82,515,597,597,125,597,4,4,4,444,2,728,226789,4,597
2012-08-28,fall,2012,August,20,Tuesday,Workingday,Clear,0.72,0.6667,0.48,0.1045,87,348,435,435,125,435,4,4,4,444,2,728,164550,4,435
2012-08-28,fall,2012,August,21,Tuesday,Workingday,Clear,0.72,0.6667,0.48,0.0896,38,276,314,314,125,314,4,4,4,444,2,728,125445,4,314
2012-08-28,fall,2012,August,22,Tuesday,Workingday,Clear,0.7,0.6515,0.54,0.0,20,196,216,216,125,216,4,3,4,434,0,728,95612,4,216
2012-08-28,fall,2012,August,23,Tuesday,Workingday,Clear,0.68,0.6364,0.57,0.0,17,92,109,109,125,109,4,2,4,424,0,728,63941,4,109
2012-08-29,fall,2012,August,0,Wednesday,Workingday,Clear,0.66,0.6212,0.69,0.0,8,39,47,47,124,47,4,2,3,423,0,726,39130,4,47
2012-08-29,fall,2012,August,1,Wednesday,Workingday,Clear,0.64,0.6061,0.69,0.1343,2,12,14,14,124,14,4,1,3,413,0,724,24164,4,14
2012-08-29,fall,2012,August,2,Wednesday,Workingday,Clear,0.62,0.5909,0.73,0.1343,2,4,6,6,124,6,4,1,3,413,0,715,16352,4,6
2012-08-29,fall,2012,August,3,Wednesday,Workingday,Clear,0.62,0.5909,0.73,0.1045,0,9,9,9,124,9,4,1,3,413,0,697,8174,4,9
2012-08-29,fall,2012,August,4,Wednesday,Workingday,Clear,0.6,0.5909,0.73,0.2239,2,8,10,10,124,10,4,1,3,413,0,697,4428,4,10
2012-08-29,fall,2012,August,5,Wednesday,Workingday,Clear,0.6,0.5909,0.73,0.194,3,37,40,40,124,40,4,1,3,413,0,717,14261,4,40
2012-08-29,fall,2012,August,6,Wednesday,Workingday,Clear,0.6,0.5909,0.73,0.194,6,175,181,181,124,181,4,3,3,433,0,725,55132,4,181
2012-08-29,fall,2012,August,7,Wednesday,Workingday,Clear,0.64,0.6061,0.65,0.0896,23,531,554,554,124,554,4,4,3,443,2,727,154171,4,554
2012-08-29,fall,2012,August,8,Wednesday,Workingday,Clear,0.66,0.6212,0.61,0.1642,28,780,808,808,124,808,4,4,3,443,2,727,261001,4,808
2012-08-29,fall,2012,August,9,Wednesday,Workingday,Clear,0.7,0.6515,0.51,0.194,40,308,348,348,124,348,4,4,4,444,2,727,159438,4,348
2012-08-29,fall,2012,August,10,Wednesday,Workingday,Clear,0.72,0.6667,0.48,0.1642,34,144,178,178,124,178,4,3,4,434,2,727,126257,4,178
2012-08-29,fall,2012,August,11,Wednesday,Workingday,Clear,0.72,0.6515,0.45,0.0,67,186,253,253,124,253,4,3,4,434,2,727,151320,4,253
2012-08-29,fall,2012,August,12,Wednesday,Workingday,Clear,0.76,0.6818,0.4,0.0,79,281,360,360,124,360,4,4,4,444,2,728,184414,4,360
2012-08-29,fall,2012,August,13,Wednesday,Workingday,Clear,0.74,0.6667,0.42,0.0,68,232,300,300,124,300,4,4,4,444,2,729,184919,4,300
2012-08-29,fall,2012,August,14,Wednesday,Workingday,Clear,0.76,0.6818,0.4,0.0896,87,214,301,301,124,301,4,4,4,444,2,729,175652,4,301
2012-08-29,fall,2012,August,15,Wednesday,Workingday,Clear,0.76,0.6818,0.4,0.194,96,242,338,338,124,338,4,4,4,444,2,729,183149,4,338
2012-08-29,fall,2012,August,16,Wednesday,Workingday,Clear,0.76,0.6667,0.37,0.1343,104,389,493,493,124,493,4,4,4,444,2,730,227748,4,493
2012-08-29,fall,2012,August,17,Wednesday,Workingday,Clear,0.78,0.6818,0.35,0.2239,108,762,870,870,124,870,4,4,4,444,2,730,336860,4,870
2012-08-29,fall,2012,August,18,Wednesday,Workingday,Clear,0.74,0.6667,0.42,0.1642,119,693,812,812,124,812,4,4,4,444,2,728,309772,4,812
2012-08-29,fall,2012,August,19,Wednesday,Workingday,Clear,0.7,0.6515,0.54,0.194,120,523,643,643,124,643,4,4,4,444,2,728,226789,4,643
2012-08-29,fall,2012,August,20,Wednesday,Workingday,Clear,0.68,0.6364,0.57,0.0,49,378,427,427,124,427,4,4,4,444,2,728,164550,4,427
2012-08-29,fall,2012,August,21,Wednesday,Workingday,Clear,0.66,0.6212,0.54,0.1045,48,265,313,313,124,313,4,4,3,443,2,728,125445,4,313
2012-08-29,fall,2012,August,22,Wednesday,Workingday,Clear,0.66,0.6212,0.54,0.0,50,185,235,235,124,235,4,3,3,433,0,728,95612,4,235
2012-08-29,fall,2012,August,23,Wednesday,Workingday,Clear,0.66,0.6212,0.57,0.0,34,123,157,157,124,157,4,3,3,433,0,728,63941,4,157
2012-08-30,fall,2012,August,0,Thursday,Workingday,Clear,0.64,0.6061,0.69,0.0,14,51,65,65,123,65,4,2,3,423,0,726,39130,4,65
2012-08-30,fall,2012,August,1,Thursday,Workingday,Clear,0.64,0.6061,0.65,0.0,6,17,23,23,123,23,4,1,3,413,0,724,24164,4,23
2012-08-30,fall,2012,August,2,Thursday,Workingday,Clear,0.62,0.5909,0.73,0.0,3,14,17,17,123,17,4,1,3,413,0,715,16352,4,17
2012-08-30,fall,2012,August,3,Thursday,Workingday,Clear,0.62,0.5909,0.73,0.0,0,5,5,5,123,5,4,1,3,413,0,697,8174,4,5
2012-08-30,fall,2012,August,4,Thursday,Workingday,Clear,0.62,0.5909,0.73,0.0,4,4,8,8,123,8,4,1,3,413,0,697,4428,4,8
2012-08-30,fall,2012,August,5,Thursday,Workingday,Clear,0.62,0.5909,0.73,0.0,2,33,35,35,123,35,4,1,3,413,0,717,14261,4,35
2012-08-30,fall,2012,August,6,Thursday,Workingday,Clear,0.6,0.5606,0.83,0.1642,8,155,163,163,123,163,4,3,3,433,0,725,55132,4,163
2012-08-30,fall,2012,August,7,Thursday,Workingday,Clear,0.64,0.6061,0.73,0.0,31,501,532,532,123,532,4,4,3,443,2,727,154171,4,532
2012-08-30,fall,2012,August,8,Thursday,Workingday,Clear,0.66,0.6212,0.65,0.0,53,701,754,754,123,754,4,4,3,443,2,727,261001,4,754
2012-08-30,fall,2012,August,9,Thursday,Workingday,Clear,0.7,0.6515,0.58,0.0,57,339,396,396,123,396,4,4,4,444,2,727,159438,4,396
2012-08-30,fall,2012,August,10,Thursday,Workingday,Clear,0.72,0.6667,0.54,0.0,73,161,234,234,123,234,4,3,4,434,2,727,126257,4,234
2012-08-30,fall,2012,August,11,Thursday,Workingday,Clear,0.76,0.6818,0.4,0.0896,85,191,276,276,123,276,4,3,4,434,2,727,151320,4,276
2012-08-30,fall,2012,August,12,Thursday,Workingday,Clear,0.76,0.6818,0.45,0.1343,73,221,294,294,123,294,4,4,4,444,2,728,184414,4,294
2012-08-30,fall,2012,August,13,Thursday,Workingday,Clear,0.76,0.6818,0.48,0.1045,76,214,290,290,123,290,4,4,4,444,2,729,184919,4,290
2012-08-30,fall,2012,August,14,Thursday,Workingday,Clear,0.76,0.6818,0.48,0.1343,74,199,273,273,123,273,4,3,4,434,2,729,175652,4,273
2012-08-30,fall,2012,August,15,Thursday,Workingday,Clear,0.8,0.7273,0.46,0.1642,99,239,338,338,123,338,4,4,4,444,2,729,183149,4,338
2012-08-30,fall,2012,August,16,Thursday,Workingday,Clear,0.8,0.7273,0.43,0.1642,77,405,482,482,123,482,4,4,4,444,2,730,227748,4,482
2012-08-30,fall,2012,August,17,Thursday,Workingday,Clear,0.82,0.7273,0.34,0.2239,93,751,844,844,123,844,4,4,4,444,2,730,336860,4,844
2012-08-30,fall,2012,August,18,Thursday,Workingday,Clear,0.8,0.7121,0.38,0.1343,109,744,853,853,123,853,4,4,4,444,2,728,309772,4,853
2012-08-30,fall,2012,August,19,Thursday,Workingday,Clear,0.76,0.6818,0.48,0.1343,78,532,610,610,123,610,4,4,4,444,2,728,226789,4,610
2012-08-30,fall,2012,August,20,Thursday,Workingday,Clear,0.74,0.6818,0.58,0.1642,68,403,471,471,123,471,4,4,4,444,2,728,164550,4,471
2012-08-30,fall,2012,August,21,Thursday,Workingday,Clear,0.72,0.6818,0.66,0.1343,32,275,307,307,123,307,4,4,4,444,2,728,125445,4,307
2012-08-30,fall,2012,August,22,Thursday,Workingday,Clear,0.7,0.6515,0.7,0.0,38,253,291,291,123,291,4,4,4,444,0,728,95612,4,291
2012-08-30,fall,2012,August,23,Thursday,Workingday,Clear,0.7,0.6667,0.74,0.1045,19,133,152,152,123,152,4,3,4,434,0,728,63941,4,152
2012-08-31,fall,2012,August,0,Friday,Workingday,Clear,0.68,0.6364,0.83,0.1642,13,69,82,82,122,82,4,2,4,424,0,726,39130,4,82
2012-08-31,fall,2012,August,1,Friday,Workingday,Clear,0.68,0.6364,0.83,0.1642,8,24,32,32,122,32,4,1,4,414,0,724,24164,4,32
2012-08-31,fall,2012,August,2,Friday,Workingday,Clear,0.66,0.5909,0.89,0.1343,9,11,20,20,122,20,4,1,3,413,0,715,16352,4,20
2012-08-31,fall,2012,August,3,Friday,Workingday,Clear,0.66,0.5909,0.89,0.1045,3,2,5,5,122,5,4,1,3,413,0,697,8174,4,5
2012-08-31,fall,2012,August,4,Friday,Workingday,Clear,0.64,0.5758,0.89,0.1343,0,7,7,7,122,7,4,1,3,413,0,697,4428,4,7
2012-08-31,fall,2012,August,5,Friday,Workingday,Clear,0.64,0.5758,0.89,0.1642,2,27,29,29,122,29,4,1,3,413,0,717,14261,4,29
2012-08-31,fall,2012,August,6,Friday,Workingday,Mist,0.64,0.5758,0.89,0.1642,7,101,108,108,122,108,4,2,3,423,0,725,55132,4,108
2012-08-31,fall,2012,August,7,Friday,Workingday,Mist,0.64,0.5758,0.89,0.0896,21,400,421,421,122,421,4,4,3,443,0,727,154171,4,421
2012-08-31,fall,2012,August,8,Friday,Workingday,Mist,0.7,0.6667,0.74,0.0,36,654,690,690,122,690,4,4,4,444,2,727,261001,4,690
2012-08-31,fall,2012,August,9,Friday,Workingday,Clear,0.74,0.697,0.7,0.0,61,337,398,398,122,398,4,4,4,444,2,727,159438,4,398
2012-08-31,fall,2012,August,10,Friday,Workingday,Clear,0.76,0.7121,0.62,0.0896,59,197,256,256,122,256,4,3,4,434,2,727,126257,4,256
2012-08-31,fall,2012,August,11,Friday,Workingday,Clear,0.86,0.7424,0.28,0.2985,88,221,309,309,122,309,4,4,4,444,2,727,151320,4,309
2012-08-31,fall,2012,August,12,Friday,Workingday,Clear,0.86,0.7424,0.26,0.2537,120,290,410,410,122,410,4,4,4,444,2,728,184414,4,410
2012-08-31,fall,2012,August,13,Friday,Workingday,Clear,0.88,0.7576,0.27,0.3284,97,271,368,368,122,368,4,4,4,444,2,729,184919,4,368
2012-08-31,fall,2012,August,14,Friday,Workingday,Clear,0.9,0.7727,0.25,0.2239,112,324,436,436,122,436,4,4,4,444,2,729,175652,4,436
2012-08-31,fall,2012,August,15,Friday,Workingday,Clear,0.9,0.7879,0.27,0.2985,109,417,526,526,122,526,4,4,4,444,2,729,183149,4,526
2012-08-31,fall,2012,August,16,Friday,Workingday,Clear,0.9,0.7879,0.27,0.2537,111,417,528,528,122,528,4,4,4,444,2,730,227748,4,528
2012-08-31,fall,2012,August,17,Friday,Workingday,Clear,0.88,0.7727,0.32,0.1642,129,488,617,617,122,617,4,4,4,444,2,730,336860,4,617
2012-08-31,fall,2012,August,18,Friday,Workingday,Clear,0.86,0.7576,0.36,0.2537,87,459,546,546,122,546,4,4,4,444,2,728,309772,4,546
2012-08-31,fall,2012,August,19,Friday,Workingday,Clear,0.8,0.7424,0.49,0.1343,91,361,452,452,122,452,4,4,4,444,2,728,226789,4,452
2012-08-31,fall,2012,August,20,Friday,Workingday,Clear,0.8,0.7424,0.49,0.1343,102,254,356,356,122,356,4,4,4,444,2,728,164550,4,356
2012-08-31,fall,2012,August,21,Friday,Workingday,Clear,0.76,0.7121,0.58,0.194,71,232,303,303,122,303,4,4,4,444,2,728,125445,4,303
2012-08-31,fall,2012,August,22,Friday,Workingday,Clear,0.76,0.7121,0.58,0.194,65,212,277,277,122,277,4,3,4,434,2,728,95612,4,277
2012-08-31,fall,2012,August,23,Friday,Workingday,Clear,0.74,0.6818,0.62,0.1045,32,142,174,174,122,174,4,3,4,434,0,728,63941,4,174
2012-09-01,fall,2012,September,0,Saturday,Holiday,Clear,0.74,0.6818,0.62,0.1045,22,146,168,168,121,168,4,3,4,434,0,726,39130,4,168
2012-09-01,fall,2012,September,1,Saturday,Holiday,Clear,0.72,0.697,0.74,0.1343,11,68,79,79,121,79,4,2,4,424,0,724,24164,4,79
2012-09-01,fall,2012,September,2,Saturday,Holiday,Clear,0.7,0.6515,0.7,0.1642,8,61,69,69,121,69,4,2,4,424,0,715,16352,4,69
2012-09-01,fall,2012,September,3,Saturday,Holiday,Clear,0.7,0.6515,0.7,0.1045,6,29,35,35,121,35,4,1,4,414,0,697,8174,4,35
2012-09-01,fall,2012,September,4,Saturday,Holiday,Clear,0.7,0.6515,0.7,0.0,3,9,12,12,121,12,4,1,4,414,0,697,4428,4,12
2012-09-01,fall,2012,September,5,Saturday,Holiday,Clear,0.68,0.6364,0.79,0.0,2,20,22,22,121,22,4,1,4,414,0,717,14261,4,22
2012-09-01,fall,2012,September,6,Saturday,Holiday,Clear,0.68,0.6364,0.79,0.0,13,23,36,36,121,36,4,1,4,414,0,725,55132,4,36
2012-09-01,fall,2012,September,7,Saturday,Holiday,Mist,0.74,0.6818,0.58,0.1343,8,58,66,66,121,66,4,2,4,424,0,727,154171,4,66
2012-09-01,fall,2012,September,8,Saturday,Holiday,Mist,0.76,0.7121,0.58,0.2537,28,134,162,162,121,162,4,3,4,434,2,727,261001,4,162
2012-09-01,fall,2012,September,9,Saturday,Holiday,Mist,0.76,0.7121,0.58,0.194,62,175,237,237,121,237,4,3,4,434,2,727,159438,4,237
2012-09-01,fall,2012,September,10,Saturday,Holiday,Mist,0.78,0.7273,0.55,0.194,128,289,417,417,121,417,4,4,4,444,2,727,126257,4,417
2012-09-01,fall,2012,September,11,Saturday,Holiday,Mist,0.8,0.7576,0.55,0.2239,219,273,492,492,121,492,4,4,4,444,2,727,151320,4,492
2012-09-01,fall,2012,September,12,Saturday,Holiday,Mist,0.8,0.7576,0.55,0.1642,187,284,471,471,121,471,4,4,4,444,2,728,184414,4,471
2012-09-01,fall,2012,September,13,Saturday,Holiday,Mist,0.82,0.7727,0.52,0.0896,237,267,504,504,121,504,4,4,4,444,2,729,184919,4,504
2012-09-01,fall,2012,September,14,Saturday,Holiday,Mist,0.86,0.7879,0.44,0.1642,240,274,514,514,121,514,4,4,4,444,2,729,175652,4,514
2012-09-01,fall,2012,September,15,Saturday,Holiday,Mist,0.86,0.7879,0.44,0.2836,257,306,563,563,121,563,4,4,4,444,2,729,183149,4,563
2012-09-01,fall,2012,September,16,Saturday,Holiday,Mist,0.84,0.7879,0.49,0.1642,209,253,462,462,121,462,4,4,4,444,2,730,227748,4,462
2012-09-01,fall,2012,September,17,Saturday,Holiday,Mist,0.82,0.7727,0.52,0.0,205,258,463,463,121,463,4,4,4,444,2,730,336860,4,463
2012-09-01,fall,2012,September,18,Saturday,Holiday,Mist,0.82,0.7727,0.52,0.0,184,258,442,442,121,442,4,4,4,444,2,728,309772,4,442
2012-09-01,fall,2012,September,19,Saturday,Holiday,Light Snow,0.78,0.7424,0.62,0.0,157,235,392,392,121,392,4,4,4,444,2,728,226789,4,392
2012-09-01,fall,2012,September,20,Saturday,Holiday,Light Snow,0.76,0.7273,0.67,0.2537,67,140,207,207,121,207,4,3,4,434,2,728,164550,4,207
2012-09-01,fall,2012,September,21,Saturday,Holiday,Light Snow,0.64,0.5758,0.89,0.0,21,83,104,104,121,104,4,2,3,423,0,728,125445,4,104
2012-09-01,fall,2012,September,22,Saturday,Holiday,Mist,0.66,0.5909,0.89,0.0,21,57,78,78,121,78,4,2,3,423,0,728,95612,4,78
2012-09-01,fall,2012,September,23,Saturday,Holiday,Clear,0.66,0.5909,0.89,0.0896,57,88,145,145,121,145,4,3,3,433,0,728,63941,4,145
2012-09-02,fall,2012,September,0,Sunday,Holiday,Mist,0.66,0.5909,0.89,0.0896,27,72,99,99,120,99,4,2,3,423,0,726,39130,4,99
2012-09-02,fall,2012,September,1,Sunday,Holiday,Clear,0.66,0.5909,0.89,0.0,15,58,73,73,120,73,4,2,3,423,0,724,24164,4,73
2012-09-02,fall,2012,September,2,Sunday,Holiday,Clear,0.66,0.5909,0.89,0.0,28,56,84,84,120,84,4,2,3,423,0,715,16352,4,84
2012-09-02,fall,2012,September,3,Sunday,Holiday,Clear,0.66,0.5909,0.89,0.0896,9,33,42,42,120,42,4,2,3,423,0,697,8174,4,42
2012-09-02,fall,2012,September,4,Sunday,Holiday,Clear,0.66,0.5909,0.89,0.0,7,15,22,22,120,22,4,1,3,413,0,697,4428,4,22
2012-09-02,fall,2012,September,5,Sunday,Holiday,Clear,0.66,0.5909,0.89,0.0,2,10,12,12,120,12,4,1,3,413,0,717,14261,4,12
2012-09-02,fall,2012,September,6,Sunday,Holiday,Mist,0.66,0.5909,0.89,0.0,2,13,15,15,120,15,4,1,3,413,0,725,55132,4,15
2012-09-02,fall,2012,September,7,Sunday,Holiday,Clear,0.66,0.5909,0.94,0.0896,13,29,42,42,120,42,4,2,3,423,0,727,154171,4,42
2012-09-02,fall,2012,September,8,Sunday,Holiday,Clear,0.68,0.6364,0.89,0.0896,30,99,129,129,120,129,4,2,4,424,0,727,261001,4,129
2012-09-02,fall,2012,September,9,Sunday,Holiday,Mist,0.7,0.6667,0.84,0.0,88,144,232,232,120,232,4,3,4,434,0,727,159438,4,232
2012-09-02,fall,2012,September,10,Sunday,Holiday,Mist,0.72,0.697,0.79,0.0,158,230,388,388,120,388,4,4,4,444,2,727,126257,4,388
2012-09-02,fall,2012,September,11,Sunday,Holiday,Mist,0.74,0.697,0.7,0.0,226,263,489,489,120,489,4,4,4,444,2,727,151320,4,489
2012-09-02,fall,2012,September,12,Sunday,Holiday,Light Snow,0.74,0.697,0.7,0.0,248,297,545,545,120,545,4,4,4,444,2,728,184414,4,545
2012-09-02,fall,2012,September,13,Sunday,Holiday,Light Snow,0.72,0.697,0.74,0.0896,263,230,493,493,120,493,4,4,4,444,2,729,184919,4,493
2012-09-02,fall,2012,September,14,Sunday,Holiday,Light Snow,0.72,0.697,0.79,0.0896,249,208,457,457,120,457,4,4,4,444,2,729,175652,4,457
2012-09-02,fall,2012,September,15,Sunday,Holiday,Light Snow,0.74,0.7121,0.74,0.1343,179,176,355,355,120,355,4,4,4,444,2,729,183149,4,355
2012-09-02,fall,2012,September,16,Sunday,Holiday,Clear,0.74,0.697,0.7,0.0,222,252,474,474,120,474,4,4,4,444,2,730,227748,4,474
2012-09-02,fall,2012,September,17,Sunday,Holiday,Clear,0.76,0.7273,0.66,0.0896,219,284,503,503,120,503,4,4,4,444,2,730,336860,4,503
2012-09-02,fall,2012,September,18,Sunday,Holiday,Clear,0.74,0.7121,0.74,0.0,227,273,500,500,120,500,4,4,4,444,2,728,309772,4,500
2012-09-02,fall,2012,September,19,Sunday,Holiday,Mist,0.7,0.6667,0.84,0.2239,140,152,292,292,120,292,4,4,4,444,2,728,226789,4,292
2012-09-02,fall,2012,September,20,Sunday,Holiday,Mist,0.7,0.6667,0.84,0.1642,63,41,104,104,120,104,4,2,4,424,0,728,164550,4,104
2012-09-02,fall,2012,September,21,Sunday,Holiday,Clear,0.7,0.6515,0.7,0.1642,79,92,171,171,120,171,4,3,4,434,0,728,125445,4,171
2012-09-02,fall,2012,September,22,Sunday,Holiday,Light Snow,0.68,0.6364,0.83,0.1343,66,100,166,166,120,166,4,3,4,434,0,728,95612,4,166
2012-09-02,fall,2012,September,23,Sunday,Holiday,Light Snow,0.66,0.5909,0.89,0.0896,53,70,123,123,120,123,4,2,3,423,0,728,63941,4,123
2012-09-03,fall,2012,September,0,Monday,Holiday,Mist,0.66,0.5909,0.94,0.0,42,62,104,104,119,104,4,2,3,423,0,726,39130,4,104
2012-09-03,fall,2012,September,1,Monday,Holiday,Mist,0.68,0.6364,0.89,0.1642,18,37,55,55,119,55,4,2,4,424,0,724,24164,4,55
2012-09-03,fall,2012,September,2,Monday,Holiday,Clear,0.66,0.5909,0.89,0.1045,10,30,40,40,119,40,4,1,3,413,0,715,16352,4,40
2012-09-03,fall,2012,September,3,Monday,Holiday,Clear,0.66,0.5909,0.89,0.1343,6,22,28,28,119,28,4,1,3,413,0,697,8174,4,28
2012-09-03,fall,2012,September,4,Monday,Holiday,Clear,0.66,0.5909,0.89,0.0896,6,5,11,11,119,11,4,1,3,413,0,697,4428,4,11
2012-09-03,fall,2012,September,5,Monday,Holiday,Clear,0.66,0.5909,0.89,0.0,1,3,4,4,119,4,4,1,3,413,0,717,14261,4,4
2012-09-03,fall,2012,September,6,Monday,Holiday,Clear,0.66,0.5909,0.94,0.0,3,12,15,15,119,15,4,1,3,413,0,725,55132,4,15
2012-09-03,fall,2012,September,7,Monday,Holiday,Clear,0.68,0.6364,0.85,0.0,6,37,43,43,119,43,4,2,4,424,0,727,154171,4,43
2012-09-03,fall,2012,September,8,Monday,Holiday,Mist,0.7,0.6667,0.84,0.1045,36,91,127,127,119,127,4,2,4,424,0,727,261001,4,127
2012-09-03,fall,2012,September,9,Monday,Holiday,Mist,0.7,0.6667,0.84,0.1343,71,158,229,229,119,229,4,3,4,434,0,727,159438,4,229
2012-09-03,fall,2012,September,10,Monday,Holiday,Mist,0.74,0.7121,0.74,0.2239,135,224,359,359,119,359,4,4,4,444,2,727,126257,4,359
2012-09-03,fall,2012,September,11,Monday,Holiday,Mist,0.74,0.697,0.7,0.2836,187,272,459,459,119,459,4,4,4,444,2,727,151320,4,459
2012-09-03,fall,2012,September,12,Monday,Holiday,Mist,0.76,0.7121,0.62,0.2985,191,352,543,543,119,543,4,4,4,444,2,728,184414,4,543
2012-09-03,fall,2012,September,13,Monday,Holiday,Mist,0.76,0.7273,0.66,0.2537,209,357,566,566,119,566,4,4,4,444,2,729,184919,4,566
2012-09-03,fall,2012,September,14,Monday,Holiday,Clear,0.74,0.697,0.7,0.2985,163,349,512,512,119,512,4,4,4,444,2,729,175652,4,512
2012-09-03,fall,2012,September,15,Monday,Holiday,Clear,0.74,0.697,0.7,0.2239,168,281,449,449,119,449,4,4,4,444,2,729,183149,4,449
2012-09-03,fall,2012,September,16,Monday,Holiday,Clear,0.74,0.697,0.7,0.2239,165,335,500,500,119,500,4,4,4,444,2,730,227748,4,500
2012-09-03,fall,2012,September,17,Monday,Holiday,Clear,0.74,0.697,0.7,0.1343,181,317,498,498,119,498,4,4,4,444,2,730,336860,4,498
2012-09-03,fall,2012,September,18,Monday,Holiday,Clear,0.74,0.697,0.66,0.1642,145,337,482,482,119,482,4,4,4,444,2,728,309772,4,482
2012-09-03,fall,2012,September,19,Monday,Holiday,Clear,0.72,0.697,0.74,0.194,73,301,374,374,119,374,4,4,4,444,2,728,226789,4,374
2012-09-03,fall,2012,September,20,Monday,Holiday,Clear,0.72,0.6818,0.76,0.1045,78,183,261,261,119,261,4,3,4,434,0,728,164550,4,261
2012-09-03,fall,2012,September,21,Monday,Holiday,Clear,0.72,0.6818,0.76,0.1045,42,142,184,184,119,184,4,3,4,434,0,728,125445,4,184
2012-09-03,fall,2012,September,22,Monday,Holiday,Mist,0.7,0.6667,0.84,0.1343,17,104,121,121,119,121,4,2,4,424,0,728,95612,4,121
2012-09-03,fall,2012,September,23,Monday,Holiday,Mist,0.7,0.6667,0.84,0.2537,12,58,70,70,119,70,4,2,4,424,0,728,63941,4,70
2012-09-04,fall,2012,September,0,Tuesday,Workingday,Mist,0.7,0.6667,0.84,0.2537,10,19,29,29,118,29,4,1,4,414,0,726,39130,4,29
2012-09-04,fall,2012,September,1,Tuesday,Workingday,Clear,0.68,0.6364,0.82,0.1343,15,9,24,24,118,24,4,1,4,414,0,724,24164,4,24
2012-09-04,fall,2012,September,2,Tuesday,Workingday,Clear,0.68,0.6364,0.82,0.1343,1,4,5,5,118,5,4,1,4,414,0,715,16352,4,5
2012-09-04,fall,2012,September,3,Tuesday,Workingday,Mist,0.66,0.5909,0.89,0.0896,1,9,10,10,118,10,4,1,3,413,0,697,8174,4,10
2012-09-04,fall,2012,September,4,Tuesday,Workingday,Mist,0.66,0.5909,0.89,0.0,0,8,8,8,118,8,4,1,3,413,0,697,4428,4,8
2012-09-04,fall,2012,September,5,Tuesday,Workingday,Mist,0.66,0.5909,0.89,0.0,1,37,38,38,118,38,4,1,3,413,0,717,14261,4,38
2012-09-04,fall,2012,September,6,Tuesday,Workingday,Mist,0.68,0.6364,0.89,0.1045,7,165,172,172,118,172,4,3,4,434,0,725,55132,4,172
2012-09-04,fall,2012,September,7,Tuesday,Workingday,Mist,0.68,0.6364,0.89,0.1045,13,480,493,493,118,493,4,4,4,444,0,727,154171,4,493
2012-09-04,fall,2012,September,8,Tuesday,Workingday,Clear,0.7,0.6667,0.84,0.1642,15,617,632,632,118,632,4,4,4,444,2,727,261001,4,632
2012-09-04,fall,2012,September,9,Tuesday,Workingday,Mist,0.72,0.697,0.79,0.2239,30,293,323,323,118,323,4,4,4,444,0,727,159438,4,323
2012-09-04,fall,2012,September,10,Tuesday,Workingday,Mist,0.72,0.697,0.74,0.2537,42,130,172,172,118,172,4,3,4,434,0,727,126257,4,172
2012-09-04,fall,2012,September,11,Tuesday,Workingday,Mist,0.74,0.697,0.7,0.2836,39,159,198,198,118,198,4,3,4,434,0,727,151320,4,198
2012-09-04,fall,2012,September,12,Tuesday,Workingday,Clear,0.76,0.7273,0.7,0.2836,54,233,287,287,118,287,4,4,4,444,2,728,184414,4,287
2012-09-04,fall,2012,September,13,Tuesday,Workingday,Clear,0.8,0.7576,0.55,0.4478,72,203,275,275,118,275,4,3,4,434,2,729,184919,4,275
2012-09-04,fall,2012,September,14,Tuesday,Workingday,Clear,0.8,0.7576,0.55,0.4179,72,202,274,274,118,274,4,3,4,434,2,729,175652,4,274
2012-09-04,fall,2012,September,15,Tuesday,Workingday,Clear,0.8,0.7727,0.59,0.4627,68,224,292,292,118,292,4,4,4,444,2,729,183149,4,292
2012-09-04,fall,2012,September,16,Tuesday,Workingday,Clear,0.76,0.7273,0.7,0.4179,61,397,458,458,118,458,4,4,4,444,2,730,227748,4,458
2012-09-04,fall,2012,September,17,Tuesday,Workingday,Clear,0.76,0.7273,0.7,0.3582,110,746,856,856,118,856,4,4,4,444,2,730,336860,4,856
2012-09-04,fall,2012,September,18,Tuesday,Workingday,Clear,0.76,0.7424,0.75,0.2239,94,745,839,839,118,839,4,4,4,444,2,728,309772,4,839
2012-09-04,fall,2012,September,19,Tuesday,Workingday,Clear,0.76,0.7273,0.7,0.2239,50,502,552,552,118,552,4,4,4,444,2,728,226789,4,552
2012-09-04,fall,2012,September,20,Tuesday,Workingday,Clear,0.74,0.697,0.7,0.2537,47,338,385,385,118,385,4,4,4,444,2,728,164550,4,385
2012-09-04,fall,2012,September,21,Tuesday,Workingday,Clear,0.74,0.7121,0.74,0.2537,28,240,268,268,118,268,4,3,4,434,0,728,125445,4,268
2012-09-04,fall,2012,September,22,Tuesday,Workingday,Clear,0.74,0.697,0.7,0.2836,25,154,179,179,118,179,4,3,4,434,0,728,95612,4,179
2012-09-04,fall,2012,September,23,Tuesday,Workingday,Clear,0.72,0.697,0.74,0.2985,12,83,95,95,118,95,4,2,4,424,0,728,63941,4,95
2012-09-05,fall,2012,September,0,Wednesday,Workingday,Clear,0.72,0.697,0.74,0.2537,10,27,37,37,117,37,4,1,4,414,0,726,39130,4,37
2012-09-05,fall,2012,September,1,Wednesday,Workingday,Clear,0.7,0.6667,0.84,0.194,2,11,13,13,117,13,4,1,4,414,0,724,24164,4,13
2012-09-05,fall,2012,September,2,Wednesday,Workingday,Clear,0.7,0.6667,0.84,0.194,0,9,9,9,117,9,4,1,4,414,0,715,16352,4,9
2012-09-05,fall,2012,September,3,Wednesday,Workingday,Clear,0.7,0.6667,0.79,0.2836,0,4,4,4,117,4,4,1,4,414,0,697,8174,4,4
2012-09-05,fall,2012,September,4,Wednesday,Workingday,Clear,0.7,0.6667,0.79,0.2836,2,3,5,5,117,5,4,1,4,414,0,697,4428,4,5
2012-09-05,fall,2012,September,5,Wednesday,Workingday,Mist,0.7,0.6667,0.79,0.2985,1,39,40,40,117,40,4,1,4,414,0,717,14261,4,40
2012-09-05,fall,2012,September,6,Wednesday,Workingday,Clear,0.7,0.6667,0.79,0.2836,7,203,210,210,117,210,4,3,4,434,0,725,55132,4,210
2012-09-05,fall,2012,September,7,Wednesday,Workingday,Mist,0.7,0.6667,0.79,0.2537,11,489,500,500,117,500,4,4,4,444,2,727,154171,4,500
2012-09-05,fall,2012,September,8,Wednesday,Workingday,Clear,0.72,0.697,0.74,0.194,33,692,725,725,117,725,4,4,4,444,2,727,261001,4,725
2012-09-05,fall,2012,September,9,Wednesday,Workingday,Clear,0.74,0.697,0.7,0.2537,27,263,290,290,117,290,4,4,4,444,2,727,159438,4,290
2012-09-05,fall,2012,September,10,Wednesday,Workingday,Mist,0.76,0.7273,0.7,0.1642,54,181,235,235,117,235,4,3,4,434,2,727,126257,4,235
2012-09-05,fall,2012,September,11,Wednesday,Workingday,Mist,0.78,0.7424,0.62,0.1642,61,156,217,217,117,217,4,3,4,434,2,727,151320,4,217
2012-09-05,fall,2012,September,12,Wednesday,Workingday,Clear,0.78,0.7727,0.7,0.1045,49,217,266,266,117,266,4,3,4,434,2,728,184414,4,266
2012-09-05,fall,2012,September,13,Wednesday,Workingday,Clear,0.8,0.7879,0.63,0.1642,50,184,234,234,117,234,4,3,4,434,2,729,184919,4,234
2012-09-05,fall,2012,September,14,Wednesday,Workingday,Clear,0.82,0.7879,0.56,0.1045,34,177,211,211,117,211,4,3,4,434,2,729,175652,4,211
2012-09-05,fall,2012,September,15,Wednesday,Workingday,Clear,0.78,0.7727,0.7,0.194,41,204,245,245,117,245,4,3,4,434,2,729,183149,4,245
2012-09-05,fall,2012,September,16,Wednesday,Workingday,Clear,0.76,0.7273,0.7,0.2537,86,344,430,430,117,430,4,4,4,444,2,730,227748,4,430
2012-09-05,fall,2012,September,17,Wednesday,Workingday,Clear,0.76,0.7273,0.66,0.2537,83,780,863,863,117,863,4,4,4,444,2,730,336860,4,863
2012-09-05,fall,2012,September,18,Wednesday,Workingday,Clear,0.76,0.7424,0.75,0.194,82,757,839,839,117,839,4,4,4,444,2,728,309772,4,839
2012-09-05,fall,2012,September,19,Wednesday,Workingday,Clear,0.74,0.697,0.7,0.1642,64,598,662,662,117,662,4,4,4,444,2,728,226789,4,662
2012-09-05,fall,2012,September,20,Wednesday,Workingday,Clear,0.72,0.7121,0.84,0.1642,55,357,412,412,117,412,4,4,4,444,2,728,164550,4,412
2012-09-05,fall,2012,September,21,Wednesday,Workingday,Clear,0.72,0.697,0.79,0.0,18,278,296,296,117,296,4,4,4,444,0,728,125445,4,296
2012-09-05,fall,2012,September,22,Wednesday,Workingday,Clear,0.72,0.697,0.79,0.0,38,181,219,219,117,219,4,3,4,434,0,728,95612,4,219
2012-09-05,fall,2012,September,23,Wednesday,Workingday,Clear,0.7,0.6667,0.84,0.0896,24,126,150,150,117,150,4,3,4,434,0,728,63941,4,150
2012-09-06,fall,2012,September,0,Thursday,Workingday,Mist,0.7,0.6667,0.84,0.0896,30,35,65,65,116,65,4,2,4,424,0,726,39130,4,65
2012-09-06,fall,2012,September,1,Thursday,Workingday,Mist,0.7,0.6667,0.84,0.0,2,16,18,18,116,18,4,1,4,414,0,724,24164,4,18
2012-09-06,fall,2012,September,2,Thursday,Workingday,Clear,0.72,0.697,0.79,0.0,1,7,8,8,116,8,4,1,4,414,0,715,16352,4,8
2012-09-06,fall,2012,September,3,Thursday,Workingday,Clear,0.7,0.6667,0.84,0.1045,0,9,9,9,116,9,4,1,4,414,0,697,8174,4,9
2012-09-06,fall,2012,September,4,Thursday,Workingday,Mist,0.7,0.6667,0.84,0.0896,0,8,8,8,116,8,4,1,4,414,0,697,4428,4,8
2012-09-06,fall,2012,September,5,Thursday,Workingday,Mist,0.7,0.6667,0.84,0.194,3,35,38,38,116,38,4,1,4,414,0,717,14261,4,38
2012-09-06,fall,2012,September,6,Thursday,Workingday,Mist,0.7,0.6667,0.84,0.0896,11,189,200,200,116,200,4,3,4,434,0,725,55132,4,200
2012-09-06,fall,2012,September,7,Thursday,Workingday,Mist,0.7,0.6667,0.84,0.1045,21,461,482,482,116,482,4,4,4,444,0,727,154171,4,482
2012-09-06,fall,2012,September,8,Thursday,Workingday,Light Snow,0.7,0.6667,0.79,0.0,24,622,646,646,116,646,4,4,4,444,2,727,261001,4,646
2012-09-06,fall,2012,September,9,Thursday,Workingday,Light Snow,0.66,0.5909,0.94,0.1343,8,115,123,123,116,123,4,2,3,423,0,727,159438,4,123
2012-09-06,fall,2012,September,10,Thursday,Workingday,Light Snow,0.66,0.5909,0.94,0.1343,9,40,49,49,116,49,4,2,3,423,0,727,126257,4,49
2012-09-06,fall,2012,September,11,Thursday,Workingday,Light Snow,0.7,0.6667,0.84,0.1642,10,52,62,62,116,62,4,2,4,424,0,727,151320,4,62
2012-09-06,fall,2012,September,12,Thursday,Workingday,Mist,0.72,0.697,0.79,0.2239,11,126,137,137,116,137,4,2,4,424,0,728,184414,4,137
2012-09-06,fall,2012,September,13,Thursday,Workingday,Mist,0.72,0.697,0.79,0.1045,39,152,191,191,116,191,4,3,4,434,0,729,184919,4,191
2012-09-06,fall,2012,September,14,Thursday,Workingday,Clear,0.74,0.7121,0.74,0.0896,38,178,216,216,116,216,4,3,4,434,0,729,175652,4,216
2012-09-06,fall,2012,September,15,Thursday,Workingday,Clear,0.74,0.697,0.66,0.194,42,228,270,270,116,270,4,3,4,434,2,729,183149,4,270
2012-09-06,fall,2012,September,16,Thursday,Workingday,Clear,0.74,0.697,0.7,0.2239,42,374,416,416,116,416,4,4,4,444,2,730,227748,4,416
2012-09-06,fall,2012,September,17,Thursday,Workingday,Clear,0.74,0.697,0.7,0.2537,67,741,808,808,116,808,4,4,4,444,2,730,336860,4,808
2012-09-06,fall,2012,September,18,Thursday,Workingday,Clear,0.72,0.6818,0.7,0.2537,74,761,835,835,116,835,4,4,4,444,2,728,309772,4,835
2012-09-06,fall,2012,September,19,Thursday,Workingday,Clear,0.68,0.6364,0.74,0.2537,54,504,558,558,116,558,4,4,4,444,2,728,226789,4,558
2012-09-06,fall,2012,September,20,Thursday,Workingday,Clear,0.66,0.6061,0.78,0.2239,50,356,406,406,116,406,4,4,3,443,2,728,164550,4,406
2012-09-06,fall,2012,September,21,Thursday,Workingday,Clear,0.64,0.5758,0.89,0.1642,32,240,272,272,116,272,4,3,3,433,0,728,125445,4,272
2012-09-06,fall,2012,September,22,Thursday,Workingday,Clear,0.64,0.5758,0.89,0.1642,24,193,217,217,116,217,4,3,3,433,0,728,95612,4,217
2012-09-06,fall,2012,September,23,Thursday,Workingday,Clear,0.64,0.5758,0.89,0.1642,19,150,169,169,116,169,4,3,3,433,0,728,63941,4,169
2012-09-07,fall,2012,September,0,Friday,Workingday,Clear,0.64,0.5758,0.89,0.1343,17,79,96,96,115,96,4,2,3,423,0,726,39130,4,96
2012-09-07,fall,2012,September,1,Friday,Workingday,Clear,0.62,0.5606,0.88,0.1045,10,19,29,29,115,29,4,1,3,413,0,724,24164,4,29
2012-09-07,fall,2012,September,2,Friday,Workingday,Clear,0.62,0.5758,0.83,0.0896,1,10,11,11,115,11,4,1,3,413,0,715,16352,4,11
2012-09-07,fall,2012,September,3,Friday,Workingday,Clear,0.62,0.5758,0.83,0.0896,0,9,9,9,115,9,4,1,3,413,0,697,8174,4,9
2012-09-07,fall,2012,September,4,Friday,Workingday,Clear,0.62,0.5606,0.88,0.0,1,7,8,8,115,8,4,1,3,413,0,697,4428,4,8
2012-09-07,fall,2012,September,5,Friday,Workingday,Clear,0.62,0.5606,0.88,0.0,1,39,40,40,115,40,4,1,3,413,0,717,14261,4,40
2012-09-07,fall,2012,September,6,Friday,Workingday,Clear,0.62,0.5606,0.88,0.1045,5,135,140,140,115,140,4,2,3,423,0,725,55132,4,140
2012-09-07,fall,2012,September,7,Friday,Workingday,Clear,0.64,0.5758,0.89,0.1045,21,465,486,486,115,486,4,4,3,443,0,727,154171,4,486
2012-09-07,fall,2012,September,8,Friday,Workingday,Clear,0.66,0.6061,0.83,0.1045,29,690,719,719,115,719,4,4,3,443,2,727,261001,4,719
2012-09-07,fall,2012,September,9,Friday,Workingday,Clear,0.7,0.6667,0.79,0.1343,33,311,344,344,115,344,4,4,4,444,0,727,159438,4,344
2012-09-07,fall,2012,September,10,Friday,Workingday,Clear,0.72,0.697,0.74,0.1343,53,171,224,224,115,224,4,3,4,434,0,727,126257,4,224
2012-09-07,fall,2012,September,11,Friday,Workingday,Clear,0.76,0.7121,0.62,0.1343,81,215,296,296,115,296,4,4,4,444,2,727,151320,4,296
2012-09-07,fall,2012,September,12,Friday,Workingday,Clear,0.78,0.7424,0.59,0.1642,76,247,323,323,115,323,4,4,4,444,2,728,184414,4,323
2012-09-07,fall,2012,September,13,Friday,Workingday,Clear,0.8,0.7727,0.59,0.2537,71,283,354,354,115,354,4,4,4,444,2,729,184919,4,354
2012-09-07,fall,2012,September,14,Friday,Workingday,Clear,0.8,0.7727,0.59,0.2537,66,187,253,253,115,253,4,3,4,434,2,729,175652,4,253
2012-09-07,fall,2012,September,15,Friday,Workingday,Clear,0.8,0.7576,0.55,0.2537,66,265,331,331,115,331,4,4,4,444,2,729,183149,4,331
2012-09-07,fall,2012,September,16,Friday,Workingday,Clear,0.8,0.7576,0.55,0.2836,75,395,470,470,115,470,4,4,4,444,2,730,227748,4,470
2012-09-07,fall,2012,September,17,Friday,Workingday,Clear,0.78,0.7424,0.59,0.3284,88,684,772,772,115,772,4,4,4,444,2,730,336860,4,772
2012-09-07,fall,2012,September,18,Friday,Workingday,Clear,0.76,0.7121,0.62,0.2985,95,697,792,792,115,792,4,4,4,444,2,728,309772,4,792
2012-09-07,fall,2012,September,19,Friday,Workingday,Clear,0.74,0.6818,0.62,0.2836,70,498,568,568,115,568,4,4,4,444,2,728,226789,4,568
2012-09-07,fall,2012,September,20,Friday,Workingday,Clear,0.72,0.6818,0.66,0.2239,51,340,391,391,115,391,4,4,4,444,2,728,164550,4,391
2012-09-07,fall,2012,September,21,Friday,Workingday,Clear,0.7,0.6667,0.74,0.1642,55,246,301,301,115,301,4,4,4,444,2,728,125445,4,301
2012-09-07,fall,2012,September,22,Friday,Workingday,Clear,0.7,0.6667,0.74,0.2239,52,247,299,299,115,299,4,4,4,444,2,728,95612,4,299
2012-09-07,fall,2012,September,23,Friday,Workingday,Clear,0.66,0.5909,0.89,0.2537,28,220,248,248,115,248,4,3,3,433,0,728,63941,4,248
2012-09-08,fall,2012,September,0,Saturday,Holiday,Clear,0.66,0.5909,0.89,0.2537,20,130,150,150,114,150,4,3,3,433,0,726,39130,4,150
2012-09-08,fall,2012,September,1,Saturday,Holiday,Mist,0.66,0.5909,0.89,0.2836,10,107,117,117,114,117,4,2,3,423,0,724,24164,4,117
2012-09-08,fall,2012,September,2,Saturday,Holiday,Clear,0.66,0.5909,0.89,0.3284,9,68,77,77,114,77,4,2,3,423,0,715,16352,4,77
2012-09-08,fall,2012,September,3,Saturday,Holiday,Mist,0.66,0.5909,0.89,0.2239,3,40,43,43,114,43,4,2,3,423,0,697,8174,4,43
2012-09-08,fall,2012,September,4,Saturday,Holiday,Mist,0.66,0.5909,0.94,0.2239,3,8,11,11,114,11,4,1,3,413,0,697,4428,4,11
2012-09-08,fall,2012,September,5,Saturday,Holiday,Mist,0.66,0.5909,0.94,0.2537,2,13,15,15,114,15,4,1,3,413,0,717,14261,4,15
2012-09-08,fall,2012,September,6,Saturday,Holiday,Mist,0.66,0.5909,0.89,0.2836,8,26,34,34,114,34,4,1,3,413,0,725,55132,4,34
2012-09-08,fall,2012,September,7,Saturday,Holiday,Clear,0.66,0.5909,0.89,0.2836,11,71,82,82,114,82,4,2,3,423,0,727,154171,4,82
2012-09-08,fall,2012,September,8,Saturday,Holiday,Clear,0.7,0.6667,0.79,0.3284,33,197,230,230,114,230,4,3,4,434,0,727,261001,4,230
2012-09-08,fall,2012,September,9,Saturday,Holiday,Clear,0.7,0.6667,0.74,0.3881,87,261,348,348,114,348,4,4,4,444,2,727,159438,4,348
2012-09-08,fall,2012,September,10,Saturday,Holiday,Clear,0.74,0.697,0.7,0.3881,100,322,422,422,114,422,4,4,4,444,2,727,126257,4,422
2012-09-08,fall,2012,September,11,Saturday,Holiday,Clear,0.76,0.7121,0.62,0.4478,173,405,578,578,114,578,4,4,4,444,2,727,151320,4,578
2012-09-08,fall,2012,September,12,Saturday,Holiday,Clear,0.8,0.7576,0.55,0.4925,220,474,694,694,114,694,4,4,4,444,2,728,184414,4,694
2012-09-08,fall,2012,September,13,Saturday,Holiday,Clear,0.82,0.7727,0.52,0.5224,233,435,668,668,114,668,4,4,4,444,2,729,184919,4,668
2012-09-08,fall,2012,September,14,Saturday,Holiday,Clear,0.82,0.7727,0.52,0.4478,260,366,626,626,114,626,4,4,4,444,2,729,175652,4,626
2012-09-08,fall,2012,September,15,Saturday,Holiday,Light Snow,0.56,0.5303,0.88,0.2537,175,337,512,512,114,512,4,4,3,443,2,729,183149,4,512
2012-09-08,fall,2012,September,16,Saturday,Holiday,Light Snow,0.56,0.5303,0.88,0.194,19,95,114,114,114,114,4,2,3,423,0,730,227748,4,114
2012-09-08,fall,2012,September,17,Saturday,Holiday,Light Snow,0.58,0.5455,0.83,0.194,52,119,171,171,114,171,4,3,3,433,0,730,336860,4,171
2012-09-08,fall,2012,September,18,Saturday,Holiday,Light Snow,0.58,0.5455,0.83,0.1343,27,140,167,167,114,167,4,3,3,433,0,728,309772,4,167
2012-09-08,fall,2012,September,19,Saturday,Holiday,Light Snow,0.58,0.5455,0.88,0.1045,28,187,215,215,114,215,4,3,3,433,0,728,226789,4,215
2012-09-08,fall,2012,September,20,Saturday,Holiday,Mist,0.58,0.5455,0.88,0.0896,28,166,194,194,114,194,4,3,3,433,0,728,164550,4,194
2012-09-08,fall,2012,September,21,Saturday,Holiday,Mist,0.6,0.5606,0.83,0.1642,26,155,181,181,114,181,4,3,3,433,0,728,125445,4,181
2012-09-08,fall,2012,September,22,Saturday,Holiday,Mist,0.58,0.5455,0.78,0.2985,18,176,194,194,114,194,4,3,3,433,0,728,95612,4,194
2012-09-08,fall,2012,September,23,Saturday,Holiday,Mist,0.58,0.5455,0.73,0.1642,12,121,133,133,114,133,4,2,3,423,0,728,63941,4,133
2012-09-09,fall,2012,September,0,Sunday,Holiday,Mist,0.56,0.5303,0.73,0.194,18,106,124,124,113,124,4,2,3,423,0,726,39130,4,124
2012-09-09,fall,2012,September,1,Sunday,Holiday,Clear,0.56,0.5303,0.73,0.2239,20,104,124,124,113,124,4,2,3,423,0,724,24164,4,124
2012-09-09,fall,2012,September,2,Sunday,Holiday,Clear,0.54,0.5152,0.77,0.2836,15,81,96,96,113,96,4,2,3,423,0,715,16352,4,96
2012-09-09,fall,2012,September,3,Sunday,Holiday,Clear,0.54,0.5152,0.73,0.2239,14,32,46,46,113,46,4,2,3,423,0,697,8174,4,46
2012-09-09,fall,2012,September,4,Sunday,Holiday,Clear,0.52,0.5,0.77,0.2537,12,16,28,28,113,28,4,1,3,413,0,697,4428,4,28
2012-09-09,fall,2012,September,5,Sunday,Holiday,Clear,0.52,0.5,0.77,0.194,16,39,55,55,113,55,4,2,3,423,0,717,14261,4,55
2012-09-09,fall,2012,September,6,Sunday,Holiday,Clear,0.52,0.5,0.77,0.194,11,24,35,35,113,35,4,1,3,413,0,725,55132,4,35
2012-09-09,fall,2012,September,7,Sunday,Holiday,Clear,0.54,0.5152,0.73,0.1642,20,50,70,70,113,70,4,2,3,423,0,727,154171,4,70
2012-09-09,fall,2012,September,8,Sunday,Holiday,Clear,0.58,0.5455,0.68,0.2239,27,143,170,170,113,170,4,3,3,433,0,727,261001,4,170
2012-09-09,fall,2012,September,9,Sunday,Holiday,Clear,0.62,0.6061,0.61,0.2537,85,214,299,299,113,299,4,4,3,443,2,727,159438,4,299
2012-09-09,fall,2012,September,10,Sunday,Holiday,Clear,0.64,0.6212,0.57,0.2985,172,323,495,495,113,495,4,4,3,443,2,727,126257,4,495
2012-09-09,fall,2012,September,11,Sunday,Holiday,Clear,0.66,0.6212,0.47,0.2537,194,391,585,585,113,585,4,4,3,443,2,727,151320,4,585
2012-09-09,fall,2012,September,12,Sunday,Holiday,Clear,0.66,0.6212,0.47,0.0,247,510,757,757,113,757,4,4,3,443,2,728,184414,4,757
2012-09-09,fall,2012,September,13,Sunday,Holiday,Clear,0.68,0.6364,0.39,0.0,238,491,729,729,113,729,4,4,4,444,2,729,184919,4,729
2012-09-09,fall,2012,September,14,Sunday,Holiday,Clear,0.72,0.6515,0.3,0.2836,232,415,647,647,113,647,4,4,4,444,2,729,175652,4,647
2012-09-09,fall,2012,September,15,Sunday,Holiday,Clear,0.72,0.6515,0.32,0.2537,284,412,696,696,113,696,4,4,4,444,2,729,183149,4,696
2012-09-09,fall,2012,September,16,Sunday,Holiday,Clear,0.68,0.6364,0.36,0.2836,228,473,701,701,113,701,4,4,4,444,2,730,227748,4,701
2012-09-09,fall,2012,September,17,Sunday,Holiday,Clear,0.7,0.6364,0.37,0.2537,213,458,671,671,113,671,4,4,4,444,2,730,336860,4,671
2012-09-09,fall,2012,September,18,Sunday,Holiday,Clear,0.66,0.6212,0.36,0.2537,156,404,560,560,113,560,4,4,3,443,2,728,309772,4,560
2012-09-09,fall,2012,September,19,Sunday,Holiday,Clear,0.66,0.6212,0.36,0.2537,134,362,496,496,113,496,4,4,3,443,2,728,226789,4,496
2012-09-09,fall,2012,September,20,Sunday,Holiday,Clear,0.62,0.6212,0.41,0.2836,91,265,356,356,113,356,4,4,3,443,2,728,164550,4,356
2012-09-09,fall,2012,September,21,Sunday,Holiday,Clear,0.6,0.6212,0.46,0.2239,57,149,206,206,113,206,4,3,3,433,2,728,125445,4,206
2012-09-09,fall,2012,September,22,Sunday,Holiday,Clear,0.58,0.5455,0.49,0.2537,64,125,189,189,113,189,4,3,3,433,2,728,95612,4,189
2012-09-09,fall,2012,September,23,Sunday,Holiday,Clear,0.56,0.5303,0.52,0.2836,22,70,92,92,113,92,4,2,3,423,0,728,63941,4,92
2012-09-10,fall,2012,September,0,Monday,Workingday,Clear,0.56,0.5303,0.52,0.2836,6,35,41,41,112,41,4,2,3,423,0,726,39130,4,41
2012-09-10,fall,2012,September,1,Monday,Workingday,Clear,0.54,0.5152,0.6,0.194,7,11,18,18,112,18,4,1,3,413,0,724,24164,4,18
2012-09-10,fall,2012,September,2,Monday,Workingday,Clear,0.54,0.5152,0.6,0.3582,11,6,17,17,112,17,4,1,3,413,0,715,16352,4,17
2012-09-10,fall,2012,September,3,Monday,Workingday,Clear,0.52,0.5,0.68,0.2836,5,7,12,12,112,12,4,1,3,413,0,697,8174,4,12
2012-09-10,fall,2012,September,4,Monday,Workingday,Clear,0.52,0.5,0.68,0.2836,1,4,5,5,112,5,4,1,3,413,0,697,4428,4,5
2012-09-10,fall,2012,September,5,Monday,Workingday,Clear,0.5,0.4848,0.72,0.2537,4,36,40,40,112,40,4,1,2,412,0,717,14261,4,40
2012-09-10,fall,2012,September,6,Monday,Workingday,Clear,0.5,0.4848,0.72,0.1343,8,172,180,180,112,180,4,3,2,432,0,725,55132,4,180
2012-09-10,fall,2012,September,7,Monday,Workingday,Clear,0.52,0.5,0.68,0.2239,20,427,447,447,112,447,4,4,3,443,2,727,154171,4,447
2012-09-10,fall,2012,September,8,Monday,Workingday,Clear,0.56,0.5303,0.6,0.2836,33,697,730,730,112,730,4,4,3,443,2,727,261001,4,730
2012-09-10,fall,2012,September,9,Monday,Workingday,Clear,0.6,0.6212,0.53,0.2985,40,321,361,361,112,361,4,4,3,443,2,727,159438,4,361
2012-09-10,fall,2012,September,10,Monday,Workingday,Clear,0.62,0.6212,0.5,0.2836,42,168,210,210,112,210,4,3,3,433,2,727,126257,4,210
2012-09-10,fall,2012,September,11,Monday,Workingday,Clear,0.62,0.6212,0.43,0.2985,69,167,236,236,112,236,4,3,3,433,2,727,151320,4,236
2012-09-10,fall,2012,September,12,Monday,Workingday,Clear,0.64,0.6212,0.44,0.3881,76,256,332,332,112,332,4,4,3,443,2,728,184414,4,332
2012-09-10,fall,2012,September,13,Monday,Workingday,Clear,0.64,0.6212,0.38,0.2239,72,251,323,323,112,323,4,4,3,443,2,729,184919,4,323
2012-09-10,fall,2012,September,14,Monday,Workingday,Clear,0.66,0.6212,0.36,0.2836,107,233,340,340,112,340,4,4,3,443,2,729,175652,4,340
2012-09-10,fall,2012,September,15,Monday,Workingday,Clear,0.66,0.6212,0.31,0.3881,115,231,346,346,112,346,4,4,3,443,2,729,183149,4,346
2012-09-10,fall,2012,September,16,Monday,Workingday,Clear,0.66,0.6212,0.34,0.3284,108,380,488,488,112,488,4,4,3,443,2,730,227748,4,488
2012-09-10,fall,2012,September,17,Monday,Workingday,Clear,0.66,0.6212,0.34,0.3284,127,744,871,871,112,871,4,4,3,443,2,730,336860,4,871
2012-09-10,fall,2012,September,18,Monday,Workingday,Clear,0.62,0.6212,0.35,0.2985,111,857,968,968,112,968,4,4,3,443,2,728,309772,4,968
2012-09-10,fall,2012,September,19,Monday,Workingday,Clear,0.62,0.6212,0.38,0.2985,71,562,633,633,112,633,4,4,3,443,2,728,226789,4,633
2012-09-10,fall,2012,September,20,Monday,Workingday,Clear,0.6,0.6212,0.4,0.194,34,356,390,390,112,390,4,4,3,443,2,728,164550,4,390
2012-09-10,fall,2012,September,21,Monday,Workingday,Clear,0.56,0.5303,0.49,0.1642,29,256,285,285,112,285,4,4,3,443,2,728,125445,4,285
2012-09-10,fall,2012,September,22,Monday,Workingday,Clear,0.54,0.5152,0.52,0.1343,15,144,159,159,112,159,4,3,3,433,0,728,95612,4,159
2012-09-10,fall,2012,September,23,Monday,Workingday,Clear,0.54,0.5152,0.52,0.0,7,86,93,93,112,93,4,2,3,423,0,728,63941,4,93
2012-09-11,fall,2012,September,0,Tuesday,Workingday,Clear,0.52,0.5,0.59,0.1045,5,27,32,32,111,32,4,1,3,413,0,726,39130,4,32
2012-09-11,fall,2012,September,1,Tuesday,Workingday,Clear,0.5,0.4848,0.63,0.0,0,10,10,10,111,10,4,1,2,412,0,724,24164,4,10
2012-09-11,fall,2012,September,2,Tuesday,Workingday,Clear,0.48,0.4697,0.77,0.1642,1,5,6,6,111,6,4,1,2,412,0,715,16352,4,6
2012-09-11,fall,2012,September,3,Tuesday,Workingday,Clear,0.48,0.4697,0.67,0.1343,1,7,8,8,111,8,4,1,2,412,0,697,8174,4,8
2012-09-11,fall,2012,September,4,Tuesday,Workingday,Clear,0.48,0.4697,0.72,0.1045,1,8,9,9,111,9,4,1,2,412,0,697,4428,4,9
2012-09-11,fall,2012,September,5,Tuesday,Workingday,Clear,0.46,0.4545,0.72,0.0896,3,41,44,44,111,44,4,2,2,422,0,717,14261,4,44
2012-09-11,fall,2012,September,6,Tuesday,Workingday,Clear,0.46,0.4545,0.77,0.1045,11,200,211,211,111,211,4,3,2,432,0,725,55132,4,211
2012-09-11,fall,2012,September,7,Tuesday,Workingday,Clear,0.5,0.4848,0.72,0.1045,24,572,596,596,111,596,4,4,2,442,2,727,154171,4,596
2012-09-11,fall,2012,September,8,Tuesday,Workingday,Clear,0.54,0.5152,0.68,0.0896,48,702,750,750,111,750,4,4,3,443,2,727,261001,4,750
2012-09-11,fall,2012,September,9,Tuesday,Workingday,Clear,0.6,0.6212,0.49,0.0,35,323,358,358,111,358,4,4,3,443,2,727,159438,4,358
2012-09-11,fall,2012,September,10,Tuesday,Workingday,Clear,0.62,0.6212,0.38,0.0,54,142,196,196,111,196,4,3,3,433,2,727,126257,4,196
2012-09-11,fall,2012,September,11,Tuesday,Workingday,Clear,0.64,0.6212,0.33,0.0896,60,187,247,247,111,247,4,3,3,433,2,727,151320,4,247
2012-09-11,fall,2012,September,12,Tuesday,Workingday,Clear,0.64,0.6212,0.33,0.0,62,254,316,316,111,316,4,4,3,443,2,728,184414,4,316
2012-09-11,fall,2012,September,13,Tuesday,Workingday,Clear,0.66,0.6212,0.29,0.0896,72,256,328,328,111,328,4,4,3,443,2,729,184919,4,328
2012-09-11,fall,2012,September,14,Tuesday,Workingday,Clear,0.68,0.6212,0.3,0.0896,74,181,255,255,111,255,4,3,3,433,2,729,175652,4,255
2012-09-11,fall,2012,September,15,Tuesday,Workingday,Clear,0.7,0.6364,0.28,0.1045,73,253,326,326,111,326,4,4,4,444,2,729,183149,4,326
2012-09-11,fall,2012,September,16,Tuesday,Workingday,Clear,0.7,0.6364,0.28,0.1343,99,437,536,536,111,536,4,4,4,444,2,730,227748,4,536
2012-09-11,fall,2012,September,17,Tuesday,Workingday,Clear,0.7,0.6364,0.28,0.0,168,802,970,970,111,970,4,4,4,444,2,730,336860,4,970
2012-09-11,fall,2012,September,18,Tuesday,Workingday,Clear,0.64,0.6212,0.36,0.1642,110,767,877,877,111,877,4,4,3,443,2,728,309772,4,877
2012-09-11,fall,2012,September,19,Tuesday,Workingday,Clear,0.62,0.6212,0.41,0.194,56,540,596,596,111,596,4,4,3,443,2,728,226789,4,596
2012-09-11,fall,2012,September,20,Tuesday,Workingday,Clear,0.58,0.5455,0.56,0.1343,40,421,461,461,111,461,4,4,3,443,2,728,164550,4,461
2012-09-11,fall,2012,September,21,Tuesday,Workingday,Clear,0.56,0.5303,0.6,0.1045,28,282,310,310,111,310,4,4,3,443,0,728,125445,4,310
2012-09-11,fall,2012,September,22,Tuesday,Workingday,Clear,0.56,0.5303,0.64,0.1045,27,189,216,216,111,216,4,3,3,433,0,728,95612,4,216
2012-09-11,fall,2012,September,23,Tuesday,Workingday,Clear,0.54,0.5152,0.68,0.1045,18,91,109,109,111,109,4,2,3,423,0,728,63941,4,109
2012-09-12,fall,2012,September,0,Wednesday,Workingday,Clear,0.52,0.5,0.72,0.1045,8,41,49,49,110,49,4,2,3,423,0,726,39130,4,49
2012-09-12,fall,2012,September,1,Wednesday,Workingday,Clear,0.52,0.5,0.72,0.1045,2,19,21,21,110,21,4,1,3,413,0,724,24164,4,21
2012-09-12,fall,2012,September,2,Wednesday,Workingday,Clear,0.52,0.5,0.72,0.0896,2,9,11,11,110,11,4,1,3,413,0,715,16352,4,11
2012-09-12,fall,2012,September,3,Wednesday,Workingday,Clear,0.5,0.4848,0.77,0.0896,0,7,7,7,110,7,4,1,2,412,0,697,8174,4,7
2012-09-12,fall,2012,September,4,Wednesday,Workingday,Clear,0.5,0.4848,0.72,0.0896,0,5,5,5,110,5,4,1,2,412,0,697,4428,4,5
2012-09-12,fall,2012,September,5,Wednesday,Workingday,Clear,0.5,0.4848,0.72,0.0896,4,44,48,48,110,48,4,2,2,422,0,717,14261,4,48
2012-09-12,fall,2012,September,6,Wednesday,Workingday,Clear,0.5,0.4848,0.72,0.0896,6,199,205,205,110,205,4,3,2,432,0,725,55132,4,205
2012-09-12,fall,2012,September,7,Wednesday,Workingday,Clear,0.52,0.5,0.72,0.0,24,533,557,557,110,557,4,4,3,443,0,727,154171,4,557
2012-09-12,fall,2012,September,8,Wednesday,Workingday,Clear,0.56,0.5303,0.64,0.1045,43,727,770,770,110,770,4,4,3,443,2,727,261001,4,770
2012-09-12,fall,2012,September,9,Wednesday,Workingday,Clear,0.6,0.6061,0.64,0.1343,50,278,328,328,110,328,4,4,3,443,2,727,159438,4,328
2012-09-12,fall,2012,September,10,Wednesday,Workingday,Clear,0.62,0.6061,0.61,0.1343,57,148,205,205,110,205,4,3,3,433,0,727,126257,4,205
2012-09-12,fall,2012,September,11,Wednesday,Workingday,Clear,0.66,0.6212,0.5,0.194,51,181,232,232,110,232,4,3,3,433,2,727,151320,4,232
2012-09-12,fall,2012,September,12,Wednesday,Workingday,Clear,0.68,0.6364,0.36,0.1343,88,264,352,352,110,352,4,4,4,444,2,728,184414,4,352
2012-09-12,fall,2012,September,13,Wednesday,Workingday,Clear,0.7,0.6364,0.34,0.1343,85,238,323,323,110,323,4,4,4,444,2,729,184919,4,323
2012-09-12,fall,2012,September,14,Wednesday,Workingday,Clear,0.7,0.6364,0.37,0.1642,78,200,278,278,110,278,4,3,4,434,2,729,175652,4,278
2012-09-12,fall,2012,September,15,Wednesday,Workingday,Clear,0.72,0.6515,0.37,0.1343,75,243,318,318,110,318,4,4,4,444,2,729,183149,4,318
2012-09-12,fall,2012,September,16,Wednesday,Workingday,Clear,0.72,0.6515,0.37,0.1642,90,419,509,509,110,509,4,4,4,444,2,730,227748,4,509
2012-09-12,fall,2012,September,17,Wednesday,Workingday,Clear,0.7,0.6364,0.41,0.2985,114,811,925,925,110,925,4,4,4,444,2,730,336860,4,925
2012-09-12,fall,2012,September,18,Wednesday,Workingday,Clear,0.66,0.6212,0.44,0.2537,91,886,977,977,110,977,4,4,3,443,2,728,309772,4,977
2012-09-12,fall,2012,September,19,Wednesday,Workingday,Clear,0.64,0.6212,0.5,0.194,78,557,635,635,110,635,4,4,3,443,2,728,226789,4,635
2012-09-12,fall,2012,September,20,Wednesday,Workingday,Clear,0.62,0.6212,0.57,0.1343,38,432,470,470,110,470,4,4,3,443,2,728,164550,4,470
2012-09-12,fall,2012,September,21,Wednesday,Workingday,Clear,0.6,0.6061,0.6,0.1343,27,279,306,306,110,306,4,4,3,443,0,728,125445,4,306
2012-09-12,fall,2012,September,22,Wednesday,Workingday,Clear,0.56,0.5303,0.64,0.0896,23,189,212,212,110,212,4,3,3,433,0,728,95612,4,212
2012-09-12,fall,2012,September,23,Wednesday,Workingday,Clear,0.56,0.5303,0.68,0.1045,16,111,127,127,110,127,4,2,3,423,0,728,63941,4,127
2012-09-13,fall,2012,September,0,Thursday,Workingday,Clear,0.56,0.5303,0.73,0.0896,11,46,57,57,109,57,4,2,3,423,0,726,39130,4,57
2012-09-13,fall,2012,September,1,Thursday,Workingday,Clear,0.54,0.5152,0.77,0.0896,6,22,28,28,109,28,4,1,3,413,0,724,24164,4,28
2012-09-13,fall,2012,September,2,Thursday,Workingday,Clear,0.54,0.5152,0.77,0.0,0,9,9,9,109,9,4,1,3,413,0,715,16352,4,9
2012-09-13,fall,2012,September,3,Thursday,Workingday,Clear,0.52,0.5,0.83,0.0,2,9,11,11,109,11,4,1,3,413,0,697,8174,4,11
2012-09-13,fall,2012,September,4,Thursday,Workingday,Clear,0.52,0.5,0.83,0.0,0,6,6,6,109,6,4,1,3,413,0,697,4428,4,6
2012-09-13,fall,2012,September,5,Thursday,Workingday,Clear,0.52,0.5,0.83,0.0,3,54,57,57,109,57,4,2,3,423,0,717,14261,4,57
2012-09-13,fall,2012,September,6,Thursday,Workingday,Clear,0.5,0.4848,0.82,0.0,9,186,195,195,109,195,4,3,2,432,0,725,55132,4,195
2012-09-13,fall,2012,September,7,Thursday,Workingday,Clear,0.54,0.5152,0.77,0.0,22,549,571,571,109,571,4,4,3,443,0,727,154171,4,571
2012-09-13,fall,2012,September,8,Thursday,Workingday,Clear,0.56,0.5303,0.73,0.0,33,725,758,758,109,758,4,4,3,443,2,727,261001,4,758
2012-09-13,fall,2012,September,9,Thursday,Workingday,Clear,0.6,0.6061,0.64,0.0896,46,292,338,338,109,338,4,4,3,443,2,727,159438,4,338
2012-09-13,fall,2012,September,10,Thursday,Workingday,Clear,0.64,0.6212,0.61,0.0896,63,149,212,212,109,212,4,3,3,433,0,727,126257,4,212
2012-09-13,fall,2012,September,11,Thursday,Workingday,Clear,0.66,0.6212,0.5,0.1642,71,183,254,254,109,254,4,3,3,433,2,727,151320,4,254
2012-09-13,fall,2012,September,12,Thursday,Workingday,Clear,0.68,0.6364,0.44,0.1045,57,240,297,297,109,297,4,4,4,444,2,728,184414,4,297
2012-09-13,fall,2012,September,13,Thursday,Workingday,Clear,0.7,0.6364,0.42,0.0,60,223,283,283,109,283,4,4,4,444,2,729,184919,4,283
2012-09-13,fall,2012,September,14,Thursday,Workingday,Clear,0.72,0.6515,0.39,0.1343,60,214,274,274,109,274,4,3,4,434,2,729,175652,4,274
2012-09-13,fall,2012,September,15,Thursday,Workingday,Clear,0.72,0.6515,0.42,0.1045,99,253,352,352,109,352,4,4,4,444,2,729,183149,4,352
2012-09-13,fall,2012,September,16,Thursday,Workingday,Clear,0.72,0.6515,0.39,0.0896,85,406,491,491,109,491,4,4,4,444,2,730,227748,4,491
2012-09-13,fall,2012,September,17,Thursday,Workingday,Clear,0.72,0.6515,0.42,0.194,97,787,884,884,109,884,4,4,4,444,2,730,336860,4,884
2012-09-13,fall,2012,September,18,Thursday,Workingday,Clear,0.68,0.6364,0.57,0.2537,108,744,852,852,109,852,4,4,4,444,2,728,309772,4,852
2012-09-13,fall,2012,September,19,Thursday,Workingday,Clear,0.64,0.6061,0.65,0.1343,80,594,674,674,109,674,4,4,3,443,2,728,226789,4,674
2012-09-13,fall,2012,September,20,Thursday,Workingday,Clear,0.62,0.6061,0.69,0.1045,55,408,463,463,109,463,4,4,3,443,2,728,164550,4,463
2012-09-13,fall,2012,September,21,Thursday,Workingday,Clear,0.62,0.6061,0.65,0.1045,26,291,317,317,109,317,4,4,3,443,0,728,125445,4,317
2012-09-13,fall,2012,September,22,Thursday,Workingday,Clear,0.6,0.5909,0.69,0.1343,28,223,251,251,109,251,4,3,3,433,0,728,95612,4,251
2012-09-13,fall,2012,September,23,Thursday,Workingday,Clear,0.58,0.5455,0.73,0.1045,33,137,170,170,109,170,4,3,3,433,0,728,63941,4,170
2012-09-14,fall,2012,September,0,Friday,Workingday,Clear,0.56,0.5303,0.73,0.0896,24,63,87,87,108,87,4,2,3,423,0,726,39130,4,87
2012-09-14,fall,2012,September,1,Friday,Workingday,Clear,0.56,0.5303,0.73,0.0896,6,35,41,41,108,41,4,2,3,423,0,724,24164,4,41
2012-09-14,fall,2012,September,2,Friday,Workingday,Clear,0.56,0.5303,0.73,0.0,7,23,30,30,108,30,4,1,3,413,0,715,16352,4,30
2012-09-14,fall,2012,September,3,Friday,Workingday,Clear,0.54,0.5152,0.77,0.0,5,9,14,14,108,14,4,1,3,413,0,697,8174,4,14
2012-09-14,fall,2012,September,4,Friday,Workingday,Clear,0.54,0.5152,0.77,0.0,1,11,12,12,108,12,4,1,3,413,0,697,4428,4,12
2012-09-14,fall,2012,September,5,Friday,Workingday,Clear,0.54,0.5152,0.83,0.0,1,40,41,41,108,41,4,2,3,423,0,717,14261,4,41
2012-09-14,fall,2012,September,6,Friday,Workingday,Clear,0.54,0.5152,0.88,0.0,8,144,152,152,108,152,4,3,3,433,0,725,55132,4,152
2012-09-14,fall,2012,September,7,Friday,Workingday,Mist,0.56,0.5303,0.88,0.0,17,437,454,454,108,454,4,4,3,443,0,727,154171,4,454
2012-09-14,fall,2012,September,8,Friday,Workingday,Mist,0.6,0.5758,0.78,0.1642,51,715,766,766,108,766,4,4,3,443,2,727,261001,4,766
2012-09-14,fall,2012,September,9,Friday,Workingday,Mist,0.62,0.5909,0.78,0.1642,46,301,347,347,108,347,4,4,3,443,0,727,159438,4,347
2012-09-14,fall,2012,September,10,Friday,Workingday,Mist,0.68,0.6364,0.65,0.0,75,171,246,246,108,246,4,3,4,434,0,727,126257,4,246
2012-09-14,fall,2012,September,11,Friday,Workingday,Mist,0.68,0.6364,0.61,0.1045,84,196,280,280,108,280,4,3,4,434,2,727,151320,4,280
2012-09-14,fall,2012,September,12,Friday,Workingday,Mist,0.7,0.6515,0.54,0.194,119,290,409,409,108,409,4,4,4,444,2,728,184414,4,409
2012-09-14,fall,2012,September,13,Friday,Workingday,Mist,0.7,0.6515,0.54,0.194,107,301,408,408,108,408,4,4,4,444,2,729,184919,4,408
2012-09-14,fall,2012,September,14,Friday,Workingday,Mist,0.72,0.6515,0.45,0.1642,113,258,371,371,108,371,4,4,4,444,2,729,175652,4,371
2012-09-14,fall,2012,September,15,Friday,Workingday,Mist,0.72,0.6667,0.48,0.1343,94,273,367,367,108,367,4,4,4,444,2,729,183149,4,367
2012-09-14,fall,2012,September,16,Friday,Workingday,Mist,0.72,0.6667,0.51,0.0,109,454,563,563,108,563,4,4,4,444,2,730,227748,4,563
2012-09-14,fall,2012,September,17,Friday,Workingday,Clear,0.72,0.6667,0.51,0.194,137,757,894,894,108,894,4,4,4,444,2,730,336860,4,894
2012-09-14,fall,2012,September,18,Friday,Workingday,Clear,0.72,0.6515,0.45,0.2239,116,692,808,808,108,808,4,4,4,444,2,728,309772,4,808
2012-09-14,fall,2012,September,19,Friday,Workingday,Clear,0.68,0.6364,0.57,0.1642,83,496,579,579,108,579,4,4,4,444,2,728,226789,4,579
2012-09-14,fall,2012,September,20,Friday,Workingday,Clear,0.66,0.6212,0.61,0.1045,67,337,404,404,108,404,4,4,3,443,2,728,164550,4,404
2012-09-14,fall,2012,September,21,Friday,Workingday,Clear,0.64,0.6061,0.73,0.2239,42,270,312,312,108,312,4,4,3,443,0,728,125445,4,312
2012-09-14,fall,2012,September,22,Friday,Workingday,Clear,0.62,0.5758,0.83,0.194,40,189,229,229,108,229,4,3,3,433,0,728,95612,4,229
2012-09-14,fall,2012,September,23,Friday,Workingday,Clear,0.62,0.5909,0.78,0.0896,27,168,195,195,108,195,4,3,3,433,0,728,63941,4,195
2012-09-15,fall,2012,September,0,Saturday,Holiday,Clear,0.6,0.5606,0.83,0.1045,38,169,207,207,107,207,4,3,3,433,0,726,39130,4,207
2012-09-15,fall,2012,September,1,Saturday,Holiday,Clear,0.6,0.5909,0.73,0.0,8,101,109,109,107,109,4,2,3,423,0,724,24164,4,109
2012-09-15,fall,2012,September,2,Saturday,Holiday,Clear,0.58,0.5455,0.78,0.1045,18,75,93,93,107,93,4,2,3,423,0,715,16352,4,93
2012-09-15,fall,2012,September,3,Saturday,Holiday,Clear,0.6,0.5909,0.73,0.2537,6,31,37,37,107,37,4,1,3,413,0,697,8174,4,37
2012-09-15,fall,2012,September,4,Saturday,Holiday,Mist,0.6,0.5909,0.69,0.3582,3,3,6,6,107,6,4,1,3,413,0,697,4428,4,6
2012-09-15,fall,2012,September,5,Saturday,Holiday,Clear,0.58,0.5455,0.6,0.5224,1,15,16,16,107,16,4,1,3,413,1,717,14261,4,16
2012-09-15,fall,2012,September,6,Saturday,Holiday,Clear,0.54,0.5152,0.49,0.4179,6,27,33,33,107,33,4,1,3,413,1,725,55132,4,33
2012-09-15,fall,2012,September,7,Saturday,Holiday,Clear,0.54,0.5152,0.52,0.2836,10,63,73,73,107,73,4,2,3,423,0,727,154171,4,73
2012-09-15,fall,2012,September,8,Saturday,Holiday,Clear,0.56,0.5303,0.49,0.4179,43,169,212,212,107,212,4,3,3,433,2,727,261001,4,212
2012-09-15,fall,2012,September,9,Saturday,Holiday,Clear,0.6,0.6212,0.43,0.4179,79,263,342,342,107,342,4,4,3,443,2,727,159438,4,342
2012-09-15,fall,2012,September,10,Saturday,Holiday,Clear,0.62,0.6212,0.41,0.3881,119,323,442,442,107,442,4,4,3,443,2,727,126257,4,442
2012-09-15,fall,2012,September,11,Saturday,Holiday,Clear,0.64,0.6212,0.38,0.3881,228,399,627,627,107,627,4,4,3,443,2,727,151320,4,627
2012-09-15,fall,2012,September,12,Saturday,Holiday,Clear,0.66,0.6212,0.36,0.3582,287,419,706,706,107,706,4,4,3,443,2,728,184414,4,706
2012-09-15,fall,2012,September,13,Saturday,Holiday,Clear,0.68,0.6364,0.36,0.194,327,377,704,704,107,704,4,4,4,444,2,729,184919,4,704
2012-09-15,fall,2012,September,14,Saturday,Holiday,Clear,0.68,0.6364,0.34,0.3284,325,390,715,715,107,715,4,4,4,444,2,729,175652,4,715
2012-09-15,fall,2012,September,15,Saturday,Holiday,Mist,0.68,0.6364,0.34,0.2836,312,342,654,654,107,654,4,4,4,444,2,729,183149,4,654
2012-09-15,fall,2012,September,16,Saturday,Holiday,Mist,0.66,0.6212,0.36,0.2239,350,433,783,783,107,783,4,4,3,443,2,730,227748,4,783
2012-09-15,fall,2012,September,17,Saturday,Holiday,Mist,0.66,0.6212,0.36,0.2537,295,434,729,729,107,729,4,4,3,443,2,730,336860,4,729
2012-09-15,fall,2012,September,18,Saturday,Holiday,Mist,0.64,0.6212,0.36,0.2836,232,382,614,614,107,614,4,4,3,443,2,728,309772,4,614
2012-09-15,fall,2012,September,19,Saturday,Holiday,Clear,0.62,0.6212,0.41,0.1642,169,309,478,478,107,478,4,4,3,443,2,728,226789,4,478
2012-09-15,fall,2012,September,20,Saturday,Holiday,Clear,0.6,0.6212,0.43,0.0896,89,241,330,330,107,330,4,4,3,443,2,728,164550,4,330
2012-09-15,fall,2012,September,21,Saturday,Holiday,Clear,0.56,0.5303,0.52,0.1045,86,210,296,296,107,296,4,4,3,443,2,728,125445,4,296
2012-09-15,fall,2012,September,22,Saturday,Holiday,Clear,0.56,0.5303,0.52,0.0,82,197,279,279,107,279,4,3,3,433,2,728,95612,4,279
2012-09-15,fall,2012,September,23,Saturday,Holiday,Clear,0.54,0.5152,0.6,0.0,47,182,229,229,107,229,4,3,3,433,0,728,63941,4,229
2012-09-16,fall,2012,September,0,Sunday,Holiday,Clear,0.54,0.5152,0.64,0.0,28,123,151,151,106,151,4,3,3,433,0,726,39130,4,151
2012-09-16,fall,2012,September,1,Sunday,Holiday,Clear,0.54,0.5152,0.64,0.0,35,82,117,117,106,117,4,2,3,423,0,724,24164,4,117
2012-09-16,fall,2012,September,2,Sunday,Holiday,Clear,0.52,0.5,0.63,0.0,27,62,89,89,106,89,4,2,3,423,0,715,16352,4,89
2012-09-16,fall,2012,September,3,Sunday,Holiday,Clear,0.5,0.4848,0.68,0.0,10,38,48,48,106,48,4,2,2,422,0,697,8174,4,48
2012-09-16,fall,2012,September,4,Sunday,Holiday,Clear,0.5,0.4848,0.72,0.0,2,6,8,8,106,8,4,1,2,412,0,697,4428,4,8
2012-09-16,fall,2012,September,5,Sunday,Holiday,Clear,0.5,0.4848,0.72,0.0,3,10,13,13,106,13,4,1,2,412,0,717,14261,4,13
2012-09-16,fall,2012,September,6,Sunday,Holiday,Clear,0.5,0.4848,0.72,0.0,9,26,35,35,106,35,4,1,2,412,0,725,55132,4,35
2012-09-16,fall,2012,September,7,Sunday,Holiday,Clear,0.5,0.4848,0.77,0.1045,28,43,71,71,106,71,4,2,2,422,0,727,154171,4,71
2012-09-16,fall,2012,September,8,Sunday,Holiday,Clear,0.54,0.5152,0.64,0.1642,34,94,128,128,106,128,4,2,3,423,0,727,261001,4,128
2012-09-16,fall,2012,September,9,Sunday,Holiday,Clear,0.58,0.5455,0.6,0.1343,70,226,296,296,106,296,4,4,3,443,2,727,159438,4,296
2012-09-16,fall,2012,September,10,Sunday,Holiday,Clear,0.62,0.6212,0.5,0.1045,160,330,490,490,106,490,4,4,3,443,2,727,126257,4,490
2012-09-16,fall,2012,September,11,Sunday,Holiday,Clear,0.64,0.6212,0.47,0.1642,183,376,559,559,106,559,4,4,3,443,2,727,151320,4,559
2012-09-16,fall,2012,September,12,Sunday,Holiday,Clear,0.66,0.6212,0.44,0.1642,188,468,656,656,106,656,4,4,3,443,2,728,184414,4,656
2012-09-16,fall,2012,September,13,Sunday,Holiday,Clear,0.64,0.6212,0.41,0.1642,240,454,694,694,106,694,4,4,3,443,2,729,184919,4,694
2012-09-16,fall,2012,September,14,Sunday,Holiday,Clear,0.66,0.6212,0.39,0.1343,225,410,635,635,106,635,4,4,3,443,2,729,175652,4,635
2012-09-16,fall,2012,September,15,Sunday,Holiday,Clear,0.64,0.6212,0.41,0.1642,215,342,557,557,106,557,4,4,3,443,2,729,183149,4,557
2012-09-16,fall,2012,September,16,Sunday,Holiday,Clear,0.64,0.6212,0.44,0.1642,194,402,596,596,106,596,4,4,3,443,2,730,227748,4,596
2012-09-16,fall,2012,September,17,Sunday,Holiday,Clear,0.66,0.6212,0.41,0.0,177,393,570,570,106,570,4,4,3,443,2,730,336860,4,570
2012-09-16,fall,2012,September,18,Sunday,Holiday,Clear,0.62,0.6212,0.5,0.1642,120,361,481,481,106,481,4,4,3,443,2,728,309772,4,481
2012-09-16,fall,2012,September,19,Sunday,Holiday,Clear,0.62,0.6212,0.5,0.1343,91,312,403,403,106,403,4,4,3,443,2,728,226789,4,403
2012-09-16,fall,2012,September,20,Sunday,Holiday,Clear,0.6,0.6212,0.53,0.1045,57,267,324,324,106,324,4,4,3,443,2,728,164550,4,324
2012-09-16,fall,2012,September,21,Sunday,Holiday,Clear,0.6,0.6212,0.56,0.1045,43,148,191,191,106,191,4,3,3,433,0,728,125445,4,191
2012-09-16,fall,2012,September,22,Sunday,Holiday,Clear,0.56,0.5303,0.68,0.0896,18,109,127,127,106,127,4,2,3,423,0,728,95612,4,127
2012-09-16,fall,2012,September,23,Sunday,Holiday,Clear,0.54,0.5152,0.68,0.1045,9,85,94,94,106,94,4,2,3,423,0,728,63941,4,94
2012-09-17,fall,2012,September,0,Monday,Workingday,Clear,0.54,0.5152,0.68,0.1642,14,31,45,45,105,45,4,2,3,423,0,726,39130,4,45
2012-09-17,fall,2012,September,1,Monday,Workingday,Clear,0.52,0.5,0.72,0.0896,9,12,21,21,105,21,4,1,3,413,0,724,24164,4,21
2012-09-17,fall,2012,September,2,Monday,Workingday,Clear,0.52,0.5,0.72,0.0,5,8,13,13,105,13,4,1,3,413,0,715,16352,4,13
2012-09-17,fall,2012,September,3,Monday,Workingday,Clear,0.5,0.4848,0.77,0.0896,0,7,7,7,105,7,4,1,2,412,0,697,8174,4,7
2012-09-17,fall,2012,September,4,Monday,Workingday,Clear,0.5,0.4848,0.77,0.0,2,9,11,11,105,11,4,1,2,412,0,697,4428,4,11
2012-09-17,fall,2012,September,5,Monday,Workingday,Clear,0.48,0.4697,0.82,0.0896,1,44,45,45,105,45,4,2,2,422,0,717,14261,4,45
2012-09-17,fall,2012,September,6,Monday,Workingday,Clear,0.48,0.4697,0.82,0.0,7,157,164,164,105,164,4,3,2,432,0,725,55132,4,164
2012-09-17,fall,2012,September,7,Monday,Workingday,Clear,0.52,0.5,0.77,0.0,18,474,492,492,105,492,4,4,3,443,0,727,154171,4,492
2012-09-17,fall,2012,September,8,Monday,Workingday,Clear,0.54,0.5152,0.77,0.0896,36,647,683,683,105,683,4,4,3,443,2,727,261001,4,683
2012-09-17,fall,2012,September,9,Monday,Workingday,Clear,0.58,0.5455,0.68,0.1343,34,265,299,299,105,299,4,4,3,443,0,727,159438,4,299
2012-09-17,fall,2012,September,10,Monday,Workingday,Mist,0.62,0.6061,0.65,0.194,73,129,202,202,105,202,4,3,3,433,0,727,126257,4,202
2012-09-17,fall,2012,September,11,Monday,Workingday,Mist,0.62,0.6061,0.69,0.2239,61,191,252,252,105,252,4,3,3,433,0,727,151320,4,252
2012-09-17,fall,2012,September,12,Monday,Workingday,Mist,0.62,0.6061,0.69,0.194,62,233,295,295,105,295,4,4,3,443,2,728,184414,4,295
2012-09-17,fall,2012,September,13,Monday,Workingday,Clear,0.64,0.6061,0.65,0.2537,112,231,343,343,105,343,4,4,3,443,2,729,184919,4,343
2012-09-17,fall,2012,September,14,Monday,Workingday,Mist,0.64,0.6061,0.65,0.2537,129,203,332,332,105,332,4,4,3,443,2,729,175652,4,332
2012-09-17,fall,2012,September,15,Monday,Workingday,Mist,0.64,0.6061,0.65,0.2537,82,256,338,338,105,338,4,4,3,443,2,729,183149,4,338
2012-09-17,fall,2012,September,16,Monday,Workingday,Mist,0.64,0.6061,0.69,0.2537,74,379,453,453,105,453,4,4,3,443,2,730,227748,4,453
2012-09-17,fall,2012,September,17,Monday,Workingday,Mist,0.64,0.6061,0.65,0.2239,102,740,842,842,105,842,4,4,3,443,2,730,336860,4,842
2012-09-17,fall,2012,September,18,Monday,Workingday,Mist,0.62,0.5909,0.73,0.1642,66,708,774,774,105,774,4,4,3,443,2,728,309772,4,774
2012-09-17,fall,2012,September,19,Monday,Workingday,Mist,0.62,0.5909,0.73,0.1045,51,435,486,486,105,486,4,4,3,443,2,728,226789,4,486
2012-09-17,fall,2012,September,20,Monday,Workingday,Mist,0.62,0.5909,0.73,0.1343,32,308,340,340,105,340,4,4,3,443,0,728,164550,4,340
2012-09-17,fall,2012,September,21,Monday,Workingday,Light Snow,0.62,0.5758,0.83,0.2239,28,205,233,233,105,233,4,3,3,433,0,728,125445,4,233
2012-09-17,fall,2012,September,22,Monday,Workingday,Light Snow,0.62,0.5758,0.83,0.2537,20,109,129,129,105,129,4,2,3,423,0,728,95612,4,129
2012-09-17,fall,2012,September,23,Monday,Workingday,Light Snow,0.6,0.5152,0.94,0.2537,4,66,70,70,105,70,4,2,3,423,0,728,63941,4,70
2012-09-18,fall,2012,September,0,Tuesday,Workingday,Light Snow,0.6,0.5152,0.94,0.2537,2,11,13,13,104,13,4,1,3,413,0,726,39130,4,13
2012-09-18,fall,2012,September,1,Tuesday,Workingday,Light Snow,0.6,0.5152,0.94,0.194,0,5,5,5,104,5,4,1,3,413,0,724,24164,4,5
2012-09-18,fall,2012,September,2,Tuesday,Workingday,Light Snow,0.6,0.5152,0.94,0.194,0,4,4,4,104,4,4,1,3,413,0,715,16352,4,4
2012-09-18,fall,2012,September,3,Tuesday,Workingday,Mist,0.62,0.5455,0.94,0.2836,0,6,6,6,104,6,4,1,3,413,0,697,8174,4,6
2012-09-18,fall,2012,September,4,Tuesday,Workingday,Mist,0.62,0.5455,0.94,0.3582,2,5,7,7,104,7,4,1,3,413,0,697,4428,4,7
2012-09-18,fall,2012,September,5,Tuesday,Workingday,Mist,0.64,0.5758,0.89,0.3284,3,45,48,48,104,48,4,2,3,423,0,717,14261,4,48
2012-09-18,fall,2012,September,6,Tuesday,Workingday,Mist,0.64,0.5758,0.89,0.3284,4,163,167,167,104,167,4,3,3,433,0,725,55132,4,167
2012-09-18,fall,2012,September,7,Tuesday,Workingday,Mist,0.64,0.5758,0.89,0.4478,13,343,356,356,104,356,4,4,3,443,0,727,154171,4,356
2012-09-18,fall,2012,September,8,Tuesday,Workingday,Mist,0.66,0.6061,0.83,0.5522,32,640,672,672,104,672,4,4,3,443,2,727,261001,4,672
2012-09-18,fall,2012,September,9,Tuesday,Workingday,Mist,0.66,0.6061,0.83,0.5821,27,266,293,293,104,293,4,4,3,443,2,727,159438,4,293
2012-09-18,fall,2012,September,10,Tuesday,Workingday,Light Snow,0.68,0.6364,0.79,0.6418,30,130,160,160,104,160,4,3,4,434,2,727,126257,4,160
2012-09-18,fall,2012,September,11,Tuesday,Workingday,Mist,0.68,0.6364,0.79,0.6418,36,115,151,151,104,151,4,3,4,434,2,727,151320,4,151
2012-09-18,fall,2012,September,12,Tuesday,Workingday,Light Snow,0.68,0.6364,0.83,0.4478,16,72,88,88,104,88,4,2,4,424,0,728,184414,4,88
2012-09-18,fall,2012,September,13,Tuesday,Workingday,Mist,0.7,0.6667,0.74,0.5821,17,97,114,114,104,114,4,2,4,424,0,729,184919,4,114
2012-09-18,fall,2012,September,14,Tuesday,Workingday,Light Snow,0.6,0.5152,0.94,0.4627,27,116,143,143,104,143,4,3,3,433,0,729,175652,4,143
2012-09-18,fall,2012,September,15,Tuesday,Workingday,Light Snow,0.6,0.5455,0.88,0.2537,1,35,36,36,104,36,4,1,3,413,0,729,183149,4,36
2012-09-18,fall,2012,September,16,Tuesday,Workingday,Light Snow,0.6,0.5455,0.88,0.2985,19,122,141,141,104,141,4,2,3,423,0,730,227748,4,141
2012-09-18,fall,2012,September,17,Tuesday,Workingday,Light Snow,0.6,0.5455,0.88,0.194,36,302,338,338,104,338,4,4,3,443,0,730,336860,4,338
2012-09-18,fall,2012,September,18,Tuesday,Workingday,Mist,0.6,0.5455,0.88,0.1642,19,262,281,281,104,281,4,3,3,433,0,728,309772,4,281
2012-09-18,fall,2012,September,19,Tuesday,Workingday,Mist,0.6,0.5455,0.88,0.2985,22,302,324,324,104,324,4,4,3,443,0,728,226789,4,324
2012-09-18,fall,2012,September,20,Tuesday,Workingday,Mist,0.6,0.5455,0.88,0.194,19,271,290,290,104,290,4,4,3,443,0,728,164550,4,290
2012-09-18,fall,2012,September,21,Tuesday,Workingday,Mist,0.6,0.5455,0.88,0.194,21,186,207,207,104,207,4,3,3,433,0,728,125445,4,207
2012-09-18,fall,2012,September,22,Tuesday,Workingday,Light Snow,0.58,0.5455,0.83,0.4627,14,137,151,151,104,151,4,3,3,433,0,728,95612,4,151
2012-09-18,fall,2012,September,23,Tuesday,Workingday,Mist,0.56,0.5303,0.83,0.2239,11,67,78,78,104,78,4,2,3,423,0,728,63941,4,78
2012-09-19,fall,2012,September,0,Wednesday,Workingday,Mist,0.56,0.5303,0.68,0.2836,3,23,26,26,103,26,4,1,3,413,0,726,39130,4,26
2012-09-19,fall,2012,September,1,Wednesday,Workingday,Mist,0.54,0.5152,0.68,0.2537,0,12,12,12,103,12,4,1,3,413,0,724,24164,4,12
2012-09-19,fall,2012,September,2,Wednesday,Workingday,Mist,0.54,0.5152,0.64,0.3284,0,3,3,3,103,3,4,1,3,413,0,715,16352,4,3
2012-09-19,fall,2012,September,3,Wednesday,Workingday,Mist,0.52,0.5,0.63,0.2537,1,4,5,5,103,5,4,1,3,413,0,697,8174,4,5
2012-09-19,fall,2012,September,4,Wednesday,Workingday,Mist,0.52,0.5,0.68,0.3582,0,10,10,10,103,10,4,1,3,413,0,697,4428,4,10
2012-09-19,fall,2012,September,5,Wednesday,Workingday,Mist,0.52,0.5,0.68,0.2836,2,54,56,56,103,56,4,2,3,423,0,717,14261,4,56
2012-09-19,fall,2012,September,6,Wednesday,Workingday,Clear,0.52,0.5,0.63,0.2537,6,166,172,172,103,172,4,3,3,433,0,725,55132,4,172
2012-09-19,fall,2012,September,7,Wednesday,Workingday,Clear,0.52,0.5,0.63,0.2239,16,529,545,545,103,545,4,4,3,443,2,727,154171,4,545
2012-09-19,fall,2012,September,8,Wednesday,Workingday,Clear,0.52,0.5,0.59,0.2239,39,758,797,797,103,797,4,4,3,443,2,727,261001,4,797
2012-09-19,fall,2012,September,9,Wednesday,Workingday,Clear,0.54,0.5152,0.6,0.2537,26,336,362,362,103,362,4,4,3,443,2,727,159438,4,362
2012-09-19,fall,2012,September,10,Wednesday,Workingday,Clear,0.56,0.5303,0.52,0.194,23,169,192,192,103,192,4,3,3,433,0,727,126257,4,192
2012-09-19,fall,2012,September,11,Wednesday,Workingday,Clear,0.6,0.6212,0.43,0.2537,44,203,247,247,103,247,4,3,3,433,2,727,151320,4,247
2012-09-19,fall,2012,September,12,Wednesday,Workingday,Clear,0.6,0.6212,0.43,0.2537,53,260,313,313,103,313,4,4,3,443,2,728,184414,4,313
2012-09-19,fall,2012,September,13,Wednesday,Workingday,Clear,0.6,0.6212,0.4,0.2537,55,234,289,289,103,289,4,4,3,443,2,729,184919,4,289
2012-09-19,fall,2012,September,14,Wednesday,Workingday,Clear,0.62,0.6212,0.38,0.2537,59,227,286,286,103,286,4,4,3,443,2,729,175652,4,286
2012-09-19,fall,2012,September,15,Wednesday,Workingday,Clear,0.62,0.6212,0.35,0.0,57,254,311,311,103,311,4,4,3,443,2,729,183149,4,311
2012-09-19,fall,2012,September,16,Wednesday,Workingday,Clear,0.62,0.6212,0.35,0.0,69,397,466,466,103,466,4,4,3,443,2,730,227748,4,466
2012-09-19,fall,2012,September,17,Wednesday,Workingday,Clear,0.6,0.6212,0.38,0.2239,74,812,886,886,103,886,4,4,3,443,2,730,336860,4,886
2012-09-19,fall,2012,September,18,Wednesday,Workingday,Clear,0.58,0.5455,0.4,0.2836,85,807,892,892,103,892,4,4,3,443,2,728,309772,4,892
2012-09-19,fall,2012,September,19,Wednesday,Workingday,Clear,0.56,0.5303,0.43,0.2239,72,539,611,611,103,611,4,4,3,443,2,728,226789,4,611
2012-09-19,fall,2012,September,20,Wednesday,Workingday,Clear,0.52,0.5,0.48,0.1642,31,378,409,409,103,409,4,4,3,443,2,728,164550,4,409
2012-09-19,fall,2012,September,21,Wednesday,Workingday,Clear,0.5,0.4848,0.59,0.1642,25,324,349,349,103,349,4,4,2,442,0,728,125445,4,349
2012-09-19,fall,2012,September,22,Wednesday,Workingday,Clear,0.5,0.4848,0.63,0.0896,31,198,229,229,103,229,4,3,2,432,0,728,95612,4,229
2012-09-19,fall,2012,September,23,Wednesday,Workingday,Clear,0.48,0.4697,0.67,0.0896,17,106,123,123,103,123,4,2,2,422,0,728,63941,4,123
2012-09-20,fall,2012,September,0,Thursday,Workingday,Clear,0.5,0.4848,0.63,0.0,12,46,58,58,102,58,4,2,2,422,0,726,39130,4,58
2012-09-20,fall,2012,September,1,Thursday,Workingday,Clear,0.46,0.4545,0.72,0.1045,4,14,18,18,102,18,4,1,2,412,0,724,24164,4,18
2012-09-20,fall,2012,September,2,Thursday,Workingday,Clear,0.46,0.4545,0.72,0.0896,2,9,11,11,102,11,4,1,2,412,0,715,16352,4,11
2012-09-20,fall,2012,September,3,Thursday,Workingday,Clear,0.44,0.4394,0.77,0.0,0,6,6,6,102,6,4,1,2,412,0,697,8174,4,6
2012-09-20,fall,2012,September,4,Thursday,Workingday,Clear,0.44,0.4394,0.77,0.1045,0,6,6,6,102,6,4,1,2,412,0,697,4428,4,6
2012-09-20,fall,2012,September,5,Thursday,Workingday,Clear,0.44,0.4394,0.77,0.1045,4,52,56,56,102,56,4,2,2,422,0,717,14261,4,56
2012-09-20,fall,2012,September,6,Thursday,Workingday,Clear,0.44,0.4394,0.77,0.0,9,161,170,170,102,170,4,3,2,432,0,725,55132,4,170
2012-09-20,fall,2012,September,7,Thursday,Workingday,Clear,0.46,0.4545,0.82,0.1045,20,514,534,534,102,534,4,4,2,442,0,727,154171,4,534
2012-09-20,fall,2012,September,8,Thursday,Workingday,Clear,0.5,0.4848,0.68,0.0896,44,746,790,790,102,790,4,4,2,442,2,727,261001,4,790
2012-09-20,fall,2012,September,9,Thursday,Workingday,Clear,0.56,0.5303,0.6,0.0896,25,330,355,355,102,355,4,4,3,443,0,727,159438,4,355
2012-09-20,fall,2012,September,10,Thursday,Workingday,Clear,0.58,0.5455,0.53,0.0896,33,157,190,190,102,190,4,3,3,433,0,727,126257,4,190
2012-09-20,fall,2012,September,11,Thursday,Workingday,Clear,0.62,0.6212,0.43,0.0,37,206,243,243,102,243,4,3,3,433,2,727,151320,4,243
2012-09-20,fall,2012,September,12,Thursday,Workingday,Clear,0.62,0.6212,0.43,0.1343,57,233,290,290,102,290,4,4,3,443,2,728,184414,4,290
2012-09-20,fall,2012,September,13,Thursday,Workingday,Clear,0.64,0.6212,0.44,0.1343,68,268,336,336,102,336,4,4,3,443,2,729,184919,4,336
2012-09-20,fall,2012,September,14,Thursday,Workingday,Clear,0.64,0.6212,0.47,0.194,76,222,298,298,102,298,4,4,3,443,2,729,175652,4,298
2012-09-20,fall,2012,September,15,Thursday,Workingday,Clear,0.66,0.6212,0.47,0.194,60,231,291,291,102,291,4,4,3,443,2,729,183149,4,291
2012-09-20,fall,2012,September,16,Thursday,Workingday,Clear,0.64,0.6212,0.47,0.1642,72,385,457,457,102,457,4,4,3,443,2,730,227748,4,457
2012-09-20,fall,2012,September,17,Thursday,Workingday,Clear,0.64,0.6212,0.5,0.2239,91,885,976,976,102,976,4,4,3,443,2,730,336860,4,976
2012-09-20,fall,2012,September,18,Thursday,Workingday,Clear,0.6,0.6212,0.56,0.2537,119,781,900,900,102,900,4,4,3,443,2,728,309772,4,900
2012-09-20,fall,2012,September,19,Thursday,Workingday,Clear,0.58,0.5455,0.6,0.2239,69,534,603,603,102,603,4,4,3,443,2,728,226789,4,603
2012-09-20,fall,2012,September,20,Thursday,Workingday,Clear,0.56,0.5303,0.64,0.1343,57,360,417,417,102,417,4,4,3,443,2,728,164550,4,417
2012-09-20,fall,2012,September,21,Thursday,Workingday,Clear,0.56,0.5303,0.64,0.194,28,246,274,274,102,274,4,3,3,433,0,728,125445,4,274
2012-09-20,fall,2012,September,22,Thursday,Workingday,Clear,0.54,0.5152,0.73,0.1045,35,252,287,287,102,287,4,4,3,443,0,728,95612,4,287
2012-09-20,fall,2012,September,23,Thursday,Workingday,Clear,0.54,0.5152,0.68,0.1045,17,137,154,154,102,154,4,3,3,433,0,728,63941,4,154
2012-09-21,fall,2012,September,0,Friday,Workingday,Clear,0.54,0.5152,0.68,0.0,13,53,66,66,101,66,4,2,3,423,0,726,39130,4,66
2012-09-21,fall,2012,September,1,Friday,Workingday,Clear,0.52,0.5,0.72,0.0,11,38,49,49,101,49,4,2,3,423,0,724,24164,4,49
2012-09-21,fall,2012,September,2,Friday,Workingday,Clear,0.52,0.5,0.72,0.0,6,8,14,14,101,14,4,1,3,413,0,715,16352,4,14
2012-09-21,fall,2012,September,3,Friday,Workingday,Clear,0.5,0.4848,0.77,0.0896,1,11,12,12,101,12,4,1,2,412,0,697,8174,4,12
2012-09-21,fall,2012,September,4,Friday,Workingday,Clear,0.5,0.4848,0.77,0.0,1,9,10,10,101,10,4,1,2,412,0,697,4428,4,10
2012-09-21,fall,2012,September,5,Friday,Workingday,Clear,0.5,0.4848,0.82,0.0,2,47,49,49,101,49,4,2,2,422,0,717,14261,4,49
2012-09-21,fall,2012,September,6,Friday,Workingday,Clear,0.5,0.4848,0.77,0.0896,19,146,165,165,101,165,4,3,2,432,0,725,55132,4,165
2012-09-21,fall,2012,September,7,Friday,Workingday,Clear,0.52,0.5,0.77,0.0,35,468,503,503,101,503,4,4,3,443,0,727,154171,4,503
2012-09-21,fall,2012,September,8,Friday,Workingday,Clear,0.54,0.5152,0.73,0.1343,31,726,757,757,101,757,4,4,3,443,2,727,261001,4,757
2012-09-21,fall,2012,September,9,Friday,Workingday,Clear,0.58,0.5455,0.68,0.1343,35,348,383,383,101,383,4,4,3,443,0,727,159438,4,383
2012-09-21,fall,2012,September,10,Friday,Workingday,Clear,0.62,0.6061,0.61,0.2239,44,181,225,225,101,225,4,3,3,433,0,727,126257,4,225
2012-09-21,fall,2012,September,11,Friday,Workingday,Clear,0.66,0.6212,0.57,0.2239,79,242,321,321,101,321,4,4,3,443,2,727,151320,4,321
2012-09-21,fall,2012,September,12,Friday,Workingday,Clear,0.68,0.6364,0.57,0.1642,84,305,389,389,101,389,4,4,4,444,2,728,184414,4,389
2012-09-21,fall,2012,September,13,Friday,Workingday,Clear,0.7,0.6515,0.54,0.1642,105,316,421,421,101,421,4,4,4,444,2,729,184919,4,421
2012-09-21,fall,2012,September,14,Friday,Workingday,Clear,0.7,0.6515,0.54,0.2985,113,299,412,412,101,412,4,4,4,444,2,729,175652,4,412
2012-09-21,fall,2012,September,15,Friday,Workingday,Clear,0.7,0.6515,0.54,0.2239,90,333,423,423,101,423,4,4,4,444,2,729,183149,4,423
2012-09-21,fall,2012,September,16,Friday,Workingday,Clear,0.7,0.6515,0.54,0.194,103,464,567,567,101,567,4,4,4,444,2,730,227748,4,567
2012-09-21,fall,2012,September,17,Friday,Workingday,Clear,0.68,0.6364,0.57,0.2836,107,739,846,846,101,846,4,4,4,444,2,730,336860,4,846
2012-09-21,fall,2012,September,18,Friday,Workingday,Clear,0.66,0.6212,0.61,0.2537,106,699,805,805,101,805,4,4,3,443,2,728,309772,4,805
2012-09-21,fall,2012,September,19,Friday,Workingday,Clear,0.64,0.6061,0.65,0.2537,95,493,588,588,101,588,4,4,3,443,2,728,226789,4,588
2012-09-21,fall,2012,September,20,Friday,Workingday,Clear,0.62,0.6061,0.69,0.194,54,315,369,369,101,369,4,4,3,443,2,728,164550,4,369
2012-09-21,fall,2012,September,21,Friday,Workingday,Clear,0.6,0.5909,0.73,0.2537,46,266,312,312,101,312,4,4,3,443,0,728,125445,4,312
2012-09-21,fall,2012,September,22,Friday,Workingday,Clear,0.6,0.5909,0.73,0.194,47,248,295,295,101,295,4,4,3,443,0,728,95612,4,295
2012-09-21,fall,2012,September,23,Friday,Workingday,Clear,0.6,0.5909,0.73,0.3284,23,163,186,186,101,186,4,3,3,433,0,728,63941,4,186
2012-09-22,fall,2012,September,0,Saturday,Holiday,Clear,0.6,0.5909,0.73,0.2836,32,140,172,172,100,172,4,3,3,433,0,726,39130,4,172
2012-09-22,fall,2012,September,1,Saturday,Holiday,Clear,0.58,0.5455,0.83,0.2985,18,106,124,124,100,124,4,2,3,423,0,724,24164,4,124
2012-09-22,fall,2012,September,2,Saturday,Holiday,Clear,0.56,0.5303,0.88,0.2537,10,73,83,83,100,83,4,2,3,423,0,715,16352,4,83
2012-09-22,fall,2012,September,3,Saturday,Holiday,Clear,0.56,0.5303,0.83,0.2836,6,39,45,45,100,45,4,2,3,423,0,697,8174,4,45
2012-09-22,fall,2012,September,4,Saturday,Holiday,Clear,0.56,0.5303,0.83,0.2836,5,10,15,15,100,15,4,1,3,413,0,697,4428,4,15
2012-09-22,fall,2012,September,5,Saturday,Holiday,Clear,0.56,0.5303,0.83,0.3284,2,15,17,17,100,17,4,1,3,413,0,717,14261,4,17
2012-09-22,fall,2012,September,6,Saturday,Holiday,Clear,0.56,0.5303,0.83,0.2985,6,35,41,41,100,41,4,2,3,423,0,725,55132,4,41
2012-09-22,fall,2012,September,7,Saturday,Holiday,Clear,0.58,0.5455,0.78,0.2537,7,70,77,77,100,77,4,2,3,423,0,727,154171,4,77
2012-09-22,fall,2012,September,8,Saturday,Holiday,Clear,0.6,0.5909,0.73,0.2985,21,197,218,218,100,218,4,3,3,433,0,727,261001,4,218
2012-09-22,fall,2012,September,9,Saturday,Holiday,Clear,0.64,0.6061,0.69,0.2537,88,289,377,377,100,377,4,4,3,443,2,727,159438,4,377
2012-09-22,fall,2012,September,10,Saturday,Holiday,Clear,0.66,0.6212,0.65,0.3284,124,350,474,474,100,474,4,4,3,443,2,727,126257,4,474
2012-09-22,fall,2012,September,11,Saturday,Holiday,Clear,0.7,0.6515,0.58,0.2836,189,437,626,626,100,626,4,4,4,444,2,727,151320,4,626
2012-09-22,fall,2012,September,12,Saturday,Holiday,Clear,0.72,0.6667,0.54,0.2985,228,460,688,688,100,688,4,4,4,444,2,728,184414,4,688
2012-09-22,fall,2012,September,13,Saturday,Holiday,Clear,0.74,0.6667,0.51,0.3582,273,434,707,707,100,707,4,4,4,444,2,729,184919,4,707
2012-09-22,fall,2012,September,14,Saturday,Holiday,Clear,0.76,0.6818,0.48,0.2836,250,404,654,654,100,654,4,4,4,444,2,729,175652,4,654
2012-09-22,fall,2012,September,15,Saturday,Holiday,Clear,0.74,0.6667,0.48,0.3881,307,443,750,750,100,750,4,4,4,444,2,729,183149,4,750
2012-09-22,fall,2012,September,16,Saturday,Holiday,Clear,0.74,0.6667,0.51,0.3284,253,427,680,680,100,680,4,4,4,444,2,730,227748,4,680
2012-09-22,fall,2012,September,17,Saturday,Holiday,Clear,0.74,0.6667,0.51,0.3284,195,451,646,646,100,646,4,4,4,444,2,730,336860,4,646
2012-09-22,fall,2012,September,18,Saturday,Holiday,Clear,0.72,0.6667,0.54,0.2836,171,427,598,598,100,598,4,4,4,444,2,728,309772,4,598
2012-09-22,fall,2012,September,19,Saturday,Holiday,Clear,0.7,0.6515,0.58,0.194,99,308,407,407,100,407,4,4,4,444,2,728,226789,4,407
2012-09-22,fall,2012,September,20,Saturday,Holiday,Clear,0.7,0.6515,0.54,0.2537,76,249,325,325,100,325,4,4,4,444,2,728,164550,4,325
2012-09-22,fall,2012,September,21,Saturday,Holiday,Clear,0.64,0.6212,0.57,0.2537,59,202,261,261,100,261,4,3,3,433,2,728,125445,4,261
2012-09-22,fall,2012,September,22,Saturday,Holiday,Clear,0.62,0.6212,0.57,0.194,59,180,239,239,100,239,4,3,3,433,2,728,95612,4,239
2012-09-22,fall,2012,September,23,Saturday,Holiday,Clear,0.62,0.6212,0.5,0.194,34,137,171,171,100,171,4,3,3,433,2,728,63941,4,171
2012-09-23,winter,2012,September,0,Sunday,Holiday,Clear,0.62,0.6212,0.38,0.2537,34,146,180,180,99,180,4,3,3,433,2,726,39130,4,180
2012-09-23,winter,2012,September,1,Sunday,Holiday,Clear,0.54,0.5152,0.52,0.3582,23,119,142,142,99,142,4,2,3,423,1,724,24164,4,142
2012-09-23,winter,2012,September,2,Sunday,Holiday,Clear,0.52,0.5,0.48,0.2537,18,77,95,95,99,95,4,2,3,423,1,715,16352,4,95
2012-09-23,winter,2012,September,3,Sunday,Holiday,Clear,0.48,0.4697,0.55,0.2985,13,41,54,54,99,54,4,2,2,422,1,697,8174,4,54
2012-09-23,winter,2012,September,4,Sunday,Holiday,Clear,0.46,0.4545,0.55,0.2239,1,9,10,10,99,10,4,1,2,412,1,697,4428,4,10
2012-09-23,winter,2012,September,5,Sunday,Holiday,Clear,0.46,0.4545,0.59,0.2537,1,5,6,6,99,6,4,1,2,412,1,717,14261,4,6
2012-09-23,winter,2012,September,6,Sunday,Holiday,Clear,0.44,0.4394,0.62,0.2537,5,11,16,16,99,16,4,1,2,412,1,725,55132,4,16
2012-09-23,winter,2012,September,7,Sunday,Holiday,Clear,0.46,0.4545,0.59,0.2239,9,48,57,57,99,57,4,2,2,422,1,727,154171,4,57
2012-09-23,winter,2012,September,8,Sunday,Holiday,Clear,0.48,0.4697,0.55,0.3582,38,137,175,175,99,175,4,3,2,432,1,727,261001,4,175
2012-09-23,winter,2012,September,9,Sunday,Holiday,Clear,0.5,0.4848,0.51,0.3284,71,205,276,276,99,276,4,3,2,432,2,727,159438,4,276
2012-09-23,winter,2012,September,10,Sunday,Holiday,Clear,0.54,0.5152,0.45,0.2537,138,351,489,489,99,489,4,4,3,443,2,727,126257,4,489
2012-09-23,winter,2012,September,11,Sunday,Holiday,Clear,0.56,0.5303,0.46,0.2537,186,384,570,570,99,570,4,4,3,443,2,727,151320,4,570
2012-09-23,winter,2012,September,12,Sunday,Holiday,Clear,0.56,0.5303,0.43,0.1045,250,526,776,776,99,776,4,4,3,443,2,728,184414,4,776
2012-09-23,winter,2012,September,13,Sunday,Holiday,Clear,0.6,0.6212,0.38,0.1642,257,445,702,702,99,702,4,4,3,443,2,729,184919,4,702
2012-09-23,winter,2012,September,14,Sunday,Holiday,Clear,0.6,0.6212,0.38,0.194,266,400,666,666,99,666,4,4,3,443,2,729,175652,4,666
2012-09-23,winter,2012,September,15,Sunday,Holiday,Clear,0.6,0.6212,0.33,0.2239,265,375,640,640,99,640,4,4,3,443,2,729,183149,4,640
2012-09-23,winter,2012,September,16,Sunday,Holiday,Clear,0.6,0.6212,0.33,0.3284,254,437,691,691,99,691,4,4,3,443,2,730,227748,4,691
2012-09-23,winter,2012,September,17,Sunday,Holiday,Clear,0.56,0.5303,0.35,0.2985,227,496,723,723,99,723,4,4,3,443,2,730,336860,4,723
2012-09-23,winter,2012,September,18,Sunday,Holiday,Clear,0.54,0.5152,0.37,0.194,135,405,540,540,99,540,4,4,3,443,2,728,309772,4,540
2012-09-23,winter,2012,September,19,Sunday,Holiday,Clear,0.52,0.5,0.42,0.1642,82,331,413,413,99,413,4,4,3,443,2,728,226789,4,413
2012-09-23,winter,2012,September,20,Sunday,Holiday,Clear,0.52,0.5,0.42,0.1642,60,192,252,252,99,252,4,3,3,433,2,728,164550,4,252
2012-09-23,winter,2012,September,21,Sunday,Holiday,Mist,0.52,0.5,0.48,0.1045,51,145,196,196,99,196,4,3,3,433,0,728,125445,4,196
2012-09-23,winter,2012,September,22,Sunday,Holiday,Clear,0.52,0.5,0.48,0.0,40,98,138,138,99,138,4,2,3,423,0,728,95612,4,138
2012-09-23,winter,2012,September,23,Sunday,Holiday,Mist,0.5,0.4848,0.59,0.1045,30,70,100,100,99,100,4,2,2,422,0,728,63941,4,100
2012-09-24,winter,2012,September,0,Monday,Workingday,Clear,0.46,0.4545,0.63,0.194,10,54,64,64,98,64,4,2,2,422,0,726,39130,4,64
2012-09-24,winter,2012,September,1,Monday,Workingday,Clear,0.46,0.4545,0.67,0.1343,6,12,18,18,98,18,4,1,2,412,0,724,24164,4,18
2012-09-24,winter,2012,September,2,Monday,Workingday,Mist,0.46,0.4545,0.63,0.1343,0,8,8,8,98,8,4,1,2,412,0,715,16352,4,8
2012-09-24,winter,2012,September,3,Monday,Workingday,Clear,0.46,0.4545,0.63,0.1642,0,5,5,5,98,5,4,1,2,412,0,697,8174,4,5
2012-09-24,winter,2012,September,4,Monday,Workingday,Clear,0.44,0.4394,0.67,0.1045,0,8,8,8,98,8,4,1,2,412,0,697,4428,4,8
2012-09-24,winter,2012,September,5,Monday,Workingday,Clear,0.46,0.4545,0.63,0.0,2,35,37,37,98,37,4,1,2,412,0,717,14261,4,37
2012-09-24,winter,2012,September,6,Monday,Workingday,Clear,0.46,0.4545,0.59,0.0,6,162,168,168,98,168,4,3,2,432,0,725,55132,4,168
2012-09-24,winter,2012,September,7,Monday,Workingday,Clear,0.46,0.4545,0.67,0.1343,17,513,530,530,98,530,4,4,2,442,2,727,154171,4,530
2012-09-24,winter,2012,September,8,Monday,Workingday,Clear,0.5,0.4848,0.55,0.194,31,719,750,750,98,750,4,4,2,442,2,727,261001,4,750
2012-09-24,winter,2012,September,9,Monday,Workingday,Clear,0.52,0.5,0.52,0.194,42,286,328,328,98,328,4,4,3,443,2,727,159438,4,328
2012-09-24,winter,2012,September,10,Monday,Workingday,Clear,0.54,0.5152,0.49,0.2239,52,146,198,198,98,198,4,3,3,433,2,727,126257,4,198
2012-09-24,winter,2012,September,11,Monday,Workingday,Clear,0.56,0.5303,0.37,0.194,71,167,238,238,98,238,4,3,3,433,2,727,151320,4,238
2012-09-24,winter,2012,September,12,Monday,Workingday,Clear,0.56,0.5303,0.35,0.2985,77,265,342,342,98,342,4,4,3,443,2,728,184414,4,342
2012-09-24,winter,2012,September,13,Monday,Workingday,Clear,0.6,0.6212,0.31,0.2985,80,248,328,328,98,328,4,4,3,443,2,729,184919,4,328
2012-09-24,winter,2012,September,14,Monday,Workingday,Clear,0.6,0.6061,0.28,0.0,77,226,303,303,98,303,4,4,3,443,2,729,175652,4,303
2012-09-24,winter,2012,September,15,Monday,Workingday,Clear,0.6,0.6212,0.31,0.0,84,216,300,300,98,300,4,4,3,443,2,729,183149,4,300
2012-09-24,winter,2012,September,16,Monday,Workingday,Clear,0.58,0.5455,0.3,0.2537,99,417,516,516,98,516,4,4,3,443,2,730,227748,4,516
2012-09-24,winter,2012,September,17,Monday,Workingday,Clear,0.58,0.5455,0.3,0.0,89,809,898,898,98,898,4,4,3,443,2,730,336860,4,898
2012-09-24,winter,2012,September,18,Monday,Workingday,Clear,0.54,0.5152,0.37,0.1642,95,758,853,853,98,853,4,4,3,443,2,728,309772,4,853
2012-09-24,winter,2012,September,19,Monday,Workingday,Clear,0.52,0.5,0.39,0.1343,56,534,590,590,98,590,4,4,3,443,2,728,226789,4,590
2012-09-24,winter,2012,September,20,Monday,Workingday,Clear,0.52,0.5,0.52,0.1045,52,380,432,432,98,432,4,4,3,443,2,728,164550,4,432
2012-09-24,winter,2012,September,21,Monday,Workingday,Clear,0.5,0.4848,0.51,0.1343,26,230,256,256,98,256,4,3,2,432,0,728,125445,4,256
2012-09-24,winter,2012,September,22,Monday,Workingday,Clear,0.5,0.4848,0.51,0.2239,18,154,172,172,98,172,4,3,2,432,1,728,95612,4,172
2012-09-24,winter,2012,September,23,Monday,Workingday,Clear,0.46,0.4545,0.63,0.1343,11,83,94,94,98,94,4,2,2,422,0,728,63941,4,94
2012-09-25,winter,2012,September,0,Tuesday,Workingday,Clear,0.46,0.4545,0.67,0.1642,8,56,64,64,97,64,4,2,2,422,0,726,39130,4,64
2012-09-25,winter,2012,September,1,Tuesday,Workingday,Clear,0.44,0.4394,0.72,0.1343,2,11,13,13,97,13,4,1,2,412,0,724,24164,4,13
2012-09-25,winter,2012,September,2,Tuesday,Workingday,Clear,0.42,0.4242,0.77,0.1343,5,9,14,14,97,14,4,1,2,412,0,715,16352,4,14
2012-09-25,winter,2012,September,3,Tuesday,Workingday,Clear,0.42,0.4242,0.71,0.0896,2,3,5,5,97,5,4,1,2,412,0,697,8174,4,5
2012-09-25,winter,2012,September,4,Tuesday,Workingday,Clear,0.42,0.4242,0.71,0.1343,2,7,9,9,97,9,4,1,2,412,0,697,4428,4,9
2012-09-25,winter,2012,September,5,Tuesday,Workingday,Clear,0.42,0.4242,0.77,0.0896,1,46,47,47,97,47,4,2,2,422,0,717,14261,4,47
2012-09-25,winter,2012,September,6,Tuesday,Workingday,Clear,0.44,0.4394,0.77,0.2239,5,189,194,194,97,194,4,3,2,432,0,725,55132,4,194
2012-09-25,winter,2012,September,7,Tuesday,Workingday,Clear,0.44,0.4394,0.77,0.194,17,539,556,556,97,556,4,4,2,442,0,727,154171,4,556
2012-09-25,winter,2012,September,8,Tuesday,Workingday,Clear,0.48,0.4697,0.67,0.194,41,764,805,805,97,805,4,4,2,442,2,727,261001,4,805
2012-09-25,winter,2012,September,9,Tuesday,Workingday,Clear,0.54,0.5152,0.56,0.2537,28,381,409,409,97,409,4,4,3,443,2,727,159438,4,409
2012-09-25,winter,2012,September,10,Tuesday,Workingday,Clear,0.56,0.5303,0.52,0.2985,45,125,170,170,97,170,4,3,3,433,2,727,126257,4,170
2012-09-25,winter,2012,September,11,Tuesday,Workingday,Clear,0.6,0.6212,0.46,0.2985,63,155,218,218,97,218,4,3,3,433,2,727,151320,4,218
2012-09-25,winter,2012,September,12,Tuesday,Workingday,Clear,0.62,0.6212,0.43,0.2836,69,233,302,302,97,302,4,4,3,443,2,728,184414,4,302
2012-09-25,winter,2012,September,13,Tuesday,Workingday,Clear,0.64,0.6212,0.47,0.2537,48,257,305,305,97,305,4,4,3,443,2,729,184919,4,305
2012-09-25,winter,2012,September,14,Tuesday,Workingday,Clear,0.66,0.6212,0.39,0.3284,80,213,293,293,97,293,4,4,3,443,2,729,175652,4,293
2012-09-25,winter,2012,September,15,Tuesday,Workingday,Clear,0.66,0.6212,0.36,0.3284,56,247,303,303,97,303,4,4,3,443,2,729,183149,4,303
2012-09-25,winter,2012,September,16,Tuesday,Workingday,Clear,0.66,0.6212,0.39,0.2985,59,436,495,495,97,495,4,4,3,443,2,730,227748,4,495
2012-09-25,winter,2012,September,17,Tuesday,Workingday,Clear,0.66,0.6212,0.39,0.2836,107,860,967,967,97,967,4,4,3,443,2,730,336860,4,967
2012-09-25,winter,2012,September,18,Tuesday,Workingday,Clear,0.64,0.6212,0.41,0.2239,64,758,822,822,97,822,4,4,3,443,2,728,309772,4,822
2012-09-25,winter,2012,September,19,Tuesday,Workingday,Clear,0.62,0.6212,0.5,0.2537,49,490,539,539,97,539,4,4,3,443,2,728,226789,4,539
2012-09-25,winter,2012,September,20,Tuesday,Workingday,Clear,0.6,0.6212,0.56,0.2985,37,388,425,425,97,425,4,4,3,443,2,728,164550,4,425
2012-09-25,winter,2012,September,21,Tuesday,Workingday,Clear,0.6,0.6212,0.56,0.2985,34,263,297,297,97,297,4,4,3,443,2,728,125445,4,297
2012-09-25,winter,2012,September,22,Tuesday,Workingday,Clear,0.6,0.6212,0.56,0.2836,14,174,188,188,97,188,4,3,3,433,0,728,95612,4,188
2012-09-25,winter,2012,September,23,Tuesday,Workingday,Clear,0.6,0.6212,0.56,0.3284,9,89,98,98,97,98,4,2,3,423,0,728,63941,4,98
2012-09-26,winter,2012,September,0,Wednesday,Workingday,Clear,0.58,0.5455,0.64,0.2985,6,34,40,40,96,40,4,1,3,413,0,726,39130,4,40
2012-09-26,winter,2012,September,1,Wednesday,Workingday,Clear,0.58,0.5455,0.64,0.3284,10,19,29,29,96,29,4,1,3,413,0,724,24164,4,29
2012-09-26,winter,2012,September,2,Wednesday,Workingday,Mist,0.58,0.5455,0.64,0.2836,2,15,17,17,96,17,4,1,3,413,0,715,16352,4,17
2012-09-26,winter,2012,September,3,Wednesday,Workingday,Mist,0.58,0.5455,0.64,0.2836,4,6,10,10,96,10,4,1,3,413,0,697,8174,4,10
2012-09-26,winter,2012,September,4,Wednesday,Workingday,Clear,0.56,0.5303,0.73,0.2537,2,12,14,14,96,14,4,1,3,413,0,697,4428,4,14
2012-09-26,winter,2012,September,5,Wednesday,Workingday,Clear,0.56,0.5303,0.73,0.2239,1,35,36,36,96,36,4,1,3,413,0,717,14261,4,36
2012-09-26,winter,2012,September,6,Wednesday,Workingday,Clear,0.54,0.5152,0.73,0.194,3,179,182,182,96,182,4,3,3,433,0,725,55132,4,182
2012-09-26,winter,2012,September,7,Wednesday,Workingday,Clear,0.54,0.5152,0.77,0.1343,9,523,532,532,96,532,4,4,3,443,0,727,154171,4,532
2012-09-26,winter,2012,September,8,Wednesday,Workingday,Clear,0.56,0.5303,0.73,0.2985,30,808,838,838,96,838,4,4,3,443,2,727,261001,4,838
2012-09-26,winter,2012,September,9,Wednesday,Workingday,Clear,0.6,0.6061,0.64,0.194,27,307,334,334,96,334,4,4,3,443,2,727,159438,4,334
2012-09-26,winter,2012,September,10,Wednesday,Workingday,Clear,0.6,0.5909,0.73,0.2836,29,156,185,185,96,185,4,3,3,433,0,727,126257,4,185
2012-09-26,winter,2012,September,11,Wednesday,Workingday,Clear,0.64,0.6212,0.61,0.2537,46,181,227,227,96,227,4,3,3,433,2,727,151320,4,227
2012-09-26,winter,2012,September,12,Wednesday,Workingday,Clear,0.68,0.6364,0.61,0.2239,56,260,316,316,96,316,4,4,4,444,2,728,184414,4,316
2012-09-26,winter,2012,September,13,Wednesday,Workingday,Clear,0.7,0.6515,0.58,0.2239,67,273,340,340,96,340,4,4,4,444,2,729,184919,4,340
2012-09-26,winter,2012,September,14,Wednesday,Workingday,Clear,0.74,0.6667,0.48,0.2836,60,217,277,277,96,277,4,3,4,434,2,729,175652,4,277
2012-09-26,winter,2012,September,15,Wednesday,Workingday,Clear,0.74,0.6667,0.48,0.2985,69,231,300,300,96,300,4,4,4,444,2,729,183149,4,300
2012-09-26,winter,2012,September,16,Wednesday,Workingday,Clear,0.74,0.6667,0.45,0.2836,71,397,468,468,96,468,4,4,4,444,2,730,227748,4,468
2012-09-26,winter,2012,September,17,Wednesday,Workingday,Clear,0.74,0.6667,0.48,0.2985,77,876,953,953,96,953,4,4,4,444,2,730,336860,4,953
2012-09-26,winter,2012,September,18,Wednesday,Workingday,Clear,0.74,0.6667,0.48,0.2239,69,815,884,884,96,884,4,4,4,444,2,728,309772,4,884
2012-09-26,winter,2012,September,19,Wednesday,Workingday,Clear,0.7,0.6515,0.54,0.1642,38,589,627,627,96,627,4,4,4,444,2,728,226789,4,627
2012-09-26,winter,2012,September,20,Wednesday,Workingday,Clear,0.66,0.6212,0.69,0.194,45,389,434,434,96,434,4,4,3,443,2,728,164550,4,434
2012-09-26,winter,2012,September,21,Wednesday,Workingday,Clear,0.66,0.6212,0.65,0.194,32,328,360,360,96,360,4,4,3,443,2,728,125445,4,360
2012-09-26,winter,2012,September,22,Wednesday,Workingday,Light Snow,0.62,0.6061,0.69,0.194,21,194,215,215,96,215,4,3,3,433,0,728,95612,4,215
2012-09-26,winter,2012,September,23,Wednesday,Workingday,Mist,0.6,0.5758,0.78,0.2537,13,102,115,115,96,115,4,2,3,423,0,728,63941,4,115
2012-09-27,winter,2012,September,0,Thursday,Workingday,Clear,0.6,0.5758,0.78,0.0896,5,60,65,65,95,65,4,2,3,423,0,726,39130,4,65
2012-09-27,winter,2012,September,1,Thursday,Workingday,Clear,0.6,0.5758,0.78,0.0896,5,16,21,21,95,21,4,1,3,413,0,724,24164,4,21
2012-09-27,winter,2012,September,2,Thursday,Workingday,Clear,0.6,0.5758,0.78,0.0896,3,13,16,16,95,16,4,1,3,413,0,715,16352,4,16
2012-09-27,winter,2012,September,3,Thursday,Workingday,Clear,0.6,0.5758,0.78,0.0,0,7,7,7,95,7,4,1,3,413,0,697,8174,4,7
2012-09-27,winter,2012,September,4,Thursday,Workingday,Clear,0.56,0.5303,0.94,0.1343,2,6,8,8,95,8,4,1,3,413,0,697,4428,4,8
2012-09-27,winter,2012,September,5,Thursday,Workingday,Clear,0.58,0.5455,0.83,0.0,2,64,66,66,95,66,4,2,3,423,0,717,14261,4,66
2012-09-27,winter,2012,September,6,Thursday,Workingday,Clear,0.56,0.5303,0.88,0.0896,5,164,169,169,95,169,4,3,3,433,0,725,55132,4,169
2012-09-27,winter,2012,September,7,Thursday,Workingday,Clear,0.6,0.5758,0.78,0.0,12,546,558,558,95,558,4,4,3,443,0,727,154171,4,558
2012-09-27,winter,2012,September,8,Thursday,Workingday,Clear,0.62,0.6061,0.71,0.0896,20,774,794,794,95,794,4,4,3,443,2,727,261001,4,794
2012-09-27,winter,2012,September,9,Thursday,Workingday,Clear,0.66,0.6212,0.65,0.0,30,305,335,335,95,335,4,4,3,443,0,727,159438,4,335
2012-09-27,winter,2012,September,10,Thursday,Workingday,Mist,0.7,0.6515,0.51,0.2836,40,168,208,208,95,208,4,3,4,434,2,727,126257,4,208
2012-09-27,winter,2012,September,11,Thursday,Workingday,Mist,0.72,0.6667,0.51,0.1642,67,227,294,294,95,294,4,4,4,444,2,727,151320,4,294
2012-09-27,winter,2012,September,12,Thursday,Workingday,Mist,0.74,0.6667,0.48,0.1343,63,272,335,335,95,335,4,4,4,444,2,728,184414,4,335
2012-09-27,winter,2012,September,13,Thursday,Workingday,Mist,0.74,0.6667,0.48,0.0,61,265,326,326,95,326,4,4,4,444,2,729,184919,4,326
2012-09-27,winter,2012,September,14,Thursday,Workingday,Mist,0.76,0.6818,0.45,0.0896,44,214,258,258,95,258,4,3,4,434,2,729,175652,4,258
2012-09-27,winter,2012,September,15,Thursday,Workingday,Mist,0.76,0.6818,0.45,0.0,41,255,296,296,95,296,4,4,4,444,2,729,183149,4,296
2012-09-27,winter,2012,September,16,Thursday,Workingday,Mist,0.72,0.6667,0.58,0.3284,73,399,472,472,95,472,4,4,4,444,2,730,227748,4,472
2012-09-27,winter,2012,September,17,Thursday,Workingday,Mist,0.66,0.6212,0.69,0.2985,87,818,905,905,95,905,4,4,3,443,2,730,336860,4,905
2012-09-27,winter,2012,September,18,Thursday,Workingday,Mist,0.66,0.6212,0.69,0.2239,77,822,899,899,95,899,4,4,3,443,2,728,309772,4,899
2012-09-27,winter,2012,September,19,Thursday,Workingday,Clear,0.66,0.6212,0.65,0.1343,48,511,559,559,95,559,4,4,3,443,2,728,226789,4,559
2012-09-27,winter,2012,September,20,Thursday,Workingday,Mist,0.64,0.6061,0.69,0.2239,45,412,457,457,95,457,4,4,3,443,2,728,164550,4,457
2012-09-27,winter,2012,September,21,Thursday,Workingday,Light Snow,0.62,0.5758,0.83,0.2985,18,235,253,253,95,253,4,3,3,433,0,728,125445,4,253
2012-09-27,winter,2012,September,22,Thursday,Workingday,Light Snow,0.62,0.5758,0.83,0.2985,2,45,47,47,95,47,4,2,3,423,0,728,95612,4,47
2012-09-27,winter,2012,September,23,Thursday,Workingday,Light Snow,0.62,0.5758,0.83,0.1642,1,44,45,45,95,45,4,2,3,423,0,728,63941,4,45
2012-09-28,winter,2012,September,0,Friday,Workingday,Light Snow,0.6,0.5455,0.88,0.1642,2,15,17,17,94,17,4,1,3,413,0,726,39130,4,17
2012-09-28,winter,2012,September,1,Friday,Workingday,Light Snow,0.6,0.5455,0.88,0.0,0,13,13,13,94,13,4,1,3,413,0,724,24164,4,13
2012-09-28,winter,2012,September,2,Friday,Workingday,Light Snow,0.6,0.5455,0.88,0.2985,1,9,10,10,94,10,4,1,3,413,0,715,16352,4,10
2012-09-28,winter,2012,September,3,Friday,Workingday,Mist,0.6,0.5606,0.83,0.1343,0,7,7,7,94,7,4,1,3,413,0,697,8174,4,7
2012-09-28,winter,2012,September,4,Friday,Workingday,Light Snow,0.56,0.5303,0.88,0.1045,2,10,12,12,94,12,4,1,3,413,0,697,4428,4,12
2012-09-28,winter,2012,September,5,Friday,Workingday,Clear,0.56,0.5303,0.88,0.0,1,37,38,38,94,38,4,1,3,413,0,717,14261,4,38
2012-09-28,winter,2012,September,6,Friday,Workingday,Mist,0.56,0.5303,0.94,0.0896,2,136,138,138,94,138,4,2,3,423,0,725,55132,4,138
2012-09-28,winter,2012,September,7,Friday,Workingday,Mist,0.56,0.5303,0.94,0.0,10,384,394,394,94,394,4,4,3,443,0,727,154171,4,394
2012-09-28,winter,2012,September,8,Friday,Workingday,Clear,0.6,0.5606,0.83,0.0896,31,674,705,705,94,705,4,4,3,443,2,727,261001,4,705
2012-09-28,winter,2012,September,9,Friday,Workingday,Mist,0.62,0.5758,0.83,0.1045,27,399,426,426,94,426,4,4,3,443,0,727,159438,4,426
2012-09-28,winter,2012,September,10,Friday,Workingday,Mist,0.64,0.5909,0.78,0.1343,51,194,245,245,94,245,4,3,3,433,0,727,126257,4,245
2012-09-28,winter,2012,September,11,Friday,Workingday,Mist,0.66,0.6212,0.69,0.0,109,252,361,361,94,361,4,4,3,443,2,727,151320,4,361
2012-09-28,winter,2012,September,12,Friday,Workingday,Mist,0.7,0.6515,0.54,0.2537,94,286,380,380,94,380,4,4,4,444,2,728,184414,4,380
2012-09-28,winter,2012,September,13,Friday,Workingday,Mist,0.7,0.6515,0.51,0.2537,106,304,410,410,94,410,4,4,4,444,2,729,184919,4,410
2012-09-28,winter,2012,September,14,Friday,Workingday,Mist,0.7,0.6515,0.54,0.2537,105,294,399,399,94,399,4,4,4,444,2,729,175652,4,399
2012-09-28,winter,2012,September,15,Friday,Workingday,Mist,0.68,0.6364,0.54,0.2836,104,288,392,392,94,392,4,4,4,444,2,729,183149,4,392
2012-09-28,winter,2012,September,16,Friday,Workingday,Mist,0.66,0.6212,0.5,0.2239,83,419,502,502,94,502,4,4,3,443,2,730,227748,4,502
2012-09-28,winter,2012,September,17,Friday,Workingday,Mist,0.66,0.6212,0.54,0.2985,101,707,808,808,94,808,4,4,3,443,2,730,336860,4,808
2012-09-28,winter,2012,September,18,Friday,Workingday,Mist,0.64,0.6212,0.5,0.2239,58,609,667,667,94,667,4,4,3,443,2,728,309772,4,667
2012-09-28,winter,2012,September,19,Friday,Workingday,Light Snow,0.62,0.6212,0.5,0.2537,38,470,508,508,94,508,4,4,3,443,2,728,226789,4,508
2012-09-28,winter,2012,September,20,Friday,Workingday,Light Snow,0.6,0.6212,0.53,0.1642,32,304,336,336,94,336,4,4,3,443,2,728,164550,4,336
2012-09-28,winter,2012,September,21,Friday,Workingday,Light Snow,0.6,0.6212,0.53,0.194,32,205,237,237,94,237,4,3,3,433,2,728,125445,4,237
2012-09-28,winter,2012,September,22,Friday,Workingday,Mist,0.58,0.5455,0.53,0.2239,30,190,220,220,94,220,4,3,3,433,0,728,95612,4,220
2012-09-28,winter,2012,September,23,Friday,Workingday,Mist,0.56,0.5303,0.56,0.194,26,164,190,190,94,190,4,3,3,433,0,728,63941,4,190
2012-09-29,winter,2012,September,0,Saturday,Holiday,Clear,0.54,0.5152,0.6,0.2239,15,134,149,149,93,149,4,3,3,433,0,726,39130,4,149
2012-09-29,winter,2012,September,1,Saturday,Holiday,Clear,0.54,0.5152,0.6,0.2239,12,89,101,101,93,101,4,2,3,423,0,724,24164,4,101
2012-09-29,winter,2012,September,2,Saturday,Holiday,Mist,0.54,0.5152,0.56,0.2239,12,80,92,92,93,92,4,2,3,423,0,715,16352,4,92
2012-09-29,winter,2012,September,3,Saturday,Holiday,Mist,0.52,0.5,0.59,0.194,4,25,29,29,93,29,4,1,3,413,0,697,8174,4,29
2012-09-29,winter,2012,September,4,Saturday,Holiday,Clear,0.52,0.5,0.59,0.2537,6,8,14,14,93,14,4,1,3,413,0,697,4428,4,14
2012-09-29,winter,2012,September,5,Saturday,Holiday,Clear,0.5,0.4848,0.63,0.194,2,13,15,15,93,15,4,1,2,412,0,717,14261,4,15
2012-09-29,winter,2012,September,6,Saturday,Holiday,Clear,0.5,0.4848,0.63,0.2537,4,33,37,37,93,37,4,1,2,412,0,725,55132,4,37
2012-09-29,winter,2012,September,7,Saturday,Holiday,Clear,0.48,0.4697,0.67,0.2836,12,61,73,73,93,73,4,2,2,422,0,727,154171,4,73
2012-09-29,winter,2012,September,8,Saturday,Holiday,Clear,0.5,0.4848,0.68,0.2836,37,174,211,211,93,211,4,3,2,432,0,727,261001,4,211
2012-09-29,winter,2012,September,9,Saturday,Holiday,Clear,0.5,0.4848,0.63,0.194,69,263,332,332,93,332,4,4,2,442,2,727,159438,4,332
2012-09-29,winter,2012,September,10,Saturday,Holiday,Clear,0.54,0.5152,0.56,0.2537,134,338,472,472,93,472,4,4,3,443,2,727,126257,4,472
2012-09-29,winter,2012,September,11,Saturday,Holiday,Clear,0.56,0.5303,0.52,0.2836,217,446,663,663,93,663,4,4,3,443,2,727,151320,4,663
2012-09-29,winter,2012,September,12,Saturday,Holiday,Clear,0.62,0.6212,0.41,0.2985,191,491,682,682,93,682,4,4,3,443,2,728,184414,4,682
2012-09-29,winter,2012,September,13,Saturday,Holiday,Clear,0.62,0.6212,0.41,0.2985,233,453,686,686,93,686,4,4,3,443,2,729,184919,4,686
2012-09-29,winter,2012,September,14,Saturday,Holiday,Clear,0.6,0.6212,0.4,0.2537,302,448,750,750,93,750,4,4,3,443,2,729,175652,4,750
2012-09-29,winter,2012,September,15,Saturday,Holiday,Clear,0.6,0.6212,0.43,0.2537,271,456,727,727,93,727,4,4,3,443,2,729,183149,4,727
2012-09-29,winter,2012,September,16,Saturday,Holiday,Clear,0.62,0.6212,0.41,0.2537,275,447,722,722,93,722,4,4,3,443,2,730,227748,4,722
2012-09-29,winter,2012,September,17,Saturday,Holiday,Clear,0.6,0.6212,0.38,0.3582,256,456,712,712,93,712,4,4,3,443,2,730,336860,4,712
2012-09-29,winter,2012,September,18,Saturday,Holiday,Clear,0.56,0.5303,0.46,0.194,174,420,594,594,93,594,4,4,3,443,2,728,309772,4,594
2012-09-29,winter,2012,September,19,Saturday,Holiday,Clear,0.52,0.5,0.55,0.1642,119,351,470,470,93,470,4,4,3,443,2,728,226789,4,470
2012-09-29,winter,2012,September,20,Saturday,Holiday,Clear,0.52,0.5,0.55,0.194,88,227,315,315,93,315,4,4,3,443,2,728,164550,4,315
2012-09-29,winter,2012,September,21,Saturday,Holiday,Clear,0.52,0.5,0.55,0.1343,73,219,292,292,93,292,4,4,3,443,2,728,125445,4,292
2012-09-29,winter,2012,September,22,Saturday,Holiday,Clear,0.5,0.4848,0.63,0.1045,48,173,221,221,93,221,4,3,2,432,0,728,95612,4,221
2012-09-29,winter,2012,September,23,Saturday,Holiday,Clear,0.5,0.4848,0.59,0.0896,35,161,196,196,93,196,4,3,2,432,0,728,63941,4,196
2012-09-30,winter,2012,September,0,Sunday,Holiday,Clear,0.5,0.4848,0.59,0.0,35,112,147,147,92,147,4,3,2,432,0,726,39130,4,147
2012-09-30,winter,2012,September,1,Sunday,Holiday,Clear,0.5,0.4848,0.59,0.0,31,85,116,116,92,116,4,2,2,422,0,724,24164,4,116
2012-09-30,winter,2012,September,2,Sunday,Holiday,Clear,0.48,0.4697,0.63,0.0,21,71,92,92,92,92,4,2,2,422,0,715,16352,4,92
2012-09-30,winter,2012,September,3,Sunday,Holiday,Clear,0.46,0.4545,0.67,0.0896,17,41,58,58,92,58,4,2,2,422,0,697,8174,4,58
2012-09-30,winter,2012,September,4,Sunday,Holiday,Clear,0.46,0.4545,0.67,0.0896,1,6,7,7,92,7,4,1,2,412,0,697,4428,4,7
2012-09-30,winter,2012,September,5,Sunday,Holiday,Clear,0.44,0.4394,0.72,0.0,1,9,10,10,92,10,4,1,2,412,0,717,14261,4,10
2012-09-30,winter,2012,September,6,Sunday,Holiday,Clear,0.44,0.4394,0.72,0.0896,2,20,22,22,92,22,4,1,2,412,0,725,55132,4,22
2012-09-30,winter,2012,September,7,Sunday,Holiday,Clear,0.44,0.4394,0.77,0.0,14,43,57,57,92,57,4,2,2,422,0,727,154171,4,57
2012-09-30,winter,2012,September,8,Sunday,Holiday,Clear,0.48,0.4697,0.67,0.1045,18,126,144,144,92,144,4,3,2,432,0,727,261001,4,144
2012-09-30,winter,2012,September,9,Sunday,Holiday,Clear,0.52,0.5,0.63,0.1045,74,211,285,285,92,285,4,4,3,443,0,727,159438,4,285
2012-09-30,winter,2012,September,10,Sunday,Holiday,Clear,0.58,0.5455,0.46,0.1642,160,319,479,479,92,479,4,4,3,443,2,727,126257,4,479
2012-09-30,winter,2012,September,11,Sunday,Holiday,Clear,0.6,0.6212,0.43,0.2239,222,369,591,591,92,591,4,4,3,443,2,727,151320,4,591
2012-09-30,winter,2012,September,12,Sunday,Holiday,Clear,0.62,0.6212,0.41,0.2985,206,474,680,680,92,680,4,4,3,443,2,728,184414,4,680
2012-09-30,winter,2012,September,13,Sunday,Holiday,Clear,0.62,0.6212,0.41,0.2537,180,414,594,594,92,594,4,4,3,443,2,729,184919,4,594
2012-09-30,winter,2012,September,14,Sunday,Holiday,Clear,0.62,0.6212,0.41,0.2537,208,404,612,612,92,612,4,4,3,443,2,729,175652,4,612
2012-09-30,winter,2012,September,15,Sunday,Holiday,Clear,0.64,0.6212,0.36,0.2537,230,419,649,649,92,649,4,4,3,443,2,729,183149,4,649
2012-09-30,winter,2012,September,16,Sunday,Holiday,Clear,0.64,0.6212,0.36,0.2239,202,446,648,648,92,648,4,4,3,443,2,730,227748,4,648
2012-09-30,winter,2012,September,17,Sunday,Holiday,Clear,0.62,0.6212,0.35,0.2836,195,380,575,575,92,575,4,4,3,443,2,730,336860,4,575
2012-09-30,winter,2012,September,18,Sunday,Holiday,Clear,0.52,0.5,0.59,0.4478,91,310,401,401,92,401,4,4,3,443,2,728,309772,4,401
2012-09-30,winter,2012,September,19,Sunday,Holiday,Light Snow,0.5,0.4848,0.72,0.1343,34,223,257,257,92,257,4,3,2,432,0,728,226789,4,257
2012-09-30,winter,2012,September,20,Sunday,Holiday,Light Snow,0.5,0.4848,0.72,0.1343,31,163,194,194,92,194,4,3,2,432,0,728,164550,4,194
2012-09-30,winter,2012,September,21,Sunday,Holiday,Clear,0.5,0.4848,0.68,0.0,19,104,123,123,92,123,4,2,2,422,0,728,125445,4,123
2012-09-30,winter,2012,September,22,Sunday,Holiday,Clear,0.48,0.4697,0.72,0.0,15,76,91,91,92,91,4,2,2,422,0,728,95612,4,91
2012-09-30,winter,2012,September,23,Sunday,Holiday,Clear,0.48,0.4697,0.72,0.0896,8,49,57,57,92,57,4,2,2,422,0,728,63941,4,57
2012-10-01,winter,2012,October,0,Monday,Workingday,Clear,0.46,0.4545,0.72,0.1045,6,39,45,45,91,45,4,2,2,422,0,726,39130,4,45
2012-10-01,winter,2012,October,1,Monday,Workingday,Clear,0.44,0.4394,0.77,0.0896,5,13,18,18,91,18,4,1,2,412,0,724,24164,4,18
2012-10-01,winter,2012,October,2,Monday,Workingday,Clear,0.46,0.4545,0.72,0.0,6,6,12,12,91,12,4,1,2,412,0,715,16352,4,12
2012-10-01,winter,2012,October,3,Monday,Workingday,Clear,0.44,0.4394,0.77,0.0,1,6,7,7,91,7,4,1,2,412,0,697,8174,4,7
2012-10-01,winter,2012,October,4,Monday,Workingday,Clear,0.42,0.4242,0.82,0.1045,0,10,10,10,91,10,4,1,2,412,0,697,4428,4,10
2012-10-01,winter,2012,October,5,Monday,Workingday,Clear,0.44,0.4394,0.77,0.0,2,34,36,36,91,36,4,1,2,412,0,717,14261,4,36
2012-10-01,winter,2012,October,6,Monday,Workingday,Clear,0.44,0.4394,0.77,0.1045,8,147,155,155,91,155,4,3,2,432,0,725,55132,4,155
2012-10-01,winter,2012,October,7,Monday,Workingday,Clear,0.44,0.4394,0.77,0.1642,13,470,483,483,91,483,4,4,2,442,0,727,154171,4,483
2012-10-01,winter,2012,October,8,Monday,Workingday,Mist,0.46,0.4545,0.77,0.1045,40,744,784,784,91,784,4,4,2,442,2,727,261001,4,784
2012-10-01,winter,2012,October,9,Monday,Workingday,Mist,0.52,0.5,0.63,0.0,26,314,340,340,91,340,4,4,3,443,0,727,159438,4,340
2012-10-01,winter,2012,October,10,Monday,Workingday,Clear,0.54,0.5152,0.56,0.0,44,135,179,179,91,179,4,3,3,433,0,727,126257,4,179
2012-10-01,winter,2012,October,11,Monday,Workingday,Clear,0.58,0.5455,0.46,0.0,76,196,272,272,91,272,4,3,3,433,2,727,151320,4,272
2012-10-01,winter,2012,October,12,Monday,Workingday,Mist,0.6,0.6212,0.43,0.1642,61,262,323,323,91,323,4,4,3,443,2,728,184414,4,323
2012-10-01,winter,2012,October,13,Monday,Workingday,Mist,0.6,0.6212,0.43,0.1642,80,225,305,305,91,305,4,4,3,443,2,729,184919,4,305
2012-10-01,winter,2012,October,14,Monday,Workingday,Mist,0.6,0.6212,0.43,0.1045,51,193,244,244,91,244,4,3,3,433,2,729,175652,4,244
2012-10-01,winter,2012,October,15,Monday,Workingday,Mist,0.62,0.6212,0.43,0.1343,95,234,329,329,91,329,4,4,3,443,2,729,183149,4,329
2012-10-01,winter,2012,October,16,Monday,Workingday,Mist,0.62,0.6212,0.46,0.2537,51,408,459,459,91,459,4,4,3,443,2,730,227748,4,459
2012-10-01,winter,2012,October,17,Monday,Workingday,Light Snow,0.56,0.5303,0.6,0.2537,65,791,856,856,91,856,4,4,3,443,2,730,336860,4,856
2012-10-01,winter,2012,October,18,Monday,Workingday,Light Snow,0.56,0.5303,0.64,0.1045,42,571,613,613,91,613,4,4,3,443,2,728,309772,4,613
2012-10-01,winter,2012,October,19,Monday,Workingday,Mist,0.54,0.5152,0.68,0.1045,33,483,516,516,91,516,4,4,3,443,2,728,226789,4,516
2012-10-01,winter,2012,October,20,Monday,Workingday,Light Snow,0.54,0.5152,0.68,0.0,11,251,262,262,91,262,4,3,3,433,0,728,164550,4,262
2012-10-01,winter,2012,October,21,Monday,Workingday,Mist,0.54,0.5152,0.73,0.1343,13,205,218,218,91,218,4,3,3,433,0,728,125445,4,218
2012-10-01,winter,2012,October,22,Monday,Workingday,Light Snow,0.54,0.5152,0.77,0.0896,17,190,207,207,91,207,4,3,3,433,0,728,95612,4,207
2012-10-01,winter,2012,October,23,Monday,Workingday,Light Snow,0.54,0.5152,0.77,0.0,17,88,105,105,91,105,4,2,3,423,0,728,63941,4,105
2012-10-02,winter,2012,October,0,Tuesday,Workingday,Mist,0.56,0.5303,0.73,0.0,1,30,31,31,90,31,4,1,3,413,0,726,39130,4,31
2012-10-02,winter,2012,October,1,Tuesday,Workingday,Mist,0.54,0.5152,0.77,0.1045,0,11,11,11,90,11,4,1,3,413,0,724,24164,4,11
2012-10-02,winter,2012,October,2,Tuesday,Workingday,Mist,0.54,0.5152,0.77,0.1045,0,2,2,2,90,2,4,1,3,413,0,715,16352,4,2
2012-10-02,winter,2012,October,3,Tuesday,Workingday,Mist,0.54,0.5152,0.88,0.194,1,4,5,5,90,5,4,1,3,413,0,697,8174,4,5
2012-10-02,winter,2012,October,4,Tuesday,Workingday,Mist,0.56,0.5303,0.83,0.0896,2,8,10,10,90,10,4,1,3,413,0,697,4428,4,10
2012-10-02,winter,2012,October,5,Tuesday,Workingday,Mist,0.56,0.5303,0.83,0.1343,1,42,43,43,90,43,4,2,3,423,0,717,14261,4,43
2012-10-02,winter,2012,October,6,Tuesday,Workingday,Light Snow,0.58,0.5455,0.83,0.1045,3,176,179,179,90,179,4,3,3,433,0,725,55132,4,179
2012-10-02,winter,2012,October,7,Tuesday,Workingday,Light Snow,0.58,0.5455,0.83,0.1045,4,256,260,260,90,260,4,3,3,433,0,727,154171,4,260
2012-10-02,winter,2012,October,8,Tuesday,Workingday,Light Snow,0.6,0.5455,0.88,0.0,6,128,134,134,90,134,4,2,3,423,0,727,261001,4,134
2012-10-02,winter,2012,October,9,Tuesday,Workingday,Light Snow,0.58,0.5455,0.88,0.1343,3,83,86,86,90,86,4,2,3,423,0,727,159438,4,86
2012-10-02,winter,2012,October,10,Tuesday,Workingday,Light Snow,0.58,0.5455,0.88,0.1343,3,42,45,45,90,45,4,2,3,423,0,727,126257,4,45
2012-10-02,winter,2012,October,11,Tuesday,Workingday,Light Snow,0.58,0.5455,0.94,0.1343,7,92,99,99,90,99,4,2,3,423,0,727,151320,4,99
2012-10-02,winter,2012,October,12,Tuesday,Workingday,Mist,0.6,0.5455,0.88,0.194,6,98,104,104,90,104,4,2,3,423,0,728,184414,4,104
2012-10-02,winter,2012,October,13,Tuesday,Workingday,Mist,0.6,0.5455,0.88,0.1343,6,148,154,154,90,154,4,3,3,433,0,729,184919,4,154
2012-10-02,winter,2012,October,14,Tuesday,Workingday,Light Snow,0.6,0.5455,0.88,0.1343,16,147,163,163,90,163,4,3,3,433,0,729,175652,4,163
2012-10-02,winter,2012,October,15,Tuesday,Workingday,Light Snow,0.62,0.5758,0.83,0.1343,14,195,209,209,90,209,4,3,3,433,0,729,183149,4,209
2012-10-02,winter,2012,October,16,Tuesday,Workingday,Light Snow,0.62,0.5606,0.88,0.1343,46,328,374,374,90,374,4,4,3,443,0,730,227748,4,374
2012-10-02,winter,2012,October,17,Tuesday,Workingday,Light Snow,0.62,0.5606,0.88,0.1045,38,677,715,715,90,715,4,4,3,443,2,730,336860,4,715
2012-10-02,winter,2012,October,18,Tuesday,Workingday,Light Snow,0.62,0.5455,0.94,0.0896,48,639,687,687,90,687,4,4,3,443,2,728,309772,4,687
2012-10-02,winter,2012,October,19,Tuesday,Workingday,Light Snow,0.62,0.5455,0.94,0.0,27,368,395,395,90,395,4,4,3,443,0,728,226789,4,395
2012-10-02,winter,2012,October,20,Tuesday,Workingday,Light Snow,0.62,0.5455,0.94,0.1343,20,286,306,306,90,306,4,4,3,443,0,728,164550,4,306
2012-10-02,winter,2012,October,21,Tuesday,Workingday,Light Snow,0.62,0.5455,0.94,0.1045,24,265,289,289,90,289,4,4,3,443,0,728,125445,4,289
2012-10-02,winter,2012,October,22,Tuesday,Workingday,Mist,0.62,0.5455,0.94,0.1045,28,212,240,240,90,240,4,3,3,433,0,728,95612,4,240
2012-10-02,winter,2012,October,23,Tuesday,Workingday,Mist,0.62,0.5455,0.94,0.0,11,87,98,98,90,98,4,2,3,423,0,728,63941,4,98
2012-10-03,winter,2012,October,0,Wednesday,Workingday,Light Snow,0.62,0.5455,0.94,0.0,5,47,52,52,89,52,4,2,3,423,0,726,39130,4,52
2012-10-03,winter,2012,October,1,Wednesday,Workingday,Mist,0.62,0.5455,0.94,0.0,3,16,19,19,89,19,4,1,3,413,0,724,24164,4,19
2012-10-03,winter,2012,October,2,Wednesday,Workingday,Mist,0.62,0.5455,0.94,0.0,2,7,9,9,89,9,4,1,3,413,0,715,16352,4,9
2012-10-03,winter,2012,October,3,Wednesday,Workingday,Mist,0.6,0.5152,0.94,0.0,0,7,7,7,89,7,4,1,3,413,0,697,8174,4,7
2012-10-03,winter,2012,October,4,Wednesday,Workingday,Mist,0.6,0.5,1.0,0.0,2,9,11,11,89,11,4,1,3,413,0,697,4428,4,11
2012-10-03,winter,2012,October,5,Wednesday,Workingday,Mist,0.62,0.5455,0.94,0.1045,2,32,34,34,89,34,4,1,3,413,0,717,14261,4,34
2012-10-03,winter,2012,October,6,Wednesday,Workingday,Mist,0.6,0.5152,0.94,0.1343,4,173,177,177,89,177,4,3,3,433,0,725,55132,4,177
2012-10-03,winter,2012,October,7,Wednesday,Workingday,Mist,0.6,0.5152,0.94,0.194,11,504,515,515,89,515,4,4,3,443,0,727,154171,4,515
2012-10-03,winter,2012,October,8,Wednesday,Workingday,Mist,0.62,0.5606,0.88,0.1045,28,781,809,809,89,809,4,4,3,443,2,727,261001,4,809
2012-10-03,winter,2012,October,9,Wednesday,Workingday,Mist,0.62,0.5758,0.83,0.194,30,332,362,362,89,362,4,4,3,443,0,727,159438,4,362
2012-10-03,winter,2012,October,10,Wednesday,Workingday,Clear,0.66,0.6061,0.78,0.1642,29,146,175,175,89,175,4,3,3,433,0,727,126257,4,175
2012-10-03,winter,2012,October,11,Wednesday,Workingday,Clear,0.66,0.6061,0.78,0.1642,52,178,230,230,89,230,4,3,3,433,0,727,151320,4,230
2012-10-03,winter,2012,October,12,Wednesday,Workingday,Mist,0.7,0.6515,0.7,0.1045,69,289,358,358,89,358,4,4,4,444,2,728,184414,4,358
2012-10-03,winter,2012,October,13,Wednesday,Workingday,Mist,0.7,0.6667,0.74,0.1045,55,224,279,279,89,279,4,3,4,434,0,729,184919,4,279
2012-10-03,winter,2012,October,14,Wednesday,Workingday,Mist,0.72,0.6818,0.7,0.1642,56,195,251,251,89,251,4,3,4,434,2,729,175652,4,251
2012-10-03,winter,2012,October,15,Wednesday,Workingday,Mist,0.72,0.6818,0.62,0.1642,59,260,319,319,89,319,4,4,4,444,2,729,183149,4,319
2012-10-03,winter,2012,October,16,Wednesday,Workingday,Mist,0.72,0.6667,0.58,0.0,42,436,478,478,89,478,4,4,4,444,2,730,227748,4,478
2012-10-03,winter,2012,October,17,Wednesday,Workingday,Clear,0.7,0.6515,0.65,0.0,84,833,917,917,89,917,4,4,4,444,2,730,336860,4,917
2012-10-03,winter,2012,October,18,Wednesday,Workingday,Clear,0.7,0.6515,0.65,0.0,54,756,810,810,89,810,4,4,4,444,2,728,309772,4,810
2012-10-03,winter,2012,October,19,Wednesday,Workingday,Clear,0.7,0.6515,0.65,0.0,49,544,593,593,89,593,4,4,4,444,2,728,226789,4,593
2012-10-03,winter,2012,October,20,Wednesday,Workingday,Clear,0.7,0.6515,0.65,0.0,48,449,497,497,89,497,4,4,4,444,2,728,164550,4,497
2012-10-03,winter,2012,October,21,Wednesday,Workingday,Mist,0.66,0.6212,0.74,0.0,14,195,209,209,89,209,4,3,3,433,0,728,125445,4,209
2012-10-03,winter,2012,October,22,Wednesday,Workingday,Clear,0.66,0.6212,0.74,0.0,9,232,241,241,89,241,4,3,3,433,0,728,95612,4,241
2012-10-03,winter,2012,October,23,Wednesday,Workingday,Mist,0.66,0.6061,0.78,0.0,21,199,220,220,89,220,4,3,3,433,0,728,63941,4,220
2012-10-04,winter,2012,October,0,Thursday,Workingday,Light Snow,0.64,0.5758,0.89,0.0,11,65,76,76,88,76,4,2,3,423,0,726,39130,4,76
2012-10-04,winter,2012,October,1,Thursday,Workingday,Mist,0.62,0.5455,0.94,0.0,2,23,25,25,88,25,4,1,3,413,0,724,24164,4,25
2012-10-04,winter,2012,October,2,Thursday,Workingday,Clear,0.64,0.5758,0.89,0.0,3,10,13,13,88,13,4,1,3,413,0,715,16352,4,13
2012-10-04,winter,2012,October,3,Thursday,Workingday,Mist,0.62,0.5606,0.88,0.0,5,6,11,11,88,11,4,1,3,413,0,697,8174,4,11
2012-10-04,winter,2012,October,4,Thursday,Workingday,Mist,0.64,0.5758,0.89,0.0,0,10,10,10,88,10,4,1,3,413,0,697,4428,4,10
2012-10-04,winter,2012,October,5,Thursday,Workingday,Light Snow,0.64,0.5758,0.89,0.1045,2,37,39,39,88,39,4,1,3,413,0,717,14261,4,39
2012-10-04,winter,2012,October,6,Thursday,Workingday,Light Snow,0.62,0.5455,0.94,0.0896,1,132,133,133,88,133,4,2,3,423,0,725,55132,4,133
2012-10-04,winter,2012,October,7,Thursday,Workingday,Mist,0.64,0.5758,0.89,0.0896,12,379,391,391,88,391,4,4,3,443,0,727,154171,4,391
2012-10-04,winter,2012,October,8,Thursday,Workingday,Clear,0.64,0.5758,0.89,0.0,27,711,738,738,88,738,4,4,3,443,2,727,261001,4,738
2012-10-04,winter,2012,October,9,Thursday,Workingday,Mist,0.64,0.5758,0.89,0.194,40,319,359,359,88,359,4,4,3,443,0,727,159438,4,359
2012-10-04,winter,2012,October,10,Thursday,Workingday,Mist,0.66,0.6061,0.83,0.1343,27,150,177,177,88,177,4,3,3,433,0,727,126257,4,177
2012-10-04,winter,2012,October,11,Thursday,Workingday,Mist,0.7,0.6515,0.7,0.1045,38,176,214,214,88,214,4,3,4,434,0,727,151320,4,214
2012-10-04,winter,2012,October,12,Thursday,Workingday,Mist,0.72,0.6667,0.54,0.194,57,231,288,288,88,288,4,4,4,444,2,728,184414,4,288
2012-10-04,winter,2012,October,13,Thursday,Workingday,Mist,0.72,0.6667,0.58,0.3284,63,231,294,294,88,294,4,4,4,444,2,729,184919,4,294
2012-10-04,winter,2012,October,14,Thursday,Workingday,Clear,0.7,0.6515,0.61,0.2537,56,211,267,267,88,267,4,3,4,434,2,729,175652,4,267
2012-10-04,winter,2012,October,15,Thursday,Workingday,Clear,0.72,0.6667,0.54,0.2836,77,248,325,325,88,325,4,4,4,444,2,729,183149,4,325
2012-10-04,winter,2012,October,16,Thursday,Workingday,Clear,0.7,0.6515,0.54,0.2836,86,411,497,497,88,497,4,4,4,444,2,730,227748,4,497
2012-10-04,winter,2012,October,17,Thursday,Workingday,Clear,0.7,0.6515,0.51,0.2239,112,789,901,901,88,901,4,4,4,444,2,730,336860,4,901
2012-10-04,winter,2012,October,18,Thursday,Workingday,Clear,0.66,0.6212,0.57,0.1045,75,812,887,887,88,887,4,4,3,443,2,728,309772,4,887
2012-10-04,winter,2012,October,19,Thursday,Workingday,Clear,0.66,0.6212,0.57,0.1045,67,467,534,534,88,534,4,4,3,443,2,728,226789,4,534
2012-10-04,winter,2012,October,20,Thursday,Workingday,Clear,0.64,0.6061,0.65,0.1045,50,391,441,441,88,441,4,4,3,443,2,728,164550,4,441
2012-10-04,winter,2012,October,21,Thursday,Workingday,Clear,0.62,0.6061,0.69,0.0,33,288,321,321,88,321,4,4,3,443,0,728,125445,4,321
2012-10-04,winter,2012,October,22,Thursday,Workingday,Clear,0.64,0.6212,0.47,0.1343,29,203,232,232,88,232,4,3,3,433,2,728,95612,4,232
2012-10-04,winter,2012,October,23,Thursday,Workingday,Clear,0.6,0.6212,0.56,0.0896,18,137,155,155,88,155,4,3,3,433,0,728,63941,4,155
2012-10-05,winter,2012,October,0,Friday,Workingday,Clear,0.56,0.5303,0.73,0.0,16,86,102,102,87,102,4,2,3,423,0,726,39130,4,102
2012-10-05,winter,2012,October,1,Friday,Workingday,Clear,0.54,0.5152,0.68,0.1045,3,43,46,46,87,46,4,2,3,423,0,724,24164,4,46
2012-10-05,winter,2012,October,2,Friday,Workingday,Clear,0.54,0.5152,0.73,0.0896,1,10,11,11,87,11,4,1,3,413,0,715,16352,4,11
2012-10-05,winter,2012,October,3,Friday,Workingday,Clear,0.54,0.5152,0.73,0.0,5,11,16,16,87,16,4,1,3,413,0,697,8174,4,16
2012-10-05,winter,2012,October,4,Friday,Workingday,Clear,0.54,0.5152,0.77,0.0,0,11,11,11,87,11,4,1,3,413,0,697,4428,4,11
2012-10-05,winter,2012,October,5,Friday,Workingday,Clear,0.52,0.5,0.77,0.0,0,41,41,41,87,41,4,2,3,423,0,717,14261,4,41
2012-10-05,winter,2012,October,6,Friday,Workingday,Clear,0.52,0.5,0.83,0.0,4,133,137,137,87,137,4,2,3,423,0,725,55132,4,137
2012-10-05,winter,2012,October,7,Friday,Workingday,Clear,0.52,0.5,0.83,0.1045,11,417,428,428,87,428,4,4,3,443,0,727,154171,4,428
2012-10-05,winter,2012,October,8,Friday,Workingday,Clear,0.58,0.5455,0.64,0.0,36,749,785,785,87,785,4,4,3,443,2,727,261001,4,785
2012-10-05,winter,2012,October,9,Friday,Workingday,Clear,0.6,0.6061,0.6,0.0896,58,326,384,384,87,384,4,4,3,443,2,727,159438,4,384
2012-10-05,winter,2012,October,10,Friday,Workingday,Clear,0.66,0.6212,0.54,0.0,68,192,260,260,87,260,4,3,3,433,2,727,126257,4,260
2012-10-05,winter,2012,October,11,Friday,Workingday,Clear,0.7,0.6515,0.48,0.194,90,214,304,304,87,304,4,4,4,444,2,727,151320,4,304
2012-10-05,winter,2012,October,12,Friday,Workingday,Clear,0.72,0.6515,0.42,0.1642,161,307,468,468,87,468,4,4,4,444,2,728,184414,4,468
2012-10-05,winter,2012,October,13,Friday,Workingday,Clear,0.7,0.6515,0.48,0.0,117,307,424,424,87,424,4,4,4,444,2,729,184919,4,424
2012-10-05,winter,2012,October,14,Friday,Workingday,Clear,0.74,0.6515,0.37,0.2239,113,287,400,400,87,400,4,4,4,444,2,729,175652,4,400
2012-10-05,winter,2012,October,15,Friday,Workingday,Clear,0.72,0.6515,0.39,0.2537,150,320,470,470,87,470,4,4,4,444,2,729,183149,4,470
2012-10-05,winter,2012,October,16,Friday,Workingday,Clear,0.72,0.6515,0.37,0.0,153,481,634,634,87,634,4,4,4,444,2,730,227748,4,634
2012-10-05,winter,2012,October,17,Friday,Workingday,Clear,0.7,0.6364,0.42,0.1642,158,742,900,900,87,900,4,4,4,444,2,730,336860,4,900
2012-10-05,winter,2012,October,18,Friday,Workingday,Clear,0.64,0.6212,0.57,0.1343,106,655,761,761,87,761,4,4,3,443,2,728,309772,4,761
2012-10-05,winter,2012,October,19,Friday,Workingday,Clear,0.62,0.5909,0.73,0.1642,67,433,500,500,87,500,4,4,3,443,2,728,226789,4,500
2012-10-05,winter,2012,October,20,Friday,Workingday,Clear,0.6,0.5758,0.78,0.1343,66,306,372,372,87,372,4,4,3,443,0,728,164550,4,372
2012-10-05,winter,2012,October,21,Friday,Workingday,Clear,0.6,0.5909,0.69,0.2239,47,220,267,267,87,267,4,3,3,433,0,728,125445,4,267
2012-10-05,winter,2012,October,22,Friday,Workingday,Clear,0.6,0.5909,0.73,0.2836,63,201,264,264,87,264,4,3,3,433,2,728,95612,4,264
2012-10-05,winter,2012,October,23,Friday,Workingday,Clear,0.58,0.5455,0.78,0.2239,23,148,171,171,87,171,4,3,3,433,0,728,63941,4,171
2012-10-06,winter,2012,October,0,Saturday,Holiday,Clear,0.56,0.5303,0.83,0.1642,37,154,191,191,86,191,4,3,3,433,0,726,39130,4,191
2012-10-06,winter,2012,October,1,Saturday,Holiday,Clear,0.56,0.5303,0.83,0.2537,25,116,141,141,86,141,4,2,3,423,0,724,24164,4,141
2012-10-06,winter,2012,October,2,Saturday,Holiday,Clear,0.56,0.5303,0.78,0.194,13,62,75,75,86,75,4,2,3,423,0,715,16352,4,75
2012-10-06,winter,2012,October,3,Saturday,Holiday,Clear,0.54,0.5152,0.77,0.2239,2,54,56,56,86,56,4,2,3,423,0,697,8174,4,56
2012-10-06,winter,2012,October,4,Saturday,Holiday,Clear,0.54,0.5152,0.83,0.2537,4,7,11,11,86,11,4,1,3,413,0,697,4428,4,11
2012-10-06,winter,2012,October,5,Saturday,Holiday,Clear,0.54,0.5152,0.83,0.194,2,8,10,10,86,10,4,1,3,413,0,717,14261,4,10
2012-10-06,winter,2012,October,6,Saturday,Holiday,Clear,0.54,0.5152,0.88,0.2537,2,28,30,30,86,30,4,1,3,413,0,725,55132,4,30
2012-10-06,winter,2012,October,7,Saturday,Holiday,Clear,0.54,0.5152,0.83,0.2985,13,71,84,84,86,84,4,2,3,423,0,727,154171,4,84
2012-10-06,winter,2012,October,8,Saturday,Holiday,Clear,0.56,0.5303,0.83,0.194,22,184,206,206,86,206,4,3,3,433,0,727,261001,4,206
2012-10-06,winter,2012,October,9,Saturday,Holiday,Clear,0.6,0.5909,0.73,0.194,130,265,395,395,86,395,4,4,3,443,2,727,159438,4,395
2012-10-06,winter,2012,October,10,Saturday,Holiday,Clear,0.62,0.6061,0.69,0.2836,198,341,539,539,86,539,4,4,3,443,2,727,126257,4,539
2012-10-06,winter,2012,October,11,Saturday,Holiday,Clear,0.64,0.6061,0.65,0.2537,258,389,647,647,86,647,4,4,3,443,2,727,151320,4,647
2012-10-06,winter,2012,October,12,Saturday,Holiday,Clear,0.7,0.6515,0.54,0.1045,362,381,743,743,86,743,4,4,4,444,2,728,184414,4,743
2012-10-06,winter,2012,October,13,Saturday,Holiday,Mist,0.64,0.6212,0.57,0.5224,310,400,710,710,86,710,4,4,3,443,2,729,184919,4,710
2012-10-06,winter,2012,October,14,Saturday,Holiday,Mist,0.6,0.6212,0.56,0.4179,269,307,576,576,86,576,4,4,3,443,2,729,175652,4,576
2012-10-06,winter,2012,October,15,Saturday,Holiday,Clear,0.6,0.6212,0.46,0.4179,279,341,620,620,86,620,4,4,3,443,2,729,183149,4,620
2012-10-06,winter,2012,October,16,Saturday,Holiday,Clear,0.6,0.6212,0.43,0.5224,317,342,659,659,86,659,4,4,3,443,2,730,227748,4,659
2012-10-06,winter,2012,October,17,Saturday,Holiday,Clear,0.54,0.5152,0.49,0.3881,268,342,610,610,86,610,4,4,3,443,2,730,336860,4,610
2012-10-06,winter,2012,October,18,Saturday,Holiday,Clear,0.52,0.5,0.48,0.4179,183,312,495,495,86,495,4,4,3,443,2,728,309772,4,495
2012-10-06,winter,2012,October,19,Saturday,Holiday,Clear,0.48,0.4697,0.55,0.2239,102,239,341,341,86,341,4,4,2,442,2,728,226789,4,341
2012-10-06,winter,2012,October,20,Saturday,Holiday,Clear,0.48,0.4697,0.55,0.2537,75,172,247,247,86,247,4,3,2,432,2,728,164550,4,247
2012-10-06,winter,2012,October,21,Saturday,Holiday,Clear,0.46,0.4545,0.59,0.1343,78,137,215,215,86,215,4,3,2,432,0,728,125445,4,215
2012-10-06,winter,2012,October,22,Saturday,Holiday,Clear,0.44,0.4394,0.62,0.1343,45,140,185,185,86,185,4,3,2,432,0,728,95612,4,185
2012-10-06,winter,2012,October,23,Saturday,Holiday,Clear,0.44,0.4394,0.62,0.1343,37,142,179,179,86,179,4,3,2,432,0,728,63941,4,179
2012-10-07,winter,2012,October,0,Sunday,Holiday,Clear,0.44,0.4394,0.62,0.1642,28,99,127,127,85,127,4,2,2,422,0,726,39130,4,127
2012-10-07,winter,2012,October,1,Sunday,Holiday,Clear,0.44,0.4394,0.54,0.2239,29,80,109,109,85,109,4,2,2,422,1,724,24164,4,109
2012-10-07,winter,2012,October,2,Sunday,Holiday,Clear,0.42,0.4242,0.62,0.1343,10,64,74,74,85,74,4,2,2,422,1,715,16352,4,74
2012-10-07,winter,2012,October,3,Sunday,Holiday,Mist,0.44,0.4394,0.62,0.1343,5,17,22,22,85,22,4,1,2,412,0,697,8174,4,22
2012-10-07,winter,2012,October,4,Sunday,Holiday,Mist,0.44,0.4394,0.54,0.2537,5,6,11,11,85,11,4,1,2,412,1,697,4428,4,11
2012-10-07,winter,2012,October,5,Sunday,Holiday,Mist,0.44,0.4394,0.54,0.1343,2,8,10,10,85,10,4,1,2,412,1,717,14261,4,10
2012-10-07,winter,2012,October,6,Sunday,Holiday,Mist,0.44,0.4394,0.54,0.194,4,19,23,23,85,23,4,1,2,412,1,725,55132,4,23
2012-10-07,winter,2012,October,7,Sunday,Holiday,Light Snow,0.42,0.4242,0.58,0.1642,6,29,35,35,85,35,4,1,2,412,1,727,154171,4,35
2012-10-07,winter,2012,October,8,Sunday,Holiday,Light Snow,0.42,0.4242,0.67,0.1343,11,51,62,62,85,62,4,2,2,422,0,727,261001,4,62
2012-10-07,winter,2012,October,9,Sunday,Holiday,Light Snow,0.4,0.4091,0.71,0.1343,16,70,86,86,85,86,4,2,2,422,0,727,159438,4,86
2012-10-07,winter,2012,October,10,Sunday,Holiday,Mist,0.42,0.4242,0.67,0.194,41,144,185,185,85,185,4,3,2,432,1,727,126257,4,185
2012-10-07,winter,2012,October,11,Sunday,Holiday,Mist,0.42,0.4242,0.71,0.1045,76,260,336,336,85,336,4,4,2,442,0,727,151320,4,336
2012-10-07,winter,2012,October,12,Sunday,Holiday,Mist,0.42,0.4242,0.71,0.0,100,292,392,392,85,392,4,4,2,442,0,728,184414,4,392
2012-10-07,winter,2012,October,13,Sunday,Holiday,Mist,0.44,0.4394,0.72,0.0896,80,240,320,320,85,320,4,4,2,442,0,729,184919,4,320
2012-10-07,winter,2012,October,14,Sunday,Holiday,Mist,0.44,0.4394,0.67,0.0,71,243,314,314,85,314,4,4,2,442,0,729,175652,4,314
2012-10-07,winter,2012,October,15,Sunday,Holiday,Light Snow,0.42,0.4242,0.77,0.1343,74,232,306,306,85,306,4,4,2,442,0,729,183149,4,306
2012-10-07,winter,2012,October,16,Sunday,Holiday,Light Snow,0.4,0.4091,0.82,0.1642,87,246,333,333,85,333,4,4,2,442,0,730,227748,4,333
2012-10-07,winter,2012,October,17,Sunday,Holiday,Light Snow,0.4,0.4091,0.82,0.2239,35,122,157,157,85,157,4,3,2,432,0,730,336860,4,157
2012-10-07,winter,2012,October,18,Sunday,Holiday,Light Snow,0.4,0.4091,0.82,0.194,24,82,106,106,85,106,4,2,2,422,0,728,309772,4,106
2012-10-07,winter,2012,October,19,Sunday,Holiday,Mist,0.4,0.4091,0.82,0.1045,17,97,114,114,85,114,4,2,2,422,0,728,226789,4,114
2012-10-07,winter,2012,October,20,Sunday,Holiday,Clear,0.4,0.4091,0.82,0.1343,19,97,116,116,85,116,4,2,2,422,0,728,164550,4,116
2012-10-07,winter,2012,October,21,Sunday,Holiday,Clear,0.38,0.3939,0.87,0.1045,22,91,113,113,85,113,4,2,2,422,0,728,125445,4,113
2012-10-07,winter,2012,October,22,Sunday,Holiday,Clear,0.38,0.3939,0.87,0.1343,7,72,79,79,85,79,4,2,2,422,0,728,95612,4,79
2012-10-07,winter,2012,October,23,Sunday,Holiday,Clear,0.36,0.3485,0.93,0.1343,12,68,80,80,85,80,4,2,2,422,0,728,63941,4,80
2012-10-08,winter,2012,October,0,Monday,Holiday,Clear,0.38,0.3939,0.76,0.2836,7,44,51,51,84,51,4,2,2,422,1,726,39130,4,51
2012-10-08,winter,2012,October,1,Monday,Holiday,Clear,0.34,0.3333,0.87,0.1642,2,35,37,37,84,37,4,1,1,411,1,724,24164,4,37
2012-10-08,winter,2012,October,2,Monday,Holiday,Clear,0.34,0.3333,0.81,0.194,3,12,15,15,84,15,4,1,1,411,1,715,16352,4,15
2012-10-08,winter,2012,October,3,Monday,Holiday,Clear,0.34,0.3485,0.81,0.1045,2,8,10,10,84,10,4,1,2,412,1,697,8174,4,10
2012-10-08,winter,2012,October,4,Monday,Holiday,Clear,0.32,0.3333,0.87,0.1343,1,6,7,7,84,7,4,1,1,411,1,697,4428,4,7
2012-10-08,winter,2012,October,5,Monday,Holiday,Clear,0.34,0.3182,0.76,0.2239,2,17,19,19,84,19,4,1,1,411,1,717,14261,4,19
2012-10-08,winter,2012,October,6,Monday,Holiday,Clear,0.34,0.3485,0.76,0.1045,5,54,59,59,84,59,4,2,2,422,1,725,55132,4,59
2012-10-08,winter,2012,October,7,Monday,Holiday,Mist,0.34,0.3333,0.76,0.1642,3,151,154,154,84,154,4,3,1,431,1,727,154171,4,154
2012-10-08,winter,2012,October,8,Monday,Holiday,Mist,0.36,0.3485,0.71,0.2239,23,374,397,397,84,397,4,4,2,442,1,727,261001,4,397
2012-10-08,winter,2012,October,9,Monday,Holiday,Mist,0.38,0.3939,0.66,0.1642,59,273,332,332,84,332,4,4,2,442,1,727,159438,4,332
2012-10-08,winter,2012,October,10,Monday,Holiday,Mist,0.38,0.3939,0.68,0.1343,69,229,298,298,84,298,4,4,2,442,1,727,126257,4,298
2012-10-08,winter,2012,October,11,Monday,Holiday,Mist,0.4,0.4091,0.62,0.0896,72,236,308,308,84,308,4,4,2,442,1,727,151320,4,308
2012-10-08,winter,2012,October,12,Monday,Holiday,Mist,0.42,0.4242,0.63,0.1642,74,267,341,341,84,341,4,4,2,442,1,728,184414,4,341
2012-10-08,winter,2012,October,13,Monday,Holiday,Mist,0.42,0.4242,0.62,0.194,82,323,405,405,84,405,4,4,2,442,2,729,184919,4,405
2012-10-08,winter,2012,October,14,Monday,Holiday,Mist,0.42,0.4242,0.58,0.1045,121,299,420,420,84,420,4,4,2,442,2,729,175652,4,420
2012-10-08,winter,2012,October,15,Monday,Holiday,Light Snow,0.42,0.4242,0.58,0.194,76,294,370,370,84,370,4,4,2,442,2,729,183149,4,370
2012-10-08,winter,2012,October,16,Monday,Holiday,Light Snow,0.42,0.4242,0.58,0.194,61,316,377,377,84,377,4,4,2,442,1,730,227748,4,377
2012-10-08,winter,2012,October,17,Monday,Holiday,Mist,0.42,0.4242,0.66,0.2537,81,416,497,497,84,497,4,4,2,442,2,730,336860,4,497
2012-10-08,winter,2012,October,18,Monday,Holiday,Mist,0.42,0.4242,0.66,0.2836,41,415,456,456,84,456,4,4,2,442,2,728,309772,4,456
2012-10-08,winter,2012,October,19,Monday,Holiday,Mist,0.4,0.4091,0.71,0.2537,38,333,371,371,84,371,4,4,2,442,1,728,226789,4,371
2012-10-08,winter,2012,October,20,Monday,Holiday,Light Snow,0.4,0.4091,0.71,0.2239,20,207,227,227,84,227,4,3,2,432,1,728,164550,4,227
2012-10-08,winter,2012,October,21,Monday,Holiday,Mist,0.4,0.4091,0.76,0.2239,17,134,151,151,84,151,4,3,2,432,1,728,125445,4,151
2012-10-08,winter,2012,October,22,Monday,Holiday,Light Snow,0.4,0.4091,0.76,0.2537,6,101,107,107,84,107,4,2,2,422,1,728,95612,4,107
2012-10-08,winter,2012,October,23,Monday,Holiday,Mist,0.4,0.4091,0.71,0.2239,9,60,69,69,84,69,4,2,2,422,1,728,63941,4,69
2012-10-09,winter,2012,October,0,Tuesday,Workingday,Mist,0.38,0.3939,0.82,0.2239,9,22,31,31,83,31,4,1,2,412,1,726,39130,4,31
2012-10-09,winter,2012,October,1,Tuesday,Workingday,Light Snow,0.36,0.3485,0.87,0.2239,0,13,13,13,83,13,4,1,2,412,1,724,24164,4,13
2012-10-09,winter,2012,October,2,Tuesday,Workingday,Light Snow,0.36,0.3333,0.87,0.2537,2,5,7,7,83,7,4,1,1,411,1,715,16352,4,7
2012-10-09,winter,2012,October,3,Tuesday,Workingday,Light Snow,0.36,0.3333,0.87,0.2836,0,3,3,3,83,3,4,1,1,411,1,697,8174,4,3
2012-10-09,winter,2012,October,4,Tuesday,Workingday,Light Snow,0.36,0.3485,0.87,0.1642,1,6,7,7,83,7,4,1,2,412,1,697,4428,4,7
2012-10-09,winter,2012,October,5,Tuesday,Workingday,Mist,0.38,0.3939,0.82,0.194,0,19,19,19,83,19,4,1,2,412,0,717,14261,4,19
2012-10-09,winter,2012,October,6,Tuesday,Workingday,Mist,0.38,0.3939,0.82,0.2537,2,141,143,143,83,143,4,3,2,432,1,725,55132,4,143
2012-10-09,winter,2012,October,7,Tuesday,Workingday,Clear,0.38,0.3939,0.83,0.2537,5,357,362,362,83,362,4,4,2,442,1,727,154171,4,362
2012-10-09,winter,2012,October,8,Tuesday,Workingday,Mist,0.42,0.4242,0.8,0.194,15,698,713,713,83,713,4,4,2,442,2,727,261001,4,713
2012-10-09,winter,2012,October,9,Tuesday,Workingday,Mist,0.42,0.4242,0.77,0.2239,37,345,382,382,83,382,4,4,2,442,0,727,159438,4,382
2012-10-09,winter,2012,October,10,Tuesday,Workingday,Mist,0.44,0.4394,0.75,0.2239,33,131,164,164,83,164,4,3,2,432,0,727,126257,4,164
2012-10-09,winter,2012,October,11,Tuesday,Workingday,Mist,0.48,0.4697,0.69,0.194,37,156,193,193,83,193,4,3,2,432,0,727,151320,4,193
2012-10-09,winter,2012,October,12,Tuesday,Workingday,Mist,0.48,0.4697,0.69,0.194,43,217,260,260,83,260,4,3,2,432,0,728,184414,4,260
2012-10-09,winter,2012,October,13,Tuesday,Workingday,Mist,0.5,0.4848,0.67,0.1343,54,184,238,238,83,238,4,3,2,432,0,729,184919,4,238
2012-10-09,winter,2012,October,14,Tuesday,Workingday,Mist,0.54,0.5152,0.64,0.194,43,201,244,244,83,244,4,3,3,433,0,729,175652,4,244
2012-10-09,winter,2012,October,15,Tuesday,Workingday,Mist,0.52,0.5,0.63,0.1642,59,195,254,254,83,254,4,3,3,433,0,729,183149,4,254
2012-10-09,winter,2012,October,16,Tuesday,Workingday,Mist,0.5,0.4848,0.72,0.1642,70,354,424,424,83,424,4,4,2,442,2,730,227748,4,424
2012-10-09,winter,2012,October,17,Tuesday,Workingday,Mist,0.52,0.5,0.68,0.1642,73,733,806,806,83,806,4,4,3,443,2,730,336860,4,806
2012-10-09,winter,2012,October,18,Tuesday,Workingday,Mist,0.5,0.4848,0.72,0.2239,26,758,784,784,83,784,4,4,2,442,2,728,309772,4,784
2012-10-09,winter,2012,October,19,Tuesday,Workingday,Mist,0.5,0.4848,0.72,0.1642,31,483,514,514,83,514,4,4,2,442,2,728,226789,4,514
2012-10-09,winter,2012,October,20,Tuesday,Workingday,Mist,0.5,0.4848,0.72,0.1642,30,330,360,360,83,360,4,4,2,442,0,728,164550,4,360
2012-10-09,winter,2012,October,21,Tuesday,Workingday,Mist,0.48,0.4697,0.77,0.1343,16,209,225,225,83,225,4,3,2,432,0,728,125445,4,225
2012-10-09,winter,2012,October,22,Tuesday,Workingday,Mist,0.48,0.4697,0.77,0.0896,7,155,162,162,83,162,4,3,2,432,0,728,95612,4,162
2012-10-09,winter,2012,October,23,Tuesday,Workingday,Mist,0.48,0.4697,0.77,0.0896,8,76,84,84,83,84,4,2,2,422,0,728,63941,4,84
2012-10-10,winter,2012,October,0,Wednesday,Workingday,Mist,0.46,0.4545,0.88,0.0896,0,33,33,33,82,33,4,1,2,412,0,726,39130,4,33
2012-10-10,winter,2012,October,1,Wednesday,Workingday,Mist,0.46,0.4545,0.88,0.0,2,6,8,8,82,8,4,1,2,412,0,724,24164,4,8
2012-10-10,winter,2012,October,2,Wednesday,Workingday,Mist,0.46,0.4545,0.88,0.0,2,6,8,8,82,8,4,1,2,412,0,715,16352,4,8
2012-10-10,winter,2012,October,3,Wednesday,Workingday,Mist,0.46,0.4545,0.88,0.0,0,6,6,6,82,6,4,1,2,412,0,697,8174,4,6
2012-10-10,winter,2012,October,4,Wednesday,Workingday,Mist,0.46,0.4545,0.88,0.1045,0,6,6,6,82,6,4,1,2,412,0,697,4428,4,6
2012-10-10,winter,2012,October,5,Wednesday,Workingday,Mist,0.46,0.4545,0.88,0.0896,2,38,40,40,82,40,4,1,2,412,0,717,14261,4,40
2012-10-10,winter,2012,October,6,Wednesday,Workingday,Mist,0.46,0.4545,0.88,0.0896,3,172,175,175,82,175,4,3,2,432,0,725,55132,4,175
2012-10-10,winter,2012,October,7,Wednesday,Workingday,Clear,0.46,0.4545,0.82,0.1045,9,498,507,507,82,507,4,4,2,442,0,727,154171,4,507
2012-10-10,winter,2012,October,8,Wednesday,Workingday,Clear,0.5,0.4848,0.77,0.1642,33,806,839,839,82,839,4,4,2,442,2,727,261001,4,839
2012-10-10,winter,2012,October,9,Wednesday,Workingday,Clear,0.54,0.5152,0.6,0.2836,35,331,366,366,82,366,4,4,3,443,2,727,159438,4,366
2012-10-10,winter,2012,October,10,Wednesday,Workingday,Clear,0.56,0.5303,0.52,0.2985,27,190,217,217,82,217,4,3,3,433,2,727,126257,4,217
2012-10-10,winter,2012,October,11,Wednesday,Workingday,Clear,0.54,0.5152,0.52,0.194,53,238,291,291,82,291,4,4,3,443,2,727,151320,4,291
2012-10-10,winter,2012,October,12,Wednesday,Workingday,Clear,0.54,0.5152,0.56,0.2239,78,312,390,390,82,390,4,4,3,443,2,728,184414,4,390
2012-10-10,winter,2012,October,13,Wednesday,Workingday,Clear,0.56,0.5303,0.49,0.0,60,237,297,297,82,297,4,4,3,443,2,729,184919,4,297
2012-10-10,winter,2012,October,14,Wednesday,Workingday,Clear,0.6,0.6212,0.4,0.1642,63,208,271,271,82,271,4,3,3,433,2,729,175652,4,271
2012-10-10,winter,2012,October,15,Wednesday,Workingday,Clear,0.6,0.6212,0.4,0.1642,58,261,319,319,82,319,4,4,3,443,2,729,183149,4,319
2012-10-10,winter,2012,October,16,Wednesday,Workingday,Clear,0.6,0.6212,0.4,0.2239,92,474,566,566,82,566,4,4,3,443,2,730,227748,4,566
2012-10-10,winter,2012,October,17,Wednesday,Workingday,Clear,0.58,0.5455,0.43,0.2239,91,857,948,948,82,948,4,4,3,443,2,730,336860,4,948
2012-10-10,winter,2012,October,18,Wednesday,Workingday,Mist,0.56,0.5303,0.49,0.1642,57,787,844,844,82,844,4,4,3,443,2,728,309772,4,844
2012-10-10,winter,2012,October,19,Wednesday,Workingday,Mist,0.56,0.5303,0.46,0.5821,32,534,566,566,82,566,4,4,3,443,2,728,226789,4,566
2012-10-10,winter,2012,October,20,Wednesday,Workingday,Clear,0.52,0.5,0.48,0.4925,21,371,392,392,82,392,4,4,3,443,2,728,164550,4,392
2012-10-10,winter,2012,October,21,Wednesday,Workingday,Clear,0.5,0.4848,0.51,0.3582,18,251,269,269,82,269,4,3,2,432,1,728,125445,4,269
2012-10-10,winter,2012,October,22,Wednesday,Workingday,Clear,0.46,0.4545,0.55,0.2985,27,170,197,197,82,197,4,3,2,432,1,728,95612,4,197
2012-10-10,winter,2012,October,23,Wednesday,Workingday,Clear,0.44,0.4394,0.58,0.194,17,119,136,136,82,136,4,2,2,422,1,728,63941,4,136
2012-10-11,winter,2012,October,0,Thursday,Workingday,Clear,0.44,0.4394,0.51,0.1343,1,41,42,42,81,42,4,2,2,422,1,726,39130,4,42
2012-10-11,winter,2012,October,1,Thursday,Workingday,Clear,0.44,0.4394,0.47,0.194,1,10,11,11,81,11,4,1,2,412,1,724,24164,4,11
2012-10-11,winter,2012,October,2,Thursday,Workingday,Clear,0.42,0.4242,0.5,0.1343,4,7,11,11,81,11,4,1,2,412,1,715,16352,4,11
2012-10-11,winter,2012,October,3,Thursday,Workingday,Clear,0.42,0.4242,0.47,0.2985,0,3,3,3,81,3,4,1,2,412,1,697,8174,4,3
2012-10-11,winter,2012,October,4,Thursday,Workingday,Clear,0.4,0.4091,0.5,0.2537,0,10,10,10,81,10,4,1,2,412,1,697,4428,4,10
2012-10-11,winter,2012,October,5,Thursday,Workingday,Clear,0.36,0.3485,0.5,0.1642,0,42,42,42,81,42,4,2,2,422,1,717,14261,4,42
2012-10-11,winter,2012,October,6,Thursday,Workingday,Clear,0.36,0.3485,0.5,0.1642,1,158,159,159,81,159,4,3,2,432,1,725,55132,4,159
2012-10-11,winter,2012,October,7,Thursday,Workingday,Clear,0.36,0.3333,0.5,0.2537,11,467,478,478,81,478,4,4,1,441,1,727,154171,4,478
2012-10-11,winter,2012,October,8,Thursday,Workingday,Clear,0.38,0.3939,0.46,0.3881,25,773,798,798,81,798,4,4,2,442,2,727,261001,4,798
2012-10-11,winter,2012,October,9,Thursday,Workingday,Clear,0.4,0.4091,0.43,0.3881,27,328,355,355,81,355,4,4,2,442,1,727,159438,4,355
2012-10-11,winter,2012,October,10,Thursday,Workingday,Clear,0.44,0.4394,0.41,0.3582,39,165,204,204,81,204,4,3,2,432,1,727,126257,4,204
2012-10-11,winter,2012,October,11,Thursday,Workingday,Clear,0.46,0.4545,0.36,0.0,76,175,251,251,81,251,4,3,2,432,2,727,151320,4,251
2012-10-11,winter,2012,October,12,Thursday,Workingday,Clear,0.46,0.4545,0.36,0.0,47,279,326,326,81,326,4,4,2,442,2,728,184414,4,326
2012-10-11,winter,2012,October,13,Thursday,Workingday,Clear,0.5,0.4848,0.31,0.1045,48,243,291,291,81,291,4,4,2,442,2,729,184919,4,291
2012-10-11,winter,2012,October,14,Thursday,Workingday,Clear,0.52,0.5,0.32,0.0896,78,270,348,348,81,348,4,4,3,443,2,729,175652,4,348
2012-10-11,winter,2012,October,15,Thursday,Workingday,Clear,0.52,0.5,0.34,0.1642,102,358,460,460,81,460,4,4,3,443,2,729,183149,4,460
2012-10-11,winter,2012,October,16,Thursday,Workingday,Clear,0.5,0.4848,0.36,0.1343,68,413,481,481,81,481,4,4,2,442,2,730,227748,4,481
2012-10-11,winter,2012,October,17,Thursday,Workingday,Clear,0.5,0.4848,0.39,0.2836,90,737,827,827,81,827,4,4,2,442,2,730,336860,4,827
2012-10-11,winter,2012,October,18,Thursday,Workingday,Clear,0.46,0.4545,0.44,0.1642,64,628,692,692,81,692,4,4,2,442,2,728,309772,4,692
2012-10-11,winter,2012,October,19,Thursday,Workingday,Clear,0.44,0.4394,0.51,0.1343,81,662,743,743,81,743,4,4,2,442,2,728,226789,4,743
2012-10-11,winter,2012,October,20,Thursday,Workingday,Clear,0.42,0.4242,0.62,0.1642,27,388,415,415,81,415,4,4,2,442,1,728,164550,4,415
2012-10-11,winter,2012,October,21,Thursday,Workingday,Clear,0.42,0.4242,0.62,0.1343,24,236,260,260,81,260,4,3,2,432,1,728,125445,4,260
2012-10-11,winter,2012,October,22,Thursday,Workingday,Clear,0.4,0.4091,0.66,0.1642,10,167,177,177,81,177,4,3,2,432,1,728,95612,4,177
2012-10-11,winter,2012,October,23,Thursday,Workingday,Clear,0.42,0.4242,0.58,0.0896,10,176,186,186,81,186,4,3,2,432,1,728,63941,4,186
2012-10-12,winter,2012,October,0,Friday,Workingday,Clear,0.4,0.4091,0.66,0.1045,8,60,68,68,80,68,4,2,2,422,1,726,39130,4,68
2012-10-12,winter,2012,October,1,Friday,Workingday,Clear,0.4,0.4091,0.66,0.0896,8,29,37,37,80,37,4,1,2,412,0,724,24164,4,37
2012-10-12,winter,2012,October,2,Friday,Workingday,Clear,0.4,0.4091,0.66,0.0896,0,16,16,16,80,16,4,1,2,412,0,715,16352,4,16
2012-10-12,winter,2012,October,3,Friday,Workingday,Clear,0.36,0.3636,0.76,0.0896,0,6,6,6,80,6,4,1,2,412,1,697,8174,4,6
2012-10-12,winter,2012,October,4,Friday,Workingday,Clear,0.36,0.3636,0.76,0.1045,0,8,8,8,80,8,4,1,2,412,1,697,4428,4,8
2012-10-12,winter,2012,October,5,Friday,Workingday,Clear,0.36,0.3636,0.81,0.0896,2,33,35,35,80,35,4,1,2,412,0,717,14261,4,35
2012-10-12,winter,2012,October,6,Friday,Workingday,Clear,0.34,0.3485,0.81,0.0896,3,140,143,143,80,143,4,3,2,432,1,725,55132,4,143
2012-10-12,winter,2012,October,7,Friday,Workingday,Clear,0.36,0.3636,0.81,0.0896,8,384,392,392,80,392,4,4,2,442,0,727,154171,4,392
2012-10-12,winter,2012,October,8,Friday,Workingday,Clear,0.42,0.4242,0.71,0.0896,34,711,745,745,80,745,4,4,2,442,2,727,261001,4,745
2012-10-12,winter,2012,October,9,Friday,Workingday,Clear,0.5,0.4848,0.39,0.2985,26,374,400,400,80,400,4,4,2,442,2,727,159438,4,400
2012-10-12,winter,2012,October,10,Friday,Workingday,Clear,0.52,0.5,0.36,0.2985,75,200,275,275,80,275,4,3,3,433,2,727,126257,4,275
2012-10-12,winter,2012,October,11,Friday,Workingday,Clear,0.54,0.5152,0.37,0.3582,61,252,313,313,80,313,4,4,3,443,2,727,151320,4,313
2012-10-12,winter,2012,October,12,Friday,Workingday,Clear,0.54,0.5152,0.39,0.4627,75,312,387,387,80,387,4,4,3,443,2,728,184414,4,387
2012-10-12,winter,2012,October,13,Friday,Workingday,Clear,0.56,0.5303,0.37,0.3881,81,300,381,381,80,381,4,4,3,443,2,729,184919,4,381
2012-10-12,winter,2012,October,14,Friday,Workingday,Clear,0.56,0.5303,0.37,0.4627,109,262,371,371,80,371,4,4,3,443,2,729,175652,4,371
2012-10-12,winter,2012,October,15,Friday,Workingday,Clear,0.52,0.5,0.42,0.4478,138,317,455,455,80,455,4,4,3,443,2,729,183149,4,455
2012-10-12,winter,2012,October,16,Friday,Workingday,Clear,0.46,0.4545,0.41,0.3582,108,412,520,520,80,520,4,4,2,442,2,730,227748,4,520
2012-10-12,winter,2012,October,17,Friday,Workingday,Clear,0.46,0.4545,0.38,0.3881,131,706,837,837,80,837,4,4,2,442,2,730,336860,4,837
2012-10-12,winter,2012,October,18,Friday,Workingday,Clear,0.44,0.4394,0.38,0.2985,76,566,642,642,80,642,4,4,2,442,2,728,309772,4,642
2012-10-12,winter,2012,October,19,Friday,Workingday,Clear,0.42,0.4242,0.41,0.2239,40,453,493,493,80,493,4,4,2,442,2,728,226789,4,493
2012-10-12,winter,2012,October,20,Friday,Workingday,Clear,0.42,0.4242,0.47,0.1343,28,280,308,308,80,308,4,4,2,442,1,728,164550,4,308
2012-10-12,winter,2012,October,21,Friday,Workingday,Clear,0.4,0.4091,0.54,0.194,21,169,190,190,80,190,4,3,2,432,1,728,125445,4,190
2012-10-12,winter,2012,October,22,Friday,Workingday,Clear,0.4,0.4091,0.47,0.2985,17,143,160,160,80,160,4,3,2,432,1,728,95612,4,160
2012-10-12,winter,2012,October,23,Friday,Workingday,Clear,0.36,0.3485,0.57,0.194,11,89,100,100,80,100,4,2,2,422,1,728,63941,4,100
2012-10-13,winter,2012,October,0,Saturday,Holiday,Clear,0.36,0.3636,0.57,0.0896,31,218,249,249,79,249,4,3,2,432,1,726,39130,4,249
2012-10-13,winter,2012,October,1,Saturday,Holiday,Clear,0.34,0.3333,0.53,0.1343,23,123,146,146,79,146,4,3,1,431,1,724,24164,4,146
2012-10-13,winter,2012,October,2,Saturday,Holiday,Clear,0.34,0.3333,0.53,0.194,7,60,67,67,79,67,4,2,1,421,1,715,16352,4,67
2012-10-13,winter,2012,October,3,Saturday,Holiday,Clear,0.32,0.303,0.66,0.2239,2,13,15,15,79,15,4,1,1,411,1,697,8174,4,15
2012-10-13,winter,2012,October,4,Saturday,Holiday,Clear,0.3,0.303,0.65,0.1642,2,9,11,11,79,11,4,1,1,411,1,697,4428,4,11
2012-10-13,winter,2012,October,5,Saturday,Holiday,Clear,0.3,0.2879,0.61,0.194,0,11,11,11,79,11,4,1,1,411,1,717,14261,4,11
2012-10-13,winter,2012,October,6,Saturday,Holiday,Clear,0.3,0.2879,0.61,0.194,5,23,28,28,79,28,4,1,1,411,1,725,55132,4,28
2012-10-13,winter,2012,October,7,Saturday,Holiday,Clear,0.3,0.303,0.61,0.1642,10,60,70,70,79,70,4,2,1,421,1,727,154171,4,70
2012-10-13,winter,2012,October,8,Saturday,Holiday,Clear,0.34,0.3485,0.53,0.1045,23,151,174,174,79,174,4,3,2,432,1,727,261001,4,174
2012-10-13,winter,2012,October,9,Saturday,Holiday,Clear,0.36,0.3636,0.5,0.0896,46,220,266,266,79,266,4,3,2,432,1,727,159438,4,266
2012-10-13,winter,2012,October,10,Saturday,Holiday,Clear,0.4,0.4091,0.43,0.0,82,265,347,347,79,347,4,4,2,442,2,727,126257,4,347
2012-10-13,winter,2012,October,11,Saturday,Holiday,Clear,0.42,0.4242,0.35,0.1343,192,335,527,527,79,527,4,4,2,442,2,727,151320,4,527
2012-10-13,winter,2012,October,12,Saturday,Holiday,Clear,0.44,0.4394,0.35,0.0,202,371,573,573,79,573,4,4,2,442,2,728,184414,4,573
2012-10-13,winter,2012,October,13,Saturday,Holiday,Clear,0.46,0.4545,0.36,0.194,235,435,670,670,79,670,4,4,2,442,2,729,184919,4,670
2012-10-13,winter,2012,October,14,Saturday,Holiday,Clear,0.48,0.4697,0.33,0.194,243,354,597,597,79,597,4,4,2,442,2,729,175652,4,597
2012-10-13,winter,2012,October,15,Saturday,Holiday,Clear,0.5,0.4848,0.36,0.194,251,364,615,615,79,615,4,4,2,442,2,729,183149,4,615
2012-10-13,winter,2012,October,16,Saturday,Holiday,Clear,0.5,0.4848,0.31,0.194,294,343,637,637,79,637,4,4,2,442,2,730,227748,4,637
2012-10-13,winter,2012,October,17,Saturday,Holiday,Clear,0.46,0.4545,0.38,0.1642,193,335,528,528,79,528,4,4,2,442,2,730,336860,4,528
2012-10-13,winter,2012,October,18,Saturday,Holiday,Clear,0.46,0.4545,0.44,0.1343,174,299,473,473,79,473,4,4,2,442,2,728,309772,4,473
2012-10-13,winter,2012,October,19,Saturday,Holiday,Clear,0.44,0.4394,0.44,0.1642,73,259,332,332,79,332,4,4,2,442,2,728,226789,4,332
2012-10-13,winter,2012,October,20,Saturday,Holiday,Clear,0.4,0.4091,0.54,0.0896,57,198,255,255,79,255,4,3,2,432,1,728,164550,4,255
2012-10-13,winter,2012,October,21,Saturday,Holiday,Clear,0.4,0.4091,0.58,0.194,47,157,204,204,79,204,4,3,2,432,1,728,125445,4,204
2012-10-13,winter,2012,October,22,Saturday,Holiday,Clear,0.4,0.4091,0.62,0.0,33,156,189,189,79,189,4,3,2,432,0,728,95612,4,189
2012-10-13,winter,2012,October,23,Saturday,Holiday,Clear,0.42,0.4242,0.58,0.2985,27,98,125,125,79,125,4,2,2,422,1,728,63941,4,125
2012-10-14,winter,2012,October,0,Sunday,Holiday,Clear,0.4,0.4091,0.71,0.2537,8,103,111,111,78,111,4,2,2,422,1,726,39130,4,111
2012-10-14,winter,2012,October,1,Sunday,Holiday,Clear,0.42,0.4242,0.77,0.2836,16,96,112,112,78,112,4,2,2,422,1,724,24164,4,112
2012-10-14,winter,2012,October,2,Sunday,Holiday,Clear,0.4,0.4091,0.76,0.0896,8,58,66,66,78,66,4,2,2,422,0,715,16352,4,66
2012-10-14,winter,2012,October,3,Sunday,Holiday,Clear,0.42,0.4242,0.77,0.2985,3,25,28,28,78,28,4,1,2,412,1,697,8174,4,28
2012-10-14,winter,2012,October,4,Sunday,Holiday,Clear,0.42,0.4242,0.77,0.2836,2,10,12,12,78,12,4,1,2,412,1,697,4428,4,12
2012-10-14,winter,2012,October,5,Sunday,Holiday,Clear,0.4,0.4091,0.82,0.194,5,6,11,11,78,11,4,1,2,412,0,717,14261,4,11
2012-10-14,winter,2012,October,6,Sunday,Holiday,Clear,0.4,0.4091,0.82,0.1642,4,20,24,24,78,24,4,1,2,412,0,725,55132,4,24
2012-10-14,winter,2012,October,7,Sunday,Holiday,Clear,0.42,0.4242,0.82,0.2239,7,44,51,51,78,51,4,2,2,422,0,727,154171,4,51
2012-10-14,winter,2012,October,8,Sunday,Holiday,Clear,0.44,0.4394,0.77,0.194,28,104,132,132,78,132,4,2,2,422,0,727,261001,4,132
2012-10-14,winter,2012,October,9,Sunday,Holiday,Mist,0.48,0.4697,0.67,0.2836,62,161,223,223,78,223,4,3,2,432,0,727,159438,4,223
2012-10-14,winter,2012,October,10,Sunday,Holiday,Clear,0.54,0.5152,0.56,0.194,150,278,428,428,78,428,4,4,3,443,2,727,126257,4,428
2012-10-14,winter,2012,October,11,Sunday,Holiday,Clear,0.56,0.5303,0.52,0.2985,156,338,494,494,78,494,4,4,3,443,2,727,151320,4,494
2012-10-14,winter,2012,October,12,Sunday,Holiday,Clear,0.62,0.6212,0.46,0.3284,200,362,562,562,78,562,4,4,3,443,2,728,184414,4,562
2012-10-14,winter,2012,October,13,Sunday,Holiday,Clear,0.64,0.6212,0.41,0.4478,218,401,619,619,78,619,4,4,3,443,2,729,184919,4,619
2012-10-14,winter,2012,October,14,Sunday,Holiday,Clear,0.66,0.6212,0.39,0.4179,249,368,617,617,78,617,4,4,3,443,2,729,175652,4,617
2012-10-14,winter,2012,October,15,Sunday,Holiday,Clear,0.66,0.6212,0.39,0.4179,213,355,568,568,78,568,4,4,3,443,2,729,183149,4,568
2012-10-14,winter,2012,October,16,Sunday,Holiday,Clear,0.64,0.6212,0.41,0.2985,203,378,581,581,78,581,4,4,3,443,2,730,227748,4,581
2012-10-14,winter,2012,October,17,Sunday,Holiday,Clear,0.64,0.6212,0.44,0.194,193,346,539,539,78,539,4,4,3,443,2,730,336860,4,539
2012-10-14,winter,2012,October,18,Sunday,Holiday,Clear,0.58,0.5455,0.6,0.2537,134,319,453,453,78,453,4,4,3,443,2,728,309772,4,453
2012-10-14,winter,2012,October,19,Sunday,Holiday,Clear,0.56,0.5303,0.64,0.2239,68,268,336,336,78,336,4,4,3,443,2,728,226789,4,336
2012-10-14,winter,2012,October,20,Sunday,Holiday,Clear,0.54,0.5152,0.73,0.2239,48,198,246,246,78,246,4,3,3,433,0,728,164550,4,246
2012-10-14,winter,2012,October,21,Sunday,Holiday,Clear,0.56,0.5303,0.73,0.4478,40,156,196,196,78,196,4,3,3,433,0,728,125445,4,196
2012-10-14,winter,2012,October,22,Sunday,Holiday,Clear,0.56,0.5303,0.73,0.3881,38,87,125,125,78,125,4,2,3,423,0,728,95612,4,125
2012-10-14,winter,2012,October,23,Sunday,Holiday,Mist,0.56,0.5303,0.68,0.2836,27,78,105,105,78,105,4,2,3,423,0,728,63941,4,105
2012-10-15,winter,2012,October,0,Monday,Workingday,Mist,0.56,0.5303,0.73,0.2537,17,31,48,48,77,48,4,2,3,423,0,726,39130,4,48
2012-10-15,winter,2012,October,1,Monday,Workingday,Mist,0.58,0.5455,0.64,0.3881,5,24,29,29,77,29,4,1,3,413,0,724,24164,4,29
2012-10-15,winter,2012,October,2,Monday,Workingday,Mist,0.58,0.5455,0.64,0.3582,1,5,6,6,77,6,4,1,3,413,0,715,16352,4,6
2012-10-15,winter,2012,October,3,Monday,Workingday,Mist,0.56,0.5303,0.73,0.2537,2,2,4,4,77,4,4,1,3,413,0,697,8174,4,4
2012-10-15,winter,2012,October,4,Monday,Workingday,Mist,0.56,0.5303,0.68,0.2239,1,9,10,10,77,10,4,1,3,413,0,697,4428,4,10
2012-10-15,winter,2012,October,5,Monday,Workingday,Mist,0.56,0.5303,0.73,0.2836,2,38,40,40,77,40,4,1,3,413,0,717,14261,4,40
2012-10-15,winter,2012,October,6,Monday,Workingday,Mist,0.56,0.5303,0.73,0.2985,6,141,147,147,77,147,4,3,3,433,0,725,55132,4,147
2012-10-15,winter,2012,October,7,Monday,Workingday,Mist,0.58,0.5455,0.68,0.3284,15,461,476,476,77,476,4,4,3,443,2,727,154171,4,476
2012-10-15,winter,2012,October,8,Monday,Workingday,Mist,0.6,0.6061,0.64,0.3881,24,713,737,737,77,737,4,4,3,443,2,727,261001,4,737
2012-10-15,winter,2012,October,9,Monday,Workingday,Light Snow,0.6,0.5909,0.69,0.3881,31,328,359,359,77,359,4,4,3,443,2,727,159438,4,359
2012-10-15,winter,2012,October,10,Monday,Workingday,Mist,0.6,0.5909,0.73,0.3881,43,125,168,168,77,168,4,3,3,433,0,727,126257,4,168
2012-10-15,winter,2012,October,11,Monday,Workingday,Mist,0.6,0.5909,0.73,0.3881,88,175,263,263,77,263,4,3,3,433,2,727,151320,4,263
2012-10-15,winter,2012,October,12,Monday,Workingday,Light Snow,0.6,0.5758,0.78,0.3284,73,211,284,284,77,284,4,4,3,443,2,728,184414,4,284
2012-10-15,winter,2012,October,13,Monday,Workingday,Mist,0.56,0.5303,0.88,0.2239,37,109,146,146,77,146,4,3,3,433,0,729,184919,4,146
2012-10-15,winter,2012,October,14,Monday,Workingday,Mist,0.6,0.5758,0.78,0.2836,57,128,185,185,77,185,4,3,3,433,0,729,175652,4,185
2012-10-15,winter,2012,October,15,Monday,Workingday,Clear,0.6,0.5758,0.78,0.3284,70,190,260,260,77,260,4,3,3,433,0,729,183149,4,260
2012-10-15,winter,2012,October,16,Monday,Workingday,Clear,0.56,0.5303,0.64,0.2985,76,371,447,447,77,447,4,4,3,443,2,730,227748,4,447
2012-10-15,winter,2012,October,17,Monday,Workingday,Clear,0.56,0.5303,0.64,0.2537,96,670,766,766,77,766,4,4,3,443,2,730,336860,4,766
2012-10-15,winter,2012,October,18,Monday,Workingday,Light Snow,0.54,0.5152,0.77,0.1343,52,540,592,592,77,592,4,4,3,443,2,728,309772,4,592
2012-10-15,winter,2012,October,19,Monday,Workingday,Light Snow,0.52,0.5,0.83,0.0896,12,227,239,239,77,239,4,3,3,433,0,728,226789,4,239
2012-10-15,winter,2012,October,20,Monday,Workingday,Mist,0.52,0.5,0.72,0.3881,19,237,256,256,77,256,4,3,3,433,0,728,164550,4,256
2012-10-15,winter,2012,October,21,Monday,Workingday,Clear,0.52,0.5,0.59,0.3284,16,190,206,206,77,206,4,3,3,433,0,728,125445,4,206
2012-10-15,winter,2012,October,22,Monday,Workingday,Clear,0.5,0.4848,0.59,0.2836,8,118,126,126,77,126,4,2,2,422,0,728,95612,4,126
2012-10-15,winter,2012,October,23,Monday,Workingday,Clear,0.46,0.4545,0.63,0.2239,9,72,81,81,77,81,4,2,2,422,0,728,63941,4,81
2012-10-16,winter,2012,October,0,Tuesday,Workingday,Clear,0.46,0.4545,0.63,0.3881,3,45,48,48,76,48,4,2,2,422,1,726,39130,4,48
2012-10-16,winter,2012,October,1,Tuesday,Workingday,Clear,0.44,0.4394,0.67,0.194,4,9,13,13,76,13,4,1,2,412,0,724,24164,4,13
2012-10-16,winter,2012,October,2,Tuesday,Workingday,Clear,0.44,0.4394,0.67,0.1343,2,1,3,3,76,3,4,1,2,412,0,715,16352,4,3
2012-10-16,winter,2012,October,3,Tuesday,Workingday,Clear,0.42,0.4242,0.67,0.1045,0,2,2,2,76,2,4,1,2,412,0,697,8174,4,2
2012-10-16,winter,2012,October,4,Tuesday,Workingday,Clear,0.42,0.4242,0.67,0.1642,0,7,7,7,76,7,4,1,2,412,1,697,4428,4,7
2012-10-16,winter,2012,October,5,Tuesday,Workingday,Clear,0.42,0.4242,0.67,0.2537,5,47,52,52,76,52,4,2,2,422,1,717,14261,4,52
2012-10-16,winter,2012,October,6,Tuesday,Workingday,Clear,0.42,0.4242,0.67,0.1642,4,168,172,172,76,172,4,3,2,432,1,725,55132,4,172
2012-10-16,winter,2012,October,7,Tuesday,Workingday,Clear,0.42,0.4242,0.67,0.0896,20,505,525,525,76,525,4,4,2,442,0,727,154171,4,525
2012-10-16,winter,2012,October,8,Tuesday,Workingday,Clear,0.44,0.4394,0.62,0.0,35,800,835,835,76,835,4,4,2,442,2,727,261001,4,835
2012-10-16,winter,2012,October,9,Tuesday,Workingday,Clear,0.48,0.4697,0.55,0.2537,32,323,355,355,76,355,4,4,2,442,2,727,159438,4,355
2012-10-16,winter,2012,October,10,Tuesday,Workingday,Clear,0.5,0.4848,0.48,0.2836,65,157,222,222,76,222,4,3,2,432,2,727,126257,4,222
2012-10-16,winter,2012,October,11,Tuesday,Workingday,Clear,0.5,0.4848,0.45,0.4179,56,172,228,228,76,228,4,3,2,432,2,727,151320,4,228
2012-10-16,winter,2012,October,12,Tuesday,Workingday,Mist,0.52,0.5,0.45,0.3284,69,256,325,325,76,325,4,4,3,443,2,728,184414,4,325
2012-10-16,winter,2012,October,13,Tuesday,Workingday,Clear,0.52,0.5,0.45,0.2836,68,260,328,328,76,328,4,4,3,443,2,729,184919,4,328
2012-10-16,winter,2012,October,14,Tuesday,Workingday,Clear,0.54,0.5152,0.39,0.2537,94,214,308,308,76,308,4,4,3,443,2,729,175652,4,308
2012-10-16,winter,2012,October,15,Tuesday,Workingday,Clear,0.54,0.5152,0.41,0.3284,76,270,346,346,76,346,4,4,3,443,2,729,183149,4,346
2012-10-16,winter,2012,October,16,Tuesday,Workingday,Clear,0.54,0.5152,0.39,0.2836,79,367,446,446,76,446,4,4,3,443,2,730,227748,4,446
2012-10-16,winter,2012,October,17,Tuesday,Workingday,Clear,0.52,0.5,0.39,0.194,104,839,943,943,76,943,4,4,3,443,2,730,336860,4,943
2012-10-16,winter,2012,October,18,Tuesday,Workingday,Clear,0.5,0.4848,0.42,0.1642,71,767,838,838,76,838,4,4,2,442,2,728,309772,4,838
2012-10-16,winter,2012,October,19,Tuesday,Workingday,Clear,0.48,0.4697,0.48,0.0,40,491,531,531,76,531,4,4,2,442,2,728,226789,4,531
2012-10-16,winter,2012,October,20,Tuesday,Workingday,Clear,0.46,0.4545,0.55,0.0,35,397,432,432,76,432,4,4,2,442,0,728,164550,4,432
2012-10-16,winter,2012,October,21,Tuesday,Workingday,Clear,0.46,0.4545,0.63,0.0,19,176,195,195,76,195,4,3,2,432,0,728,125445,4,195
2012-10-16,winter,2012,October,22,Tuesday,Workingday,Clear,0.4,0.4091,0.71,0.0896,18,163,181,181,76,181,4,3,2,432,0,728,95612,4,181
2012-10-16,winter,2012,October,23,Tuesday,Workingday,Clear,0.4,0.4091,0.71,0.0,23,176,199,199,76,199,4,3,2,432,0,728,63941,4,199
2012-10-17,winter,2012,October,0,Wednesday,Workingday,Clear,0.38,0.3939,0.76,0.0,1,48,49,49,75,49,4,2,2,422,0,726,39130,4,49
2012-10-17,winter,2012,October,1,Wednesday,Workingday,Clear,0.38,0.3939,0.76,0.0,3,14,17,17,75,17,4,1,2,412,0,724,24164,4,17
2012-10-17,winter,2012,October,2,Wednesday,Workingday,Clear,0.38,0.3939,0.76,0.0,4,12,16,16,75,16,4,1,2,412,0,715,16352,4,16
2012-10-17,winter,2012,October,3,Wednesday,Workingday,Clear,0.36,0.3788,0.87,0.0,0,7,7,7,75,7,4,1,2,412,0,697,8174,4,7
2012-10-17,winter,2012,October,4,Wednesday,Workingday,Clear,0.36,0.3636,0.81,0.0896,0,4,4,4,75,4,4,1,2,412,0,697,4428,4,4
2012-10-17,winter,2012,October,5,Wednesday,Workingday,Mist,0.36,0.3788,0.81,0.0,2,39,41,41,75,41,4,2,2,422,0,717,14261,4,41
2012-10-17,winter,2012,October,6,Wednesday,Workingday,Clear,0.38,0.3939,0.82,0.0,7,171,178,178,75,178,4,3,2,432,0,725,55132,4,178
2012-10-17,winter,2012,October,7,Wednesday,Workingday,Clear,0.36,0.3636,0.81,0.1045,15,449,464,464,75,464,4,4,2,442,0,727,154171,4,464
2012-10-17,winter,2012,October,8,Wednesday,Workingday,Mist,0.4,0.4091,0.76,0.0,38,779,817,817,75,817,4,4,2,442,2,727,261001,4,817
2012-10-17,winter,2012,October,9,Wednesday,Workingday,Mist,0.42,0.4242,0.77,0.0,38,344,382,382,75,382,4,4,2,442,0,727,159438,4,382
2012-10-17,winter,2012,October,10,Wednesday,Workingday,Mist,0.46,0.4545,0.67,0.0,60,168,228,228,75,228,4,3,2,432,0,727,126257,4,228
2012-10-17,winter,2012,October,11,Wednesday,Workingday,Mist,0.5,0.4848,0.51,0.0896,78,156,234,234,75,234,4,3,2,432,2,727,151320,4,234
2012-10-17,winter,2012,October,12,Wednesday,Workingday,Mist,0.52,0.5,0.48,0.1642,71,261,332,332,75,332,4,4,3,443,2,728,184414,4,332
2012-10-17,winter,2012,October,13,Wednesday,Workingday,Mist,0.54,0.5152,0.49,0.1343,73,237,310,310,75,310,4,4,3,443,2,729,184919,4,310
2012-10-17,winter,2012,October,14,Wednesday,Workingday,Mist,0.56,0.5303,0.43,0.1642,82,188,270,270,75,270,4,3,3,433,2,729,175652,4,270
2012-10-17,winter,2012,October,15,Wednesday,Workingday,Mist,0.58,0.5455,0.43,0.2239,62,239,301,301,75,301,4,4,3,443,2,729,183149,4,301
2012-10-17,winter,2012,October,16,Wednesday,Workingday,Clear,0.56,0.5303,0.52,0.194,70,396,466,466,75,466,4,4,3,443,2,730,227748,4,466
2012-10-17,winter,2012,October,17,Wednesday,Workingday,Clear,0.54,0.5152,0.56,0.1045,122,766,888,888,75,888,4,4,3,443,2,730,336860,4,888
2012-10-17,winter,2012,October,18,Wednesday,Workingday,Clear,0.52,0.5,0.59,0.1642,90,794,884,884,75,884,4,4,3,443,2,728,309772,4,884
2012-10-17,winter,2012,October,19,Wednesday,Workingday,Clear,0.5,0.4848,0.72,0.194,49,467,516,516,75,516,4,4,2,442,2,728,226789,4,516
2012-10-17,winter,2012,October,20,Wednesday,Workingday,Clear,0.5,0.4848,0.72,0.1343,54,360,414,414,75,414,4,4,2,442,0,728,164550,4,414
2012-10-17,winter,2012,October,21,Wednesday,Workingday,Clear,0.46,0.4545,0.82,0.194,28,301,329,329,75,329,4,4,2,442,0,728,125445,4,329
2012-10-17,winter,2012,October,22,Wednesday,Workingday,Clear,0.46,0.4545,0.88,0.2537,17,198,215,215,75,215,4,3,2,432,0,728,95612,4,215
2012-10-17,winter,2012,October,23,Wednesday,Workingday,Clear,0.46,0.4545,0.88,0.2239,15,84,99,99,75,99,4,2,2,422,0,728,63941,4,99
2012-10-18,winter,2012,October,0,Thursday,Workingday,Clear,0.46,0.4545,0.88,0.194,4,53,57,57,74,57,4,2,2,422,0,726,39130,4,57
2012-10-18,winter,2012,October,1,Thursday,Workingday,Clear,0.46,0.4545,0.82,0.2239,0,14,14,14,74,14,4,1,2,412,0,724,24164,4,14
2012-10-18,winter,2012,October,2,Thursday,Workingday,Clear,0.46,0.4545,0.82,0.194,1,13,14,14,74,14,4,1,2,412,0,715,16352,4,14
2012-10-18,winter,2012,October,3,Thursday,Workingday,Clear,0.44,0.4394,0.88,0.2239,0,5,5,5,74,5,4,1,2,412,0,697,8174,4,5
2012-10-18,winter,2012,October,4,Thursday,Workingday,Clear,0.44,0.4394,0.88,0.2239,0,5,5,5,74,5,4,1,2,412,0,697,4428,4,5
2012-10-18,winter,2012,October,5,Thursday,Workingday,Clear,0.44,0.4394,0.82,0.2239,1,41,42,42,74,42,4,2,2,422,0,717,14261,4,42
2012-10-18,winter,2012,October,6,Thursday,Workingday,Clear,0.44,0.4394,0.88,0.2985,3,150,153,153,74,153,4,3,2,432,0,725,55132,4,153
2012-10-18,winter,2012,October,7,Thursday,Workingday,Clear,0.44,0.4394,0.88,0.2537,20,488,508,508,74,508,4,4,2,442,0,727,154171,4,508
2012-10-18,winter,2012,October,8,Thursday,Workingday,Clear,0.46,0.4545,0.82,0.2537,31,803,834,834,74,834,4,4,2,442,2,727,261001,4,834
2012-10-18,winter,2012,October,9,Thursday,Workingday,Mist,0.5,0.4848,0.77,0.1642,41,346,387,387,74,387,4,4,2,442,0,727,159438,4,387
2012-10-18,winter,2012,October,10,Thursday,Workingday,Mist,0.52,0.5,0.68,0.2239,60,158,218,218,74,218,4,3,3,433,0,727,126257,4,218
2012-10-18,winter,2012,October,11,Thursday,Workingday,Mist,0.56,0.5303,0.56,0.2239,79,189,268,268,74,268,4,3,3,433,2,727,151320,4,268
2012-10-18,winter,2012,October,12,Thursday,Workingday,Mist,0.6,0.6212,0.53,0.2537,93,284,377,377,74,377,4,4,3,443,2,728,184414,4,377
2012-10-18,winter,2012,October,13,Thursday,Workingday,Clear,0.62,0.6212,0.53,0.3582,96,236,332,332,74,332,4,4,3,443,2,729,184919,4,332
2012-10-18,winter,2012,October,14,Thursday,Workingday,Mist,0.62,0.6212,0.5,0.2985,94,191,285,285,74,285,4,4,3,443,2,729,175652,4,285
2012-10-18,winter,2012,October,15,Thursday,Workingday,Mist,0.6,0.6061,0.6,0.194,69,284,353,353,74,353,4,4,3,443,2,729,183149,4,353
2012-10-18,winter,2012,October,16,Thursday,Workingday,Clear,0.6,0.6212,0.56,0.2836,94,356,450,450,74,450,4,4,3,443,2,730,227748,4,450
2012-10-18,winter,2012,October,17,Thursday,Workingday,Mist,0.58,0.5455,0.64,0.3284,102,788,890,890,74,890,4,4,3,443,2,730,336860,4,890
2012-10-18,winter,2012,October,18,Thursday,Workingday,Mist,0.56,0.5303,0.64,0.3284,68,720,788,788,74,788,4,4,3,443,2,728,309772,4,788
2012-10-18,winter,2012,October,19,Thursday,Workingday,Mist,0.56,0.5303,0.68,0.2985,42,471,513,513,74,513,4,4,3,443,2,728,226789,4,513
2012-10-18,winter,2012,October,20,Thursday,Workingday,Mist,0.56,0.5303,0.68,0.2537,39,348,387,387,74,387,4,4,3,443,2,728,164550,4,387
2012-10-18,winter,2012,October,21,Thursday,Workingday,Mist,0.54,0.5152,0.77,0.194,38,245,283,283,74,283,4,4,3,443,0,728,125445,4,283
2012-10-18,winter,2012,October,22,Thursday,Workingday,Mist,0.54,0.5152,0.83,0.194,27,202,229,229,74,229,4,3,3,433,0,728,95612,4,229
2012-10-18,winter,2012,October,23,Thursday,Workingday,Mist,0.54,0.5152,0.83,0.0,6,111,117,117,74,117,4,2,3,423,0,728,63941,4,117
2012-10-19,winter,2012,October,0,Friday,Workingday,Mist,0.56,0.5303,0.83,0.1045,5,51,56,56,73,56,4,2,3,423,0,726,39130,4,56
2012-10-19,winter,2012,October,1,Friday,Workingday,Light Snow,0.54,0.5152,0.88,0.0,4,12,16,16,73,16,4,1,3,413,0,724,24164,4,16
2012-10-19,winter,2012,October,2,Friday,Workingday,Mist,0.54,0.5152,0.88,0.0,1,9,10,10,73,10,4,1,3,413,0,715,16352,4,10
2012-10-19,winter,2012,October,3,Friday,Workingday,Mist,0.56,0.5303,0.83,0.0,0,5,5,5,73,5,4,1,3,413,0,697,8174,4,5
2012-10-19,winter,2012,October,4,Friday,Workingday,Mist,0.56,0.5303,0.83,0.0,1,5,6,6,73,6,4,1,3,413,0,697,4428,4,6
2012-10-19,winter,2012,October,5,Friday,Workingday,Mist,0.54,0.5152,0.88,0.0,1,35,36,36,73,36,4,1,3,413,0,717,14261,4,36
2012-10-19,winter,2012,October,6,Friday,Workingday,Light Snow,0.54,0.5152,0.94,0.1642,5,126,131,131,73,131,4,2,3,423,0,725,55132,4,131
2012-10-19,winter,2012,October,7,Friday,Workingday,Light Snow,0.54,0.5152,0.94,0.0,5,149,154,154,73,154,4,3,3,433,0,727,154171,4,154
2012-10-19,winter,2012,October,8,Friday,Workingday,Mist,0.54,0.5152,0.94,0.1045,20,447,467,467,73,467,4,4,3,443,0,727,261001,4,467
2012-10-19,winter,2012,October,9,Friday,Workingday,Mist,0.54,0.5152,0.94,0.1045,26,363,389,389,73,389,4,4,3,443,0,727,159438,4,389
2012-10-19,winter,2012,October,10,Friday,Workingday,Mist,0.58,0.5455,0.88,0.194,26,198,224,224,73,224,4,3,3,433,0,727,126257,4,224
2012-10-19,winter,2012,October,11,Friday,Workingday,Clear,0.6,0.5606,0.83,0.194,41,211,252,252,73,252,4,3,3,433,0,727,151320,4,252
2012-10-19,winter,2012,October,12,Friday,Workingday,Clear,0.64,0.6061,0.69,0.2239,74,258,332,332,73,332,4,4,3,443,2,728,184414,4,332
2012-10-19,winter,2012,October,13,Friday,Workingday,Clear,0.62,0.5909,0.73,0.2239,87,288,375,375,73,375,4,4,3,443,2,729,184919,4,375
2012-10-19,winter,2012,October,14,Friday,Workingday,Clear,0.66,0.6212,0.61,0.2537,88,277,365,365,73,365,4,4,3,443,2,729,175652,4,365
2012-10-19,winter,2012,October,15,Friday,Workingday,Clear,0.64,0.6061,0.65,0.2985,93,302,395,395,73,395,4,4,3,443,2,729,183149,4,395
2012-10-19,winter,2012,October,16,Friday,Workingday,Light Snow,0.62,0.6061,0.69,0.3582,131,434,565,565,73,565,4,4,3,443,2,730,227748,4,565
2012-10-19,winter,2012,October,17,Friday,Workingday,Light Snow,0.62,0.6061,0.69,0.3582,48,377,425,425,73,425,4,4,3,443,2,730,336860,4,425
2012-10-19,winter,2012,October,18,Friday,Workingday,Clear,0.56,0.5303,0.83,0.1045,21,212,233,233,73,233,4,3,3,433,0,728,309772,4,233
2012-10-19,winter,2012,October,19,Friday,Workingday,Clear,0.54,0.5152,0.88,0.1642,19,213,232,232,73,232,4,3,3,433,0,728,226789,4,232
2012-10-19,winter,2012,October,20,Friday,Workingday,Clear,0.52,0.5,0.77,0.194,13,216,229,229,73,229,4,3,3,433,0,728,164550,4,229
2012-10-19,winter,2012,October,21,Friday,Workingday,Clear,0.5,0.4848,0.77,0.0,17,189,206,206,73,206,4,3,2,432,0,728,125445,4,206
2012-10-19,winter,2012,October,22,Friday,Workingday,Clear,0.5,0.4848,0.77,0.0896,14,176,190,190,73,190,4,3,2,432,0,728,95612,4,190
2012-10-19,winter,2012,October,23,Friday,Workingday,Clear,0.46,0.4545,0.88,0.1045,13,118,131,131,73,131,4,2,2,422,0,728,63941,4,131
2012-10-20,winter,2012,October,0,Saturday,Holiday,Clear,0.46,0.4545,0.82,0.1343,13,110,123,123,72,123,4,2,2,422,0,726,39130,4,123
2012-10-20,winter,2012,October,1,Saturday,Holiday,Clear,0.46,0.4545,0.72,0.1343,2,93,95,95,72,95,4,2,2,422,0,724,24164,4,95
2012-10-20,winter,2012,October,2,Saturday,Holiday,Clear,0.44,0.4394,0.77,0.1045,9,69,78,78,72,78,4,2,2,422,0,715,16352,4,78
2012-10-20,winter,2012,October,3,Saturday,Holiday,Clear,0.42,0.4242,0.77,0.1343,2,27,29,29,72,29,4,1,2,412,0,697,8174,4,29
2012-10-20,winter,2012,October,4,Saturday,Holiday,Clear,0.44,0.4394,0.72,0.0,9,9,18,18,72,18,4,1,2,412,0,697,4428,4,18
2012-10-20,winter,2012,October,5,Saturday,Holiday,Clear,0.4,0.4091,0.82,0.0,6,7,13,13,72,13,4,1,2,412,0,717,14261,4,13
2012-10-20,winter,2012,October,6,Saturday,Holiday,Clear,0.42,0.4242,0.71,0.0,5,26,31,31,72,31,4,1,2,412,0,725,55132,4,31
2012-10-20,winter,2012,October,7,Saturday,Holiday,Clear,0.4,0.4091,0.82,0.0,6,59,65,65,72,65,4,2,2,422,0,727,154171,4,65
2012-10-20,winter,2012,October,8,Saturday,Holiday,Clear,0.46,0.4545,0.67,0.1343,29,164,193,193,72,193,4,3,2,432,0,727,261001,4,193
2012-10-20,winter,2012,October,9,Saturday,Holiday,Clear,0.5,0.4848,0.59,0.1343,106,257,363,363,72,363,4,4,2,442,2,727,159438,4,363
2012-10-20,winter,2012,October,10,Saturday,Holiday,Clear,0.52,0.5,0.52,0.1343,111,312,423,423,72,423,4,4,3,443,2,727,126257,4,423
2012-10-20,winter,2012,October,11,Saturday,Holiday,Clear,0.54,0.5152,0.52,0.2239,204,408,612,612,72,612,4,4,3,443,2,727,151320,4,612
2012-10-20,winter,2012,October,12,Saturday,Holiday,Clear,0.56,0.5303,0.46,0.1045,267,436,703,703,72,703,4,4,3,443,2,728,184414,4,703
2012-10-20,winter,2012,October,13,Saturday,Holiday,Clear,0.56,0.5303,0.43,0.1642,273,441,714,714,72,714,4,4,3,443,2,729,184919,4,714
2012-10-20,winter,2012,October,14,Saturday,Holiday,Clear,0.56,0.5303,0.4,0.0,335,376,711,711,72,711,4,4,3,443,2,729,175652,4,711
2012-10-20,winter,2012,October,15,Saturday,Holiday,Clear,0.56,0.5303,0.43,0.0,308,403,711,711,72,711,4,4,3,443,2,729,183149,4,711
2012-10-20,winter,2012,October,16,Saturday,Holiday,Clear,0.54,0.5152,0.42,0.2836,325,366,691,691,72,691,4,4,3,443,2,730,227748,4,691
2012-10-20,winter,2012,October,17,Saturday,Holiday,Clear,0.54,0.5152,0.37,0.2239,347,384,731,731,72,731,4,4,3,443,2,730,336860,4,731
2012-10-20,winter,2012,October,18,Saturday,Holiday,Clear,0.52,0.5,0.39,0.2239,165,356,521,521,72,521,4,4,3,443,2,728,309772,4,521
2012-10-20,winter,2012,October,19,Saturday,Holiday,Clear,0.5,0.4848,0.45,0.1343,77,268,345,345,72,345,4,4,2,442,2,728,226789,4,345
2012-10-20,winter,2012,October,20,Saturday,Holiday,Clear,0.5,0.4848,0.39,0.2239,61,198,259,259,72,259,4,3,2,432,2,728,164550,4,259
2012-10-20,winter,2012,October,21,Saturday,Holiday,Clear,0.46,0.4545,0.47,0.2239,72,224,296,296,72,296,4,4,2,442,2,728,125445,4,296
2012-10-20,winter,2012,October,22,Saturday,Holiday,Clear,0.44,0.4394,0.51,0.1045,47,155,202,202,72,202,4,3,2,432,1,728,95612,4,202
2012-10-20,winter,2012,October,23,Saturday,Holiday,Clear,0.42,0.4242,0.58,0.0,27,136,163,163,72,163,4,3,2,432,0,728,63941,4,163
2012-10-21,winter,2012,October,0,Sunday,Holiday,Clear,0.44,0.4394,0.54,0.1642,35,119,154,154,71,154,4,3,2,432,1,726,39130,4,154
2012-10-21,winter,2012,October,1,Sunday,Holiday,Clear,0.42,0.4242,0.58,0.2239,20,97,117,117,71,117,4,2,2,422,1,724,24164,4,117
2012-10-21,winter,2012,October,2,Sunday,Holiday,Clear,0.4,0.4091,0.62,0.1642,44,88,132,132,71,132,4,2,2,422,1,715,16352,4,132
2012-10-21,winter,2012,October,3,Sunday,Holiday,Clear,0.38,0.3939,0.66,0.0896,12,29,41,41,71,41,4,2,2,422,1,697,8174,4,41
2012-10-21,winter,2012,October,4,Sunday,Holiday,Clear,0.36,0.3485,0.71,0.1642,8,13,21,21,71,21,4,1,2,412,1,697,4428,4,21
2012-10-21,winter,2012,October,5,Sunday,Holiday,Clear,0.38,0.3939,0.66,0.0896,6,4,10,10,71,10,4,1,2,412,1,717,14261,4,10
2012-10-21,winter,2012,October,6,Sunday,Holiday,Clear,0.4,0.4091,0.62,0.0,8,18,26,26,71,26,4,1,2,412,0,725,55132,4,26
2012-10-21,winter,2012,October,7,Sunday,Holiday,Clear,0.4,0.4091,0.62,0.0,13,43,56,56,71,56,4,2,2,422,0,727,154171,4,56
2012-10-21,winter,2012,October,8,Sunday,Holiday,Clear,0.42,0.4242,0.67,0.0,39,104,143,143,71,143,4,3,2,432,0,727,261001,4,143
2012-10-21,winter,2012,October,9,Sunday,Holiday,Clear,0.46,0.4545,0.55,0.1642,77,192,269,269,71,269,4,3,2,432,2,727,159438,4,269
2012-10-21,winter,2012,October,10,Sunday,Holiday,Clear,0.5,0.4848,0.48,0.2985,167,276,443,443,71,443,4,4,2,442,2,727,126257,4,443
2012-10-21,winter,2012,October,11,Sunday,Holiday,Clear,0.52,0.5,0.44,0.3284,191,356,547,547,71,547,4,4,3,443,2,727,151320,4,547
2012-10-21,winter,2012,October,12,Sunday,Holiday,Clear,0.54,0.5152,0.39,0.3284,236,439,675,675,71,675,4,4,3,443,2,728,184414,4,675
2012-10-21,winter,2012,October,13,Sunday,Holiday,Clear,0.56,0.5303,0.37,0.2537,243,383,626,626,71,626,4,4,3,443,2,729,184919,4,626
2012-10-21,winter,2012,October,14,Sunday,Holiday,Clear,0.56,0.5303,0.35,0.194,235,405,640,640,71,640,4,4,3,443,2,729,175652,4,640
2012-10-21,winter,2012,October,15,Sunday,Holiday,Clear,0.56,0.5303,0.35,0.3284,240,383,623,623,71,623,4,4,3,443,2,729,183149,4,623
2012-10-21,winter,2012,October,16,Sunday,Holiday,Clear,0.54,0.5152,0.37,0.2239,182,409,591,591,71,591,4,4,3,443,2,730,227748,4,591
2012-10-21,winter,2012,October,17,Sunday,Holiday,Clear,0.52,0.5,0.39,0.2537,153,338,491,491,71,491,4,4,3,443,2,730,336860,4,491
2012-10-21,winter,2012,October,18,Sunday,Holiday,Clear,0.52,0.5,0.39,0.194,71,342,413,413,71,413,4,4,3,443,2,728,309772,4,413
2012-10-21,winter,2012,October,19,Sunday,Holiday,Clear,0.5,0.4848,0.42,0.1642,50,216,266,266,71,266,4,3,2,432,2,728,226789,4,266
2012-10-21,winter,2012,October,20,Sunday,Holiday,Clear,0.48,0.4697,0.44,0.194,35,160,195,195,71,195,4,3,2,432,1,728,164550,4,195
2012-10-21,winter,2012,October,21,Sunday,Holiday,Clear,0.42,0.4242,0.54,0.1642,42,124,166,166,71,166,4,3,2,432,1,728,125445,4,166
2012-10-21,winter,2012,October,22,Sunday,Holiday,Clear,0.42,0.4242,0.54,0.0,18,95,113,113,71,113,4,2,2,422,0,728,95612,4,113
2012-10-21,winter,2012,October,23,Sunday,Holiday,Clear,0.44,0.4394,0.54,0.0,7,59,66,66,71,66,4,2,2,422,0,728,63941,4,66
2012-10-22,winter,2012,October,0,Monday,Workingday,Clear,0.4,0.4091,0.62,0.0,3,28,31,31,70,31,4,1,2,412,0,726,39130,4,31
2012-10-22,winter,2012,October,1,Monday,Workingday,Clear,0.4,0.4091,0.71,0.0,0,11,11,11,70,11,4,1,2,412,0,724,24164,4,11
2012-10-22,winter,2012,October,2,Monday,Workingday,Clear,0.38,0.3939,0.71,0.0,1,4,5,5,70,5,4,1,2,412,0,715,16352,4,5
2012-10-22,winter,2012,October,3,Monday,Workingday,Clear,0.4,0.4091,0.62,0.0,1,5,6,6,70,6,4,1,2,412,0,697,8174,4,6
2012-10-22,winter,2012,October,4,Monday,Workingday,Clear,0.38,0.3939,0.66,0.0,1,6,7,7,70,7,4,1,2,412,0,697,4428,4,7
2012-10-22,winter,2012,October,5,Monday,Workingday,Clear,0.38,0.3939,0.76,0.0896,2,44,46,46,70,46,4,2,2,422,0,717,14261,4,46
2012-10-22,winter,2012,October,6,Monday,Workingday,Clear,0.36,0.3636,0.76,0.0896,4,140,144,144,70,144,4,3,2,432,1,725,55132,4,144
2012-10-22,winter,2012,October,7,Monday,Workingday,Clear,0.38,0.3939,0.66,0.0896,15,437,452,452,70,452,4,4,2,442,1,727,154171,4,452
2012-10-22,winter,2012,October,8,Monday,Workingday,Clear,0.44,0.4394,0.67,0.0,32,696,728,728,70,728,4,4,2,442,2,727,261001,4,728
2012-10-22,winter,2012,October,9,Monday,Workingday,Clear,0.46,0.4545,0.63,0.0896,25,335,360,360,70,360,4,4,2,442,0,727,159438,4,360
2012-10-22,winter,2012,October,10,Monday,Workingday,Clear,0.5,0.4848,0.55,0.0,51,161,212,212,70,212,4,3,2,432,0,727,126257,4,212
2012-10-22,winter,2012,October,11,Monday,Workingday,Clear,0.56,0.5303,0.37,0.1642,63,148,211,211,70,211,4,3,3,433,2,727,151320,4,211
2012-10-22,winter,2012,October,12,Monday,Workingday,Clear,0.58,0.5455,0.35,0.0,52,231,283,283,70,283,4,4,3,443,2,728,184414,4,283
2012-10-22,winter,2012,October,13,Monday,Workingday,Clear,0.62,0.6212,0.29,0.1642,88,227,315,315,70,315,4,4,3,443,2,729,184919,4,315
2012-10-22,winter,2012,October,14,Monday,Workingday,Clear,0.62,0.6061,0.27,0.194,73,209,282,282,70,282,4,4,3,443,2,729,175652,4,282
2012-10-22,winter,2012,October,15,Monday,Workingday,Clear,0.64,0.6212,0.29,0.1642,74,222,296,296,70,296,4,4,3,443,2,729,183149,4,296
2012-10-22,winter,2012,October,16,Monday,Workingday,Clear,0.62,0.6212,0.33,0.1642,80,444,524,524,70,524,4,4,3,443,2,730,227748,4,524
2012-10-22,winter,2012,October,17,Monday,Workingday,Clear,0.62,0.6212,0.33,0.1045,84,838,922,922,70,922,4,4,3,443,2,730,336860,4,922
2012-10-22,winter,2012,October,18,Monday,Workingday,Clear,0.54,0.5152,0.64,0.1045,60,726,786,786,70,786,4,4,3,443,2,728,309772,4,786
2012-10-22,winter,2012,October,19,Monday,Workingday,Clear,0.52,0.5,0.52,0.1045,36,478,514,514,70,514,4,4,3,443,2,728,226789,4,514
2012-10-22,winter,2012,October,20,Monday,Workingday,Clear,0.5,0.4848,0.59,0.1045,21,382,403,403,70,403,4,4,2,442,0,728,164550,4,403
2012-10-22,winter,2012,October,21,Monday,Workingday,Clear,0.48,0.4697,0.67,0.0896,19,155,174,174,70,174,4,3,2,432,0,728,125445,4,174
2012-10-22,winter,2012,October,22,Monday,Workingday,Clear,0.46,0.4545,0.82,0.1343,25,158,183,183,70,183,4,3,2,432,0,728,95612,4,183
2012-10-22,winter,2012,October,23,Monday,Workingday,Clear,0.46,0.4545,0.82,0.1045,20,143,163,163,70,163,4,3,2,432,0,728,63941,4,163
2012-10-23,winter,2012,October,0,Tuesday,Workingday,Clear,0.46,0.4545,0.88,0.1642,5,32,37,37,69,37,4,1,2,412,0,726,39130,4,37
2012-10-23,winter,2012,October,1,Tuesday,Workingday,Clear,0.46,0.4545,0.77,0.1642,1,16,17,17,69,17,4,1,2,412,0,724,24164,4,17
2012-10-23,winter,2012,October,2,Tuesday,Workingday,Clear,0.44,0.4394,0.88,0.1343,1,6,7,7,69,7,4,1,2,412,0,715,16352,4,7
2012-10-23,winter,2012,October,3,Tuesday,Workingday,Clear,0.44,0.4394,0.77,0.1343,0,1,1,1,69,1,4,1,2,412,0,697,8174,4,1
2012-10-23,winter,2012,October,4,Tuesday,Workingday,Clear,0.42,0.4242,0.77,0.1045,1,6,7,7,69,7,4,1,2,412,0,697,4428,4,7
2012-10-23,winter,2012,October,5,Tuesday,Workingday,Clear,0.44,0.4394,0.77,0.0896,1,49,50,50,69,50,4,2,2,422,0,717,14261,4,50
2012-10-23,winter,2012,October,6,Tuesday,Workingday,Clear,0.4,0.4091,0.82,0.0896,6,152,158,158,69,158,4,3,2,432,0,725,55132,4,158
2012-10-23,winter,2012,October,7,Tuesday,Workingday,Mist,0.44,0.4394,0.77,0.1045,12,519,531,531,69,531,4,4,2,442,0,727,154171,4,531
2012-10-23,winter,2012,October,8,Tuesday,Workingday,Mist,0.46,0.4545,0.72,0.0896,28,733,761,761,69,761,4,4,2,442,2,727,261001,4,761
2012-10-23,winter,2012,October,9,Tuesday,Workingday,Mist,0.5,0.4848,0.72,0.1045,29,305,334,334,69,334,4,4,2,442,0,727,159438,4,334
2012-10-23,winter,2012,October,10,Tuesday,Workingday,Clear,0.54,0.5152,0.6,0.0,50,171,221,221,69,221,4,3,3,433,0,727,126257,4,221
2012-10-23,winter,2012,October,11,Tuesday,Workingday,Clear,0.6,0.6212,0.53,0.0,52,201,253,253,69,253,4,3,3,433,0,727,151320,4,253
2012-10-23,winter,2012,October,12,Tuesday,Workingday,Mist,0.62,0.6212,0.46,0.0896,80,298,378,378,69,378,4,4,3,443,2,728,184414,4,378
2012-10-23,winter,2012,October,13,Tuesday,Workingday,Mist,0.64,0.6212,0.44,0.0,59,244,303,303,69,303,4,4,3,443,2,729,184919,4,303
2012-10-23,winter,2012,October,14,Tuesday,Workingday,Clear,0.68,0.6364,0.41,0.1642,67,229,296,296,69,296,4,4,4,444,2,729,175652,4,296
2012-10-23,winter,2012,October,15,Tuesday,Workingday,Clear,0.68,0.6364,0.41,0.2239,76,270,346,346,69,346,4,4,4,444,2,729,183149,4,346
2012-10-23,winter,2012,October,16,Tuesday,Workingday,Clear,0.68,0.6364,0.44,0.0896,108,433,541,541,69,541,4,4,4,444,2,730,227748,4,541
2012-10-23,winter,2012,October,17,Tuesday,Workingday,Clear,0.68,0.6364,0.41,0.0,67,871,938,938,69,938,4,4,4,444,2,730,336860,4,938
2012-10-23,winter,2012,October,18,Tuesday,Workingday,Clear,0.62,0.6212,0.53,0.0896,64,762,826,826,69,826,4,4,3,443,2,728,309772,4,826
2012-10-23,winter,2012,October,19,Tuesday,Workingday,Clear,0.62,0.6212,0.57,0.0896,25,457,482,482,69,482,4,4,3,443,2,728,226789,4,482
2012-10-23,winter,2012,October,20,Tuesday,Workingday,Clear,0.58,0.5455,0.64,0.1343,45,334,379,379,69,379,4,4,3,443,2,728,164550,4,379
2012-10-23,winter,2012,October,21,Tuesday,Workingday,Clear,0.56,0.5303,0.68,0.0,35,260,295,295,69,295,4,4,3,443,0,728,125445,4,295
2012-10-23,winter,2012,October,22,Tuesday,Workingday,Clear,0.56,0.5303,0.68,0.1045,20,174,194,194,69,194,4,3,3,433,0,728,95612,4,194
2012-10-23,winter,2012,October,23,Tuesday,Workingday,Clear,0.54,0.5152,0.73,0.1045,9,102,111,111,69,111,4,2,3,423,0,728,63941,4,111
2012-10-24,winter,2012,October,0,Wednesday,Workingday,Clear,0.54,0.5152,0.73,0.0896,7,39,46,46,68,46,4,2,3,423,0,726,39130,4,46
2012-10-24,winter,2012,October,1,Wednesday,Workingday,Clear,0.54,0.5152,0.68,0.0,4,23,27,27,68,27,4,1,3,413,0,724,24164,4,27
2012-10-24,winter,2012,October,2,Wednesday,Workingday,Clear,0.54,0.5152,0.68,0.0,0,6,6,6,68,6,4,1,3,413,0,715,16352,4,6
2012-10-24,winter,2012,October,3,Wednesday,Workingday,Clear,0.5,0.4848,0.77,0.0896,0,4,4,4,68,4,4,1,2,412,0,697,8174,4,4
2012-10-24,winter,2012,October,4,Wednesday,Workingday,Clear,0.5,0.4848,0.77,0.0896,1,5,6,6,68,6,4,1,2,412,0,697,4428,4,6
2012-10-24,winter,2012,October,5,Wednesday,Workingday,Clear,0.5,0.4848,0.82,0.0,1,52,53,53,68,53,4,2,2,422,0,717,14261,4,53
2012-10-24,winter,2012,October,6,Wednesday,Workingday,Clear,0.48,0.4697,0.82,0.1045,11,162,173,173,68,173,4,3,2,432,0,725,55132,4,173
2012-10-24,winter,2012,October,7,Wednesday,Workingday,Clear,0.5,0.4848,0.88,0.0896,20,506,526,526,68,526,4,4,2,442,0,727,154171,4,526
2012-10-24,winter,2012,October,8,Wednesday,Workingday,Mist,0.52,0.5,0.83,0.1045,24,777,801,801,68,801,4,4,3,443,2,727,261001,4,801
2012-10-24,winter,2012,October,9,Wednesday,Workingday,Mist,0.52,0.5,0.77,0.0896,24,349,373,373,68,373,4,4,3,443,0,727,159438,4,373
2012-10-24,winter,2012,October,10,Wednesday,Workingday,Mist,0.54,0.5152,0.73,0.0,29,142,171,171,68,171,4,3,3,433,0,727,126257,4,171
2012-10-24,winter,2012,October,11,Wednesday,Workingday,Clear,0.58,0.5455,0.64,0.0,47,189,236,236,68,236,4,3,3,433,0,727,151320,4,236
2012-10-24,winter,2012,October,12,Wednesday,Workingday,Clear,0.62,0.6061,0.61,0.0896,48,268,316,316,68,316,4,4,3,443,2,728,184414,4,316
2012-10-24,winter,2012,October,13,Wednesday,Workingday,Clear,0.66,0.6212,0.54,0.0,65,241,306,306,68,306,4,4,3,443,2,729,184919,4,306
2012-10-24,winter,2012,October,14,Wednesday,Workingday,Clear,0.74,0.6515,0.3,0.2537,64,237,301,301,68,301,4,4,4,444,2,729,175652,4,301
2012-10-24,winter,2012,October,15,Wednesday,Workingday,Clear,0.7,0.6364,0.39,0.1045,63,245,308,308,68,308,4,4,4,444,2,729,183149,4,308
2012-10-24,winter,2012,October,16,Wednesday,Workingday,Clear,0.74,0.6515,0.33,0.1343,67,465,532,532,68,532,4,4,4,444,2,730,227748,4,532
2012-10-24,winter,2012,October,17,Wednesday,Workingday,Clear,0.66,0.6212,0.47,0.0,87,876,963,963,68,963,4,4,3,443,2,730,336860,4,963
2012-10-24,winter,2012,October,18,Wednesday,Workingday,Clear,0.66,0.6212,0.44,0.0,63,795,858,858,68,858,4,4,3,443,2,728,309772,4,858
2012-10-24,winter,2012,October,19,Wednesday,Workingday,Mist,0.64,0.6212,0.53,0.0896,50,522,572,572,68,572,4,4,3,443,2,728,226789,4,572
2012-10-24,winter,2012,October,20,Wednesday,Workingday,Mist,0.62,0.6061,0.61,0.0896,45,396,441,441,68,441,4,4,3,443,2,728,164550,4,441
2012-10-24,winter,2012,October,21,Wednesday,Workingday,Mist,0.62,0.6061,0.61,0.1045,33,280,313,313,68,313,4,4,3,443,0,728,125445,4,313
2012-10-24,winter,2012,October,22,Wednesday,Workingday,Mist,0.6,0.6061,0.64,0.1343,30,208,238,238,68,238,4,3,3,433,0,728,95612,4,238
2012-10-24,winter,2012,October,23,Wednesday,Workingday,Mist,0.58,0.5455,0.68,0.0896,12,111,123,123,68,123,4,2,3,423,0,728,63941,4,123
2012-10-25,winter,2012,October,0,Thursday,Workingday,Mist,0.6,0.6061,0.64,0.1045,19,57,76,76,67,76,4,2,3,423,0,726,39130,4,76
2012-10-25,winter,2012,October,1,Thursday,Workingday,Clear,0.58,0.5455,0.68,0.0,6,22,28,28,67,28,4,1,3,413,0,724,24164,4,28
2012-10-25,winter,2012,October,2,Thursday,Workingday,Clear,0.54,0.5152,0.77,0.0,3,15,18,18,67,18,4,1,3,413,0,715,16352,4,18
2012-10-25,winter,2012,October,3,Thursday,Workingday,Mist,0.52,0.5,0.88,0.1343,0,8,8,8,67,8,4,1,3,413,0,697,8174,4,8
2012-10-25,winter,2012,October,4,Thursday,Workingday,Mist,0.52,0.5,0.88,0.1045,1,4,5,5,67,5,4,1,3,413,0,697,4428,4,5
2012-10-25,winter,2012,October,5,Thursday,Workingday,Mist,0.52,0.5,0.88,0.1642,2,53,55,55,67,55,4,2,3,423,0,717,14261,4,55
2012-10-25,winter,2012,October,6,Thursday,Workingday,Mist,0.52,0.5,0.88,0.194,3,168,171,171,67,171,4,3,3,433,0,725,55132,4,171
2012-10-25,winter,2012,October,7,Thursday,Workingday,Mist,0.52,0.5,0.88,0.194,18,477,495,495,67,495,4,4,3,443,0,727,154171,4,495
2012-10-25,winter,2012,October,8,Thursday,Workingday,Mist,0.52,0.5,0.83,0.1642,33,746,779,779,67,779,4,4,3,443,2,727,261001,4,779
2012-10-25,winter,2012,October,9,Thursday,Workingday,Mist,0.52,0.5,0.83,0.194,23,320,343,343,67,343,4,4,3,443,0,727,159438,4,343
2012-10-25,winter,2012,October,10,Thursday,Workingday,Mist,0.54,0.5152,0.83,0.1343,53,172,225,225,67,225,4,3,3,433,0,727,126257,4,225
2012-10-25,winter,2012,October,11,Thursday,Workingday,Mist,0.54,0.5152,0.83,0.1045,57,181,238,238,67,238,4,3,3,433,0,727,151320,4,238
2012-10-25,winter,2012,October,12,Thursday,Workingday,Mist,0.56,0.5303,0.78,0.1045,61,258,319,319,67,319,4,4,3,443,0,728,184414,4,319
2012-10-25,winter,2012,October,13,Thursday,Workingday,Mist,0.56,0.5303,0.78,0.0,49,264,313,313,67,313,4,4,3,443,0,729,184919,4,313
2012-10-25,winter,2012,October,14,Thursday,Workingday,Clear,0.6,0.5909,0.73,0.1343,71,214,285,285,67,285,4,4,3,443,0,729,175652,4,285
2012-10-25,winter,2012,October,15,Thursday,Workingday,Clear,0.62,0.6061,0.65,0.1343,63,242,305,305,67,305,4,4,3,443,2,729,183149,4,305
2012-10-25,winter,2012,October,16,Thursday,Workingday,Clear,0.6,0.5909,0.69,0.1642,92,407,499,499,67,499,4,4,3,443,2,730,227748,4,499
2012-10-25,winter,2012,October,17,Thursday,Workingday,Clear,0.6,0.5909,0.69,0.1642,112,774,886,886,67,886,4,4,3,443,2,730,336860,4,886
2012-10-25,winter,2012,October,18,Thursday,Workingday,Clear,0.56,0.5303,0.83,0.1045,77,732,809,809,67,809,4,4,3,443,2,728,309772,4,809
2012-10-25,winter,2012,October,19,Thursday,Workingday,Clear,0.54,0.5152,0.83,0.194,45,497,542,542,67,542,4,4,3,443,2,728,226789,4,542
2012-10-25,winter,2012,October,20,Thursday,Workingday,Mist,0.52,0.5,0.88,0.1343,28,319,347,347,67,347,4,4,3,443,0,728,164550,4,347
2012-10-25,winter,2012,October,21,Thursday,Workingday,Mist,0.52,0.5,0.88,0.1343,24,247,271,271,67,271,4,3,3,433,0,728,125445,4,271
2012-10-25,winter,2012,October,22,Thursday,Workingday,Mist,0.54,0.5152,0.83,0.0896,22,185,207,207,67,207,4,3,3,433,0,728,95612,4,207
2012-10-25,winter,2012,October,23,Thursday,Workingday,Mist,0.54,0.5152,0.83,0.1343,13,122,135,135,67,135,4,2,3,423,0,728,63941,4,135
2012-10-26,winter,2012,October,0,Friday,Workingday,Mist,0.54,0.5152,0.77,0.0,6,65,71,71,66,71,4,2,3,423,0,726,39130,4,71
2012-10-26,winter,2012,October,1,Friday,Workingday,Mist,0.52,0.5,0.88,0.0896,4,32,36,36,66,36,4,1,3,413,0,724,24164,4,36
2012-10-26,winter,2012,October,2,Friday,Workingday,Mist,0.52,0.5,0.88,0.1045,4,15,19,19,66,19,4,1,3,413,0,715,16352,4,19
2012-10-26,winter,2012,October,3,Friday,Workingday,Mist,0.52,0.5,0.88,0.1642,5,8,13,13,66,13,4,1,3,413,0,697,8174,4,13
2012-10-26,winter,2012,October,4,Friday,Workingday,Mist,0.52,0.5,0.88,0.1642,1,4,5,5,66,5,4,1,3,413,0,697,4428,4,5
2012-10-26,winter,2012,October,5,Friday,Workingday,Mist,0.52,0.5,0.88,0.1045,3,47,50,50,66,50,4,2,3,423,0,717,14261,4,50
2012-10-26,winter,2012,October,6,Friday,Workingday,Mist,0.52,0.5,0.88,0.0896,2,142,144,144,66,144,4,3,3,433,0,725,55132,4,144
2012-10-26,winter,2012,October,7,Friday,Workingday,Mist,0.52,0.5,0.88,0.1045,13,408,421,421,66,421,4,4,3,443,0,727,154171,4,421
2012-10-26,winter,2012,October,8,Friday,Workingday,Mist,0.54,0.5152,0.88,0.1343,20,714,734,734,66,734,4,4,3,443,2,727,261001,4,734
2012-10-26,winter,2012,October,9,Friday,Workingday,Mist,0.54,0.5152,0.88,0.1343,56,347,403,403,66,403,4,4,3,443,0,727,159438,4,403
2012-10-26,winter,2012,October,10,Friday,Workingday,Mist,0.54,0.5152,0.88,0.1045,41,156,197,197,66,197,4,3,3,433,0,727,126257,4,197
2012-10-26,winter,2012,October,11,Friday,Workingday,Mist,0.56,0.5303,0.78,0.1642,68,222,290,290,66,290,4,4,3,443,0,727,151320,4,290
2012-10-26,winter,2012,October,12,Friday,Workingday,Mist,0.58,0.5455,0.73,0.194,90,302,392,392,66,392,4,4,3,443,2,728,184414,4,392
2012-10-26,winter,2012,October,13,Friday,Workingday,Mist,0.58,0.5455,0.68,0.1343,77,260,337,337,66,337,4,4,3,443,2,729,184919,4,337
2012-10-26,winter,2012,October,14,Friday,Workingday,Mist,0.6,0.6061,0.64,0.1343,99,252,351,351,66,351,4,4,3,443,2,729,175652,4,351
2012-10-26,winter,2012,October,15,Friday,Workingday,Mist,0.62,0.6061,0.61,0.1045,142,306,448,448,66,448,4,4,3,443,2,729,183149,4,448
2012-10-26,winter,2012,October,16,Friday,Workingday,Mist,0.58,0.5455,0.73,0.1642,137,445,582,582,66,582,4,4,3,443,2,730,227748,4,582
2012-10-26,winter,2012,October,17,Friday,Workingday,Mist,0.56,0.5303,0.76,0.194,125,692,817,817,66,817,4,4,3,443,2,730,336860,4,817
2012-10-26,winter,2012,October,18,Friday,Workingday,Mist,0.56,0.5303,0.78,0.1343,81,584,665,665,66,665,4,4,3,443,2,728,309772,4,665
2012-10-26,winter,2012,October,19,Friday,Workingday,Mist,0.54,0.5152,0.83,0.1642,72,399,471,471,66,471,4,4,3,443,2,728,226789,4,471
2012-10-26,winter,2012,October,20,Friday,Workingday,Mist,0.54,0.5152,0.83,0.1642,40,271,311,311,66,311,4,4,3,443,0,728,164550,4,311
2012-10-26,winter,2012,October,21,Friday,Workingday,Mist,0.54,0.5152,0.77,0.1343,40,252,292,292,66,292,4,4,3,443,0,728,125445,4,292
2012-10-26,winter,2012,October,22,Friday,Workingday,Mist,0.52,0.5,0.83,0.1343,37,180,217,217,66,217,4,3,3,433,0,728,95612,4,217
2012-10-26,winter,2012,October,23,Friday,Workingday,Clear,0.52,0.5,0.83,0.1642,19,159,178,178,66,178,4,3,3,433,0,728,63941,4,178
2012-10-27,winter,2012,October,0,Saturday,Holiday,Clear,0.5,0.4848,0.88,0.1343,10,132,142,142,65,142,4,2,2,422,0,726,39130,4,142
2012-10-27,winter,2012,October,1,Saturday,Holiday,Mist,0.5,0.4848,0.88,0.1343,23,123,146,146,65,146,4,3,2,432,0,724,24164,4,146
2012-10-27,winter,2012,October,2,Saturday,Holiday,Mist,0.5,0.4848,0.88,0.194,19,71,90,90,65,90,4,2,2,422,0,715,16352,4,90
2012-10-27,winter,2012,October,3,Saturday,Holiday,Clear,0.5,0.4848,0.88,0.1642,5,21,26,26,65,26,4,1,2,412,0,697,8174,4,26
2012-10-27,winter,2012,October,4,Saturday,Holiday,Mist,0.5,0.4848,0.88,0.1642,1,12,13,13,65,13,4,1,2,412,0,697,4428,4,13
2012-10-27,winter,2012,October,5,Saturday,Holiday,Mist,0.5,0.4848,0.82,0.194,2,7,9,9,65,9,4,1,2,412,0,717,14261,4,9
2012-10-27,winter,2012,October,6,Saturday,Holiday,Mist,0.5,0.4848,0.82,0.194,2,29,31,31,65,31,4,1,2,412,0,725,55132,4,31
2012-10-27,winter,2012,October,7,Saturday,Holiday,Clear,0.48,0.4697,0.83,0.194,7,79,86,86,65,86,4,2,2,422,0,727,154171,4,86
2012-10-27,winter,2012,October,8,Saturday,Holiday,Clear,0.5,0.4848,0.77,0.2537,26,187,213,213,65,213,4,3,2,432,0,727,261001,4,213
2012-10-27,winter,2012,October,9,Saturday,Holiday,Clear,0.5,0.4848,0.77,0.2537,88,240,328,328,65,328,4,4,2,442,0,727,159438,4,328
2012-10-27,winter,2012,October,10,Saturday,Holiday,Clear,0.54,0.5152,0.73,0.2836,165,314,479,479,65,479,4,4,3,443,2,727,126257,4,479
2012-10-27,winter,2012,October,11,Saturday,Holiday,Clear,0.56,0.5303,0.64,0.2836,197,388,585,585,65,585,4,4,3,443,2,727,151320,4,585
2012-10-27,winter,2012,October,12,Saturday,Holiday,Clear,0.6,0.6212,0.53,0.2537,264,404,668,668,65,668,4,4,3,443,2,728,184414,4,668
2012-10-27,winter,2012,October,13,Saturday,Holiday,Clear,0.6,0.6212,0.43,0.2537,310,450,760,760,65,760,4,4,3,443,2,729,184919,4,760
2012-10-27,winter,2012,October,14,Saturday,Holiday,Clear,0.6,0.6212,0.46,0.2537,325,425,750,750,65,750,4,4,3,443,2,729,175652,4,750
2012-10-27,winter,2012,October,15,Saturday,Holiday,Mist,0.56,0.5303,0.6,0.2836,310,401,711,711,65,711,4,4,3,443,2,729,183149,4,711
2012-10-27,winter,2012,October,16,Saturday,Holiday,Mist,0.56,0.5303,0.64,0.2836,257,355,612,612,65,612,4,4,3,443,2,730,227748,4,612
2012-10-27,winter,2012,October,17,Saturday,Holiday,Mist,0.56,0.5303,0.64,0.2836,248,370,618,618,65,618,4,4,3,443,2,730,336860,4,618
2012-10-27,winter,2012,October,18,Saturday,Holiday,Mist,0.56,0.5303,0.64,0.2836,138,318,456,456,65,456,4,4,3,443,2,728,309772,4,456
2012-10-27,winter,2012,October,19,Saturday,Holiday,Mist,0.52,0.5,0.72,0.2239,67,233,300,300,65,300,4,4,3,443,0,728,226789,4,300
2012-10-27,winter,2012,October,20,Saturday,Holiday,Mist,0.52,0.5,0.72,0.2239,58,238,296,296,65,296,4,4,3,443,0,728,164550,4,296
2012-10-27,winter,2012,October,21,Saturday,Holiday,Mist,0.52,0.5,0.72,0.2239,49,160,209,209,65,209,4,3,3,433,0,728,125445,4,209
2012-10-27,winter,2012,October,22,Saturday,Holiday,Mist,0.52,0.5,0.72,0.2537,41,116,157,157,65,157,4,3,3,433,0,728,95612,4,157
2012-10-27,winter,2012,October,23,Saturday,Holiday,Mist,0.52,0.5,0.68,0.3881,31,136,167,167,65,167,4,3,3,433,0,728,63941,4,167
2012-10-28,winter,2012,October,0,Sunday,Holiday,Light Snow,0.52,0.5,0.68,0.2985,20,97,117,117,64,117,4,2,3,423,0,726,39130,4,117
2012-10-28,winter,2012,October,1,Sunday,Holiday,Mist,0.5,0.4848,0.72,0.2836,22,111,133,133,64,133,4,2,2,422,0,724,24164,4,133
2012-10-28,winter,2012,October,2,Sunday,Holiday,Mist,0.5,0.4848,0.68,0.2985,17,99,116,116,64,116,4,2,2,422,0,715,16352,4,116
2012-10-28,winter,2012,October,3,Sunday,Holiday,Mist,0.5,0.4848,0.63,0.3284,18,61,79,79,64,79,4,2,2,422,0,697,8174,4,79
2012-10-28,winter,2012,October,4,Sunday,Holiday,Mist,0.5,0.4848,0.63,0.3582,1,19,20,20,64,20,4,1,2,412,1,697,4428,4,20
2012-10-28,winter,2012,October,5,Sunday,Holiday,Mist,0.5,0.4848,0.63,0.2985,6,22,28,28,64,28,4,1,2,412,0,717,14261,4,28
2012-10-28,winter,2012,October,6,Sunday,Holiday,Mist,0.5,0.4848,0.59,0.3284,7,32,39,39,64,39,4,1,2,412,1,725,55132,4,39
2012-10-28,winter,2012,October,7,Sunday,Holiday,Mist,0.5,0.4848,0.59,0.2985,17,48,65,65,64,65,4,2,2,422,1,727,154171,4,65
2012-10-28,winter,2012,October,8,Sunday,Holiday,Mist,0.5,0.4848,0.59,0.5522,55,118,173,173,64,173,4,3,2,432,1,727,261001,4,173
2012-10-28,winter,2012,October,9,Sunday,Holiday,Mist,0.5,0.4848,0.55,0.4179,124,206,330,330,64,330,4,4,2,442,2,727,159438,4,330
2012-10-28,winter,2012,October,10,Sunday,Holiday,Mist,0.48,0.4697,0.51,0.4179,120,314,434,434,64,434,4,4,2,442,2,727,126257,4,434
2012-10-28,winter,2012,October,11,Sunday,Holiday,Mist,0.5,0.4848,0.51,0.3881,110,352,462,462,64,462,4,4,2,442,2,727,151320,4,462
2012-10-28,winter,2012,October,12,Sunday,Holiday,Mist,0.48,0.4697,0.59,0.4925,118,373,491,491,64,491,4,4,2,442,2,728,184414,4,491
2012-10-28,winter,2012,October,13,Sunday,Holiday,Mist,0.48,0.4697,0.59,0.4179,75,316,391,391,64,391,4,4,2,442,2,729,184919,4,391
2012-10-28,winter,2012,October,14,Sunday,Holiday,Mist,0.5,0.4848,0.59,0.4478,98,304,402,402,64,402,4,4,2,442,2,729,175652,4,402
2012-10-28,winter,2012,October,15,Sunday,Holiday,Mist,0.5,0.4848,0.63,0.4925,76,225,301,301,64,301,4,4,2,442,2,729,183149,4,301
2012-10-28,winter,2012,October,16,Sunday,Holiday,Light Snow,0.48,0.4697,0.67,0.4627,42,251,293,293,64,293,4,4,2,442,1,730,227748,4,293
2012-10-28,winter,2012,October,17,Sunday,Holiday,Light Snow,0.46,0.4545,0.77,0.5224,37,188,225,225,64,225,4,3,2,432,1,730,336860,4,225
2012-10-28,winter,2012,October,18,Sunday,Holiday,Light Snow,0.42,0.4242,0.94,0.4925,18,136,154,154,64,154,4,3,2,432,1,728,309772,4,154
2012-10-28,winter,2012,October,19,Sunday,Holiday,Light Snow,0.42,0.4242,0.94,0.3582,7,47,54,54,64,54,4,2,2,422,0,728,226789,4,54
2012-10-28,winter,2012,October,20,Sunday,Holiday,Light Snow,0.42,0.4242,0.94,0.4627,4,51,55,55,64,55,4,2,2,422,1,728,164550,4,55
2012-10-28,winter,2012,October,21,Sunday,Holiday,Light Snow,0.44,0.4394,0.88,0.4179,2,44,46,46,64,46,4,2,2,422,0,728,125445,4,46
2012-10-28,winter,2012,October,22,Sunday,Holiday,Light Snow,0.44,0.4394,0.88,0.3582,2,35,37,37,64,37,4,1,2,412,0,728,95612,4,37
2012-10-28,winter,2012,October,23,Sunday,Holiday,Light Snow,0.42,0.4242,0.94,0.3582,2,12,14,14,64,14,4,1,2,412,0,728,63941,4,14
2012-10-29,winter,2012,October,0,Monday,Workingday,Light Snow,0.44,0.4394,0.88,0.3582,2,20,22,22,63,22,4,1,2,412,0,726,39130,4,22
2012-10-30,winter,2012,October,13,Tuesday,Workingday,Light Snow,0.3,0.2727,0.81,0.3582,11,105,116,116,62,116,4,2,1,421,1,729,184919,4,116
2012-10-30,winter,2012,October,14,Tuesday,Workingday,Light Snow,0.3,0.2727,0.81,0.3582,8,118,126,126,62,126,4,2,1,421,1,729,175652,4,126
2012-10-30,winter,2012,October,15,Tuesday,Workingday,Light Snow,0.3,0.2879,0.87,0.2537,10,114,124,124,62,124,4,2,1,421,1,729,183149,4,124
2012-10-30,winter,2012,October,16,Tuesday,Workingday,Light Snow,0.3,0.2879,0.87,0.2537,15,83,98,98,62,98,4,2,1,421,1,730,227748,4,98
2012-10-30,winter,2012,October,17,Tuesday,Workingday,Light Snow,0.3,0.2879,0.87,0.2239,19,105,124,124,62,124,4,2,1,421,1,730,336860,4,124
2012-10-30,winter,2012,October,18,Tuesday,Workingday,Light Snow,0.3,0.303,0.87,0.1343,4,139,143,143,62,143,4,3,1,431,1,728,309772,4,143
2012-10-30,winter,2012,October,19,Tuesday,Workingday,Mist,0.5,0.4848,0.68,0.194,6,109,115,115,62,115,4,2,2,422,0,728,226789,4,115
2012-10-30,winter,2012,October,20,Tuesday,Workingday,Mist,0.3,0.2879,0.81,0.194,5,76,81,81,62,81,4,2,1,421,1,728,164550,4,81
2012-10-30,winter,2012,October,21,Tuesday,Workingday,Mist,0.3,0.3182,0.87,0.1045,4,60,64,64,62,64,4,2,1,421,1,728,125445,4,64
2012-10-30,winter,2012,October,22,Tuesday,Workingday,Clear,0.3,0.303,0.81,0.1343,2,64,66,66,62,66,4,2,1,421,1,728,95612,4,66
2012-10-30,winter,2012,October,23,Tuesday,Workingday,Clear,0.3,0.303,0.81,0.1343,3,36,39,39,62,39,4,1,1,411,1,728,63941,4,39
2012-10-31,winter,2012,October,0,Wednesday,Workingday,Mist,0.3,0.3182,0.81,0.1045,0,16,16,16,61,16,4,1,1,411,1,726,39130,4,16
2012-10-31,winter,2012,October,1,Wednesday,Workingday,Mist,0.3,0.3182,0.81,0.0896,0,8,8,8,61,8,4,1,1,411,1,724,24164,4,8
2012-10-31,winter,2012,October,2,Wednesday,Workingday,Mist,0.3,0.303,0.81,0.1343,0,7,7,7,61,7,4,1,1,411,1,715,16352,4,7
2012-10-31,winter,2012,October,3,Wednesday,Workingday,Mist,0.3,0.3182,0.81,0.1045,0,3,3,3,61,3,4,1,1,411,1,697,8174,4,3
2012-10-31,winter,2012,October,4,Wednesday,Workingday,Mist,0.3,0.2879,0.87,0.194,0,5,5,5,61,5,4,1,1,411,1,697,4428,4,5
2012-10-31,winter,2012,October,5,Wednesday,Workingday,Mist,0.3,0.303,0.81,0.1343,0,24,24,24,61,24,4,1,1,411,1,717,14261,4,24
2012-10-31,winter,2012,October,6,Wednesday,Workingday,Clear,0.3,0.303,0.81,0.1642,0,116,116,116,61,116,4,2,1,421,1,725,55132,4,116
2012-10-31,winter,2012,October,7,Wednesday,Workingday,Mist,0.3,0.303,0.87,0.1343,3,334,337,337,61,337,4,4,1,441,1,727,154171,4,337
2012-10-31,winter,2012,October,8,Wednesday,Workingday,Clear,0.32,0.3333,0.81,0.1343,6,615,621,621,61,621,4,4,1,441,1,727,261001,4,621
2012-10-31,winter,2012,October,9,Wednesday,Workingday,Clear,0.34,0.3333,0.76,0.1343,17,280,297,297,61,297,4,4,1,441,1,727,159438,4,297
2012-10-31,winter,2012,October,10,Wednesday,Workingday,Clear,0.36,0.3333,0.71,0.2836,21,147,168,168,61,168,4,3,1,431,1,727,126257,4,168
2012-10-31,winter,2012,October,11,Wednesday,Workingday,Mist,0.36,0.3485,0.66,0.2239,37,152,189,189,61,189,4,3,2,432,1,727,151320,4,189
2012-10-31,winter,2012,October,12,Wednesday,Workingday,Clear,0.4,0.4091,0.58,0.194,44,197,241,241,61,241,4,3,2,432,1,728,184414,4,241
2012-10-31,winter,2012,October,13,Wednesday,Workingday,Clear,0.42,0.4242,0.5,0.2239,22,191,213,213,61,213,4,3,2,432,1,729,184919,4,213
2012-10-31,winter,2012,October,14,Wednesday,Workingday,Mist,0.42,0.4242,0.5,0.2239,45,179,224,224,61,224,4,3,2,432,1,729,175652,4,224
2012-10-31,winter,2012,October,15,Wednesday,Workingday,Clear,0.42,0.4242,0.54,0.1642,33,197,230,230,61,230,4,3,2,432,1,729,183149,4,230
2012-10-31,winter,2012,October,16,Wednesday,Workingday,Mist,0.42,0.4242,0.54,0.2239,51,373,424,424,61,424,4,4,2,442,2,730,227748,4,424
2012-10-31,winter,2012,October,17,Wednesday,Workingday,Mist,0.4,0.4091,0.58,0.1642,39,684,723,723,61,723,4,4,2,442,2,730,336860,4,723
2012-10-31,winter,2012,October,18,Wednesday,Workingday,Mist,0.4,0.4091,0.58,0.1642,28,556,584,584,61,584,4,4,2,442,2,728,309772,4,584
2012-10-31,winter,2012,October,19,Wednesday,Workingday,Mist,0.4,0.4091,0.5,0.194,27,383,410,410,61,410,4,4,2,442,1,728,226789,4,410
2012-10-31,winter,2012,October,20,Wednesday,Workingday,Mist,0.4,0.4091,0.5,0.194,9,259,268,268,61,268,4,3,2,432,1,728,164550,4,268
2012-10-31,winter,2012,October,21,Wednesday,Workingday,Mist,0.4,0.4091,0.5,0.194,12,180,192,192,61,192,4,3,2,432,1,728,125445,4,192
2012-10-31,winter,2012,October,22,Wednesday,Workingday,Clear,0.36,0.3485,0.57,0.1343,18,147,165,165,61,165,4,3,2,432,1,728,95612,4,165
2012-10-31,winter,2012,October,23,Wednesday,Workingday,Clear,0.36,0.3636,0.57,0.0896,7,94,101,101,61,101,4,2,2,422,1,728,63941,4,101
2012-11-01,winter,2012,November,0,Thursday,Workingday,Clear,0.36,0.3636,0.57,0.0896,8,52,60,60,60,60,4,2,2,422,1,726,39130,4,60
2012-11-01,winter,2012,November,1,Thursday,Workingday,Clear,0.3,0.3182,0.75,0.1045,8,22,30,30,60,30,4,1,1,411,1,724,24164,4,30
2012-11-01,winter,2012,November,2,Thursday,Workingday,Clear,0.32,0.3333,0.66,0.1343,10,10,20,20,60,20,4,1,1,411,1,715,16352,4,20
2012-11-01,winter,2012,November,3,Thursday,Workingday,Clear,0.34,0.3333,0.61,0.1343,5,10,15,15,60,15,4,1,1,411,1,697,8174,4,15
2012-11-01,winter,2012,November,4,Thursday,Workingday,Mist,0.34,0.3485,0.66,0.1045,2,8,10,10,60,10,4,1,2,412,1,697,4428,4,10
2012-11-01,winter,2012,November,5,Thursday,Workingday,Clear,0.34,0.3333,0.66,0.1343,1,39,40,40,60,40,4,1,1,411,1,717,14261,4,40
2012-11-01,winter,2012,November,6,Thursday,Workingday,Clear,0.34,0.3333,0.61,0.1642,2,146,148,148,60,148,4,3,1,431,1,725,55132,4,148
2012-11-01,winter,2012,November,7,Thursday,Workingday,Mist,0.36,0.3485,0.57,0.1642,6,414,420,420,60,420,4,4,2,442,1,727,154171,4,420
2012-11-01,winter,2012,November,8,Thursday,Workingday,Mist,0.36,0.3788,0.56,0.1045,12,668,680,680,60,680,4,4,2,442,2,727,261001,4,680
2012-11-01,winter,2012,November,9,Thursday,Workingday,Light Snow,0.36,0.3636,0.57,0.1045,21,310,331,331,60,331,4,4,2,442,1,727,159438,4,331
2012-11-01,winter,2012,November,10,Thursday,Workingday,Light Snow,0.36,0.3485,0.62,0.194,13,133,146,146,60,146,4,3,2,432,1,727,126257,4,146
2012-11-01,winter,2012,November,11,Thursday,Workingday,Light Snow,0.36,0.3485,0.62,0.194,14,156,170,170,60,170,4,3,2,432,1,727,151320,4,170
2012-11-01,winter,2012,November,12,Thursday,Workingday,Light Snow,0.38,0.3939,0.62,0.1642,23,198,221,221,60,221,4,3,2,432,1,728,184414,4,221
2012-11-01,winter,2012,November,13,Thursday,Workingday,Mist,0.4,0.4091,0.58,0.1642,49,199,248,248,60,248,4,3,2,432,1,729,184919,4,248
2012-11-01,winter,2012,November,14,Thursday,Workingday,Mist,0.4,0.4091,0.5,0.2239,31,154,185,185,60,185,4,3,2,432,1,729,175652,4,185
2012-11-01,winter,2012,November,15,Thursday,Workingday,Mist,0.4,0.4091,0.54,0.1642,35,179,214,214,60,214,4,3,2,432,1,729,183149,4,214
2012-11-01,winter,2012,November,16,Thursday,Workingday,Mist,0.4,0.4091,0.54,0.1642,31,313,344,344,60,344,4,4,2,442,1,730,227748,4,344
2012-11-01,winter,2012,November,17,Thursday,Workingday,Light Snow,0.4,0.4091,0.5,0.2239,37,652,689,689,60,689,4,4,2,442,2,730,336860,4,689
2012-11-01,winter,2012,November,18,Thursday,Workingday,Mist,0.4,0.4091,0.5,0.1642,50,628,678,678,60,678,4,4,2,442,2,728,309772,4,678
2012-11-01,winter,2012,November,19,Thursday,Workingday,Mist,0.4,0.4091,0.5,0.1642,28,424,452,452,60,452,4,4,2,442,1,728,226789,4,452
2012-11-01,winter,2012,November,20,Thursday,Workingday,Mist,0.38,0.3939,0.54,0.2537,16,280,296,296,60,296,4,4,2,442,1,728,164550,4,296
2012-11-01,winter,2012,November,21,Thursday,Workingday,Mist,0.38,0.3939,0.54,0.1343,29,238,267,267,60,267,4,3,2,432,1,728,125445,4,267
2012-11-01,winter,2012,November,22,Thursday,Workingday,Clear,0.36,0.3485,0.57,0.1642,27,175,202,202,60,202,4,3,2,432,1,728,95612,4,202
2012-11-01,winter,2012,November,23,Thursday,Workingday,Clear,0.34,0.3333,0.57,0.1642,8,112,120,120,60,120,4,2,1,421,1,728,63941,4,120
2012-11-02,winter,2012,November,0,Friday,Workingday,Clear,0.34,0.3333,0.57,0.1642,10,40,50,50,59,50,4,2,1,421,1,726,39130,4,50
2012-11-02,winter,2012,November,1,Friday,Workingday,Clear,0.32,0.3182,0.66,0.1642,5,19,24,24,59,24,4,1,1,411,1,724,24164,4,24
2012-11-02,winter,2012,November,2,Friday,Workingday,Clear,0.32,0.3182,0.66,0.1642,3,7,10,10,59,10,4,1,1,411,1,715,16352,4,10
2012-11-02,winter,2012,November,3,Friday,Workingday,Clear,0.3,0.303,0.7,0.1642,0,3,3,3,59,3,4,1,1,411,1,697,8174,4,3
2012-11-02,winter,2012,November,4,Friday,Workingday,Clear,0.3,0.3182,0.7,0.1045,1,6,7,7,59,7,4,1,1,411,1,697,4428,4,7
2012-11-02,winter,2012,November,5,Friday,Workingday,Mist,0.32,0.3182,0.66,0.1642,1,25,26,26,59,26,4,1,1,411,1,717,14261,4,26
2012-11-02,winter,2012,November,6,Friday,Workingday,Clear,0.3,0.303,0.7,0.1642,2,120,122,122,59,122,4,2,1,421,1,725,55132,4,122
2012-11-02,winter,2012,November,7,Friday,Workingday,Mist,0.3,0.303,0.7,0.1343,8,349,357,357,59,357,4,4,1,441,1,727,154171,4,357
2012-11-02,winter,2012,November,8,Friday,Workingday,Clear,0.32,0.3333,0.57,0.1045,31,656,687,687,59,687,4,4,1,441,1,727,261001,4,687
2012-11-02,winter,2012,November,9,Friday,Workingday,Clear,0.34,0.3485,0.53,0.1045,27,355,382,382,59,382,4,4,2,442,1,727,159438,4,382
2012-11-02,winter,2012,November,10,Friday,Workingday,Clear,0.38,0.3939,0.46,0.2985,21,183,204,204,59,204,4,3,2,432,1,727,126257,4,204
2012-11-02,winter,2012,November,11,Friday,Workingday,Clear,0.42,0.4242,0.41,0.4179,42,179,221,221,59,221,4,3,2,432,1,727,151320,4,221
2012-11-02,winter,2012,November,12,Friday,Workingday,Clear,0.42,0.4242,0.41,0.3582,52,240,292,292,59,292,4,4,2,442,1,728,184414,4,292
2012-11-02,winter,2012,November,13,Friday,Workingday,Clear,0.4,0.4091,0.43,0.3582,64,230,294,294,59,294,4,4,2,442,1,729,184919,4,294
2012-11-02,winter,2012,November,14,Friday,Workingday,Mist,0.4,0.4091,0.4,0.4925,63,199,262,262,59,262,4,3,2,432,1,729,175652,4,262
2012-11-02,winter,2012,November,15,Friday,Workingday,Mist,0.4,0.4091,0.4,0.4179,51,255,306,306,59,306,4,4,2,442,1,729,183149,4,306
2012-11-02,winter,2012,November,16,Friday,Workingday,Clear,0.38,0.3939,0.4,0.3284,48,373,421,421,59,421,4,4,2,442,1,730,227748,4,421
2012-11-02,winter,2012,November,17,Friday,Workingday,Clear,0.38,0.3939,0.4,0.3284,57,581,638,638,59,638,4,4,2,442,2,730,336860,4,638
2012-11-02,winter,2012,November,18,Friday,Workingday,Mist,0.38,0.3939,0.43,0.3284,32,490,522,522,59,522,4,4,2,442,2,728,309772,4,522
2012-11-02,winter,2012,November,19,Friday,Workingday,Mist,0.38,0.3939,0.43,0.2985,38,336,374,374,59,374,4,4,2,442,1,728,226789,4,374
2012-11-02,winter,2012,November,20,Friday,Workingday,Mist,0.36,0.3333,0.46,0.4179,14,207,221,221,59,221,4,3,1,431,1,728,164550,4,221
2012-11-02,winter,2012,November,21,Friday,Workingday,Mist,0.36,0.3333,0.46,0.3582,23,133,156,156,59,156,4,3,1,431,1,728,125445,4,156
2012-11-02,winter,2012,November,22,Friday,Workingday,Clear,0.36,0.3333,0.46,0.2537,14,135,149,149,59,149,4,3,1,431,1,728,95612,4,149
2012-11-02,winter,2012,November,23,Friday,Workingday,Clear,0.34,0.303,0.53,0.2985,11,108,119,119,59,119,4,2,1,421,1,728,63941,4,119
2012-11-03,winter,2012,November,0,Saturday,Holiday,Clear,0.34,0.3333,0.53,0.1642,9,99,108,108,58,108,4,2,1,421,1,726,39130,4,108
2012-11-03,winter,2012,November,1,Saturday,Holiday,Mist,0.34,0.303,0.49,0.3284,6,83,89,89,58,89,4,2,1,421,1,724,24164,4,89
2012-11-03,winter,2012,November,2,Saturday,Holiday,Mist,0.34,0.3182,0.49,0.2537,10,36,46,46,58,46,4,2,1,421,1,715,16352,4,46
2012-11-03,winter,2012,November,3,Saturday,Holiday,Mist,0.34,0.3182,0.49,0.2537,6,22,28,28,58,28,4,1,1,411,1,697,8174,4,28
2012-11-03,winter,2012,November,4,Saturday,Holiday,Mist,0.32,0.303,0.49,0.2985,8,8,16,16,58,16,4,1,1,411,1,697,4428,4,16
2012-11-03,winter,2012,November,5,Saturday,Holiday,Mist,0.32,0.303,0.49,0.2537,1,8,9,9,58,9,4,1,1,411,1,717,14261,4,9
2012-11-03,winter,2012,November,6,Saturday,Holiday,Mist,0.32,0.3182,0.49,0.194,4,17,21,21,58,21,4,1,1,411,1,725,55132,4,21
2012-11-03,winter,2012,November,7,Saturday,Holiday,Mist,0.32,0.303,0.49,0.2537,1,58,59,59,58,59,4,2,1,421,1,727,154171,4,59
2012-11-03,winter,2012,November,8,Saturday,Holiday,Mist,0.34,0.303,0.46,0.2985,10,132,142,142,58,142,4,2,1,421,1,727,261001,4,142
2012-11-03,winter,2012,November,9,Saturday,Holiday,Mist,0.34,0.303,0.49,0.2985,31,188,219,219,58,219,4,3,1,431,1,727,159438,4,219
2012-11-03,winter,2012,November,10,Saturday,Holiday,Clear,0.36,0.3333,0.46,0.3881,68,260,328,328,58,328,4,4,1,441,1,727,126257,4,328
2012-11-03,winter,2012,November,11,Saturday,Holiday,Mist,0.36,0.3333,0.46,0.3881,56,284,340,340,58,340,4,4,1,441,1,727,151320,4,340
2012-11-03,winter,2012,November,12,Saturday,Holiday,Mist,0.36,0.3182,0.46,0.4627,74,320,394,394,58,394,4,4,1,441,1,728,184414,4,394
2012-11-03,winter,2012,November,13,Saturday,Holiday,Mist,0.36,0.3333,0.46,0.3582,110,339,449,449,58,449,4,4,1,441,2,729,184919,4,449
2012-11-03,winter,2012,November,14,Saturday,Holiday,Mist,0.36,0.3333,0.5,0.3284,136,319,455,455,58,455,4,4,1,441,2,729,175652,4,455
2012-11-03,winter,2012,November,15,Saturday,Holiday,Mist,0.36,0.3182,0.46,0.4478,117,331,448,448,58,448,4,4,1,441,2,729,183149,4,448
2012-11-03,winter,2012,November,16,Saturday,Holiday,Mist,0.36,0.3333,0.46,0.3284,108,292,400,400,58,400,4,4,1,441,1,730,227748,4,400
2012-11-03,winter,2012,November,17,Saturday,Holiday,Mist,0.36,0.3333,0.46,0.2985,112,298,410,410,58,410,4,4,1,441,2,730,336860,4,410
2012-11-03,winter,2012,November,18,Saturday,Holiday,Mist,0.36,0.3333,0.46,0.2836,58,239,297,297,58,297,4,4,1,441,1,728,309772,4,297
2012-11-03,winter,2012,November,19,Saturday,Holiday,Clear,0.36,0.3485,0.5,0.1642,22,217,239,239,58,239,4,3,2,432,1,728,226789,4,239
2012-11-03,winter,2012,November,20,Saturday,Holiday,Clear,0.34,0.3333,0.53,0.1343,23,158,181,181,58,181,4,3,1,431,1,728,164550,4,181
2012-11-03,winter,2012,November,21,Saturday,Holiday,Clear,0.34,0.3485,0.53,0.1045,31,135,166,166,58,166,4,3,2,432,1,728,125445,4,166
2012-11-03,winter,2012,November,22,Saturday,Holiday,Clear,0.32,0.3333,0.57,0.1045,13,133,146,146,58,146,4,3,1,431,1,728,95612,4,146
2012-11-03,winter,2012,November,23,Saturday,Holiday,Clear,0.32,0.3333,0.57,0.1045,15,133,148,148,58,148,4,3,1,431,1,728,63941,4,148
2012-11-04,winter,2012,November,0,Sunday,Holiday,Clear,0.3,0.3182,0.61,0.1045,5,97,102,102,57,102,4,2,1,421,1,726,39130,4,102
2012-11-04,winter,2012,November,1,Sunday,Holiday,Clear,0.26,0.2879,0.81,0.0896,26,139,165,165,57,165,4,3,1,431,1,724,24164,4,165
2012-11-04,winter,2012,November,2,Sunday,Holiday,Clear,0.3,0.3333,0.65,0.0,6,31,37,37,57,37,4,1,1,411,1,715,16352,4,37
2012-11-04,winter,2012,November,3,Sunday,Holiday,Clear,0.28,0.2879,0.61,0.1045,1,10,11,11,57,11,4,1,1,411,1,697,8174,4,11
2012-11-04,winter,2012,November,4,Sunday,Holiday,Clear,0.26,0.2727,0.65,0.1343,2,7,9,9,57,9,4,1,1,411,1,697,4428,4,9
2012-11-04,winter,2012,November,5,Sunday,Holiday,Clear,0.26,0.2727,0.65,0.1045,0,5,5,5,57,5,4,1,1,411,1,717,14261,4,5
2012-11-04,winter,2012,November,6,Sunday,Holiday,Clear,0.28,0.2879,0.61,0.1343,2,14,16,16,57,16,4,1,1,411,1,725,55132,4,16
2012-11-04,winter,2012,November,7,Sunday,Holiday,Clear,0.26,0.2727,0.65,0.1045,11,39,50,50,57,50,4,2,1,421,1,727,154171,4,50
2012-11-04,winter,2012,November,8,Sunday,Holiday,Clear,0.3,0.303,0.56,0.1343,34,115,149,149,57,149,4,3,1,431,1,727,261001,4,149
2012-11-04,winter,2012,November,9,Sunday,Holiday,Clear,0.32,0.3333,0.53,0.0,56,161,217,217,57,217,4,3,1,431,1,727,159438,4,217
2012-11-04,winter,2012,November,10,Sunday,Holiday,Clear,0.34,0.3333,0.49,0.194,73,287,360,360,57,360,4,4,1,441,1,727,126257,4,360
2012-11-04,winter,2012,November,11,Sunday,Holiday,Clear,0.38,0.3939,0.46,0.2239,134,311,445,445,57,445,4,4,2,442,2,727,151320,4,445
2012-11-04,winter,2012,November,12,Sunday,Holiday,Clear,0.38,0.3939,0.46,0.2239,150,354,504,504,57,504,4,4,2,442,2,728,184414,4,504
2012-11-04,winter,2012,November,13,Sunday,Holiday,Clear,0.4,0.4091,0.43,0.2239,122,371,493,493,57,493,4,4,2,442,2,729,184919,4,493
2012-11-04,winter,2012,November,14,Sunday,Holiday,Clear,0.4,0.4091,0.4,0.194,149,360,509,509,57,509,4,4,2,442,2,729,175652,4,509
2012-11-04,winter,2012,November,15,Sunday,Holiday,Clear,0.4,0.4091,0.4,0.2239,149,300,449,449,57,449,4,4,2,442,2,729,183149,4,449
2012-11-04,winter,2012,November,16,Sunday,Holiday,Clear,0.4,0.4091,0.4,0.3284,119,316,435,435,57,435,4,4,2,442,2,730,227748,4,435
2012-11-04,winter,2012,November,17,Sunday,Holiday,Clear,0.36,0.3485,0.43,0.194,57,270,327,327,57,327,4,4,2,442,1,730,336860,4,327
2012-11-04,winter,2012,November,18,Sunday,Holiday,Clear,0.36,0.3485,0.43,0.2239,31,206,237,237,57,237,4,3,2,432,1,728,309772,4,237
2012-11-04,winter,2012,November,19,Sunday,Holiday,Clear,0.36,0.3333,0.43,0.2537,24,203,227,227,57,227,4,3,1,431,1,728,226789,4,227
2012-11-04,winter,2012,November,20,Sunday,Holiday,Clear,0.32,0.2879,0.53,0.3582,7,134,141,141,57,141,4,2,1,421,1,728,164550,4,141
2012-11-04,winter,2012,November,21,Sunday,Holiday,Clear,0.3,0.2727,0.52,0.2985,16,71,87,87,57,87,4,2,1,421,1,728,125445,4,87
2012-11-04,winter,2012,November,22,Sunday,Holiday,Clear,0.3,0.2879,0.52,0.2836,15,64,79,79,57,79,4,2,1,421,1,728,95612,4,79
2012-11-04,winter,2012,November,23,Sunday,Holiday,Mist,0.3,0.303,0.56,0.1642,12,41,53,53,57,53,4,2,1,421,1,728,63941,4,53
2012-11-05,winter,2012,November,0,Monday,Workingday,Mist,0.3,0.2879,0.56,0.194,3,20,23,23,56,23,4,1,1,411,1,726,39130,4,23
2012-11-05,winter,2012,November,1,Monday,Workingday,Mist,0.3,0.303,0.56,0.1642,0,8,8,8,56,8,4,1,1,411,1,724,24164,4,8
2012-11-05,winter,2012,November,2,Monday,Workingday,Mist,0.3,0.303,0.56,0.1642,2,4,6,6,56,6,4,1,1,411,1,715,16352,4,6
2012-11-05,winter,2012,November,3,Monday,Workingday,Mist,0.3,0.2879,0.56,0.2239,1,3,4,4,56,4,4,1,1,411,1,697,8174,4,4
2012-11-05,winter,2012,November,4,Monday,Workingday,Mist,0.3,0.2879,0.52,0.2537,5,11,16,16,56,16,4,1,1,411,1,697,4428,4,16
2012-11-05,winter,2012,November,5,Monday,Workingday,Mist,0.3,0.2727,0.52,0.3284,1,38,39,39,56,39,4,1,1,411,1,717,14261,4,39
2012-11-05,winter,2012,November,6,Monday,Workingday,Mist,0.3,0.2879,0.49,0.2836,4,135,139,139,56,139,4,2,1,421,1,725,55132,4,139
2012-11-05,winter,2012,November,7,Monday,Workingday,Mist,0.3,0.2879,0.49,0.2537,8,453,461,461,56,461,4,4,1,441,1,727,154171,4,461
2012-11-05,winter,2012,November,8,Monday,Workingday,Mist,0.3,0.2879,0.49,0.2239,19,629,648,648,56,648,4,4,1,441,1,727,261001,4,648
2012-11-05,winter,2012,November,9,Monday,Workingday,Mist,0.3,0.2879,0.52,0.2836,18,239,257,257,56,257,4,3,1,431,1,727,159438,4,257
2012-11-05,winter,2012,November,10,Monday,Workingday,Clear,0.32,0.303,0.49,0.2836,30,112,142,142,56,142,4,2,1,421,1,727,126257,4,142
2012-11-05,winter,2012,November,11,Monday,Workingday,Clear,0.34,0.3182,0.46,0.2239,31,119,150,150,56,150,4,3,1,431,1,727,151320,4,150
2012-11-05,winter,2012,November,12,Monday,Workingday,Clear,0.36,0.3333,0.43,0.3284,38,206,244,244,56,244,4,3,1,431,1,728,184414,4,244
2012-11-05,winter,2012,November,13,Monday,Workingday,Clear,0.36,0.3333,0.4,0.2537,39,183,222,222,56,222,4,3,1,431,1,729,184919,4,222
2012-11-05,winter,2012,November,14,Monday,Workingday,Clear,0.38,0.3939,0.4,0.1642,31,165,196,196,56,196,4,3,2,432,1,729,175652,4,196
2012-11-05,winter,2012,November,15,Monday,Workingday,Clear,0.38,0.3939,0.4,0.2836,24,207,231,231,56,231,4,3,2,432,1,729,183149,4,231
2012-11-05,winter,2012,November,16,Monday,Workingday,Clear,0.36,0.3333,0.43,0.2836,35,325,360,360,56,360,4,4,1,441,1,730,227748,4,360
2012-11-05,winter,2012,November,17,Monday,Workingday,Clear,0.34,0.3182,0.46,0.2239,34,604,638,638,56,638,4,4,1,441,1,730,336860,4,638
2012-11-05,winter,2012,November,18,Monday,Workingday,Clear,0.34,0.3182,0.46,0.2239,19,523,542,542,56,542,4,4,1,441,1,728,309772,4,542
2012-11-05,winter,2012,November,19,Monday,Workingday,Clear,0.32,0.3182,0.49,0.1642,11,361,372,372,56,372,4,4,1,441,1,728,226789,4,372
2012-11-05,winter,2012,November,20,Monday,Workingday,Clear,0.32,0.303,0.49,0.2537,13,228,241,241,56,241,4,3,1,431,1,728,164550,4,241
2012-11-05,winter,2012,November,21,Monday,Workingday,Clear,0.3,0.2879,0.52,0.2836,8,144,152,152,56,152,4,3,1,431,1,728,125445,4,152
2012-11-05,winter,2012,November,22,Monday,Workingday,Clear,0.28,0.2727,0.56,0.194,4,111,115,115,56,115,4,2,1,421,1,728,95612,4,115
2012-11-05,winter,2012,November,23,Monday,Workingday,Clear,0.26,0.2727,0.6,0.1343,0,53,53,53,56,53,4,2,1,421,1,728,63941,4,53
2012-11-06,winter,2012,November,0,Tuesday,Workingday,Clear,0.24,0.2576,0.6,0.1045,1,18,19,19,55,19,4,1,1,411,1,726,39130,4,19
2012-11-06,winter,2012,November,1,Tuesday,Workingday,Clear,0.24,0.2424,0.6,0.1642,0,8,8,8,55,8,4,1,1,411,1,724,24164,4,8
2012-11-06,winter,2012,November,2,Tuesday,Workingday,Clear,0.24,0.2576,0.65,0.0896,0,2,2,2,55,2,4,1,1,411,1,715,16352,4,2
2012-11-06,winter,2012,November,3,Tuesday,Workingday,Clear,0.22,0.2424,0.64,0.1045,0,4,4,4,55,4,4,1,1,411,1,697,8174,4,4
2012-11-06,winter,2012,November,4,Tuesday,Workingday,Clear,0.22,0.2576,0.69,0.0896,0,7,7,7,55,7,4,1,1,411,1,697,4428,4,7
2012-11-06,winter,2012,November,5,Tuesday,Workingday,Mist,0.22,0.2273,0.64,0.194,1,40,41,41,55,41,4,2,1,421,1,717,14261,4,41
2012-11-06,winter,2012,November,6,Tuesday,Workingday,Clear,0.22,0.2273,0.69,0.1343,6,143,149,149,55,149,4,3,1,431,1,725,55132,4,149
2012-11-06,winter,2012,November,7,Tuesday,Workingday,Clear,0.2,0.2121,0.69,0.1642,9,378,387,387,55,387,4,4,1,441,1,727,154171,4,387
2012-11-06,winter,2012,November,8,Tuesday,Workingday,Clear,0.22,0.2273,0.69,0.1642,20,568,588,588,55,588,4,4,1,441,1,727,261001,4,588
2012-11-06,winter,2012,November,9,Tuesday,Workingday,Clear,0.26,0.2576,0.6,0.1642,25,338,363,363,55,363,4,4,1,441,1,727,159438,4,363
2012-11-06,winter,2012,November,10,Tuesday,Workingday,Clear,0.3,0.2879,0.49,0.194,41,189,230,230,55,230,4,3,1,431,1,727,126257,4,230
2012-11-06,winter,2012,November,11,Tuesday,Workingday,Clear,0.32,0.3333,0.45,0.1343,39,177,216,216,55,216,4,3,1,431,1,727,151320,4,216
2012-11-06,winter,2012,November,12,Tuesday,Workingday,Clear,0.32,0.3333,0.45,0.1343,31,217,248,248,55,248,4,3,1,431,1,728,184414,4,248
2012-11-06,winter,2012,November,13,Tuesday,Workingday,Clear,0.34,0.3333,0.46,0.1343,46,232,278,278,55,278,4,3,1,431,1,729,184919,4,278
2012-11-06,winter,2012,November,14,Tuesday,Workingday,Clear,0.36,0.3636,0.4,0.1045,44,196,240,240,55,240,4,3,2,432,1,729,175652,4,240
2012-11-06,winter,2012,November,15,Tuesday,Workingday,Clear,0.34,0.3182,0.46,0.2537,45,227,272,272,55,272,4,3,1,431,1,729,183149,4,272
2012-11-06,winter,2012,November,16,Tuesday,Workingday,Clear,0.34,0.3333,0.46,0.1642,33,369,402,402,55,402,4,4,1,441,1,730,227748,4,402
2012-11-06,winter,2012,November,17,Tuesday,Workingday,Clear,0.32,0.303,0.53,0.2239,30,597,627,627,55,627,4,4,1,441,1,730,336860,4,627
2012-11-06,winter,2012,November,18,Tuesday,Workingday,Clear,0.32,0.303,0.57,0.2985,20,477,497,497,55,497,4,4,1,441,1,728,309772,4,497
2012-11-06,winter,2012,November,19,Tuesday,Workingday,Clear,0.3,0.2879,0.56,0.2239,15,356,371,371,55,371,4,4,1,441,1,728,226789,4,371
2012-11-06,winter,2012,November,20,Tuesday,Workingday,Clear,0.3,0.2879,0.61,0.2239,10,218,228,228,55,228,4,3,1,431,1,728,164550,4,228
2012-11-06,winter,2012,November,21,Tuesday,Workingday,Mist,0.3,0.2879,0.56,0.2537,14,137,151,151,55,151,4,3,1,431,1,728,125445,4,151
2012-11-06,winter,2012,November,22,Tuesday,Workingday,Mist,0.3,0.2879,0.56,0.2239,17,136,153,153,55,153,4,3,1,431,1,728,95612,4,153
2012-11-06,winter,2012,November,23,Tuesday,Workingday,Clear,0.3,0.2879,0.56,0.2239,19,186,205,205,55,205,4,3,1,431,1,728,63941,4,205
2012-11-07,winter,2012,November,0,Wednesday,Workingday,Mist,0.3,0.2879,0.56,0.2836,49,234,283,283,54,283,4,4,1,441,1,726,39130,4,283
2012-11-07,winter,2012,November,1,Wednesday,Workingday,Mist,0.28,0.2727,0.61,0.2537,6,86,92,92,54,92,4,2,1,421,1,724,24164,4,92
2012-11-07,winter,2012,November,2,Wednesday,Workingday,Mist,0.28,0.2576,0.56,0.2985,6,68,74,74,54,74,4,2,1,421,1,715,16352,4,74
2012-11-07,winter,2012,November,3,Wednesday,Workingday,Mist,0.28,0.2576,0.52,0.3284,2,9,11,11,54,11,4,1,1,411,1,697,8174,4,11
2012-11-07,winter,2012,November,4,Wednesday,Workingday,Mist,0.28,0.2576,0.52,0.2985,0,9,9,9,54,9,4,1,1,411,1,697,4428,4,9
2012-11-07,winter,2012,November,5,Wednesday,Workingday,Mist,0.28,0.2576,0.52,0.3284,0,27,27,27,54,27,4,1,1,411,1,717,14261,4,27
2012-11-07,winter,2012,November,6,Wednesday,Workingday,Mist,0.26,0.2424,0.56,0.2836,3,115,118,118,54,118,4,2,1,421,1,725,55132,4,118
2012-11-07,winter,2012,November,7,Wednesday,Workingday,Mist,0.26,0.2273,0.56,0.2985,5,314,319,319,54,319,4,4,1,441,1,727,154171,4,319
2012-11-07,winter,2012,November,8,Wednesday,Workingday,Mist,0.26,0.2424,0.6,0.2836,18,583,601,601,54,601,4,4,1,441,1,727,261001,4,601
2012-11-07,winter,2012,November,9,Wednesday,Workingday,Mist,0.26,0.2424,0.6,0.2836,17,351,368,368,54,368,4,4,1,441,1,727,159438,4,368
2012-11-07,winter,2012,November,10,Wednesday,Workingday,Mist,0.28,0.2576,0.56,0.2985,27,151,178,178,54,178,4,3,1,431,1,727,126257,4,178
2012-11-07,winter,2012,November,11,Wednesday,Workingday,Mist,0.32,0.2879,0.51,0.3582,15,132,147,147,54,147,4,3,1,431,1,727,151320,4,147
2012-11-07,winter,2012,November,12,Wednesday,Workingday,Mist,0.32,0.303,0.53,0.2836,24,188,212,212,54,212,4,3,1,431,1,728,184414,4,212
2012-11-07,winter,2012,November,13,Wednesday,Workingday,Mist,0.32,0.303,0.53,0.2537,23,158,181,181,54,181,4,3,1,431,1,729,184919,4,181
2012-11-07,winter,2012,November,14,Wednesday,Workingday,Mist,0.32,0.2879,0.53,0.3582,19,142,161,161,54,161,4,3,1,431,1,729,175652,4,161
2012-11-07,winter,2012,November,15,Wednesday,Workingday,Mist,0.32,0.303,0.53,0.2985,20,178,198,198,54,198,4,3,1,431,1,729,183149,4,198
2012-11-07,winter,2012,November,16,Wednesday,Workingday,Mist,0.32,0.2879,0.53,0.3582,23,250,273,273,54,273,4,3,1,431,1,730,227748,4,273
2012-11-07,winter,2012,November,17,Wednesday,Workingday,Mist,0.32,0.2879,0.53,0.3881,16,501,517,517,54,517,4,4,1,441,1,730,336860,4,517
2012-11-07,winter,2012,November,18,Wednesday,Workingday,Mist,0.32,0.2879,0.53,0.3582,17,448,465,465,54,465,4,4,1,441,1,728,309772,4,465
2012-11-07,winter,2012,November,19,Wednesday,Workingday,Mist,0.3,0.2727,0.56,0.2985,17,302,319,319,54,319,4,4,1,441,1,728,226789,4,319
2012-11-07,winter,2012,November,20,Wednesday,Workingday,Mist,0.32,0.303,0.49,0.3284,7,249,256,256,54,256,4,3,1,431,1,728,164550,4,256
2012-11-07,winter,2012,November,21,Wednesday,Workingday,Mist,0.32,0.303,0.49,0.2985,5,121,126,126,54,126,4,2,1,421,1,728,125445,4,126
2012-11-07,winter,2012,November,22,Wednesday,Workingday,Light Snow,0.3,0.2879,0.56,0.2537,4,56,60,60,54,60,4,2,1,421,1,728,95612,4,60
2012-11-07,winter,2012,November,23,Wednesday,Workingday,Light Snow,0.28,0.2727,0.65,0.2239,3,37,40,40,54,40,4,1,1,411,1,728,63941,4,40
2012-11-08,winter,2012,November,0,Thursday,Workingday,Light Snow,0.28,0.2727,0.61,0.2239,1,14,15,15,53,15,4,1,1,411,1,726,39130,4,15
2012-11-08,winter,2012,November,1,Thursday,Workingday,Light Snow,0.3,0.2727,0.52,0.3582,1,11,12,12,53,12,4,1,1,411,1,724,24164,4,12
2012-11-08,winter,2012,November,2,Thursday,Workingday,Mist,0.3,0.2879,0.49,0.2239,1,5,6,6,53,6,4,1,1,411,1,715,16352,4,6
2012-11-08,winter,2012,November,4,Thursday,Workingday,Mist,0.3,0.2879,0.45,0.2836,1,9,10,10,53,10,4,1,1,411,1,697,4428,4,10
2012-11-08,winter,2012,November,5,Thursday,Workingday,Mist,0.3,0.2879,0.42,0.2239,0,35,35,35,53,35,4,1,1,411,1,717,14261,4,35
2012-11-08,winter,2012,November,6,Thursday,Workingday,Clear,0.3,0.2879,0.39,0.2239,2,122,124,124,53,124,4,2,1,421,1,725,55132,4,124
2012-11-08,winter,2012,November,7,Thursday,Workingday,Clear,0.28,0.2576,0.36,0.3881,12,411,423,423,53,423,4,4,1,441,1,727,154171,4,423
2012-11-08,winter,2012,November,8,Thursday,Workingday,Clear,0.3,0.2879,0.33,0.2836,16,652,668,668,53,668,4,4,1,441,1,727,261001,4,668
2012-11-08,winter,2012,November,9,Thursday,Workingday,Clear,0.32,0.2879,0.31,0.3582,22,253,275,275,53,275,4,3,1,431,1,727,159438,4,275
2012-11-08,winter,2012,November,10,Thursday,Workingday,Clear,0.32,0.303,0.31,0.3284,13,148,161,161,53,161,4,3,1,431,1,727,126257,4,161
2012-11-08,winter,2012,November,11,Thursday,Workingday,Clear,0.36,0.3333,0.29,0.3881,16,155,171,171,53,171,4,3,1,431,1,727,151320,4,171
2012-11-08,winter,2012,November,12,Thursday,Workingday,Clear,0.4,0.4091,0.24,0.4925,33,202,235,235,53,235,4,3,2,432,1,728,184414,4,235
2012-11-08,winter,2012,November,13,Thursday,Workingday,Clear,0.44,0.4394,0.18,0.4179,33,195,228,228,53,228,4,3,2,432,1,729,184919,4,228
2012-11-08,winter,2012,November,14,Thursday,Workingday,Clear,0.44,0.4394,0.18,0.4179,33,149,182,182,53,182,4,3,2,432,1,729,175652,4,182
2012-11-08,winter,2012,November,15,Thursday,Workingday,Clear,0.44,0.4394,0.18,0.4179,32,201,233,233,53,233,4,3,2,432,1,729,183149,4,233
2012-11-08,winter,2012,November,16,Thursday,Workingday,Clear,0.42,0.4242,0.16,0.3881,18,321,339,339,53,339,4,4,2,442,1,730,227748,4,339
2012-11-08,winter,2012,November,17,Thursday,Workingday,Clear,0.4,0.4091,0.2,0.2985,36,556,592,592,53,592,4,4,2,442,2,730,336860,4,592
2012-11-08,winter,2012,November,18,Thursday,Workingday,Clear,0.4,0.4091,0.24,0.4179,16,491,507,507,53,507,4,4,2,442,2,728,309772,4,507
2012-11-08,winter,2012,November,19,Thursday,Workingday,Clear,0.38,0.3939,0.27,0.3582,14,359,373,373,53,373,4,4,2,442,1,728,226789,4,373
2012-11-08,winter,2012,November,20,Thursday,Workingday,Clear,0.38,0.3939,0.29,0.4627,10,235,245,245,53,245,4,3,2,432,1,728,164550,4,245
2012-11-08,winter,2012,November,21,Thursday,Workingday,Clear,0.36,0.3333,0.37,0.3881,11,222,233,233,53,233,4,3,1,431,1,728,125445,4,233
2012-11-08,winter,2012,November,22,Thursday,Workingday,Clear,0.34,0.303,0.42,0.2985,14,147,161,161,53,161,4,3,1,431,1,728,95612,4,161
2012-11-08,winter,2012,November,23,Thursday,Workingday,Clear,0.34,0.303,0.46,0.3582,5,82,87,87,53,87,4,2,1,421,1,728,63941,4,87
2012-11-09,winter,2012,November,0,Friday,Workingday,Clear,0.34,0.303,0.49,0.3284,9,46,55,55,52,55,4,2,1,421,1,726,39130,4,55
2012-11-09,winter,2012,November,1,Friday,Workingday,Clear,0.32,0.303,0.53,0.2836,3,17,20,20,52,20,4,1,1,411,1,724,24164,4,20
2012-11-09,winter,2012,November,2,Friday,Workingday,Clear,0.32,0.303,0.53,0.2537,1,11,12,12,52,12,4,1,1,411,1,715,16352,4,12
2012-11-09,winter,2012,November,3,Friday,Workingday,Clear,0.32,0.2879,0.53,0.4179,3,6,9,9,52,9,4,1,1,411,1,697,8174,4,9
2012-11-09,winter,2012,November,4,Friday,Workingday,Clear,0.32,0.2879,0.53,0.3582,0,14,14,14,52,14,4,1,1,411,1,697,4428,4,14
2012-11-09,winter,2012,November,5,Friday,Workingday,Clear,0.3,0.2879,0.56,0.194,2,25,27,27,52,27,4,1,1,411,1,717,14261,4,27
2012-11-09,winter,2012,November,6,Friday,Workingday,Clear,0.26,0.2727,0.65,0.1045,5,126,131,131,52,131,4,2,1,421,1,725,55132,4,131
2012-11-09,winter,2012,November,7,Friday,Workingday,Clear,0.26,0.2727,0.65,0.1343,9,332,341,341,52,341,4,4,1,441,1,727,154171,4,341
2012-11-09,winter,2012,November,8,Friday,Workingday,Clear,0.32,0.3182,0.57,0.1642,25,668,693,693,52,693,4,4,1,441,1,727,261001,4,693
2012-11-09,winter,2012,November,9,Friday,Workingday,Clear,0.34,0.303,0.53,0.4179,23,304,327,327,52,327,4,4,1,441,1,727,159438,4,327
2012-11-09,winter,2012,November,10,Friday,Workingday,Clear,0.36,0.3333,0.5,0.3284,34,163,197,197,52,197,4,3,1,431,1,727,126257,4,197
2012-11-09,winter,2012,November,11,Friday,Workingday,Clear,0.4,0.4091,0.47,0.2985,66,185,251,251,52,251,4,3,2,432,1,727,151320,4,251
2012-11-09,winter,2012,November,12,Friday,Workingday,Clear,0.44,0.4394,0.41,0.3284,48,214,262,262,52,262,4,3,2,432,1,728,184414,4,262
2012-11-09,winter,2012,November,13,Friday,Workingday,Clear,0.46,0.4545,0.38,0.2985,62,237,299,299,52,299,4,4,2,442,2,729,184919,4,299
2012-11-09,winter,2012,November,14,Friday,Workingday,Clear,0.46,0.4545,0.38,0.194,67,207,274,274,52,274,4,3,2,432,2,729,175652,4,274
2012-11-09,winter,2012,November,15,Friday,Workingday,Clear,0.46,0.4545,0.36,0.2239,78,278,356,356,52,356,4,4,2,442,2,729,183149,4,356
2012-11-09,winter,2012,November,16,Friday,Workingday,Clear,0.46,0.4545,0.38,0.1642,57,377,434,434,52,434,4,4,2,442,2,730,227748,4,434
2012-11-09,winter,2012,November,17,Friday,Workingday,Clear,0.42,0.4242,0.44,0.1343,61,593,654,654,52,654,4,4,2,442,2,730,336860,4,654
2012-11-09,winter,2012,November,18,Friday,Workingday,Clear,0.42,0.4242,0.44,0.1045,46,450,496,496,52,496,4,4,2,442,2,728,309772,4,496
2012-11-09,winter,2012,November,19,Friday,Workingday,Clear,0.34,0.3485,0.71,0.0896,30,331,361,361,52,361,4,4,2,442,1,728,226789,4,361
2012-11-09,winter,2012,November,20,Friday,Workingday,Clear,0.36,0.3485,0.66,0.1343,20,235,255,255,52,255,4,3,2,432,1,728,164550,4,255
2012-11-09,winter,2012,November,21,Friday,Workingday,Clear,0.34,0.3636,0.76,0.0,23,176,199,199,52,199,4,3,2,432,0,728,125445,4,199
2012-11-09,winter,2012,November,22,Friday,Workingday,Clear,0.34,0.3485,0.71,0.1045,17,146,163,163,52,163,4,3,2,432,1,728,95612,4,163
2012-11-09,winter,2012,November,23,Friday,Workingday,Clear,0.32,0.3333,0.81,0.0896,20,142,162,162,52,162,4,3,1,431,1,728,63941,4,162
2012-11-10,winter,2012,November,0,Saturday,Holiday,Clear,0.32,0.3333,0.76,0.0896,16,106,122,122,51,122,4,2,1,421,1,726,39130,4,122
2012-11-10,winter,2012,November,1,Saturday,Holiday,Clear,0.3,0.3182,0.81,0.0896,8,68,76,76,51,76,4,2,1,421,1,724,24164,4,76
2012-11-10,winter,2012,November,2,Saturday,Holiday,Clear,0.32,0.3485,0.81,0.0,2,42,44,44,51,44,4,2,2,422,0,715,16352,4,44
2012-11-10,winter,2012,November,3,Saturday,Holiday,Clear,0.3,0.3333,0.81,0.0,9,11,20,20,51,20,4,1,1,411,1,697,8174,4,20
2012-11-10,winter,2012,November,4,Saturday,Holiday,Clear,0.26,0.2727,0.87,0.1045,2,4,6,6,51,6,4,1,1,411,1,697,4428,4,6
2012-11-10,winter,2012,November,5,Saturday,Holiday,Clear,0.28,0.3182,0.87,0.0,1,9,10,10,51,10,4,1,1,411,1,717,14261,4,10
2012-11-10,winter,2012,November,6,Saturday,Holiday,Clear,0.24,0.2576,0.93,0.0896,5,11,16,16,51,16,4,1,1,411,1,725,55132,4,16
2012-11-10,winter,2012,November,7,Saturday,Holiday,Clear,0.26,0.2727,0.87,0.1045,14,57,71,71,51,71,4,2,1,421,1,727,154171,4,71
2012-11-10,winter,2012,November,8,Saturday,Holiday,Clear,0.32,0.3485,0.76,0.0,16,130,146,146,51,146,4,3,2,432,1,727,261001,4,146
2012-11-10,winter,2012,November,9,Saturday,Holiday,Clear,0.36,0.3485,0.66,0.194,43,216,259,259,51,259,4,3,2,432,1,727,159438,4,259
2012-11-10,winter,2012,November,10,Saturday,Holiday,Clear,0.4,0.4091,0.58,0.0,86,264,350,350,51,350,4,4,2,442,0,727,126257,4,350
2012-11-10,winter,2012,November,11,Saturday,Holiday,Clear,0.4,0.4091,0.58,0.1045,143,323,466,466,51,466,4,4,2,442,2,727,151320,4,466
2012-11-10,winter,2012,November,12,Saturday,Holiday,Clear,0.48,0.4697,0.48,0.0,258,348,606,606,51,606,4,4,2,442,2,728,184414,4,606
2012-11-10,winter,2012,November,13,Saturday,Holiday,Clear,0.52,0.5,0.39,0.0,268,383,651,651,51,651,4,4,3,443,2,729,184919,4,651
2012-11-10,winter,2012,November,14,Saturday,Holiday,Clear,0.54,0.5152,0.37,0.0,280,347,627,627,51,627,4,4,3,443,2,729,175652,4,627
2012-11-10,winter,2012,November,15,Saturday,Holiday,Clear,0.52,0.5,0.45,0.0,216,351,567,567,51,567,4,4,3,443,2,729,183149,4,567
2012-11-10,winter,2012,November,16,Saturday,Holiday,Clear,0.54,0.5152,0.37,0.0,227,378,605,605,51,605,4,4,3,443,2,730,227748,4,605
2012-11-10,winter,2012,November,17,Saturday,Holiday,Clear,0.5,0.4848,0.45,0.194,183,318,501,501,51,501,4,4,2,442,2,730,336860,4,501
2012-11-10,winter,2012,November,18,Saturday,Holiday,Clear,0.44,0.4394,0.54,0.1343,103,256,359,359,51,359,4,4,2,442,2,728,309772,4,359
2012-11-10,winter,2012,November,19,Saturday,Holiday,Clear,0.46,0.4545,0.51,0.0896,55,228,283,283,51,283,4,4,2,442,0,728,226789,4,283
2012-11-10,winter,2012,November,20,Saturday,Holiday,Clear,0.44,0.4394,0.54,0.0,39,153,192,192,51,192,4,3,2,432,0,728,164550,4,192
2012-11-10,winter,2012,November,21,Saturday,Holiday,Clear,0.4,0.4091,0.66,0.0,51,169,220,220,51,220,4,3,2,432,0,728,125445,4,220
2012-11-10,winter,2012,November,22,Saturday,Holiday,Clear,0.38,0.3939,0.71,0.0896,39,154,193,193,51,193,4,3,2,432,0,728,95612,4,193
2012-11-10,winter,2012,November,23,Saturday,Holiday,Clear,0.36,0.3636,0.71,0.1045,26,120,146,146,51,146,4,3,2,432,1,728,63941,4,146
2012-11-11,winter,2012,November,0,Sunday,Holiday,Clear,0.34,0.3485,0.81,0.0896,14,110,124,124,50,124,4,2,2,422,1,726,39130,4,124
2012-11-11,winter,2012,November,1,Sunday,Holiday,Clear,0.34,0.3485,0.76,0.0896,26,82,108,108,50,108,4,2,2,422,1,724,24164,4,108
2012-11-11,winter,2012,November,2,Sunday,Holiday,Clear,0.32,0.3333,0.87,0.1045,12,58,70,70,50,70,4,2,1,421,1,715,16352,4,70
2012-11-11,winter,2012,November,3,Sunday,Holiday,Clear,0.34,0.3636,0.81,0.0,9,39,48,48,50,48,4,2,2,422,0,697,8174,4,48
2012-11-11,winter,2012,November,4,Sunday,Holiday,Clear,0.32,0.3333,0.81,0.1045,5,6,11,11,50,11,4,1,1,411,1,697,4428,4,11
2012-11-11,winter,2012,November,5,Sunday,Holiday,Clear,0.3,0.303,0.87,0.1343,0,12,12,12,50,12,4,1,1,411,1,717,14261,4,12
2012-11-11,winter,2012,November,6,Sunday,Holiday,Clear,0.3,0.3182,0.87,0.0896,3,16,19,19,50,19,4,1,1,411,1,725,55132,4,19
2012-11-11,winter,2012,November,7,Sunday,Holiday,Clear,0.3,0.3182,0.89,0.0896,12,56,68,68,50,68,4,2,1,421,1,727,154171,4,68
2012-11-11,winter,2012,November,8,Sunday,Holiday,Clear,0.32,0.3333,0.87,0.1045,32,87,119,119,50,119,4,2,1,421,1,727,261001,4,119
2012-11-11,winter,2012,November,9,Sunday,Holiday,Clear,0.36,0.3788,0.77,0.0,94,179,273,273,50,273,4,3,2,432,0,727,159438,4,273
2012-11-11,winter,2012,November,10,Sunday,Holiday,Clear,0.4,0.4091,0.69,0.1045,133,272,405,405,50,405,4,4,2,442,2,727,126257,4,405
2012-11-11,winter,2012,November,11,Sunday,Holiday,Clear,0.46,0.4545,0.59,0.1343,180,324,504,504,50,504,4,4,2,442,2,727,151320,4,504
2012-11-11,winter,2012,November,12,Sunday,Holiday,Clear,0.5,0.4848,0.48,0.0896,195,390,585,585,50,585,4,4,2,442,2,728,184414,4,585
2012-11-11,winter,2012,November,13,Sunday,Holiday,Clear,0.54,0.5152,0.45,0.1045,262,424,686,686,50,686,4,4,3,443,2,729,184919,4,686
2012-11-11,winter,2012,November,14,Sunday,Holiday,Clear,0.6,0.6212,0.33,0.1642,292,362,654,654,50,654,4,4,3,443,2,729,175652,4,654
2012-11-11,winter,2012,November,15,Sunday,Holiday,Clear,0.56,0.5303,0.37,0.2239,304,420,724,724,50,724,4,4,3,443,2,729,183149,4,724
2012-11-11,winter,2012,November,16,Sunday,Holiday,Clear,0.54,0.5152,0.42,0.2239,260,393,653,653,50,653,4,4,3,443,2,730,227748,4,653
2012-11-11,winter,2012,November,17,Sunday,Holiday,Clear,0.54,0.5152,0.45,0.1642,151,342,493,493,50,493,4,4,3,443,2,730,336860,4,493
2012-11-11,winter,2012,November,18,Sunday,Holiday,Clear,0.52,0.5,0.45,0.1343,102,303,405,405,50,405,4,4,3,443,2,728,309772,4,405
2012-11-11,winter,2012,November,19,Sunday,Holiday,Clear,0.48,0.4697,0.55,0.1343,69,208,277,277,50,277,4,3,2,432,2,728,226789,4,277
2012-11-11,winter,2012,November,20,Sunday,Holiday,Clear,0.44,0.4394,0.62,0.1642,54,146,200,200,50,200,4,3,2,432,0,728,164550,4,200
2012-11-11,winter,2012,November,21,Sunday,Holiday,Clear,0.44,0.4394,0.67,0.2239,44,127,171,171,50,171,4,3,2,432,0,728,125445,4,171
2012-11-11,winter,2012,November,22,Sunday,Holiday,Clear,0.42,0.4242,0.71,0.194,21,113,134,134,50,134,4,2,2,422,0,728,95612,4,134
2012-11-11,winter,2012,November,23,Sunday,Holiday,Clear,0.42,0.4242,0.71,0.194,16,93,109,109,50,109,4,2,2,422,0,728,63941,4,109
2012-11-12,winter,2012,November,0,Monday,Holiday,Clear,0.42,0.4242,0.71,0.1045,6,43,49,49,49,49,4,2,2,422,0,726,39130,4,49
2012-11-12,winter,2012,November,1,Monday,Holiday,Clear,0.4,0.4091,0.76,0.1642,4,26,30,30,49,30,4,1,2,412,0,724,24164,4,30
2012-11-12,winter,2012,November,2,Monday,Holiday,Clear,0.4,0.4091,0.76,0.1343,6,14,20,20,49,20,4,1,2,412,0,715,16352,4,20
2012-11-12,winter,2012,November,3,Monday,Holiday,Clear,0.4,0.4091,0.76,0.1343,1,3,4,4,49,4,4,1,2,412,0,697,8174,4,4
2012-11-12,winter,2012,November,4,Monday,Holiday,Clear,0.4,0.4091,0.76,0.0896,1,3,4,4,49,4,4,1,2,412,0,697,4428,4,4
2012-11-12,winter,2012,November,5,Monday,Holiday,Clear,0.38,0.3939,0.87,0.0,1,23,24,24,49,24,4,1,2,412,0,717,14261,4,24
2012-11-12,winter,2012,November,6,Monday,Holiday,Clear,0.38,0.3939,0.87,0.1045,7,64,71,71,49,71,4,2,2,422,0,725,55132,4,71
2012-11-12,winter,2012,November,7,Monday,Holiday,Clear,0.4,0.4091,0.87,0.0,16,248,264,264,49,264,4,3,2,432,0,727,154171,4,264
2012-11-12,winter,2012,November,8,Monday,Holiday,Clear,0.42,0.4242,0.82,0.1642,50,490,540,540,49,540,4,4,2,442,0,727,261001,4,540
2012-11-12,winter,2012,November,9,Monday,Holiday,Clear,0.44,0.4394,0.88,0.1045,60,337,397,397,49,397,4,4,2,442,0,727,159438,4,397
2012-11-12,winter,2012,November,10,Monday,Holiday,Clear,0.48,0.4697,0.77,0.1642,82,184,266,266,49,266,4,3,2,432,0,727,126257,4,266
2012-11-12,winter,2012,November,11,Monday,Holiday,Clear,0.52,0.5,0.72,0.1642,112,255,367,367,49,367,4,4,3,443,2,727,151320,4,367
2012-11-12,winter,2012,November,12,Monday,Holiday,Clear,0.56,0.5303,0.64,0.2239,105,314,419,419,49,419,4,4,3,443,2,728,184414,4,419
2012-11-12,winter,2012,November,13,Monday,Holiday,Clear,0.6,0.6061,0.6,0.2239,108,312,420,420,49,420,4,4,3,443,2,729,184919,4,420
2012-11-12,winter,2012,November,14,Monday,Holiday,Clear,0.58,0.5455,0.6,0.2836,134,310,444,444,49,444,4,4,3,443,2,729,175652,4,444
2012-11-12,winter,2012,November,15,Monday,Holiday,Clear,0.56,0.5303,0.64,0.2537,102,280,382,382,49,382,4,4,3,443,2,729,183149,4,382
2012-11-12,winter,2012,November,16,Monday,Holiday,Clear,0.56,0.5303,0.64,0.1642,87,347,434,434,49,434,4,4,3,443,2,730,227748,4,434
2012-11-12,winter,2012,November,17,Monday,Holiday,Clear,0.56,0.5303,0.64,0.2836,66,530,596,596,49,596,4,4,3,443,2,730,336860,4,596
2012-11-12,winter,2012,November,18,Monday,Holiday,Clear,0.52,0.5,0.72,0.1343,65,486,551,551,49,551,4,4,3,443,2,728,309772,4,551
2012-11-12,winter,2012,November,19,Monday,Holiday,Clear,0.54,0.5152,0.73,0.2836,30,323,353,353,49,353,4,4,3,443,0,728,226789,4,353
2012-11-12,winter,2012,November,20,Monday,Holiday,Mist,0.52,0.5,0.77,0.2836,31,273,304,304,49,304,4,4,3,443,0,728,164550,4,304
2012-11-12,winter,2012,November,21,Monday,Holiday,Light Snow,0.54,0.5152,0.73,0.2239,10,145,155,155,49,155,4,3,3,433,0,728,125445,4,155
2012-11-12,winter,2012,November,22,Monday,Holiday,Clear,0.52,0.5,0.77,0.2537,12,100,112,112,49,112,4,2,3,423,0,728,95612,4,112
2012-11-12,winter,2012,November,23,Monday,Holiday,Mist,0.54,0.5152,0.77,0.2239,1,62,63,63,49,63,4,2,3,423,0,728,63941,4,63
2012-11-13,winter,2012,November,0,Tuesday,Workingday,Mist,0.52,0.5,0.83,0.2836,5,18,23,23,48,23,4,1,3,413,0,726,39130,4,23
2012-11-13,winter,2012,November,1,Tuesday,Workingday,Light Snow,0.44,0.4394,0.88,0.6418,0,5,5,5,48,5,4,1,2,412,1,724,24164,4,5
2012-11-13,winter,2012,November,2,Tuesday,Workingday,Light Snow,0.36,0.3182,0.87,0.4478,7,4,11,11,48,11,4,1,1,411,1,715,16352,4,11
2012-11-13,winter,2012,November,3,Tuesday,Workingday,Light Snow,0.36,0.3333,0.87,0.3582,2,3,5,5,48,5,4,1,1,411,1,697,8174,4,5
2012-11-13,winter,2012,November,4,Tuesday,Workingday,Mist,0.36,0.3333,0.81,0.3881,0,9,9,9,48,9,4,1,1,411,1,697,4428,4,9
2012-11-13,winter,2012,November,5,Tuesday,Workingday,Mist,0.34,0.3182,0.87,0.2836,0,18,18,18,48,18,4,1,1,411,1,717,14261,4,18
2012-11-13,winter,2012,November,6,Tuesday,Workingday,Light Snow,0.32,0.2879,0.81,0.4627,2,48,50,50,48,50,4,2,1,421,1,725,55132,4,50
2012-11-13,winter,2012,November,7,Tuesday,Workingday,Light Snow,0.32,0.303,0.87,0.2537,1,106,107,107,48,107,4,2,1,421,1,727,154171,4,107
2012-11-13,winter,2012,November,8,Tuesday,Workingday,Light Snow,0.32,0.303,0.87,0.2537,4,207,211,211,48,211,4,3,1,431,1,727,261001,4,211
2012-11-13,winter,2012,November,9,Tuesday,Workingday,Light Snow,0.32,0.303,0.81,0.3284,1,109,110,110,48,110,4,2,1,421,1,727,159438,4,110
2012-11-13,winter,2012,November,10,Tuesday,Workingday,Light Snow,0.3,0.2727,0.75,0.3881,10,84,94,94,48,94,4,2,1,421,1,727,126257,4,94
2012-11-13,winter,2012,November,11,Tuesday,Workingday,Clear,0.32,0.303,0.7,0.2537,22,133,155,155,48,155,4,3,1,431,1,727,151320,4,155
2012-11-13,winter,2012,November,12,Tuesday,Workingday,Clear,0.34,0.3182,0.61,0.2836,16,180,196,196,48,196,4,3,1,431,1,728,184414,4,196
2012-11-13,winter,2012,November,13,Tuesday,Workingday,Clear,0.34,0.3182,0.53,0.2537,30,188,218,218,48,218,4,3,1,431,1,729,184919,4,218
2012-11-13,winter,2012,November,14,Tuesday,Workingday,Clear,0.38,0.3939,0.46,0.3881,34,169,203,203,48,203,4,3,2,432,1,729,175652,4,203
2012-11-13,winter,2012,November,15,Tuesday,Workingday,Clear,0.4,0.4091,0.4,0.2985,33,184,217,217,48,217,4,3,2,432,1,729,183149,4,217
2012-11-13,winter,2012,November,16,Tuesday,Workingday,Clear,0.38,0.3939,0.4,0.2985,28,282,310,310,48,310,4,4,2,442,1,730,227748,4,310
2012-11-13,winter,2012,November,17,Tuesday,Workingday,Clear,0.34,0.303,0.49,0.3582,33,575,608,608,48,608,4,4,1,441,1,730,336860,4,608
2012-11-13,winter,2012,November,18,Tuesday,Workingday,Clear,0.34,0.3182,0.49,0.2836,45,514,559,559,48,559,4,4,1,441,1,728,309772,4,559
2012-11-13,winter,2012,November,19,Tuesday,Workingday,Clear,0.32,0.2879,0.49,0.3582,12,344,356,356,48,356,4,4,1,441,1,728,226789,4,356
2012-11-13,winter,2012,November,20,Tuesday,Workingday,Clear,0.3,0.2727,0.49,0.3582,12,211,223,223,48,223,4,3,1,431,1,728,164550,4,223
2012-11-13,winter,2012,November,21,Tuesday,Workingday,Clear,0.3,0.2727,0.49,0.3582,9,178,187,187,48,187,4,3,1,431,1,728,125445,4,187
2012-11-13,winter,2012,November,22,Tuesday,Workingday,Clear,0.26,0.2273,0.56,0.3284,15,120,135,135,48,135,4,2,1,421,1,728,95612,4,135
2012-11-13,winter,2012,November,23,Tuesday,Workingday,Clear,0.26,0.2273,0.56,0.2985,6,78,84,84,48,84,4,2,1,421,1,728,63941,4,84
2012-11-14,winter,2012,November,0,Wednesday,Workingday,Clear,0.26,0.2424,0.56,0.2836,4,20,24,24,47,24,4,1,1,411,1,726,39130,4,24
2012-11-14,winter,2012,November,1,Wednesday,Workingday,Clear,0.24,0.2121,0.6,0.2985,2,10,12,12,47,12,4,1,1,411,1,724,24164,4,12
2012-11-14,winter,2012,November,2,Wednesday,Workingday,Clear,0.24,0.2121,0.6,0.2985,0,1,1,1,47,1,4,1,1,411,1,715,16352,4,1
2012-11-14,winter,2012,November,3,Wednesday,Workingday,Clear,0.24,0.2273,0.65,0.2239,0,5,5,5,47,5,4,1,1,411,1,697,8174,4,5
2012-11-14,winter,2012,November,4,Wednesday,Workingday,Clear,0.22,0.2273,0.69,0.194,0,6,6,6,47,6,4,1,1,411,1,697,4428,4,6
2012-11-14,winter,2012,November,5,Wednesday,Workingday,Clear,0.22,0.2273,0.69,0.194,0,39,39,39,47,39,4,1,1,411,1,717,14261,4,39
2012-11-14,winter,2012,November,6,Wednesday,Workingday,Clear,0.24,0.2273,0.65,0.194,4,142,146,146,47,146,4,3,1,431,1,725,55132,4,146
2012-11-14,winter,2012,November,7,Wednesday,Workingday,Clear,0.24,0.2121,0.65,0.2836,10,405,415,415,47,415,4,4,1,441,1,727,154171,4,415
2012-11-14,winter,2012,November,8,Wednesday,Workingday,Clear,0.28,0.2576,0.56,0.2985,27,664,691,691,47,691,4,4,1,441,1,727,261001,4,691
2012-11-14,winter,2012,November,9,Wednesday,Workingday,Clear,0.3,0.2727,0.52,0.3881,22,310,332,332,47,332,4,4,1,441,1,727,159438,4,332
2012-11-14,winter,2012,November,10,Wednesday,Workingday,Clear,0.32,0.2879,0.45,0.3582,18,153,171,171,47,171,4,3,1,431,1,727,126257,4,171
2012-11-14,winter,2012,November,11,Wednesday,Workingday,Clear,0.32,0.303,0.49,0.2537,25,126,151,151,47,151,4,3,1,431,1,727,151320,4,151
2012-11-14,winter,2012,November,12,Wednesday,Workingday,Clear,0.34,0.3333,0.46,0.0,40,200,240,240,47,240,4,3,1,431,1,728,184414,4,240
2012-11-14,winter,2012,November,13,Wednesday,Workingday,Clear,0.36,0.3333,0.43,0.2537,32,182,214,214,47,214,4,3,1,431,1,729,184919,4,214
2012-11-14,winter,2012,November,14,Wednesday,Workingday,Clear,0.36,0.3485,0.43,0.1343,20,161,181,181,47,181,4,3,2,432,1,729,175652,4,181
2012-11-14,winter,2012,November,15,Wednesday,Workingday,Clear,0.36,0.3333,0.43,0.2836,32,228,260,260,47,260,4,3,1,431,1,729,183149,4,260
2012-11-14,winter,2012,November,16,Wednesday,Workingday,Clear,0.34,0.3485,0.46,0.1045,31,290,321,321,47,321,4,4,2,442,1,730,227748,4,321
2012-11-14,winter,2012,November,17,Wednesday,Workingday,Clear,0.32,0.3182,0.49,0.194,19,564,583,583,47,583,4,4,1,441,1,730,336860,4,583
2012-11-14,winter,2012,November,18,Wednesday,Workingday,Clear,0.32,0.3182,0.53,0.1642,24,543,567,567,47,567,4,4,1,441,1,728,309772,4,567
2012-11-14,winter,2012,November,19,Wednesday,Workingday,Clear,0.3,0.303,0.52,0.1642,28,368,396,396,47,396,4,4,1,441,1,728,226789,4,396
2012-11-14,winter,2012,November,20,Wednesday,Workingday,Clear,0.3,0.3182,0.52,0.0896,15,252,267,267,47,267,4,3,1,431,1,728,164550,4,267
2012-11-14,winter,2012,November,21,Wednesday,Workingday,Clear,0.3,0.3333,0.56,0.0,5,208,213,213,47,213,4,3,1,431,1,728,125445,4,213
2012-11-14,winter,2012,November,22,Wednesday,Workingday,Clear,0.28,0.3182,0.61,0.0,6,167,173,173,47,173,4,3,1,431,1,728,95612,4,173
2012-11-14,winter,2012,November,23,Wednesday,Workingday,Clear,0.24,0.2424,0.7,0.1343,9,78,87,87,47,87,4,2,1,421,1,728,63941,4,87
2012-11-15,winter,2012,November,0,Thursday,Workingday,Mist,0.26,0.303,0.65,0.0,1,33,34,34,46,34,4,1,1,411,1,726,39130,4,34
2012-11-15,winter,2012,November,1,Thursday,Workingday,Mist,0.26,0.2727,0.65,0.1045,2,14,16,16,46,16,4,1,1,411,1,724,24164,4,16
2012-11-15,winter,2012,November,2,Thursday,Workingday,Mist,0.26,0.2576,0.7,0.1642,0,7,7,7,46,7,4,1,1,411,1,715,16352,4,7
2012-11-15,winter,2012,November,3,Thursday,Workingday,Mist,0.26,0.2879,0.7,0.0896,0,2,2,2,46,2,4,1,1,411,1,697,8174,4,2
2012-11-15,winter,2012,November,4,Thursday,Workingday,Mist,0.28,0.2879,0.65,0.1343,0,5,5,5,46,5,4,1,1,411,1,697,4428,4,5
2012-11-15,winter,2012,November,5,Thursday,Workingday,Mist,0.3,0.2879,0.61,0.2239,3,34,37,37,46,37,4,1,1,411,1,717,14261,4,37
2012-11-15,winter,2012,November,6,Thursday,Workingday,Mist,0.3,0.2879,0.65,0.2537,1,146,147,147,46,147,4,3,1,431,1,725,55132,4,147
2012-11-15,winter,2012,November,7,Thursday,Workingday,Mist,0.3,0.2879,0.65,0.194,7,403,410,410,46,410,4,4,1,441,1,727,154171,4,410
2012-11-15,winter,2012,November,8,Thursday,Workingday,Mist,0.3,0.2879,0.61,0.2239,21,625,646,646,46,646,4,4,1,441,1,727,261001,4,646
2012-11-15,winter,2012,November,9,Thursday,Workingday,Mist,0.32,0.3182,0.61,0.194,17,306,323,323,46,323,4,4,1,441,1,727,159438,4,323
2012-11-15,winter,2012,November,10,Thursday,Workingday,Mist,0.32,0.3333,0.66,0.1343,11,142,153,153,46,153,4,3,1,431,1,727,126257,4,153
2012-11-15,winter,2012,November,11,Thursday,Workingday,Mist,0.34,0.3333,0.61,0.1343,28,138,166,166,46,166,4,3,1,431,1,727,151320,4,166
2012-11-15,winter,2012,November,12,Thursday,Workingday,Mist,0.36,0.3636,0.62,0.1045,29,184,213,213,46,213,4,3,2,432,1,728,184414,4,213
2012-11-15,winter,2012,November,13,Thursday,Workingday,Mist,0.38,0.3939,0.54,0.1045,20,197,217,217,46,217,4,3,2,432,1,729,184919,4,217
2012-11-15,winter,2012,November,14,Thursday,Workingday,Mist,0.38,0.3939,0.54,0.1642,27,174,201,201,46,201,4,3,2,432,1,729,175652,4,201
2012-11-15,winter,2012,November,15,Thursday,Workingday,Mist,0.38,0.3939,0.58,0.1642,26,191,217,217,46,217,4,3,2,432,1,729,183149,4,217
2012-11-15,winter,2012,November,16,Thursday,Workingday,Mist,0.36,0.3485,0.57,0.194,24,318,342,342,46,342,4,4,2,442,1,730,227748,4,342
2012-11-15,winter,2012,November,17,Thursday,Workingday,Mist,0.36,0.3485,0.57,0.2239,22,541,563,563,46,563,4,4,2,442,1,730,336860,4,563
2012-11-15,winter,2012,November,18,Thursday,Workingday,Mist,0.36,0.3485,0.57,0.194,10,563,573,573,46,573,4,4,2,442,1,728,309772,4,573
2012-11-15,winter,2012,November,19,Thursday,Workingday,Mist,0.34,0.3333,0.61,0.1343,11,375,386,386,46,386,4,4,1,441,1,728,226789,4,386
2012-11-15,winter,2012,November,20,Thursday,Workingday,Clear,0.34,0.3485,0.61,0.1045,23,262,285,285,46,285,4,4,2,442,1,728,164550,4,285
2012-11-15,winter,2012,November,21,Thursday,Workingday,Mist,0.32,0.3333,0.66,0.1045,20,204,224,224,46,224,4,3,1,431,1,728,125445,4,224
2012-11-15,winter,2012,November,22,Thursday,Workingday,Mist,0.32,0.3182,0.66,0.1642,10,143,153,153,46,153,4,3,1,431,1,728,95612,4,153
2012-11-15,winter,2012,November,23,Thursday,Workingday,Mist,0.32,0.3182,0.61,0.1642,7,118,125,125,46,125,4,2,1,421,1,728,63941,4,125
2012-11-16,winter,2012,November,0,Friday,Workingday,Mist,0.32,0.3333,0.66,0.1045,7,58,65,65,45,65,4,2,1,421,1,726,39130,4,65
2012-11-16,winter,2012,November,1,Friday,Workingday,Mist,0.3,0.3182,0.65,0.0896,5,16,21,21,45,21,4,1,1,411,1,724,24164,4,21
2012-11-16,winter,2012,November,2,Friday,Workingday,Mist,0.3,0.303,0.7,0.1642,0,9,9,9,45,9,4,1,1,411,1,715,16352,4,9
2012-11-16,winter,2012,November,3,Friday,Workingday,Mist,0.3,0.303,0.65,0.1343,0,6,6,6,45,6,4,1,1,411,1,697,8174,4,6
2012-11-16,winter,2012,November,4,Friday,Workingday,Mist,0.3,0.3182,0.65,0.1045,0,5,5,5,45,5,4,1,1,411,1,697,4428,4,5
2012-11-16,winter,2012,November,5,Friday,Workingday,Mist,0.3,0.3182,0.65,0.0896,2,34,36,36,45,36,4,1,1,411,1,717,14261,4,36
2012-11-16,winter,2012,November,6,Friday,Workingday,Mist,0.3,0.3182,0.61,0.0896,4,126,130,130,45,130,4,2,1,421,1,725,55132,4,130
2012-11-16,winter,2012,November,7,Friday,Workingday,Mist,0.3,0.303,0.61,0.1642,5,362,367,367,45,367,4,4,1,441,1,727,154171,4,367
2012-11-16,winter,2012,November,8,Friday,Workingday,Mist,0.32,0.3333,0.57,0.1343,17,694,711,711,45,711,4,4,1,441,1,727,261001,4,711
2012-11-16,winter,2012,November,9,Friday,Workingday,Clear,0.34,0.3485,0.53,0.1045,21,330,351,351,45,351,4,4,2,442,1,727,159438,4,351
2012-11-16,winter,2012,November,10,Friday,Workingday,Clear,0.34,0.3333,0.53,0.194,33,165,198,198,45,198,4,3,1,431,1,727,126257,4,198
2012-11-16,winter,2012,November,11,Friday,Workingday,Clear,0.38,0.3939,0.43,0.2239,33,185,218,218,45,218,4,3,2,432,1,727,151320,4,218
2012-11-16,winter,2012,November,12,Friday,Workingday,Clear,0.4,0.4091,0.43,0.2836,28,262,290,290,45,290,4,4,2,442,1,728,184414,4,290
2012-11-16,winter,2012,November,13,Friday,Workingday,Clear,0.42,0.4242,0.38,0.194,52,226,278,278,45,278,4,3,2,432,1,729,184919,4,278
2012-11-16,winter,2012,November,14,Friday,Workingday,Clear,0.42,0.4242,0.35,0.1045,47,204,251,251,45,251,4,3,2,432,1,729,175652,4,251
2012-11-16,winter,2012,November,15,Friday,Workingday,Clear,0.42,0.4242,0.38,0.1343,30,237,267,267,45,267,4,3,2,432,1,729,183149,4,267
2012-11-16,winter,2012,November,16,Friday,Workingday,Clear,0.42,0.4242,0.35,0.2836,33,350,383,383,45,383,4,4,2,442,1,730,227748,4,383
2012-11-16,winter,2012,November,17,Friday,Workingday,Clear,0.36,0.3485,0.46,0.194,41,539,580,580,45,580,4,4,2,442,2,730,336860,4,580
2012-11-16,winter,2012,November,18,Friday,Workingday,Clear,0.34,0.3333,0.53,0.1642,22,483,505,505,45,505,4,4,1,441,1,728,309772,4,505
2012-11-16,winter,2012,November,19,Friday,Workingday,Clear,0.36,0.3485,0.46,0.2239,26,306,332,332,45,332,4,4,2,442,1,728,226789,4,332
2012-11-16,winter,2012,November,20,Friday,Workingday,Clear,0.36,0.3333,0.46,0.2537,20,207,227,227,45,227,4,3,1,431,1,728,164550,4,227
2012-11-16,winter,2012,November,21,Friday,Workingday,Clear,0.34,0.3333,0.49,0.194,21,157,178,178,45,178,4,3,1,431,1,728,125445,4,178
2012-11-16,winter,2012,November,22,Friday,Workingday,Clear,0.32,0.303,0.53,0.2537,23,139,162,162,45,162,4,3,1,431,1,728,95612,4,162
2012-11-16,winter,2012,November,23,Friday,Workingday,Clear,0.32,0.303,0.53,0.2239,14,114,128,128,45,128,4,2,1,421,1,728,63941,4,128
2012-11-17,winter,2012,November,0,Saturday,Holiday,Clear,0.3,0.303,0.52,0.1642,11,95,106,106,44,106,4,2,1,421,1,726,39130,4,106
2012-11-17,winter,2012,November,1,Saturday,Holiday,Clear,0.26,0.2576,0.6,0.194,13,74,87,87,44,87,4,2,1,421,1,724,24164,4,87
2012-11-17,winter,2012,November,2,Saturday,Holiday,Clear,0.26,0.2576,0.65,0.194,8,41,49,49,44,49,4,2,1,421,1,715,16352,4,49
2012-11-17,winter,2012,November,3,Saturday,Holiday,Clear,0.26,0.2576,0.65,0.194,2,19,21,21,44,21,4,1,1,411,1,697,8174,4,21
2012-11-17,winter,2012,November,4,Saturday,Holiday,Clear,0.24,0.2273,0.7,0.194,1,6,7,7,44,7,4,1,1,411,1,697,4428,4,7
2012-11-17,winter,2012,November,5,Saturday,Holiday,Clear,0.24,0.2424,0.7,0.1642,1,10,11,11,44,11,4,1,1,411,1,717,14261,4,11
2012-11-17,winter,2012,November,6,Saturday,Holiday,Clear,0.24,0.2273,0.7,0.2239,0,21,21,21,44,21,4,1,1,411,1,725,55132,4,21
2012-11-17,winter,2012,November,7,Saturday,Holiday,Clear,0.24,0.2273,0.7,0.194,8,70,78,78,44,78,4,2,1,421,1,727,154171,4,78
2012-11-17,winter,2012,November,8,Saturday,Holiday,Clear,0.26,0.2576,0.65,0.2239,30,138,168,168,44,168,4,3,1,431,1,727,261001,4,168
2012-11-17,winter,2012,November,9,Saturday,Holiday,Clear,0.34,0.3182,0.49,0.2239,48,200,248,248,44,248,4,3,1,431,1,727,159438,4,248
2012-11-17,winter,2012,November,10,Saturday,Holiday,Clear,0.36,0.3333,0.46,0.2537,62,258,320,320,44,320,4,4,1,441,1,727,126257,4,320
2012-11-17,winter,2012,November,11,Saturday,Holiday,Clear,0.38,0.3939,0.43,0.194,80,343,423,423,44,423,4,4,2,442,2,727,151320,4,423
2012-11-17,winter,2012,November,12,Saturday,Holiday,Clear,0.4,0.4091,0.4,0.1642,117,359,476,476,44,476,4,4,2,442,2,728,184414,4,476
2012-11-17,winter,2012,November,13,Saturday,Holiday,Clear,0.42,0.4242,0.38,0.2537,179,346,525,525,44,525,4,4,2,442,2,729,184919,4,525
2012-11-17,winter,2012,November,14,Saturday,Holiday,Clear,0.42,0.4242,0.38,0.194,175,380,555,555,44,555,4,4,2,442,2,729,175652,4,555
2012-11-17,winter,2012,November,15,Saturday,Holiday,Clear,0.42,0.4242,0.35,0.2985,175,374,549,549,44,549,4,4,2,442,2,729,183149,4,549
2012-11-17,winter,2012,November,16,Saturday,Holiday,Clear,0.4,0.4091,0.4,0.2239,144,325,469,469,44,469,4,4,2,442,2,730,227748,4,469
2012-11-17,winter,2012,November,17,Saturday,Holiday,Clear,0.38,0.3939,0.4,0.1642,101,302,403,403,44,403,4,4,2,442,2,730,336860,4,403
2012-11-17,winter,2012,November,18,Saturday,Holiday,Clear,0.36,0.3636,0.5,0.1045,34,237,271,271,44,271,4,3,2,432,1,728,309772,4,271
2012-11-17,winter,2012,November,19,Saturday,Holiday,Clear,0.34,0.3485,0.53,0.0896,45,208,253,253,44,253,4,3,2,432,1,728,226789,4,253
2012-11-17,winter,2012,November,20,Saturday,Holiday,Mist,0.34,0.3485,0.66,0.0896,30,142,172,172,44,172,4,3,2,432,1,728,164550,4,172
2012-11-17,winter,2012,November,21,Saturday,Holiday,Mist,0.32,0.3333,0.57,0.1045,15,124,139,139,44,139,4,2,1,421,1,728,125445,4,139
2012-11-17,winter,2012,November,22,Saturday,Holiday,Mist,0.32,0.3333,0.57,0.1045,15,130,145,145,44,145,4,3,1,431,1,728,95612,4,145
2012-11-17,winter,2012,November,23,Saturday,Holiday,Mist,0.3,0.3182,0.7,0.1045,19,114,133,133,44,133,4,2,1,421,1,728,63941,4,133
2012-11-18,winter,2012,November,0,Sunday,Holiday,Mist,0.3,0.303,0.7,0.1642,11,118,129,129,43,129,4,2,1,421,1,726,39130,4,129
2012-11-18,winter,2012,November,1,Sunday,Holiday,Clear,0.3,0.2879,0.7,0.194,14,81,95,95,43,95,4,2,1,421,1,724,24164,4,95
2012-11-18,winter,2012,November,2,Sunday,Holiday,Clear,0.28,0.2879,0.81,0.1045,8,65,73,73,43,73,4,2,1,421,1,715,16352,4,73
2012-11-18,winter,2012,November,3,Sunday,Holiday,Mist,0.3,0.303,0.81,0.1642,9,37,46,46,43,46,4,2,1,421,1,697,8174,4,46
2012-11-18,winter,2012,November,4,Sunday,Holiday,Mist,0.3,0.2879,0.81,0.194,4,8,12,12,43,12,4,1,1,411,1,697,4428,4,12
2012-11-18,winter,2012,November,5,Sunday,Holiday,Clear,0.28,0.2879,0.81,0.1343,5,7,12,12,43,12,4,1,1,411,1,717,14261,4,12
2012-11-18,winter,2012,November,6,Sunday,Holiday,Clear,0.28,0.2727,0.81,0.1642,2,13,15,15,43,15,4,1,1,411,1,725,55132,4,15
2012-11-18,winter,2012,November,7,Sunday,Holiday,Clear,0.28,0.2727,0.81,0.194,3,39,42,42,43,42,4,2,1,421,1,727,154171,4,42
2012-11-18,winter,2012,November,8,Sunday,Holiday,Clear,0.3,0.2879,0.75,0.2537,19,100,119,119,43,119,4,2,1,421,1,727,261001,4,119
2012-11-18,winter,2012,November,9,Sunday,Holiday,Clear,0.32,0.303,0.7,0.2537,49,155,204,204,43,204,4,3,1,431,1,727,159438,4,204
2012-11-18,winter,2012,November,10,Sunday,Holiday,Clear,0.34,0.303,0.66,0.2985,79,250,329,329,43,329,4,4,1,441,1,727,126257,4,329
2012-11-18,winter,2012,November,11,Sunday,Holiday,Clear,0.38,0.3939,0.62,0.2836,92,267,359,359,43,359,4,4,2,442,1,727,151320,4,359
2012-11-18,winter,2012,November,12,Sunday,Holiday,Clear,0.4,0.4091,0.62,0.2836,101,341,442,442,43,442,4,4,2,442,2,728,184414,4,442
2012-11-18,winter,2012,November,13,Sunday,Holiday,Clear,0.4,0.4091,0.62,0.3284,113,334,447,447,43,447,4,4,2,442,2,729,184919,4,447
2012-11-18,winter,2012,November,14,Sunday,Holiday,Clear,0.4,0.4091,0.62,0.2985,125,303,428,428,43,428,4,4,2,442,2,729,175652,4,428
2012-11-18,winter,2012,November,15,Sunday,Holiday,Clear,0.42,0.4242,0.54,0.2836,89,318,407,407,43,407,4,4,2,442,2,729,183149,4,407
2012-11-18,winter,2012,November,16,Sunday,Holiday,Mist,0.4,0.4091,0.62,0.3284,59,313,372,372,43,372,4,4,2,442,1,730,227748,4,372
2012-11-18,winter,2012,November,17,Sunday,Holiday,Mist,0.38,0.3939,0.66,0.2537,48,232,280,280,43,280,4,3,2,432,1,730,336860,4,280
2012-11-18,winter,2012,November,18,Sunday,Holiday,Clear,0.36,0.3485,0.66,0.2239,36,240,276,276,43,276,4,3,2,432,1,728,309772,4,276
2012-11-18,winter,2012,November,19,Sunday,Holiday,Clear,0.36,0.3485,0.66,0.1642,16,194,210,210,43,210,4,3,2,432,1,728,226789,4,210
2012-11-18,winter,2012,November,20,Sunday,Holiday,Clear,0.36,0.3485,0.66,0.1642,9,120,129,129,43,129,4,2,2,422,1,728,164550,4,129
2012-11-18,winter,2012,November,21,Sunday,Holiday,Clear,0.36,0.3333,0.66,0.2537,17,93,110,110,43,110,4,2,1,421,1,728,125445,4,110
2012-11-18,winter,2012,November,22,Sunday,Holiday,Mist,0.36,0.3333,0.66,0.2537,8,66,74,74,43,74,4,2,1,421,1,728,95612,4,74
2012-11-18,winter,2012,November,23,Sunday,Holiday,Clear,0.36,0.3485,0.66,0.2239,6,53,59,59,43,59,4,2,2,422,1,728,63941,4,59
2012-11-19,winter,2012,November,0,Monday,Workingday,Clear,0.36,0.3485,0.66,0.2239,5,22,27,27,42,27,4,1,2,412,1,726,39130,4,27
2012-11-19,winter,2012,November,1,Monday,Workingday,Mist,0.36,0.3485,0.66,0.2239,0,19,19,19,42,19,4,1,2,412,1,724,24164,4,19
2012-11-19,winter,2012,November,2,Monday,Workingday,Mist,0.36,0.3333,0.66,0.2537,0,5,5,5,42,5,4,1,1,411,1,715,16352,4,5
2012-11-19,winter,2012,November,3,Monday,Workingday,Mist,0.36,0.3485,0.66,0.2239,0,2,2,2,42,2,4,1,2,412,1,697,8174,4,2
2012-11-19,winter,2012,November,4,Monday,Workingday,Mist,0.36,0.3485,0.66,0.2239,1,11,12,12,42,12,4,1,2,412,1,697,4428,4,12
2012-11-19,winter,2012,November,5,Monday,Workingday,Mist,0.36,0.3485,0.66,0.2239,1,38,39,39,42,39,4,1,2,412,1,717,14261,4,39
2012-11-19,winter,2012,November,6,Monday,Workingday,Mist,0.36,0.3333,0.66,0.2537,3,128,131,131,42,131,4,2,1,421,1,725,55132,4,131
2012-11-19,winter,2012,November,7,Monday,Workingday,Mist,0.36,0.3333,0.66,0.2985,5,381,386,386,42,386,4,4,1,441,1,727,154171,4,386
2012-11-19,winter,2012,November,8,Monday,Workingday,Mist,0.36,0.3333,0.66,0.2985,13,650,663,663,42,663,4,4,1,441,1,727,261001,4,663
2012-11-19,winter,2012,November,9,Monday,Workingday,Mist,0.36,0.3333,0.66,0.2537,18,260,278,278,42,278,4,3,1,431,1,727,159438,4,278
2012-11-19,winter,2012,November,10,Monday,Workingday,Mist,0.36,0.3333,0.66,0.2537,33,106,139,139,42,139,4,2,1,421,1,727,126257,4,139
2012-11-19,winter,2012,November,11,Monday,Workingday,Mist,0.38,0.3939,0.66,0.2537,33,164,197,197,42,197,4,3,2,432,1,727,151320,4,197
2012-11-19,winter,2012,November,12,Monday,Workingday,Mist,0.4,0.4091,0.62,0.2836,35,207,242,242,42,242,4,3,2,432,1,728,184414,4,242
2012-11-19,winter,2012,November,13,Monday,Workingday,Clear,0.44,0.4394,0.54,0.2537,46,205,251,251,42,251,4,3,2,432,1,729,184919,4,251
2012-11-19,winter,2012,November,14,Monday,Workingday,Clear,0.44,0.4394,0.54,0.2537,47,170,217,217,42,217,4,3,2,432,1,729,175652,4,217
2012-11-19,winter,2012,November,15,Monday,Workingday,Clear,0.44,0.4394,0.54,0.194,44,213,257,257,42,257,4,3,2,432,1,729,183149,4,257
2012-11-19,winter,2012,November,16,Monday,Workingday,Clear,0.42,0.4242,0.58,0.2537,55,325,380,380,42,380,4,4,2,442,1,730,227748,4,380
2012-11-19,winter,2012,November,17,Monday,Workingday,Mist,0.42,0.4242,0.58,0.194,33,586,619,619,42,619,4,4,2,442,2,730,336860,4,619
2012-11-19,winter,2012,November,18,Monday,Workingday,Mist,0.4,0.4091,0.58,0.2537,21,559,580,580,42,580,4,4,2,442,2,728,309772,4,580
2012-11-19,winter,2012,November,19,Monday,Workingday,Mist,0.4,0.4091,0.58,0.2836,25,381,406,406,42,406,4,4,2,442,1,728,226789,4,406
2012-11-19,winter,2012,November,20,Monday,Workingday,Mist,0.38,0.3939,0.62,0.2537,7,252,259,259,42,259,4,3,2,432,1,728,164550,4,259
2012-11-19,winter,2012,November,21,Monday,Workingday,Mist,0.38,0.3939,0.54,0.2239,15,188,203,203,42,203,4,3,2,432,1,728,125445,4,203
2012-11-19,winter,2012,November,22,Monday,Workingday,Clear,0.34,0.3485,0.66,0.1045,7,106,113,113,42,113,4,2,2,422,1,728,95612,4,113
2012-11-19,winter,2012,November,23,Monday,Workingday,Clear,0.34,0.3485,0.66,0.1045,2,72,74,74,42,74,4,2,2,422,1,728,63941,4,74
2012-11-20,winter,2012,November,0,Tuesday,Workingday,Clear,0.32,0.3333,0.7,0.1343,3,26,29,29,41,29,4,1,1,411,1,726,39130,4,29
2012-11-20,winter,2012,November,1,Tuesday,Workingday,Clear,0.34,0.3485,0.66,0.1045,3,10,13,13,41,13,4,1,2,412,1,724,24164,4,13
2012-11-20,winter,2012,November,2,Tuesday,Workingday,Mist,0.32,0.3333,0.76,0.0896,0,5,5,5,41,5,4,1,1,411,1,715,16352,4,5
2012-11-20,winter,2012,November,3,Tuesday,Workingday,Mist,0.34,0.3485,0.71,0.1045,0,2,2,2,41,2,4,1,2,412,1,697,8174,4,2
2012-11-20,winter,2012,November,4,Tuesday,Workingday,Mist,0.34,0.3333,0.66,0.194,0,6,6,6,41,6,4,1,1,411,1,697,4428,4,6
2012-11-20,winter,2012,November,5,Tuesday,Workingday,Mist,0.34,0.3333,0.66,0.1343,2,32,34,34,41,34,4,1,1,411,1,717,14261,4,34
2012-11-20,winter,2012,November,6,Tuesday,Workingday,Mist,0.34,0.3333,0.71,0.1642,2,146,148,148,41,148,4,3,1,431,1,725,55132,4,148
2012-11-20,winter,2012,November,7,Tuesday,Workingday,Clear,0.32,0.3333,0.76,0.0896,7,411,418,418,41,418,4,4,1,441,1,727,154171,4,418
2012-11-20,winter,2012,November,8,Tuesday,Workingday,Clear,0.34,0.3333,0.71,0.1343,16,649,665,665,41,665,4,4,1,441,1,727,261001,4,665
2012-11-20,winter,2012,November,9,Tuesday,Workingday,Mist,0.36,0.3788,0.71,0.0,28,298,326,326,41,326,4,4,2,442,0,727,159438,4,326
2012-11-20,winter,2012,November,10,Tuesday,Workingday,Mist,0.4,0.4091,0.66,0.0896,32,144,176,176,41,176,4,3,2,432,0,727,126257,4,176
2012-11-20,winter,2012,November,11,Tuesday,Workingday,Mist,0.42,0.4242,0.67,0.0896,45,160,205,205,41,205,4,3,2,432,0,727,151320,4,205
2012-11-20,winter,2012,November,12,Tuesday,Workingday,Mist,0.42,0.4242,0.67,0.0,70,243,313,313,41,313,4,4,2,442,0,728,184414,4,313
2012-11-20,winter,2012,November,13,Tuesday,Workingday,Mist,0.44,0.4394,0.58,0.0,49,218,267,267,41,267,4,3,2,432,0,729,184919,4,267
2012-11-20,winter,2012,November,14,Tuesday,Workingday,Mist,0.44,0.4394,0.58,0.1045,47,177,224,224,41,224,4,3,2,432,0,729,175652,4,224
2012-11-20,winter,2012,November,15,Tuesday,Workingday,Mist,0.46,0.4545,0.55,0.1045,61,226,287,287,41,287,4,4,2,442,0,729,183149,4,287
2012-11-20,winter,2012,November,16,Tuesday,Workingday,Mist,0.42,0.4242,0.62,0.0896,60,335,395,395,41,395,4,4,2,442,0,730,227748,4,395
2012-11-20,winter,2012,November,17,Tuesday,Workingday,Mist,0.4,0.4091,0.71,0.1642,37,553,590,590,41,590,4,4,2,442,2,730,336860,4,590
2012-11-20,winter,2012,November,18,Tuesday,Workingday,Mist,0.4,0.4091,0.66,0.0896,16,534,550,550,41,550,4,4,2,442,0,728,309772,4,550
2012-11-20,winter,2012,November,19,Tuesday,Workingday,Mist,0.4,0.4091,0.71,0.0,23,361,384,384,41,384,4,4,2,442,0,728,226789,4,384
2012-11-20,winter,2012,November,20,Tuesday,Workingday,Mist,0.38,0.3939,0.76,0.0,11,224,235,235,41,235,4,3,2,432,0,728,164550,4,235
2012-11-20,winter,2012,November,21,Tuesday,Workingday,Clear,0.36,0.3788,0.71,0.0,14,143,157,157,41,157,4,3,2,432,0,728,125445,4,157
2012-11-20,winter,2012,November,22,Tuesday,Workingday,Clear,0.36,0.3788,0.71,0.0,7,115,122,122,41,122,4,2,2,422,0,728,95612,4,122
2012-11-20,winter,2012,November,23,Tuesday,Workingday,Clear,0.32,0.3333,0.81,0.1045,1,82,83,83,41,83,4,2,1,421,1,728,63941,4,83
2012-11-21,winter,2012,November,0,Wednesday,Workingday,Clear,0.34,0.3636,0.81,0.0,1,25,26,26,40,26,4,1,2,412,0,726,39130,4,26
2012-11-21,winter,2012,November,1,Wednesday,Workingday,Clear,0.32,0.3333,0.81,0.1045,1,13,14,14,40,14,4,1,1,411,1,724,24164,4,14
2012-11-21,winter,2012,November,2,Wednesday,Workingday,Clear,0.28,0.2879,0.87,0.1045,2,6,8,8,40,8,4,1,1,411,1,715,16352,4,8
2012-11-21,winter,2012,November,3,Wednesday,Workingday,Clear,0.28,0.2879,0.87,0.1045,0,2,2,2,40,2,4,1,1,411,1,697,8174,4,2
2012-11-21,winter,2012,November,4,Wednesday,Workingday,Clear,0.28,0.2879,0.87,0.1045,0,10,10,10,40,10,4,1,1,411,1,697,4428,4,10
2012-11-21,winter,2012,November,5,Wednesday,Workingday,Clear,0.28,0.2879,0.87,0.1045,1,28,29,29,40,29,4,1,1,411,1,717,14261,4,29
2012-11-21,winter,2012,November,6,Wednesday,Workingday,Clear,0.28,0.303,0.87,0.0896,2,99,101,101,40,101,4,2,1,421,1,725,55132,4,101
2012-11-21,winter,2012,November,7,Wednesday,Workingday,Clear,0.26,0.2879,0.87,0.0896,11,262,273,273,40,273,4,3,1,431,1,727,154171,4,273
2012-11-21,winter,2012,November,8,Wednesday,Workingday,Mist,0.28,0.303,0.81,0.0896,12,539,551,551,40,551,4,4,1,441,1,727,261001,4,551
2012-11-21,winter,2012,November,9,Wednesday,Workingday,Clear,0.32,0.3333,0.76,0.0896,45,320,365,365,40,365,4,4,1,441,1,727,159438,4,365
2012-11-21,winter,2012,November,10,Wednesday,Workingday,Clear,0.36,0.3788,0.62,0.0,22,150,172,172,40,172,4,3,2,432,1,727,126257,4,172
2012-11-21,winter,2012,November,11,Wednesday,Workingday,Clear,0.4,0.4091,0.5,0.194,43,198,241,241,40,241,4,3,2,432,1,727,151320,4,241
2012-11-21,winter,2012,November,12,Wednesday,Workingday,Clear,0.44,0.4394,0.41,0.194,74,270,344,344,40,344,4,4,2,442,2,728,184414,4,344
2012-11-21,winter,2012,November,13,Wednesday,Workingday,Clear,0.44,0.4394,0.35,0.2239,70,295,365,365,40,365,4,4,2,442,2,729,184919,4,365
2012-11-21,winter,2012,November,14,Wednesday,Workingday,Clear,0.46,0.4545,0.33,0.194,84,329,413,413,40,413,4,4,2,442,2,729,175652,4,413
2012-11-21,winter,2012,November,15,Wednesday,Workingday,Clear,0.46,0.4545,0.36,0.0896,68,381,449,449,40,449,4,4,2,442,2,729,183149,4,449
2012-11-21,winter,2012,November,16,Wednesday,Workingday,Clear,0.44,0.4394,0.33,0.1343,59,410,469,469,40,469,4,4,2,442,2,730,227748,4,469
2012-11-21,winter,2012,November,17,Wednesday,Workingday,Clear,0.4,0.4091,0.4,0.1642,41,333,374,374,40,374,4,4,2,442,1,730,336860,4,374
2012-11-21,winter,2012,November,18,Wednesday,Workingday,Clear,0.42,0.4242,0.38,0.1045,24,287,311,311,40,311,4,4,2,442,1,728,309772,4,311
2012-11-21,winter,2012,November,19,Wednesday,Workingday,Clear,0.38,0.3939,0.43,0.194,23,220,243,243,40,243,4,3,2,432,1,728,226789,4,243
2012-11-21,winter,2012,November,20,Wednesday,Workingday,Clear,0.34,0.3485,0.61,0.1045,11,125,136,136,40,136,4,2,2,422,1,728,164550,4,136
2012-11-21,winter,2012,November,21,Wednesday,Workingday,Clear,0.36,0.3788,0.5,0.0,8,97,105,105,40,105,4,2,2,422,1,728,125445,4,105
2012-11-21,winter,2012,November,22,Wednesday,Workingday,Clear,0.34,0.3636,0.49,0.0,6,82,88,88,40,88,4,2,2,422,1,728,95612,4,88
2012-11-21,winter,2012,November,23,Wednesday,Workingday,Clear,0.32,0.3485,0.61,0.0,7,50,57,57,40,57,4,2,2,422,1,728,63941,4,57
2012-11-22,winter,2012,November,0,Thursday,Holiday,Clear,0.32,0.3333,0.66,0.0896,3,43,46,46,39,46,4,2,1,421,1,726,39130,4,46
2012-11-22,winter,2012,November,1,Thursday,Holiday,Clear,0.28,0.303,0.65,0.0896,5,37,42,42,39,42,4,2,1,421,1,724,24164,4,42
2012-11-22,winter,2012,November,2,Thursday,Holiday,Clear,0.24,0.2576,0.75,0.0896,3,15,18,18,39,18,4,1,1,411,1,715,16352,4,18
2012-11-22,winter,2012,November,3,Thursday,Holiday,Clear,0.24,0.2576,0.75,0.1045,0,6,6,6,39,6,4,1,1,411,1,697,8174,4,6
2012-11-22,winter,2012,November,4,Thursday,Holiday,Clear,0.22,0.2273,0.8,0.1343,1,2,3,3,39,3,4,1,1,411,1,697,4428,4,3
2012-11-22,winter,2012,November,5,Thursday,Holiday,Clear,0.24,0.2576,0.75,0.1045,2,6,8,8,39,8,4,1,1,411,1,717,14261,4,8
2012-11-22,winter,2012,November,6,Thursday,Holiday,Clear,0.26,0.2727,0.7,0.1045,2,15,17,17,39,17,4,1,1,411,1,725,55132,4,17
2012-11-22,winter,2012,November,7,Thursday,Holiday,Clear,0.22,0.2273,0.75,0.1343,7,49,56,56,39,56,4,2,1,421,1,727,154171,4,56
2012-11-22,winter,2012,November,8,Thursday,Holiday,Clear,0.24,0.2424,0.75,0.1343,20,77,97,97,39,97,4,2,1,421,1,727,261001,4,97
2012-11-22,winter,2012,November,9,Thursday,Holiday,Clear,0.3,0.3333,0.65,0.0,25,94,119,119,39,119,4,2,1,421,1,727,159438,4,119
2012-11-22,winter,2012,November,10,Thursday,Holiday,Clear,0.36,0.3636,0.57,0.1045,65,154,219,219,39,219,4,3,2,432,1,727,126257,4,219
2012-11-22,winter,2012,November,11,Thursday,Holiday,Clear,0.42,0.4242,0.41,0.0896,89,143,232,232,39,232,4,3,2,432,1,727,151320,4,232
2012-11-22,winter,2012,November,12,Thursday,Holiday,Clear,0.44,0.4394,0.35,0.0,117,145,262,262,39,262,4,3,2,432,2,728,184414,4,262
2012-11-22,winter,2012,November,13,Thursday,Holiday,Clear,0.46,0.4545,0.31,0.0,125,144,269,269,39,269,4,3,2,432,2,729,184919,4,269
2012-11-22,winter,2012,November,14,Thursday,Holiday,Clear,0.48,0.4697,0.29,0.0,125,95,220,220,39,220,4,3,2,432,2,729,175652,4,220
2012-11-22,winter,2012,November,15,Thursday,Holiday,Clear,0.48,0.4697,0.29,0.0,132,96,228,228,39,228,4,3,2,432,2,729,183149,4,228
2012-11-22,winter,2012,November,16,Thursday,Holiday,Clear,0.46,0.4545,0.33,0.0,101,81,182,182,39,182,4,3,2,432,2,730,227748,4,182
2012-11-22,winter,2012,November,17,Thursday,Holiday,Clear,0.44,0.4394,0.35,0.0,66,43,109,109,39,109,4,2,2,422,1,730,336860,4,109
2012-11-22,winter,2012,November,18,Thursday,Holiday,Clear,0.4,0.4091,0.43,0.0,16,54,70,70,39,70,4,2,2,422,1,728,309772,4,70
2012-11-22,winter,2012,November,19,Thursday,Holiday,Clear,0.36,0.3788,0.76,0.0,13,31,44,44,39,44,4,2,2,422,0,728,226789,4,44
2012-11-22,winter,2012,November,20,Thursday,Holiday,Clear,0.34,0.3636,0.71,0.0,15,37,52,52,39,52,4,2,2,422,1,728,164550,4,52
2012-11-22,winter,2012,November,21,Thursday,Holiday,Clear,0.34,0.3485,0.61,0.0896,7,39,46,46,39,46,4,2,2,422,1,728,125445,4,46
2012-11-22,winter,2012,November,22,Thursday,Holiday,Clear,0.32,0.3485,0.61,0.0,8,36,44,44,39,44,4,2,2,422,1,728,95612,4,44
2012-11-22,winter,2012,November,23,Thursday,Holiday,Clear,0.3,0.3333,0.7,0.0,8,28,36,36,39,36,4,1,1,411,1,728,63941,4,36
2012-11-23,winter,2012,November,0,Friday,Workingday,Clear,0.28,0.3182,0.65,0.0,0,32,32,32,38,32,4,1,1,411,1,726,39130,4,32
2012-11-23,winter,2012,November,1,Friday,Workingday,Clear,0.28,0.303,0.81,0.0896,2,11,13,13,38,13,4,1,1,411,1,724,24164,4,13
2012-11-23,winter,2012,November,2,Friday,Workingday,Clear,0.26,0.2879,0.75,0.0896,1,4,5,5,38,5,4,1,1,411,1,715,16352,4,5
2012-11-23,winter,2012,November,3,Friday,Workingday,Clear,0.26,0.303,0.7,0.0,1,0,1,1,38,1,4,1,1,411,1,697,8174,4,1
2012-11-23,winter,2012,November,4,Friday,Workingday,Clear,0.24,0.2576,0.75,0.1045,1,3,4,4,38,4,4,1,1,411,1,697,4428,4,4
2012-11-23,winter,2012,November,5,Friday,Workingday,Clear,0.24,0.2879,0.81,0.0,0,10,10,10,38,10,4,1,1,411,1,717,14261,4,10
2012-11-23,winter,2012,November,6,Friday,Workingday,Clear,0.24,0.2879,0.81,0.0,0,20,20,20,38,20,4,1,1,411,1,725,55132,4,20
2012-11-23,winter,2012,November,7,Friday,Workingday,Clear,0.24,0.2879,0.81,0.0,5,72,77,77,38,77,4,2,1,421,1,727,154171,4,77
2012-11-23,winter,2012,November,8,Friday,Workingday,Clear,0.24,0.2576,0.87,0.0896,11,83,94,94,38,94,4,2,1,421,1,727,261001,4,94
2012-11-23,winter,2012,November,9,Friday,Workingday,Clear,0.28,0.2879,0.75,0.1045,32,80,112,112,38,112,4,2,1,421,1,727,159438,4,112
2012-11-23,winter,2012,November,10,Friday,Workingday,Clear,0.34,0.3333,0.61,0.1642,87,114,201,201,38,201,4,3,1,431,1,727,126257,4,201
2012-11-23,winter,2012,November,11,Friday,Workingday,Clear,0.4,0.4091,0.5,0.194,121,130,251,251,38,251,4,3,2,432,2,727,151320,4,251
2012-11-23,winter,2012,November,12,Friday,Workingday,Clear,0.44,0.4394,0.38,0.2537,186,193,379,379,38,379,4,4,2,442,2,728,184414,4,379
2012-11-23,winter,2012,November,13,Friday,Workingday,Clear,0.46,0.4545,0.38,0.2836,224,200,424,424,38,424,4,4,2,442,2,729,184919,4,424
2012-11-23,winter,2012,November,14,Friday,Workingday,Clear,0.5,0.4848,0.36,0.2537,240,195,435,435,38,435,4,4,2,442,2,729,175652,4,435
2012-11-23,winter,2012,November,15,Friday,Workingday,Clear,0.48,0.4697,0.41,0.2537,233,214,447,447,38,447,4,4,2,442,2,729,183149,4,447
2012-11-23,winter,2012,November,16,Friday,Workingday,Mist,0.48,0.4697,0.41,0.1045,158,199,357,357,38,357,4,4,2,442,2,730,227748,4,357
2012-11-23,winter,2012,November,17,Friday,Workingday,Mist,0.48,0.4697,0.39,0.0896,117,183,300,300,38,300,4,4,2,442,2,730,336860,4,300
2012-11-23,winter,2012,November,18,Friday,Workingday,Mist,0.46,0.4545,0.44,0.0,50,158,208,208,38,208,4,3,2,432,0,728,309772,4,208
2012-11-23,winter,2012,November,19,Friday,Workingday,Mist,0.46,0.4545,0.47,0.1642,33,121,154,154,38,154,4,3,2,432,1,728,226789,4,154
2012-11-23,winter,2012,November,20,Friday,Workingday,Clear,0.46,0.4545,0.41,0.0896,42,100,142,142,38,142,4,2,2,422,1,728,164550,4,142
2012-11-23,winter,2012,November,21,Friday,Workingday,Clear,0.46,0.4545,0.47,0.2537,23,75,98,98,38,98,4,2,2,422,1,728,125445,4,98
2012-11-23,winter,2012,November,22,Friday,Workingday,Clear,0.44,0.4394,0.33,0.5224,16,63,79,79,38,79,4,2,2,422,1,728,95612,4,79
2012-11-23,winter,2012,November,23,Friday,Workingday,Clear,0.42,0.4242,0.38,0.4478,20,47,67,67,38,67,4,2,2,422,1,728,63941,4,67
2012-11-24,winter,2012,November,0,Saturday,Holiday,Clear,0.4,0.4091,0.37,0.4179,9,33,42,42,37,42,4,2,2,422,1,726,39130,4,42
2012-11-24,winter,2012,November,1,Saturday,Holiday,Clear,0.34,0.2879,0.42,0.4925,1,19,20,20,37,20,4,1,1,411,1,724,24164,4,20
2012-11-24,winter,2012,November,2,Saturday,Holiday,Clear,0.32,0.2727,0.39,0.6119,10,22,32,32,37,32,4,1,1,411,1,715,16352,4,32
2012-11-24,winter,2012,November,3,Saturday,Holiday,Clear,0.28,0.2576,0.41,0.3582,6,5,11,11,37,11,4,1,1,411,1,697,8174,4,11
2012-11-24,winter,2012,November,4,Saturday,Holiday,Clear,0.26,0.2121,0.41,0.4478,1,2,3,3,37,3,4,1,1,411,1,697,4428,4,3
2012-11-24,winter,2012,November,5,Saturday,Holiday,Clear,0.26,0.2273,0.41,0.3284,1,2,3,3,37,3,4,1,1,411,1,717,14261,4,3
2012-11-24,winter,2012,November,6,Saturday,Holiday,Clear,0.24,0.2121,0.44,0.2836,1,9,10,10,37,10,4,1,1,411,1,725,55132,4,10
2012-11-24,winter,2012,November,7,Saturday,Holiday,Mist,0.26,0.2273,0.41,0.3284,4,21,25,25,37,25,4,1,1,411,1,727,154171,4,25
2012-11-24,winter,2012,November,8,Saturday,Holiday,Mist,0.26,0.2121,0.44,0.4627,7,55,62,62,37,62,4,2,1,421,1,727,261001,4,62
2012-11-24,winter,2012,November,9,Saturday,Holiday,Mist,0.26,0.2121,0.41,0.4478,26,96,122,122,37,122,4,2,1,421,1,727,159438,4,122
2012-11-24,winter,2012,November,10,Saturday,Holiday,Mist,0.26,0.2273,0.44,0.2985,46,96,142,142,37,142,4,2,1,421,1,727,126257,4,142
2012-11-24,winter,2012,November,11,Saturday,Holiday,Mist,0.28,0.2576,0.41,0.2985,55,131,186,186,37,186,4,3,1,431,1,727,151320,4,186
2012-11-24,winter,2012,November,12,Saturday,Holiday,Mist,0.3,0.2576,0.36,0.6119,53,146,199,199,37,199,4,3,1,431,1,728,184414,4,199
2012-11-24,winter,2012,November,13,Saturday,Holiday,Clear,0.32,0.303,0.36,0.3284,64,161,225,225,37,225,4,3,1,431,1,729,184919,4,225
2012-11-24,winter,2012,November,14,Saturday,Holiday,Clear,0.32,0.2879,0.33,0.4627,58,149,207,207,37,207,4,3,1,431,1,729,175652,4,207
2012-11-24,winter,2012,November,15,Saturday,Holiday,Clear,0.3,0.2727,0.36,0.4627,59,139,198,198,37,198,4,3,1,431,1,729,183149,4,198
2012-11-24,winter,2012,November,16,Saturday,Holiday,Clear,0.28,0.2424,0.38,0.4478,43,127,170,170,37,170,4,3,1,431,1,730,227748,4,170
2012-11-24,winter,2012,November,17,Saturday,Holiday,Clear,0.26,0.2273,0.41,0.3881,29,97,126,126,37,126,4,2,1,421,1,730,336860,4,126
2012-11-24,winter,2012,November,18,Saturday,Holiday,Clear,0.26,0.2273,0.38,0.3881,22,123,145,145,37,145,4,3,1,431,1,728,309772,4,145
2012-11-24,winter,2012,November,19,Saturday,Holiday,Clear,0.26,0.2424,0.41,0.2537,9,74,83,83,37,83,4,2,1,421,1,728,226789,4,83
2012-11-24,winter,2012,November,20,Saturday,Holiday,Clear,0.24,0.2121,0.44,0.2836,3,55,58,58,37,58,4,2,1,421,1,728,164550,4,58
2012-11-24,winter,2012,November,21,Saturday,Holiday,Clear,0.24,0.2273,0.44,0.194,9,66,75,75,37,75,4,2,1,421,1,728,125445,4,75
2012-11-24,winter,2012,November,22,Saturday,Holiday,Clear,0.24,0.2273,0.44,0.2537,7,69,76,76,37,76,4,2,1,421,1,728,95612,4,76
2012-11-24,winter,2012,November,23,Saturday,Holiday,Clear,0.24,0.2273,0.44,0.194,9,48,57,57,37,57,4,2,1,421,1,728,63941,4,57
2012-11-25,winter,2012,November,0,Sunday,Holiday,Clear,0.22,0.2121,0.47,0.2537,3,31,34,34,36,34,4,1,1,411,1,726,39130,4,34
2012-11-25,winter,2012,November,1,Sunday,Holiday,Clear,0.22,0.2273,0.44,0.194,4,32,36,36,36,36,4,1,1,411,1,724,24164,4,36
2012-11-25,winter,2012,November,2,Sunday,Holiday,Clear,0.22,0.197,0.44,0.3582,1,27,28,28,36,28,4,1,1,411,1,715,16352,4,28
2012-11-25,winter,2012,November,3,Sunday,Holiday,Clear,0.22,0.2727,0.44,0.0,0,8,8,8,36,8,4,1,1,411,1,697,8174,4,8
2012-11-25,winter,2012,November,4,Sunday,Holiday,Clear,0.22,0.2727,0.44,0.0,1,1,2,2,36,2,4,1,1,411,1,697,4428,4,2
2012-11-25,winter,2012,November,5,Sunday,Holiday,Mist,0.22,0.2273,0.47,0.1642,0,3,3,3,36,3,4,1,1,411,1,717,14261,4,3
2012-11-25,winter,2012,November,6,Sunday,Holiday,Mist,0.22,0.2424,0.47,0.1045,1,10,11,11,36,11,4,1,1,411,1,725,55132,4,11
2012-11-25,winter,2012,November,7,Sunday,Holiday,Mist,0.22,0.2424,0.51,0.1045,2,19,21,21,36,21,4,1,1,411,1,727,154171,4,21
2012-11-25,winter,2012,November,8,Sunday,Holiday,Mist,0.22,0.2273,0.51,0.194,2,32,34,34,36,34,4,1,1,411,1,727,261001,4,34
2012-11-25,winter,2012,November,9,Sunday,Holiday,Mist,0.24,0.2273,0.48,0.2239,13,83,96,96,36,96,4,2,1,421,1,727,159438,4,96
2012-11-25,winter,2012,November,10,Sunday,Holiday,Clear,0.24,0.2273,0.48,0.2537,15,124,139,139,36,139,4,2,1,421,1,727,126257,4,139
2012-11-25,winter,2012,November,11,Sunday,Holiday,Mist,0.26,0.2576,0.41,0.2239,49,155,204,204,36,204,4,3,1,431,1,727,151320,4,204
2012-11-25,winter,2012,November,12,Sunday,Holiday,Mist,0.26,0.2576,0.41,0.2239,37,165,202,202,36,202,4,3,1,431,1,728,184414,4,202
2012-11-25,winter,2012,November,13,Sunday,Holiday,Mist,0.26,0.2576,0.41,0.1642,37,158,195,195,36,195,4,3,1,431,1,729,184919,4,195
2012-11-25,winter,2012,November,14,Sunday,Holiday,Mist,0.3,0.2879,0.42,0.2537,33,170,203,203,36,203,4,3,1,431,1,729,175652,4,203
2012-11-25,winter,2012,November,15,Sunday,Holiday,Clear,0.3,0.2879,0.42,0.2537,36,209,245,245,36,245,4,3,1,431,1,729,183149,4,245
2012-11-25,winter,2012,November,16,Sunday,Holiday,Clear,0.3,0.2879,0.39,0.2239,25,203,228,228,36,228,4,3,1,431,1,730,227748,4,228
2012-11-25,winter,2012,November,17,Sunday,Holiday,Clear,0.28,0.2727,0.41,0.1642,11,170,181,181,36,181,4,3,1,431,1,730,336860,4,181
2012-11-25,winter,2012,November,18,Sunday,Holiday,Clear,0.26,0.2576,0.44,0.1642,9,132,141,141,36,141,4,2,1,421,1,728,309772,4,141
2012-11-25,winter,2012,November,19,Sunday,Holiday,Clear,0.26,0.303,0.41,0.0,13,114,127,127,36,127,4,2,1,421,1,728,226789,4,127
2012-11-25,winter,2012,November,20,Sunday,Holiday,Clear,0.24,0.2879,0.6,0.0,9,110,119,119,36,119,4,2,1,421,1,728,164550,4,119
2012-11-25,winter,2012,November,21,Sunday,Holiday,Clear,0.26,0.303,0.48,0.0,4,60,64,64,36,64,4,2,1,421,1,728,125445,4,64
2012-11-25,winter,2012,November,22,Sunday,Holiday,Clear,0.24,0.2879,0.6,0.0,3,59,62,62,36,62,4,2,1,421,1,728,95612,4,62
2012-11-25,winter,2012,November,23,Sunday,Holiday,Clear,0.22,0.2576,0.69,0.0896,1,40,41,41,36,41,4,2,1,421,1,728,63941,4,41
2012-11-26,winter,2012,November,0,Monday,Workingday,Clear,0.22,0.2727,0.69,0.0,4,19,23,23,35,23,4,1,1,411,1,726,39130,4,23
2012-11-26,winter,2012,November,1,Monday,Workingday,Clear,0.2,0.2576,0.69,0.0,1,9,10,10,35,10,4,1,1,411,1,724,24164,4,10
2012-11-26,winter,2012,November,2,Monday,Workingday,Clear,0.2,0.2576,0.69,0.0,0,5,5,5,35,5,4,1,1,411,1,715,16352,4,5
2012-11-26,winter,2012,November,3,Monday,Workingday,Clear,0.2,0.2576,0.69,0.0,1,4,5,5,35,5,4,1,1,411,1,697,8174,4,5
2012-11-26,winter,2012,November,4,Monday,Workingday,Clear,0.22,0.2727,0.69,0.0,0,10,10,10,35,10,4,1,1,411,1,697,4428,4,10
2012-11-26,winter,2012,November,5,Monday,Workingday,Clear,0.22,0.2273,0.69,0.1642,0,41,41,41,35,41,4,2,1,421,1,717,14261,4,41
2012-11-26,winter,2012,November,6,Monday,Workingday,Clear,0.22,0.2727,0.69,0.0,1,123,124,124,35,124,4,2,1,421,1,725,55132,4,124
2012-11-26,winter,2012,November,7,Monday,Workingday,Clear,0.24,0.2879,0.65,0.0,2,363,365,365,35,365,4,4,1,441,1,727,154171,4,365
2012-11-26,winter,2012,November,8,Monday,Workingday,Clear,0.24,0.2879,0.65,0.0,9,629,638,638,35,638,4,4,1,441,1,727,261001,4,638
2012-11-26,winter,2012,November,9,Monday,Workingday,Clear,0.28,0.303,0.56,0.0896,10,276,286,286,35,286,4,4,1,441,1,727,159438,4,286
2012-11-26,winter,2012,November,10,Monday,Workingday,Clear,0.32,0.3485,0.49,0.0,20,127,147,147,35,147,4,3,2,432,1,727,126257,4,147
2012-11-26,winter,2012,November,11,Monday,Workingday,Clear,0.4,0.4091,0.37,0.2985,18,112,130,130,35,130,4,2,2,422,1,727,151320,4,130
2012-11-26,winter,2012,November,12,Monday,Workingday,Clear,0.42,0.4242,0.35,0.1045,22,188,210,210,35,210,4,3,2,432,1,728,184414,4,210
2012-11-26,winter,2012,November,13,Monday,Workingday,Clear,0.42,0.4242,0.35,0.1045,20,197,217,217,35,217,4,3,2,432,1,729,184919,4,217
2012-11-26,winter,2012,November,14,Monday,Workingday,Clear,0.42,0.4242,0.35,0.0,51,177,228,228,35,228,4,3,2,432,1,729,175652,4,228
2012-11-26,winter,2012,November,15,Monday,Workingday,Clear,0.42,0.4242,0.35,0.0896,49,181,230,230,35,230,4,3,2,432,1,729,183149,4,230
2012-11-26,winter,2012,November,16,Monday,Workingday,Clear,0.44,0.4394,0.3,0.0,49,297,346,346,35,346,4,4,2,442,2,730,227748,4,346
2012-11-26,winter,2012,November,17,Monday,Workingday,Clear,0.42,0.4242,0.32,0.0,13,540,553,553,35,553,4,4,2,442,2,730,336860,4,553
2012-11-26,winter,2012,November,18,Monday,Workingday,Clear,0.36,0.3485,0.5,0.1642,19,502,521,521,35,521,4,4,2,442,1,728,309772,4,521
2012-11-26,winter,2012,November,19,Monday,Workingday,Clear,0.34,0.3636,0.53,0.0,16,355,371,371,35,371,4,4,2,442,1,728,226789,4,371
2012-11-26,winter,2012,November,20,Monday,Workingday,Clear,0.34,0.3636,0.49,0.0,12,265,277,277,35,277,4,3,2,432,1,728,164550,4,277
2012-11-26,winter,2012,November,21,Monday,Workingday,Clear,0.34,0.3636,0.49,0.0,9,172,181,181,35,181,4,3,2,432,1,728,125445,4,181
2012-11-26,winter,2012,November,22,Monday,Workingday,Clear,0.32,0.3485,0.61,0.0,3,101,104,104,35,104,4,2,2,422,1,728,95612,4,104
2012-11-26,winter,2012,November,23,Monday,Workingday,Mist,0.32,0.3333,0.66,0.1045,8,57,65,65,35,65,4,2,1,421,1,728,63941,4,65
2012-11-27,winter,2012,November,0,Tuesday,Workingday,Mist,0.32,0.3333,0.66,0.0896,2,24,26,26,34,26,4,1,1,411,1,726,39130,4,26
2012-11-27,winter,2012,November,1,Tuesday,Workingday,Mist,0.32,0.3333,0.7,0.1343,0,6,6,6,34,6,4,1,1,411,1,724,24164,4,6
2012-11-27,winter,2012,November,2,Tuesday,Workingday,Mist,0.32,0.3182,0.7,0.1642,0,5,5,5,34,5,4,1,1,411,1,715,16352,4,5
2012-11-27,winter,2012,November,3,Tuesday,Workingday,Light Snow,0.32,0.3333,0.7,0.1343,1,3,4,4,34,4,4,1,1,411,1,697,8174,4,4
2012-11-27,winter,2012,November,4,Tuesday,Workingday,Light Snow,0.3,0.2879,0.81,0.194,0,5,5,5,34,5,4,1,1,411,1,697,4428,4,5
2012-11-27,winter,2012,November,5,Tuesday,Workingday,Mist,0.3,0.2879,0.81,0.2239,0,31,31,31,34,31,4,1,1,411,1,717,14261,4,31
2012-11-27,winter,2012,November,6,Tuesday,Workingday,Mist,0.3,0.303,0.81,0.1642,3,97,100,100,34,100,4,2,1,421,1,725,55132,4,100
2012-11-27,winter,2012,November,7,Tuesday,Workingday,Light Snow,0.3,0.303,0.81,0.1343,4,289,293,293,34,293,4,4,1,441,1,727,154171,4,293
2012-11-27,winter,2012,November,8,Tuesday,Workingday,Light Snow,0.32,0.3182,0.81,0.1642,6,494,500,500,34,500,4,4,1,441,1,727,261001,4,500
2012-11-27,winter,2012,November,9,Tuesday,Workingday,Mist,0.32,0.3333,0.81,0.1343,11,257,268,268,34,268,4,3,1,431,1,727,159438,4,268
2012-11-27,winter,2012,November,10,Tuesday,Workingday,Light Snow,0.32,0.3182,0.81,0.194,5,52,57,57,34,57,4,2,1,421,1,727,126257,4,57
2012-11-27,winter,2012,November,11,Tuesday,Workingday,Light Snow,0.3,0.2727,0.87,0.2985,6,59,65,65,34,65,4,2,1,421,1,727,151320,4,65
2012-11-27,winter,2012,November,12,Tuesday,Workingday,Light Snow,0.28,0.2576,0.87,0.3881,6,70,76,76,34,76,4,2,1,421,1,728,184414,4,76
2012-11-27,winter,2012,November,13,Tuesday,Workingday,Light Snow,0.28,0.2727,0.87,0.2537,4,73,77,77,34,77,4,2,1,421,1,729,184919,4,77
2012-11-27,winter,2012,November,14,Tuesday,Workingday,Light Snow,0.28,0.2576,0.87,0.3582,8,86,94,94,34,94,4,2,1,421,1,729,175652,4,94
2012-11-27,winter,2012,November,15,Tuesday,Workingday,Mist,0.3,0.2727,0.75,0.2985,9,146,155,155,34,155,4,3,1,431,1,729,183149,4,155
2012-11-27,winter,2012,November,16,Tuesday,Workingday,Mist,0.3,0.2727,0.75,0.2985,5,252,257,257,34,257,4,3,1,431,1,730,227748,4,257
2012-11-27,winter,2012,November,17,Tuesday,Workingday,Mist,0.3,0.2727,0.75,0.3881,13,514,527,527,34,527,4,4,1,441,1,730,336860,4,527
2012-11-27,winter,2012,November,18,Tuesday,Workingday,Clear,0.26,0.2273,0.81,0.3582,13,469,482,482,34,482,4,4,1,441,1,728,309772,4,482
2012-11-27,winter,2012,November,19,Tuesday,Workingday,Clear,0.26,0.2576,0.73,0.2985,12,338,350,350,34,350,4,4,1,441,1,728,226789,4,350
2012-11-27,winter,2012,November,20,Tuesday,Workingday,Clear,0.26,0.2273,0.75,0.3284,4,228,232,232,34,232,4,3,1,431,1,728,164550,4,232
2012-11-27,winter,2012,November,21,Tuesday,Workingday,Clear,0.24,0.2121,0.81,0.2836,6,179,185,185,34,185,4,3,1,431,1,728,125445,4,185
2012-11-27,winter,2012,November,22,Tuesday,Workingday,Clear,0.24,0.2424,0.81,0.1642,2,95,97,97,34,97,4,2,1,421,1,728,95612,4,97
2012-11-27,winter,2012,November,23,Tuesday,Workingday,Mist,0.26,0.2424,0.81,0.2537,3,64,67,67,34,67,4,2,1,421,1,728,63941,4,67
2012-11-28,winter,2012,November,0,Wednesday,Workingday,Mist,0.26,0.2424,0.75,0.2537,1,22,23,23,33,23,4,1,1,411,1,726,39130,4,23
2012-11-28,winter,2012,November,1,Wednesday,Workingday,Mist,0.26,0.2576,0.75,0.2239,0,12,12,12,33,12,4,1,1,411,1,724,24164,4,12
2012-11-28,winter,2012,November,2,Wednesday,Workingday,Mist,0.26,0.2576,0.75,0.2239,0,1,1,1,33,1,4,1,1,411,1,715,16352,4,1
2012-11-28,winter,2012,November,3,Wednesday,Workingday,Mist,0.26,0.2576,0.7,0.2239,0,3,3,3,33,3,4,1,1,411,1,697,8174,4,3
2012-11-28,winter,2012,November,4,Wednesday,Workingday,Mist,0.26,0.2576,0.7,0.194,0,4,4,4,33,4,4,1,1,411,1,697,4428,4,4
2012-11-28,winter,2012,November,5,Wednesday,Workingday,Mist,0.26,0.2727,0.7,0.1343,0,39,39,39,33,39,4,1,1,411,1,717,14261,4,39
2012-11-28,winter,2012,November,6,Wednesday,Workingday,Mist,0.26,0.2576,0.65,0.2239,4,132,136,136,33,136,4,2,1,421,1,725,55132,4,136
2012-11-28,winter,2012,November,7,Wednesday,Workingday,Mist,0.26,0.2576,0.56,0.194,6,403,409,409,33,409,4,4,1,441,1,727,154171,4,409
2012-11-28,winter,2012,November,8,Wednesday,Workingday,Clear,0.24,0.2121,0.6,0.2836,9,683,692,692,33,692,4,4,1,441,1,727,261001,4,692
2012-11-28,winter,2012,November,9,Wednesday,Workingday,Clear,0.28,0.2727,0.52,0.194,13,309,322,322,33,322,4,4,1,441,1,727,159438,4,322
2012-11-28,winter,2012,November,10,Wednesday,Workingday,Clear,0.3,0.3182,0.49,0.1045,17,144,161,161,33,161,4,3,1,431,1,727,126257,4,161
2012-11-28,winter,2012,November,11,Wednesday,Workingday,Clear,0.32,0.3182,0.45,0.1642,19,127,146,146,33,146,4,3,1,431,1,727,151320,4,146
2012-11-28,winter,2012,November,12,Wednesday,Workingday,Clear,0.34,0.303,0.42,0.3881,19,189,208,208,33,208,4,3,1,431,1,728,184414,4,208
2012-11-28,winter,2012,November,13,Wednesday,Workingday,Clear,0.34,0.3333,0.42,0.194,21,193,214,214,33,214,4,3,1,431,1,729,184919,4,214
2012-11-28,winter,2012,November,14,Wednesday,Workingday,Clear,0.36,0.3333,0.4,0.2985,15,161,176,176,33,176,4,3,1,431,1,729,175652,4,176
2012-11-28,winter,2012,November,15,Wednesday,Workingday,Clear,0.36,0.3333,0.32,0.3284,7,172,179,179,33,179,4,3,1,431,1,729,183149,4,179
2012-11-28,winter,2012,November,16,Wednesday,Workingday,Clear,0.36,0.3333,0.29,0.2537,9,316,325,325,33,325,4,4,1,441,1,730,227748,4,325
2012-11-28,winter,2012,November,17,Wednesday,Workingday,Clear,0.34,0.3333,0.31,0.1343,17,546,563,563,33,563,4,4,1,441,1,730,336860,4,563
2012-11-28,winter,2012,November,18,Wednesday,Workingday,Clear,0.32,0.303,0.33,0.2836,12,530,542,542,33,542,4,4,1,441,1,728,309772,4,542
2012-11-28,winter,2012,November,19,Wednesday,Workingday,Clear,0.32,0.3182,0.36,0.1642,9,378,387,387,33,387,4,4,1,441,1,728,226789,4,387
2012-11-28,winter,2012,November,20,Wednesday,Workingday,Clear,0.32,0.3333,0.36,0.1343,5,258,263,263,33,263,4,3,1,431,1,728,164550,4,263
2012-11-28,winter,2012,November,21,Wednesday,Workingday,Clear,0.3,0.303,0.39,0.1642,4,219,223,223,33,223,4,3,1,431,1,728,125445,4,223
2012-11-28,winter,2012,November,22,Wednesday,Workingday,Clear,0.28,0.2727,0.45,0.1642,6,148,154,154,33,154,4,3,1,431,1,728,95612,4,154
2012-11-28,winter,2012,November,23,Wednesday,Workingday,Clear,0.26,0.2727,0.48,0.1343,5,73,78,78,33,78,4,2,1,421,1,728,63941,4,78
2012-11-29,winter,2012,November,0,Thursday,Workingday,Clear,0.24,0.2576,0.56,0.0896,4,25,29,29,32,29,4,1,1,411,1,726,39130,4,29
2012-11-29,winter,2012,November,1,Thursday,Workingday,Clear,0.22,0.2576,0.64,0.0896,1,15,16,16,32,16,4,1,1,411,1,724,24164,4,16
2012-11-29,winter,2012,November,2,Thursday,Workingday,Clear,0.22,0.2727,0.64,0.0,1,6,7,7,32,7,4,1,1,411,1,715,16352,4,7
2012-11-29,winter,2012,November,4,Thursday,Workingday,Clear,0.2,0.2273,0.75,0.0896,0,7,7,7,32,7,4,1,1,411,1,697,4428,4,7
2012-11-29,winter,2012,November,5,Thursday,Workingday,Clear,0.2,0.2576,0.69,0.0,0,42,42,42,32,42,4,2,1,421,1,717,14261,4,42
2012-11-29,winter,2012,November,6,Thursday,Workingday,Clear,0.22,0.2727,0.69,0.0,1,120,121,121,32,121,4,2,1,421,1,725,55132,4,121
2012-11-29,winter,2012,November,7,Thursday,Workingday,Clear,0.2,0.2576,0.64,0.0,8,354,362,362,32,362,4,4,1,441,1,727,154171,4,362
2012-11-29,winter,2012,November,8,Thursday,Workingday,Clear,0.2,0.2273,0.69,0.1045,15,664,679,679,32,679,4,4,1,441,1,727,261001,4,679
2012-11-29,winter,2012,November,9,Thursday,Workingday,Clear,0.24,0.2879,0.6,0.0,13,286,299,299,32,299,4,4,1,441,1,727,159438,4,299
2012-11-29,winter,2012,November,10,Thursday,Workingday,Clear,0.28,0.303,0.65,0.0896,25,153,178,178,32,178,4,3,1,431,1,727,126257,4,178
2012-11-29,winter,2012,November,11,Thursday,Workingday,Clear,0.36,0.3485,0.37,0.2239,13,150,163,163,32,163,4,3,2,432,1,727,151320,4,163
2012-11-29,winter,2012,November,12,Thursday,Workingday,Clear,0.36,0.3485,0.4,0.1642,11,225,236,236,32,236,4,3,2,432,1,728,184414,4,236
2012-11-29,winter,2012,November,13,Thursday,Workingday,Clear,0.38,0.3939,0.32,0.1343,15,209,224,224,32,224,4,3,2,432,1,729,184919,4,224
2012-11-29,winter,2012,November,14,Thursday,Workingday,Clear,0.36,0.3485,0.43,0.2239,13,174,187,187,32,187,4,3,2,432,1,729,175652,4,187
2012-11-29,winter,2012,November,15,Thursday,Workingday,Clear,0.36,0.3333,0.43,0.2836,19,201,220,220,32,220,4,3,1,431,1,729,183149,4,220
2012-11-29,winter,2012,November,16,Thursday,Workingday,Clear,0.36,0.3485,0.4,0.2239,24,346,370,370,32,370,4,4,2,442,1,730,227748,4,370
2012-11-29,winter,2012,November,17,Thursday,Workingday,Clear,0.34,0.3333,0.39,0.194,17,544,561,561,32,561,4,4,1,441,1,730,336860,4,561
2012-11-29,winter,2012,November,18,Thursday,Workingday,Clear,0.32,0.3182,0.49,0.1642,17,520,537,537,32,537,4,4,1,441,1,728,309772,4,537
2012-11-29,winter,2012,November,19,Thursday,Workingday,Clear,0.3,0.2879,0.52,0.194,18,326,344,344,32,344,4,4,1,441,1,728,226789,4,344
2012-11-29,winter,2012,November,20,Thursday,Workingday,Clear,0.3,0.303,0.52,0.1642,11,241,252,252,32,252,4,3,1,431,1,728,164550,4,252
2012-11-29,winter,2012,November,21,Thursday,Workingday,Clear,0.26,0.2727,0.65,0.1343,7,201,208,208,32,208,4,3,1,431,1,728,125445,4,208
2012-11-29,winter,2012,November,22,Thursday,Workingday,Clear,0.26,0.2879,0.7,0.0896,4,147,151,151,32,151,4,3,1,431,1,728,95612,4,151
2012-11-29,winter,2012,November,23,Thursday,Workingday,Clear,0.28,0.3182,0.61,0.0,6,124,130,130,32,130,4,2,1,421,1,728,63941,4,130
2012-11-30,winter,2012,November,0,Friday,Workingday,Clear,0.26,0.2576,0.7,0.1642,4,48,52,52,31,52,4,2,1,421,1,726,39130,4,52
2012-11-30,winter,2012,November,1,Friday,Workingday,Clear,0.24,0.2576,0.7,0.0896,2,17,19,19,31,19,4,1,1,411,1,724,24164,4,19
2012-11-30,winter,2012,November,2,Friday,Workingday,Clear,0.24,0.2879,0.75,0.0,2,10,12,12,31,12,4,1,1,411,1,715,16352,4,12
2012-11-30,winter,2012,November,3,Friday,Workingday,Clear,0.24,0.2879,0.75,0.0,0,4,4,4,31,4,4,1,1,411,1,697,8174,4,4
2012-11-30,winter,2012,November,4,Friday,Workingday,Clear,0.22,0.2727,0.75,0.0,0,3,3,3,31,3,4,1,1,411,1,697,4428,4,3
2012-11-30,winter,2012,November,5,Friday,Workingday,Clear,0.2,0.2576,0.8,0.0,1,39,40,40,31,40,4,1,1,411,1,717,14261,4,40
2012-11-30,winter,2012,November,6,Friday,Workingday,Clear,0.2,0.2576,0.86,0.0,2,104,106,106,31,106,4,2,1,421,1,725,55132,4,106
2012-11-30,winter,2012,November,7,Friday,Workingday,Clear,0.22,0.2727,0.8,0.0,6,346,352,352,31,352,4,4,1,441,1,727,154171,4,352
2012-11-30,winter,2012,November,8,Friday,Workingday,Mist,0.22,0.2576,0.8,0.0896,20,709,729,729,31,729,4,4,1,441,1,727,261001,4,729
2012-11-30,winter,2012,November,9,Friday,Workingday,Clear,0.24,0.2576,0.75,0.0896,17,313,330,330,31,330,4,4,1,441,1,727,159438,4,330
2012-11-30,winter,2012,November,10,Friday,Workingday,Mist,0.3,0.3333,0.65,0.0,10,159,169,169,31,169,4,3,1,431,1,727,126257,4,169
2012-11-30,winter,2012,November,11,Friday,Workingday,Mist,0.34,0.3485,0.53,0.0896,31,170,201,201,31,201,4,3,2,432,1,727,151320,4,201
2012-11-30,winter,2012,November,12,Friday,Workingday,Mist,0.38,0.3939,0.46,0.0,25,243,268,268,31,268,4,3,2,432,1,728,184414,4,268
2012-11-30,winter,2012,November,13,Friday,Workingday,Mist,0.4,0.4091,0.4,0.1642,21,241,262,262,31,262,4,3,2,432,1,729,184919,4,262
2012-11-30,winter,2012,November,14,Friday,Workingday,Mist,0.4,0.4091,0.4,0.1045,26,225,251,251,31,251,4,3,2,432,1,729,175652,4,251
2012-11-30,winter,2012,November,15,Friday,Workingday,Mist,0.42,0.4242,0.38,0.1045,34,262,296,296,31,296,4,4,2,442,1,729,183149,4,296
2012-11-30,winter,2012,November,16,Friday,Workingday,Clear,0.4,0.4091,0.43,0.1343,37,368,405,405,31,405,4,4,2,442,1,730,227748,4,405
2012-11-30,winter,2012,November,17,Friday,Workingday,Clear,0.36,0.3485,0.5,0.194,31,551,582,582,31,582,4,4,2,442,1,730,336860,4,582
2012-11-30,winter,2012,November,18,Friday,Workingday,Mist,0.34,0.3636,0.61,0.0,20,489,509,509,31,509,4,4,2,442,1,728,309772,4,509
2012-11-30,winter,2012,November,19,Friday,Workingday,Clear,0.32,0.3485,0.66,0.0,18,359,377,377,31,377,4,4,2,442,1,728,226789,4,377
2012-11-30,winter,2012,November,20,Friday,Workingday,Clear,0.32,0.3485,0.66,0.0,12,233,245,245,31,245,4,3,2,432,1,728,164550,4,245
2012-11-30,winter,2012,November,21,Friday,Workingday,Clear,0.3,0.3182,0.75,0.0896,14,169,183,183,31,183,4,3,1,431,1,728,125445,4,183
2012-11-30,winter,2012,November,22,Friday,Workingday,Clear,0.3,0.3333,0.75,0.0,18,145,163,163,31,163,4,3,1,431,1,728,95612,4,163
2012-11-30,winter,2012,November,23,Friday,Workingday,Mist,0.3,0.3182,0.75,0.0896,11,99,110,110,31,110,4,2,1,421,1,728,63941,4,110
2012-12-01,winter,2012,December,0,Saturday,Holiday,Clear,0.26,0.303,0.81,0.0,9,99,108,108,30,108,4,2,1,421,1,726,39130,4,108
2012-12-01,winter,2012,December,1,Saturday,Holiday,Clear,0.26,0.303,0.81,0.0,5,64,69,69,30,69,4,2,1,421,1,724,24164,4,69
2012-12-01,winter,2012,December,2,Saturday,Holiday,Mist,0.26,0.303,0.81,0.0,3,47,50,50,30,50,4,2,1,421,1,715,16352,4,50
2012-12-01,winter,2012,December,3,Saturday,Holiday,Mist,0.26,0.2727,0.81,0.1343,1,14,15,15,30,15,4,1,1,411,1,697,8174,4,15
2012-12-01,winter,2012,December,4,Saturday,Holiday,Clear,0.26,0.2879,0.81,0.0896,0,5,5,5,30,5,4,1,1,411,1,697,4428,4,5
2012-12-01,winter,2012,December,5,Saturday,Holiday,Clear,0.24,0.2576,0.87,0.0896,1,12,13,13,30,13,4,1,1,411,1,717,14261,4,13
2012-12-01,winter,2012,December,6,Saturday,Holiday,Clear,0.24,0.2424,0.87,0.1343,7,20,27,27,30,27,4,1,1,411,1,725,55132,4,27
2012-12-01,winter,2012,December,7,Saturday,Holiday,Mist,0.24,0.2424,0.87,0.1343,7,56,63,63,30,63,4,2,1,421,1,727,154171,4,63
2012-12-01,winter,2012,December,8,Saturday,Holiday,Mist,0.24,0.2424,0.87,0.1343,11,133,144,144,30,144,4,3,1,431,1,727,261001,4,144
2012-12-01,winter,2012,December,9,Saturday,Holiday,Mist,0.26,0.2424,0.93,0.2537,34,159,193,193,30,193,4,3,1,431,1,727,159438,4,193
2012-12-01,winter,2012,December,10,Saturday,Holiday,Mist,0.28,0.2727,0.89,0.1642,45,211,256,256,30,256,4,3,1,431,1,727,126257,4,256
2012-12-01,winter,2012,December,11,Saturday,Holiday,Mist,0.32,0.3333,0.76,0.1045,74,318,392,392,30,392,4,4,1,441,1,727,151320,4,392
2012-12-01,winter,2012,December,12,Saturday,Holiday,Mist,0.32,0.3333,0.81,0.0896,119,327,446,446,30,446,4,4,1,441,1,728,184414,4,446
2012-12-01,winter,2012,December,13,Saturday,Holiday,Mist,0.34,0.3636,0.76,0.0,123,386,509,509,30,509,4,4,2,442,2,729,184919,4,509
2012-12-01,winter,2012,December,14,Saturday,Holiday,Mist,0.36,0.3788,0.71,0.0,110,369,479,479,30,479,4,4,2,442,2,729,175652,4,479
2012-12-01,winter,2012,December,15,Saturday,Holiday,Mist,0.4,0.4091,0.62,0.0,113,371,484,484,30,484,4,4,2,442,2,729,183149,4,484
2012-12-01,winter,2012,December,16,Saturday,Holiday,Mist,0.38,0.3939,0.66,0.0,89,354,443,443,30,443,4,4,2,442,0,730,227748,4,443
2012-12-01,winter,2012,December,17,Saturday,Holiday,Mist,0.34,0.3485,0.76,0.1045,50,270,320,320,30,320,4,4,2,442,1,730,336860,4,320
2012-12-01,winter,2012,December,18,Saturday,Holiday,Mist,0.34,0.3636,0.76,0.0,42,255,297,297,30,297,4,4,2,442,0,728,309772,4,297
2012-12-01,winter,2012,December,19,Saturday,Holiday,Mist,0.32,0.3485,0.81,0.0,30,219,249,249,30,249,4,3,2,432,0,728,226789,4,249
2012-12-01,winter,2012,December,20,Saturday,Holiday,Clear,0.32,0.3485,0.81,0.0,28,170,198,198,30,198,4,3,2,432,0,728,164550,4,198
2012-12-01,winter,2012,December,21,Saturday,Holiday,Mist,0.3,0.3333,0.87,0.0,23,135,158,158,30,158,4,3,1,431,0,728,125445,4,158
2012-12-01,winter,2012,December,22,Saturday,Holiday,Mist,0.3,0.3333,0.87,0.0,17,130,147,147,30,147,4,3,1,431,0,728,95612,4,147
2012-12-01,winter,2012,December,23,Saturday,Holiday,Mist,0.32,0.3485,0.81,0.0,10,116,126,126,30,126,4,2,2,422,0,728,63941,4,126
2012-12-02,winter,2012,December,0,Sunday,Holiday,Mist,0.3,0.3182,0.87,0.0896,9,108,117,117,29,117,4,2,1,421,1,726,39130,4,117
2012-12-02,winter,2012,December,1,Sunday,Holiday,Mist,0.3,0.3182,0.87,0.0896,10,84,94,94,29,94,4,2,1,421,1,724,24164,4,94
2012-12-02,winter,2012,December,2,Sunday,Holiday,Mist,0.3,0.3333,0.87,0.0,2,72,74,74,29,74,4,2,1,421,0,715,16352,4,74
2012-12-02,winter,2012,December,3,Sunday,Holiday,Mist,0.26,0.303,0.93,0.0,4,21,25,25,29,25,4,1,1,411,0,697,8174,4,25
2012-12-02,winter,2012,December,4,Sunday,Holiday,Mist,0.26,0.303,0.93,0.0,1,6,7,7,29,7,4,1,1,411,0,697,4428,4,7
2012-12-02,winter,2012,December,5,Sunday,Holiday,Mist,0.26,0.303,0.93,0.0,1,7,8,8,29,8,4,1,1,411,0,717,14261,4,8
2012-12-02,winter,2012,December,6,Sunday,Holiday,Mist,0.24,0.2424,0.93,0.1343,1,15,16,16,29,16,4,1,1,411,1,725,55132,4,16
2012-12-02,winter,2012,December,7,Sunday,Holiday,Mist,0.24,0.2424,0.93,0.1343,5,26,31,31,29,31,4,1,1,411,1,727,154171,4,31
2012-12-02,winter,2012,December,8,Sunday,Holiday,Mist,0.26,0.2879,0.93,0.0896,12,81,93,93,29,93,4,2,1,421,1,727,261001,4,93
2012-12-02,winter,2012,December,9,Sunday,Holiday,Mist,0.28,0.2727,0.93,0.1642,37,135,172,172,29,172,4,3,1,431,1,727,159438,4,172
2012-12-02,winter,2012,December,10,Sunday,Holiday,Mist,0.3,0.3333,0.87,0.0,63,230,293,293,29,293,4,4,1,441,0,727,126257,4,293
2012-12-02,winter,2012,December,11,Sunday,Holiday,Mist,0.32,0.3182,0.81,0.1642,81,274,355,355,29,355,4,4,1,441,1,727,151320,4,355
2012-12-02,winter,2012,December,12,Sunday,Holiday,Mist,0.34,0.3333,0.81,0.1642,111,409,520,520,29,520,4,4,1,441,2,728,184414,4,520
2012-12-02,winter,2012,December,13,Sunday,Holiday,Clear,0.4,0.4091,0.71,0.2239,84,347,431,431,29,431,4,4,2,442,2,729,184919,4,431
2012-12-02,winter,2012,December,14,Sunday,Holiday,Clear,0.44,0.4394,0.62,0.2537,142,331,473,473,29,473,4,4,2,442,2,729,175652,4,473
2012-12-02,winter,2012,December,15,Sunday,Holiday,Clear,0.44,0.4394,0.67,0.1343,106,311,417,417,29,417,4,4,2,442,2,729,183149,4,417
2012-12-02,winter,2012,December,16,Sunday,Holiday,Mist,0.44,0.4394,0.67,0.1045,85,358,443,443,29,443,4,4,2,442,2,730,227748,4,443
2012-12-02,winter,2012,December,17,Sunday,Holiday,Light Snow,0.4,0.4091,0.76,0.194,59,244,303,303,29,303,4,4,2,442,0,730,336860,4,303
2012-12-02,winter,2012,December,18,Sunday,Holiday,Mist,0.44,0.4394,0.72,0.1045,25,178,203,203,29,203,4,3,2,432,0,728,309772,4,203
2012-12-02,winter,2012,December,19,Sunday,Holiday,Mist,0.4,0.4091,0.82,0.194,16,158,174,174,29,174,4,3,2,432,0,728,226789,4,174
2012-12-02,winter,2012,December,20,Sunday,Holiday,Mist,0.42,0.4242,0.82,0.194,12,142,154,154,29,154,4,3,2,432,0,728,164550,4,154
2012-12-02,winter,2012,December,21,Sunday,Holiday,Mist,0.44,0.4394,0.77,0.2239,8,91,99,99,29,99,4,2,2,422,0,728,125445,4,99
2012-12-02,winter,2012,December,22,Sunday,Holiday,Mist,0.44,0.4394,0.77,0.194,11,85,96,96,29,96,4,2,2,422,0,728,95612,4,96
2012-12-02,winter,2012,December,23,Sunday,Holiday,Mist,0.42,0.4242,0.82,0.1343,7,44,51,51,29,51,4,2,2,422,0,728,63941,4,51
2012-12-03,winter,2012,December,0,Monday,Workingday,Mist,0.42,0.4242,0.82,0.1642,3,18,21,21,28,21,4,1,2,412,0,726,39130,4,21
2012-12-03,winter,2012,December,1,Monday,Workingday,Clear,0.4,0.4091,0.82,0.1343,2,11,13,13,28,13,4,1,2,412,0,724,24164,4,13
2012-12-03,winter,2012,December,2,Monday,Workingday,Clear,0.42,0.4242,0.77,0.1642,1,9,10,10,28,10,4,1,2,412,0,715,16352,4,10
2012-12-03,winter,2012,December,3,Monday,Workingday,Clear,0.38,0.3939,0.87,0.0,2,6,8,8,28,8,4,1,2,412,0,697,8174,4,8
2012-12-03,winter,2012,December,4,Monday,Workingday,Clear,0.36,0.3788,0.93,0.0,1,4,5,5,28,5,4,1,2,412,0,697,4428,4,5
2012-12-03,winter,2012,December,5,Monday,Workingday,Clear,0.34,0.3485,0.93,0.0896,0,38,38,38,28,38,4,1,2,412,0,717,14261,4,38
2012-12-03,winter,2012,December,6,Monday,Workingday,Clear,0.36,0.3788,0.93,0.0,2,136,138,138,28,138,4,2,2,422,0,725,55132,4,138
2012-12-03,winter,2012,December,7,Monday,Workingday,Mist,0.34,0.3636,0.93,0.0,9,387,396,396,28,396,4,4,2,442,0,727,154171,4,396
2012-12-03,winter,2012,December,8,Monday,Workingday,Clear,0.36,0.3788,0.93,0.0,19,712,731,731,28,731,4,4,2,442,0,727,261001,4,731
2012-12-03,winter,2012,December,9,Monday,Workingday,Clear,0.4,0.4091,0.87,0.0896,19,289,308,308,28,308,4,4,2,442,0,727,159438,4,308
2012-12-03,winter,2012,December,10,Monday,Workingday,Clear,0.44,0.4394,0.77,0.1343,31,105,136,136,28,136,4,2,2,422,0,727,126257,4,136
2012-12-03,winter,2012,December,11,Monday,Workingday,Clear,0.48,0.4697,0.77,0.1343,51,182,233,233,28,233,4,3,2,432,0,727,151320,4,233
2012-12-03,winter,2012,December,12,Monday,Workingday,Clear,0.52,0.5,0.68,0.1642,40,228,268,268,28,268,4,3,3,433,0,728,184414,4,268
2012-12-03,winter,2012,December,13,Monday,Workingday,Clear,0.58,0.5455,0.56,0.0896,81,240,321,321,28,321,4,4,3,443,2,729,184919,4,321
2012-12-03,winter,2012,December,14,Monday,Workingday,Clear,0.6,0.6212,0.53,0.0,51,209,260,260,28,260,4,3,3,433,0,729,175652,4,260
2012-12-03,winter,2012,December,15,Monday,Workingday,Clear,0.6,0.6212,0.56,0.0,58,210,268,268,28,268,4,3,3,433,0,729,183149,4,268
2012-12-03,winter,2012,December,16,Monday,Workingday,Clear,0.6,0.6212,0.53,0.1343,45,397,442,442,28,442,4,4,3,443,2,730,227748,4,442
2012-12-03,winter,2012,December,17,Monday,Workingday,Clear,0.52,0.5,0.63,0.1045,43,665,708,708,28,708,4,4,3,443,2,730,336860,4,708
2012-12-03,winter,2012,December,18,Monday,Workingday,Clear,0.5,0.4848,0.68,0.0896,26,666,692,692,28,692,4,4,2,442,2,728,309772,4,692
2012-12-03,winter,2012,December,19,Monday,Workingday,Clear,0.5,0.4848,0.68,0.0896,27,444,471,471,28,471,4,4,2,442,0,728,226789,4,471
2012-12-03,winter,2012,December,20,Monday,Workingday,Mist,0.46,0.4545,0.77,0.0,16,284,300,300,28,300,4,4,2,442,0,728,164550,4,300
2012-12-03,winter,2012,December,21,Monday,Workingday,Clear,0.44,0.4394,0.82,0.194,14,207,221,221,28,221,4,3,2,432,0,728,125445,4,221
2012-12-03,winter,2012,December,22,Monday,Workingday,Clear,0.42,0.4242,0.82,0.1045,5,139,144,144,28,144,4,3,2,432,0,728,95612,4,144
2012-12-03,winter,2012,December,23,Monday,Workingday,Clear,0.42,0.4242,0.82,0.1045,9,93,102,102,28,102,4,2,2,422,0,728,63941,4,102
2012-12-04,winter,2012,December,0,Tuesday,Workingday,Clear,0.42,0.4242,0.88,0.1045,6,49,55,55,27,55,4,2,2,422,0,726,39130,4,55
2012-12-04,winter,2012,December,1,Tuesday,Workingday,Clear,0.42,0.4242,0.82,0.1045,3,22,25,25,27,25,4,1,2,412,0,724,24164,4,25
2012-12-04,winter,2012,December,2,Tuesday,Workingday,Clear,0.42,0.4242,0.88,0.0896,3,5,8,8,27,8,4,1,2,412,0,715,16352,4,8
2012-12-04,winter,2012,December,3,Tuesday,Workingday,Mist,0.4,0.4091,0.87,0.1343,1,3,4,4,27,4,4,1,2,412,0,697,8174,4,4
2012-12-04,winter,2012,December,4,Tuesday,Workingday,Mist,0.4,0.4091,0.87,0.1343,0,7,7,7,27,7,4,1,2,412,0,697,4428,4,7
2012-12-04,winter,2012,December,5,Tuesday,Workingday,Mist,0.44,0.4394,0.88,0.0,1,45,46,46,27,46,4,2,2,422,0,717,14261,4,46
2012-12-04,winter,2012,December,6,Tuesday,Workingday,Mist,0.36,0.3788,0.93,0.0,3,150,153,153,27,153,4,3,2,432,0,725,55132,4,153
2012-12-04,winter,2012,December,7,Tuesday,Workingday,Clear,0.42,0.4242,0.88,0.1343,7,495,502,502,27,502,4,4,2,442,0,727,154171,4,502
2012-12-04,winter,2012,December,8,Tuesday,Workingday,Mist,0.44,0.4394,0.88,0.1642,21,700,721,721,27,721,4,4,2,442,2,727,261001,4,721
2012-12-04,winter,2012,December,9,Tuesday,Workingday,Clear,0.46,0.4545,0.82,0.1045,19,317,336,336,27,336,4,4,2,442,0,727,159438,4,336
2012-12-04,winter,2012,December,10,Tuesday,Workingday,Clear,0.46,0.4545,0.82,0.194,26,130,156,156,27,156,4,3,2,432,0,727,126257,4,156
2012-12-04,winter,2012,December,11,Tuesday,Workingday,Clear,0.48,0.4697,0.77,0.194,24,183,207,207,27,207,4,3,2,432,0,727,151320,4,207
2012-12-04,winter,2012,December,12,Tuesday,Workingday,Clear,0.52,0.5,0.68,0.194,39,273,312,312,27,312,4,4,3,443,0,728,184414,4,312
2012-12-04,winter,2012,December,13,Tuesday,Workingday,Mist,0.54,0.5152,0.64,0.1642,39,233,272,272,27,272,4,3,3,433,0,729,184919,4,272
2012-12-04,winter,2012,December,14,Tuesday,Workingday,Mist,0.58,0.5455,0.56,0.2239,39,231,270,270,27,270,4,3,3,433,2,729,175652,4,270
2012-12-04,winter,2012,December,15,Tuesday,Workingday,Mist,0.6,0.6212,0.49,0.2537,56,244,300,300,27,300,4,4,3,443,2,729,183149,4,300
2012-12-04,winter,2012,December,16,Tuesday,Workingday,Clear,0.58,0.5455,0.49,0.2836,44,391,435,435,27,435,4,4,3,443,2,730,227748,4,435
2012-12-04,winter,2012,December,17,Tuesday,Workingday,Clear,0.52,0.5,0.59,0.2239,43,700,743,743,27,743,4,4,3,443,2,730,336860,4,743
2012-12-04,winter,2012,December,18,Tuesday,Workingday,Clear,0.5,0.4848,0.63,0.2239,38,693,731,731,27,731,4,4,2,442,2,728,309772,4,731
2012-12-04,winter,2012,December,19,Tuesday,Workingday,Clear,0.48,0.4697,0.67,0.2239,46,414,460,460,27,460,4,4,2,442,2,728,226789,4,460
2012-12-04,winter,2012,December,20,Tuesday,Workingday,Mist,0.5,0.4848,0.63,0.2239,34,272,306,306,27,306,4,4,2,442,0,728,164550,4,306
2012-12-04,winter,2012,December,21,Tuesday,Workingday,Mist,0.5,0.4848,0.63,0.2537,28,252,280,280,27,280,4,3,2,432,0,728,125445,4,280
2012-12-04,winter,2012,December,22,Tuesday,Workingday,Mist,0.5,0.4848,0.63,0.2985,26,155,181,181,27,181,4,3,2,432,0,728,95612,4,181
2012-12-04,winter,2012,December,23,Tuesday,Workingday,Clear,0.48,0.4697,0.67,0.2537,5,91,96,96,27,96,4,2,2,422,0,728,63941,4,96
2012-12-05,winter,2012,December,0,Wednesday,Workingday,Clear,0.5,0.4848,0.59,0.2836,6,31,37,37,26,37,4,1,2,412,0,726,39130,4,37
2012-12-05,winter,2012,December,1,Wednesday,Workingday,Clear,0.52,0.5,0.55,0.3284,0,11,11,11,26,11,4,1,3,413,1,724,24164,4,11
2012-12-05,winter,2012,December,2,Wednesday,Workingday,Clear,0.46,0.4545,0.67,0.1642,2,7,9,9,26,9,4,1,2,412,0,715,16352,4,9
2012-12-05,winter,2012,December,3,Wednesday,Workingday,Clear,0.48,0.4697,0.67,0.1343,0,7,7,7,26,7,4,1,2,412,0,697,8174,4,7
2012-12-05,winter,2012,December,4,Wednesday,Workingday,Clear,0.5,0.4848,0.63,0.4478,1,9,10,10,26,10,4,1,2,412,1,697,4428,4,10
2012-12-05,winter,2012,December,5,Wednesday,Workingday,Clear,0.5,0.4848,0.59,0.2836,1,48,49,49,26,49,4,2,2,422,0,717,14261,4,49
2012-12-05,winter,2012,December,6,Wednesday,Workingday,Light Snow,0.48,0.4697,0.55,0.3881,5,119,124,124,26,124,4,2,2,422,1,725,55132,4,124
2012-12-05,winter,2012,December,7,Wednesday,Workingday,Light Snow,0.46,0.4545,0.59,0.2985,9,389,398,398,26,398,4,4,2,442,1,727,154171,4,398
2012-12-05,winter,2012,December,8,Wednesday,Workingday,Mist,0.44,0.4394,0.58,0.2836,22,737,759,759,26,759,4,4,2,442,2,727,261001,4,759
2012-12-05,winter,2012,December,9,Wednesday,Workingday,Mist,0.44,0.4394,0.51,0.2239,26,362,388,388,26,388,4,4,2,442,1,727,159438,4,388
2012-12-05,winter,2012,December,10,Wednesday,Workingday,Mist,0.44,0.4394,0.47,0.3582,14,127,141,141,26,141,4,2,2,422,1,727,126257,4,141
2012-12-05,winter,2012,December,11,Wednesday,Workingday,Clear,0.44,0.4394,0.44,0.2836,11,161,172,172,26,172,4,3,2,432,1,727,151320,4,172
2012-12-05,winter,2012,December,12,Wednesday,Workingday,Clear,0.44,0.4394,0.41,0.2836,24,208,232,232,26,232,4,3,2,432,1,728,184414,4,232
2012-12-05,winter,2012,December,13,Wednesday,Workingday,Clear,0.46,0.4545,0.41,0.2836,14,200,214,214,26,214,4,3,2,432,1,729,184919,4,214
2012-12-05,winter,2012,December,14,Wednesday,Workingday,Clear,0.48,0.4697,0.33,0.4925,39,179,218,218,26,218,4,3,2,432,1,729,175652,4,218
2012-12-05,winter,2012,December,15,Wednesday,Workingday,Clear,0.48,0.4697,0.33,0.2836,20,265,285,285,26,285,4,4,2,442,1,729,183149,4,285
2012-12-05,winter,2012,December,16,Wednesday,Workingday,Clear,0.46,0.4545,0.33,0.2836,23,354,377,377,26,377,4,4,2,442,2,730,227748,4,377
2012-12-05,winter,2012,December,17,Wednesday,Workingday,Clear,0.44,0.4394,0.35,0.2836,29,576,605,605,26,605,4,4,2,442,2,730,336860,4,605
2012-12-05,winter,2012,December,18,Wednesday,Workingday,Clear,0.42,0.4242,0.35,0.4478,29,580,609,609,26,609,4,4,2,442,2,728,309772,4,609
2012-12-05,winter,2012,December,19,Wednesday,Workingday,Clear,0.38,0.3939,0.43,0.3582,14,400,414,414,26,414,4,4,2,442,1,728,226789,4,414
2012-12-05,winter,2012,December,20,Wednesday,Workingday,Clear,0.34,0.303,0.46,0.3881,19,274,293,293,26,293,4,4,1,441,1,728,164550,4,293
2012-12-05,winter,2012,December,21,Wednesday,Workingday,Clear,0.34,0.303,0.46,0.4179,14,184,198,198,26,198,4,3,1,431,1,728,125445,4,198
2012-12-05,winter,2012,December,22,Wednesday,Workingday,Clear,0.32,0.2879,0.45,0.3881,4,101,105,105,26,105,4,2,1,421,1,728,95612,4,105
2012-12-05,winter,2012,December,23,Wednesday,Workingday,Clear,0.3,0.2727,0.49,0.3881,5,69,74,74,26,74,4,2,1,421,1,728,63941,4,74
2012-12-06,winter,2012,December,0,Thursday,Workingday,Clear,0.26,0.2424,0.48,0.2836,1,43,44,44,25,44,4,2,1,421,1,726,39130,4,44
2012-12-06,winter,2012,December,1,Thursday,Workingday,Clear,0.26,0.2424,0.48,0.2836,0,16,16,16,25,16,4,1,1,411,1,724,24164,4,16
2012-12-06,winter,2012,December,2,Thursday,Workingday,Clear,0.24,0.2121,0.52,0.2836,0,9,9,9,25,9,4,1,1,411,1,715,16352,4,9
2012-12-06,winter,2012,December,3,Thursday,Workingday,Clear,0.22,0.2273,0.55,0.194,0,2,2,2,25,2,4,1,1,411,1,697,8174,4,2
2012-12-06,winter,2012,December,4,Thursday,Workingday,Clear,0.22,0.2121,0.55,0.2985,1,8,9,9,25,9,4,1,1,411,1,697,4428,4,9
2012-12-06,winter,2012,December,5,Thursday,Workingday,Clear,0.22,0.2121,0.55,0.2836,0,32,32,32,25,32,4,1,1,411,1,717,14261,4,32
2012-12-06,winter,2012,December,6,Thursday,Workingday,Clear,0.22,0.2121,0.55,0.2985,2,122,124,124,25,124,4,2,1,421,1,725,55132,4,124
2012-12-06,winter,2012,December,7,Thursday,Workingday,Clear,0.22,0.2121,0.51,0.2985,8,381,389,389,25,389,4,4,1,441,1,727,154171,4,389
2012-12-06,winter,2012,December,8,Thursday,Workingday,Clear,0.22,0.2121,0.51,0.2985,13,646,659,659,25,659,4,4,1,441,1,727,261001,4,659
2012-12-06,winter,2012,December,9,Thursday,Workingday,Clear,0.24,0.2273,0.48,0.194,19,257,276,276,25,276,4,3,1,431,1,727,159438,4,276
2012-12-06,winter,2012,December,10,Thursday,Workingday,Clear,0.24,0.2273,0.52,0.194,23,122,145,145,25,145,4,3,1,431,1,727,126257,4,145
2012-12-06,winter,2012,December,11,Thursday,Workingday,Clear,0.26,0.2576,0.48,0.1642,16,162,178,178,25,178,4,3,1,431,1,727,151320,4,178
2012-12-06,winter,2012,December,12,Thursday,Workingday,Clear,0.28,0.3182,0.41,0.0,29,206,235,235,25,235,4,3,1,431,1,728,184414,4,235
2012-12-06,winter,2012,December,13,Thursday,Workingday,Clear,0.3,0.3333,0.39,0.0,33,212,245,245,25,245,4,3,1,431,1,729,184919,4,245
2012-12-06,winter,2012,December,14,Thursday,Workingday,Clear,0.3,0.3182,0.42,0.0896,37,175,212,212,25,212,4,3,1,431,1,729,175652,4,212
2012-12-06,winter,2012,December,15,Thursday,Workingday,Clear,0.32,0.3485,0.39,0.0,38,232,270,270,25,270,4,3,2,432,1,729,183149,4,270
2012-12-06,winter,2012,December,16,Thursday,Workingday,Clear,0.32,0.3485,0.42,0.0,39,292,331,331,25,331,4,4,2,442,1,730,227748,4,331
2012-12-06,winter,2012,December,17,Thursday,Workingday,Clear,0.3,0.3182,0.45,0.1045,31,586,617,617,25,617,4,4,1,441,1,730,336860,4,617
2012-12-06,winter,2012,December,18,Thursday,Workingday,Clear,0.28,0.2727,0.45,0.1642,23,542,565,565,25,565,4,4,1,441,1,728,309772,4,565
2012-12-06,winter,2012,December,19,Thursday,Workingday,Clear,0.26,0.2576,0.6,0.194,13,360,373,373,25,373,4,4,1,441,1,728,226789,4,373
2012-12-06,winter,2012,December,20,Thursday,Workingday,Mist,0.24,0.2576,0.6,0.1045,5,222,227,227,25,227,4,3,1,431,1,728,164550,4,227
2012-12-06,winter,2012,December,21,Thursday,Workingday,Mist,0.24,0.2424,0.6,0.1343,7,184,191,191,25,191,4,3,1,431,1,728,125445,4,191
2012-12-06,winter,2012,December,22,Thursday,Workingday,Clear,0.24,0.2424,0.65,0.1642,2,131,133,133,25,133,4,2,1,421,1,728,95612,4,133
2012-12-06,winter,2012,December,23,Thursday,Workingday,Clear,0.24,0.2424,0.65,0.1642,0,93,93,93,25,93,4,2,1,421,1,728,63941,4,93
2012-12-07,winter,2012,December,0,Friday,Workingday,Clear,0.24,0.2576,0.7,0.1045,3,45,48,48,24,48,4,2,1,421,1,726,39130,4,48
2012-12-07,winter,2012,December,1,Friday,Workingday,Mist,0.24,0.2273,0.7,0.194,2,26,28,28,24,28,4,1,1,411,1,724,24164,4,28
2012-12-07,winter,2012,December,2,Friday,Workingday,Mist,0.26,0.2727,0.7,0.1343,0,11,11,11,24,11,4,1,1,411,1,715,16352,4,11
2012-12-07,winter,2012,December,3,Friday,Workingday,Mist,0.26,0.2576,0.81,0.194,0,5,5,5,24,5,4,1,1,411,1,697,8174,4,5
2012-12-07,winter,2012,December,4,Friday,Workingday,Clear,0.26,0.2727,0.75,0.1045,0,10,10,10,24,10,4,1,1,411,1,697,4428,4,10
2012-12-07,winter,2012,December,5,Friday,Workingday,Mist,0.26,0.2727,0.81,0.1045,1,25,26,26,24,26,4,1,1,411,1,717,14261,4,26
2012-12-07,winter,2012,December,6,Friday,Workingday,Mist,0.28,0.2727,0.75,0.1642,0,84,84,84,24,84,4,2,1,421,1,725,55132,4,84
2012-12-07,winter,2012,December,7,Friday,Workingday,Light Snow,0.28,0.2727,0.81,0.1642,3,212,215,215,24,215,4,3,1,431,1,727,154171,4,215
2012-12-07,winter,2012,December,8,Friday,Workingday,Mist,0.3,0.2879,0.75,0.194,11,430,441,441,24,441,4,4,1,441,1,727,261001,4,441
2012-12-07,winter,2012,December,9,Friday,Workingday,Mist,0.3,0.303,0.81,0.1343,10,291,301,301,24,301,4,4,1,441,1,727,159438,4,301
2012-12-07,winter,2012,December,10,Friday,Workingday,Mist,0.32,0.3182,0.76,0.1642,16,150,166,166,24,166,4,3,1,431,1,727,126257,4,166
2012-12-07,winter,2012,December,11,Friday,Workingday,Mist,0.32,0.3182,0.76,0.194,20,183,203,203,24,203,4,3,1,431,1,727,151320,4,203
2012-12-07,winter,2012,December,12,Friday,Workingday,Mist,0.34,0.3333,0.71,0.194,36,204,240,240,24,240,4,3,1,431,1,728,184414,4,240
2012-12-07,winter,2012,December,13,Friday,Workingday,Mist,0.36,0.3485,0.66,0.1343,23,197,220,220,24,220,4,3,2,432,1,729,184919,4,220
2012-12-07,winter,2012,December,14,Friday,Workingday,Mist,0.36,0.3485,0.71,0.1642,40,175,215,215,24,215,4,3,2,432,1,729,175652,4,215
2012-12-07,winter,2012,December,15,Friday,Workingday,Mist,0.36,0.3485,0.71,0.1642,34,269,303,303,24,303,4,4,2,442,1,729,183149,4,303
2012-12-07,winter,2012,December,16,Friday,Workingday,Clear,0.36,0.3485,0.76,0.1343,39,336,375,375,24,375,4,4,2,442,1,730,227748,4,375
2012-12-07,winter,2012,December,17,Friday,Workingday,Mist,0.38,0.3939,0.66,0.0,29,539,568,568,24,568,4,4,2,442,0,730,336860,4,568
2012-12-07,winter,2012,December,18,Friday,Workingday,Mist,0.38,0.3939,0.71,0.1045,25,473,498,498,24,498,4,4,2,442,1,728,309772,4,498
2012-12-07,winter,2012,December,19,Friday,Workingday,Mist,0.38,0.3939,0.76,0.0,15,337,352,352,24,352,4,4,2,442,0,728,226789,4,352
2012-12-07,winter,2012,December,20,Friday,Workingday,Light Snow,0.38,0.3939,0.76,0.1045,12,229,241,241,24,241,4,3,2,432,0,728,164550,4,241
2012-12-07,winter,2012,December,21,Friday,Workingday,Mist,0.36,0.3636,0.93,0.1045,9,162,171,171,24,171,4,3,2,432,0,728,125445,4,171
2012-12-07,winter,2012,December,22,Friday,Workingday,Mist,0.36,0.3636,0.93,0.0896,15,150,165,165,24,165,4,3,2,432,0,728,95612,4,165
2012-12-07,winter,2012,December,23,Friday,Workingday,Mist,0.36,0.3636,0.93,0.0896,6,116,122,122,24,122,4,2,2,422,0,728,63941,4,122
2012-12-08,winter,2012,December,0,Saturday,Holiday,Mist,0.36,0.3636,0.93,0.0896,5,98,103,103,23,103,4,2,2,422,0,726,39130,4,103
2012-12-08,winter,2012,December,1,Saturday,Holiday,Mist,0.36,0.3485,0.93,0.1343,16,84,100,100,23,100,4,2,2,422,0,724,24164,4,100
2012-12-08,winter,2012,December,2,Saturday,Holiday,Mist,0.36,0.3485,0.93,0.1343,3,67,70,70,23,70,4,2,2,422,0,715,16352,4,70
2012-12-08,winter,2012,December,3,Saturday,Holiday,Mist,0.36,0.3636,0.93,0.1045,6,23,29,29,23,29,4,1,2,412,0,697,8174,4,29
2012-12-08,winter,2012,December,4,Saturday,Holiday,Mist,0.36,0.3788,0.93,0.0,3,9,12,12,23,12,4,1,2,412,0,697,4428,4,12
2012-12-08,winter,2012,December,5,Saturday,Holiday,Mist,0.36,0.3636,0.93,0.1045,2,4,6,6,23,6,4,1,2,412,0,717,14261,4,6
2012-12-08,winter,2012,December,6,Saturday,Holiday,Mist,0.36,0.3636,0.93,0.1045,1,19,20,20,23,20,4,1,2,412,0,725,55132,4,20
2012-12-08,winter,2012,December,7,Saturday,Holiday,Mist,0.36,0.3636,1.0,0.0896,3,36,39,39,23,39,4,1,2,412,0,727,154171,4,39
2012-12-08,winter,2012,December,8,Saturday,Holiday,Mist,0.38,0.3939,0.94,0.0896,5,106,111,111,23,111,4,2,2,422,0,727,261001,4,111
2012-12-08,winter,2012,December,9,Saturday,Holiday,Mist,0.38,0.3939,0.94,0.0,17,153,170,170,23,170,4,3,2,432,0,727,159438,4,170
2012-12-08,winter,2012,December,10,Saturday,Holiday,Mist,0.4,0.4091,0.87,0.1343,43,244,287,287,23,287,4,4,2,442,0,727,126257,4,287
2012-12-08,winter,2012,December,11,Saturday,Holiday,Mist,0.4,0.4091,0.87,0.1045,63,341,404,404,23,404,4,4,2,442,0,727,151320,4,404
2012-12-08,winter,2012,December,12,Saturday,Holiday,Mist,0.4,0.4091,0.87,0.2239,122,364,486,486,23,486,4,4,2,442,2,728,184414,4,486
2012-12-08,winter,2012,December,13,Saturday,Holiday,Mist,0.4,0.4091,0.87,0.1642,148,399,547,547,23,547,4,4,2,442,2,729,184919,4,547
2012-12-08,winter,2012,December,14,Saturday,Holiday,Mist,0.4,0.4091,0.87,0.2836,164,378,542,542,23,542,4,4,2,442,2,729,175652,4,542
2012-12-08,winter,2012,December,15,Saturday,Holiday,Clear,0.42,0.4242,0.82,0.1642,167,374,541,541,23,541,4,4,2,442,2,729,183149,4,541
2012-12-08,winter,2012,December,16,Saturday,Holiday,Clear,0.42,0.4242,0.82,0.1642,139,368,507,507,23,507,4,4,2,442,2,730,227748,4,507
2012-12-08,winter,2012,December,17,Saturday,Holiday,Clear,0.38,0.3939,0.87,0.1343,77,268,345,345,23,345,4,4,2,442,0,730,336860,4,345
2012-12-08,winter,2012,December,18,Saturday,Holiday,Clear,0.4,0.4091,0.87,0.1045,40,264,304,304,23,304,4,4,2,442,0,728,309772,4,304
2012-12-08,winter,2012,December,19,Saturday,Holiday,Clear,0.4,0.4091,0.87,0.0,34,212,246,246,23,246,4,3,2,432,0,728,226789,4,246
2012-12-08,winter,2012,December,20,Saturday,Holiday,Mist,0.36,0.3788,1.0,0.0,20,162,182,182,23,182,4,3,2,432,0,728,164550,4,182
2012-12-08,winter,2012,December,21,Saturday,Holiday,Mist,0.36,0.3788,1.0,0.0,34,175,209,209,23,209,4,3,2,432,0,728,125445,4,209
2012-12-08,winter,2012,December,22,Saturday,Holiday,Mist,0.38,0.3939,0.94,0.1045,23,137,160,160,23,160,4,3,2,432,0,728,95612,4,160
2012-12-08,winter,2012,December,23,Saturday,Holiday,Mist,0.4,0.4091,0.94,0.0,18,144,162,162,23,162,4,3,2,432,0,728,63941,4,162
2012-12-09,winter,2012,December,0,Sunday,Holiday,Mist,0.4,0.4091,0.87,0.1343,15,103,118,118,22,118,4,2,2,422,0,726,39130,4,118
2012-12-09,winter,2012,December,1,Sunday,Holiday,Mist,0.4,0.4091,0.87,0.1045,17,85,102,102,22,102,4,2,2,422,0,724,24164,4,102
2012-12-09,winter,2012,December,2,Sunday,Holiday,Mist,0.4,0.4091,0.87,0.1045,8,70,78,78,22,78,4,2,2,422,0,715,16352,4,78
2012-12-09,winter,2012,December,3,Sunday,Holiday,Mist,0.4,0.4091,0.87,0.1045,14,34,48,48,22,48,4,2,2,422,0,697,8174,4,48
2012-12-09,winter,2012,December,4,Sunday,Holiday,Mist,0.4,0.4091,0.94,0.1045,1,11,12,12,22,12,4,1,2,412,0,697,4428,4,12
2012-12-09,winter,2012,December,5,Sunday,Holiday,Mist,0.4,0.4091,0.87,0.1045,0,8,8,8,22,8,4,1,2,412,0,717,14261,4,8
2012-12-09,winter,2012,December,6,Sunday,Holiday,Light Snow,0.4,0.4091,0.94,0.1045,0,6,6,6,22,6,4,1,2,412,0,725,55132,4,6
2012-12-09,winter,2012,December,7,Sunday,Holiday,Light Snow,0.4,0.4091,0.87,0.2239,1,22,23,23,22,23,4,1,2,412,0,727,154171,4,23
2012-12-09,winter,2012,December,8,Sunday,Holiday,Light Snow,0.4,0.4091,0.87,0.1642,1,68,69,69,22,69,4,2,2,422,0,727,261001,4,69
2012-12-09,winter,2012,December,9,Sunday,Holiday,Mist,0.4,0.4091,0.87,0.2537,9,94,103,103,22,103,4,2,2,422,0,727,159438,4,103
2012-12-09,winter,2012,December,10,Sunday,Holiday,Mist,0.4,0.4091,0.87,0.2836,39,180,219,219,22,219,4,3,2,432,0,727,126257,4,219
2012-12-09,winter,2012,December,11,Sunday,Holiday,Mist,0.4,0.4091,0.87,0.2985,40,210,250,250,22,250,4,3,2,432,0,727,151320,4,250
2012-12-09,winter,2012,December,12,Sunday,Holiday,Mist,0.4,0.4091,0.82,0.2985,60,255,315,315,22,315,4,4,2,442,1,728,184414,4,315
2012-12-09,winter,2012,December,13,Sunday,Holiday,Mist,0.38,0.3939,0.87,0.2836,65,220,285,285,22,285,4,4,2,442,0,729,184919,4,285
2012-12-09,winter,2012,December,14,Sunday,Holiday,Mist,0.38,0.3939,0.87,0.194,42,190,232,232,22,232,4,3,2,432,0,729,175652,4,232
2012-12-09,winter,2012,December,15,Sunday,Holiday,Light Snow,0.36,0.3485,0.93,0.1642,25,200,225,225,22,225,4,3,2,432,0,729,183149,4,225
2012-12-09,winter,2012,December,16,Sunday,Holiday,Light Snow,0.36,0.3485,0.93,0.1642,33,220,253,253,22,253,4,3,2,432,0,730,227748,4,253
2012-12-09,winter,2012,December,17,Sunday,Holiday,Light Snow,0.36,0.3485,0.93,0.1343,20,209,229,229,22,229,4,3,2,432,0,730,336860,4,229
2012-12-09,winter,2012,December,18,Sunday,Holiday,Light Snow,0.36,0.3636,0.93,0.0896,17,181,198,198,22,198,4,3,2,432,0,728,309772,4,198
2012-12-09,winter,2012,December,19,Sunday,Holiday,Light Snow,0.38,0.3939,0.94,0.0896,12,110,122,122,22,122,4,2,2,422,0,728,226789,4,122
2012-12-09,winter,2012,December,20,Sunday,Holiday,Light Snow,0.36,0.3636,1.0,0.0896,6,102,108,108,22,108,4,2,2,422,0,728,164550,4,108
2012-12-09,winter,2012,December,21,Sunday,Holiday,Mist,0.36,0.3636,1.0,0.1045,10,86,96,96,22,96,4,2,2,422,0,728,125445,4,96
2012-12-09,winter,2012,December,22,Sunday,Holiday,Light Snow,0.36,0.3636,0.93,0.1045,3,75,78,78,22,78,4,2,2,422,0,728,95612,4,78
2012-12-09,winter,2012,December,23,Sunday,Holiday,Light Snow,0.36,0.3636,1.0,0.0896,3,48,51,51,22,51,4,2,2,422,0,728,63941,4,51
2012-12-10,winter,2012,December,0,Monday,Workingday,Light Snow,0.36,0.3636,1.0,0.0896,0,20,20,20,21,20,4,1,2,412,0,726,39130,4,20
2012-12-10,winter,2012,December,1,Monday,Workingday,Mist,0.36,0.3788,1.0,0.0,0,4,4,4,21,4,4,1,2,412,0,724,24164,4,4
2012-12-10,winter,2012,December,2,Monday,Workingday,Mist,0.38,0.3939,0.94,0.1045,2,3,5,5,21,5,4,1,2,412,0,715,16352,4,5
2012-12-10,winter,2012,December,3,Monday,Workingday,Mist,0.38,0.3939,0.94,0.1045,0,4,4,4,21,4,4,1,2,412,0,697,8174,4,4
2012-12-10,winter,2012,December,4,Monday,Workingday,Mist,0.38,0.3939,0.94,0.1045,3,9,12,12,21,12,4,1,2,412,0,697,4428,4,12
2012-12-10,winter,2012,December,5,Monday,Workingday,Mist,0.38,0.3939,0.94,0.1045,0,27,27,27,21,27,4,1,2,412,0,717,14261,4,27
2012-12-10,winter,2012,December,6,Monday,Workingday,Mist,0.38,0.3939,0.94,0.1642,2,121,123,123,21,123,4,2,2,422,0,725,55132,4,123
2012-12-10,winter,2012,December,7,Monday,Workingday,Mist,0.38,0.3939,0.94,0.2537,3,291,294,294,21,294,4,4,2,442,0,727,154171,4,294
2012-12-10,winter,2012,December,8,Monday,Workingday,Mist,0.42,0.4242,1.0,0.2537,9,575,584,584,21,584,4,4,2,442,0,727,261001,4,584
2012-12-10,winter,2012,December,9,Monday,Workingday,Mist,0.42,0.4242,1.0,0.2239,11,273,284,284,21,284,4,4,2,442,0,727,159438,4,284
2012-12-10,winter,2012,December,10,Monday,Workingday,Mist,0.44,0.4394,0.94,0.2239,12,121,133,133,21,133,4,2,2,422,0,727,126257,4,133
2012-12-10,winter,2012,December,11,Monday,Workingday,Light Snow,0.46,0.4545,0.94,0.2239,8,126,134,134,21,134,4,2,2,422,0,727,151320,4,134
2012-12-10,winter,2012,December,12,Monday,Workingday,Light Snow,0.44,0.4394,1.0,0.2239,23,150,173,173,21,173,4,3,2,432,0,728,184414,4,173
2012-12-10,winter,2012,December,13,Monday,Workingday,Light Snow,0.44,0.4394,1.0,0.2239,30,190,220,220,21,220,4,3,2,432,0,729,184919,4,220
2012-12-10,winter,2012,December,14,Monday,Workingday,Mist,0.5,0.4848,0.94,0.2239,31,179,210,210,21,210,4,3,2,432,0,729,175652,4,210
2012-12-10,winter,2012,December,15,Monday,Workingday,Mist,0.5,0.4848,0.87,0.1642,29,207,236,236,21,236,4,3,2,432,0,729,183149,4,236
2012-12-10,winter,2012,December,16,Monday,Workingday,Mist,0.5,0.4848,0.88,0.1045,37,308,345,345,21,345,4,4,2,442,0,730,227748,4,345
2012-12-10,winter,2012,December,17,Monday,Workingday,Mist,0.48,0.4697,0.82,0.2836,38,578,616,616,21,616,4,4,2,442,2,730,336860,4,616
2012-12-10,winter,2012,December,18,Monday,Workingday,Mist,0.46,0.4545,0.88,0.2836,20,544,564,564,21,564,4,4,2,442,0,728,309772,4,564
2012-12-10,winter,2012,December,19,Monday,Workingday,Clear,0.52,0.5,0.77,0.2836,18,409,427,427,21,427,4,4,3,443,0,728,226789,4,427
2012-12-10,winter,2012,December,20,Monday,Workingday,Clear,0.46,0.4545,0.88,0.2537,13,287,300,300,21,300,4,4,2,442,0,728,164550,4,300
2012-12-10,winter,2012,December,21,Monday,Workingday,Mist,0.46,0.4545,0.94,0.194,21,224,245,245,21,245,4,3,2,432,0,728,125445,4,245
2012-12-10,winter,2012,December,22,Monday,Workingday,Mist,0.5,0.4848,0.82,0.2239,11,115,126,126,21,126,4,2,2,422,0,728,95612,4,126
2012-12-10,winter,2012,December,23,Monday,Workingday,Clear,0.46,0.4545,0.88,0.2537,8,76,84,84,21,84,4,2,2,422,0,728,63941,4,84
2012-12-11,winter,2012,December,0,Tuesday,Workingday,Light Snow,0.46,0.4545,0.77,0.4627,2,29,31,31,20,31,4,1,2,412,1,726,39130,4,31
2012-12-11,winter,2012,December,1,Tuesday,Workingday,Clear,0.42,0.4242,0.71,0.4478,1,7,8,8,20,8,4,1,2,412,1,724,24164,4,8
2012-12-11,winter,2012,December,2,Tuesday,Workingday,Mist,0.4,0.4091,0.66,0.3284,0,1,1,1,20,1,4,1,2,412,1,715,16352,4,1
2012-12-11,winter,2012,December,3,Tuesday,Workingday,Light Snow,0.36,0.3333,0.76,0.2836,0,3,3,3,20,3,4,1,1,411,1,697,8174,4,3
2012-12-11,winter,2012,December,4,Tuesday,Workingday,Mist,0.34,0.3182,0.76,0.2836,0,8,8,8,20,8,4,1,1,411,1,697,4428,4,8
2012-12-11,winter,2012,December,5,Tuesday,Workingday,Light Snow,0.34,0.303,0.71,0.3284,1,40,41,41,20,41,4,2,1,421,1,717,14261,4,41
2012-12-11,winter,2012,December,6,Tuesday,Workingday,Mist,0.34,0.303,0.71,0.2985,0,118,118,118,20,118,4,2,1,421,1,725,55132,4,118
2012-12-11,winter,2012,December,7,Tuesday,Workingday,Clear,0.34,0.303,0.66,0.4179,8,372,380,380,20,380,4,4,1,441,1,727,154171,4,380
2012-12-11,winter,2012,December,8,Tuesday,Workingday,Mist,0.34,0.303,0.61,0.2985,16,708,724,724,20,724,4,4,1,441,1,727,261001,4,724
2012-12-11,winter,2012,December,9,Tuesday,Workingday,Clear,0.34,0.303,0.61,0.3881,12,322,334,334,20,334,4,4,1,441,1,727,159438,4,334
2012-12-11,winter,2012,December,10,Tuesday,Workingday,Clear,0.36,0.3333,0.57,0.3284,12,142,154,154,20,154,4,3,1,431,1,727,126257,4,154
2012-12-11,winter,2012,December,11,Tuesday,Workingday,Mist,0.36,0.3333,0.53,0.3582,28,145,173,173,20,173,4,3,1,431,1,727,151320,4,173
2012-12-11,winter,2012,December,12,Tuesday,Workingday,Mist,0.36,0.3182,0.53,0.4478,13,213,226,226,20,226,4,3,1,431,1,728,184414,4,226
2012-12-11,winter,2012,December,13,Tuesday,Workingday,Mist,0.38,0.3939,0.5,0.2239,28,226,254,254,20,254,4,3,2,432,1,729,184919,4,254
2012-12-11,winter,2012,December,14,Tuesday,Workingday,Mist,0.38,0.3939,0.5,0.2239,19,185,204,204,20,204,4,3,2,432,1,729,175652,4,204
2012-12-11,winter,2012,December,15,Tuesday,Workingday,Mist,0.38,0.3939,0.5,0.2239,20,250,270,270,20,270,4,3,2,432,1,729,183149,4,270
2012-12-11,winter,2012,December,16,Tuesday,Workingday,Mist,0.38,0.3939,0.5,0.2239,24,334,358,358,20,358,4,4,2,442,1,730,227748,4,358
2012-12-11,winter,2012,December,17,Tuesday,Workingday,Clear,0.32,0.303,0.53,0.2239,21,580,601,601,20,601,4,4,1,441,1,730,336860,4,601
2012-12-11,winter,2012,December,18,Tuesday,Workingday,Clear,0.32,0.303,0.53,0.2239,23,523,546,546,20,546,4,4,1,441,1,728,309772,4,546
2012-12-11,winter,2012,December,19,Tuesday,Workingday,Clear,0.32,0.303,0.53,0.2239,21,412,433,433,20,433,4,4,1,441,1,728,226789,4,433
2012-12-11,winter,2012,December,20,Tuesday,Workingday,Clear,0.32,0.303,0.53,0.2239,9,248,257,257,20,257,4,3,1,431,1,728,164550,4,257
2012-12-11,winter,2012,December,21,Tuesday,Workingday,Clear,0.32,0.3182,0.53,0.194,14,193,207,207,20,207,4,3,1,431,1,728,125445,4,207
2012-12-11,winter,2012,December,22,Tuesday,Workingday,Clear,0.3,0.2879,0.56,0.2239,6,100,106,106,20,106,4,2,1,421,1,728,95612,4,106
2012-12-11,winter,2012,December,23,Tuesday,Workingday,Clear,0.3,0.2879,0.52,0.2239,4,60,64,64,20,64,4,2,1,421,1,728,63941,4,64
2012-12-12,winter,2012,December,0,Wednesday,Workingday,Clear,0.3,0.303,0.52,0.1642,1,33,34,34,19,34,4,1,1,411,1,726,39130,4,34
2012-12-12,winter,2012,December,1,Wednesday,Workingday,Clear,0.28,0.2727,0.61,0.2239,3,18,21,21,19,21,4,1,1,411,1,724,24164,4,21
2012-12-12,winter,2012,December,2,Wednesday,Workingday,Clear,0.28,0.2727,0.56,0.1642,5,4,9,9,19,9,4,1,1,411,1,715,16352,4,9
2012-12-12,winter,2012,December,3,Wednesday,Workingday,Clear,0.26,0.2727,0.6,0.1343,3,7,10,10,19,10,4,1,1,411,1,697,8174,4,10
2012-12-12,winter,2012,December,4,Wednesday,Workingday,Clear,0.26,0.303,0.6,0.0,0,4,4,4,19,4,4,1,1,411,1,697,4428,4,4
2012-12-12,winter,2012,December,5,Wednesday,Workingday,Clear,0.26,0.2576,0.6,0.194,0,37,37,37,19,37,4,1,1,411,1,717,14261,4,37
2012-12-12,winter,2012,December,6,Wednesday,Workingday,Mist,0.26,0.2424,0.6,0.2537,2,126,128,128,19,128,4,2,1,421,1,725,55132,4,128
2012-12-12,winter,2012,December,7,Wednesday,Workingday,Mist,0.26,0.2576,0.6,0.194,3,366,369,369,19,369,4,4,1,441,1,727,154171,4,369
2012-12-12,winter,2012,December,8,Wednesday,Workingday,Mist,0.26,0.2576,0.65,0.1642,18,670,688,688,19,688,4,4,1,441,1,727,261001,4,688
2012-12-12,winter,2012,December,9,Wednesday,Workingday,Mist,0.28,0.2879,0.61,0.1343,13,272,285,285,19,285,4,4,1,441,1,727,159438,4,285
2012-12-12,winter,2012,December,10,Wednesday,Workingday,Mist,0.3,0.303,0.56,0.1642,20,116,136,136,19,136,4,2,1,421,1,727,126257,4,136
2012-12-12,winter,2012,December,11,Wednesday,Workingday,Mist,0.32,0.303,0.49,0.2239,24,148,172,172,19,172,4,3,1,431,1,727,151320,4,172
2012-12-12,winter,2012,December,12,Wednesday,Workingday,Mist,0.34,0.3636,0.42,0.0,14,218,232,232,19,232,4,3,2,432,1,728,184414,4,232
2012-12-12,winter,2012,December,13,Wednesday,Workingday,Mist,0.34,0.3636,0.42,0.0,18,220,238,238,19,238,4,3,2,432,1,729,184919,4,238
2012-12-12,winter,2012,December,14,Wednesday,Workingday,Mist,0.34,0.3636,0.46,0.0,34,191,225,225,19,225,4,3,2,432,1,729,175652,4,225
2012-12-12,winter,2012,December,15,Wednesday,Workingday,Mist,0.34,0.3485,0.46,0.1045,21,207,228,228,19,228,4,3,2,432,1,729,183149,4,228
2012-12-12,winter,2012,December,16,Wednesday,Workingday,Mist,0.34,0.3333,0.46,0.1343,19,310,329,329,19,329,4,4,1,441,1,730,227748,4,329
2012-12-12,winter,2012,December,17,Wednesday,Workingday,Mist,0.32,0.303,0.53,0.2239,21,540,561,561,19,561,4,4,1,441,1,730,336860,4,561
2012-12-12,winter,2012,December,18,Wednesday,Workingday,Mist,0.32,0.303,0.49,0.2239,25,515,540,540,19,540,4,4,1,441,1,728,309772,4,540
2012-12-12,winter,2012,December,19,Wednesday,Workingday,Mist,0.3,0.2879,0.56,0.2239,18,384,402,402,19,402,4,4,1,441,1,728,226789,4,402
2012-12-12,winter,2012,December,20,Wednesday,Workingday,Clear,0.3,0.2879,0.52,0.2836,25,243,268,268,19,268,4,3,1,431,1,728,164550,4,268
2012-12-12,winter,2012,December,21,Wednesday,Workingday,Mist,0.3,0.2879,0.52,0.2537,16,186,202,202,19,202,4,3,1,431,1,728,125445,4,202
2012-12-12,winter,2012,December,22,Wednesday,Workingday,Mist,0.3,0.2879,0.52,0.2239,4,118,122,122,19,122,4,2,1,421,1,728,95612,4,122
2012-12-12,winter,2012,December,23,Wednesday,Workingday,Mist,0.28,0.2727,0.56,0.2239,3,76,79,79,19,79,4,2,1,421,1,728,63941,4,79
2012-12-13,winter,2012,December,0,Thursday,Workingday,Mist,0.28,0.2727,0.52,0.2239,1,31,32,32,18,32,4,1,1,411,1,726,39130,4,32
2012-12-13,winter,2012,December,1,Thursday,Workingday,Mist,0.28,0.2576,0.52,0.2836,4,19,23,23,18,23,4,1,1,411,1,724,24164,4,23
2012-12-13,winter,2012,December,2,Thursday,Workingday,Mist,0.26,0.2424,0.56,0.2537,3,5,8,8,18,8,4,1,1,411,1,715,16352,4,8
2012-12-13,winter,2012,December,3,Thursday,Workingday,Mist,0.26,0.2424,0.56,0.2836,0,2,2,2,18,2,4,1,1,411,1,697,8174,4,2
2012-12-13,winter,2012,December,4,Thursday,Workingday,Mist,0.26,0.2576,0.56,0.194,0,8,8,8,18,8,4,1,1,411,1,697,4428,4,8
2012-12-13,winter,2012,December,5,Thursday,Workingday,Mist,0.26,0.2576,0.56,0.1642,2,31,33,33,18,33,4,1,1,411,1,717,14261,4,33
2012-12-13,winter,2012,December,6,Thursday,Workingday,Clear,0.26,0.2424,0.56,0.2537,2,112,114,114,18,114,4,2,1,421,1,725,55132,4,114
2012-12-13,winter,2012,December,7,Thursday,Workingday,Clear,0.24,0.2273,0.6,0.2239,5,380,385,385,18,385,4,4,1,441,1,727,154171,4,385
2012-12-13,winter,2012,December,8,Thursday,Workingday,Clear,0.24,0.2273,0.6,0.194,24,655,679,679,18,679,4,4,1,441,1,727,261001,4,679
2012-12-13,winter,2012,December,9,Thursday,Workingday,Clear,0.28,0.2727,0.52,0.2537,25,300,325,325,18,325,4,4,1,441,1,727,159438,4,325
2012-12-13,winter,2012,December,10,Thursday,Workingday,Clear,0.32,0.303,0.45,0.2836,28,139,167,167,18,167,4,3,1,431,1,727,126257,4,167
2012-12-13,winter,2012,December,11,Thursday,Workingday,Clear,0.34,0.3182,0.42,0.2537,25,164,189,189,18,189,4,3,1,431,1,727,151320,4,189
2012-12-13,winter,2012,December,12,Thursday,Workingday,Clear,0.36,0.3333,0.4,0.2537,30,252,282,282,18,282,4,4,1,441,1,728,184414,4,282
2012-12-13,winter,2012,December,13,Thursday,Workingday,Clear,0.36,0.3485,0.34,0.194,41,230,271,271,18,271,4,3,2,432,1,729,184919,4,271
2012-12-13,winter,2012,December,14,Thursday,Workingday,Clear,0.36,0.3485,0.34,0.1642,31,211,242,242,18,242,4,3,2,432,1,729,175652,4,242
2012-12-13,winter,2012,December,15,Thursday,Workingday,Clear,0.36,0.3485,0.34,0.1343,40,240,280,280,18,280,4,3,2,432,1,729,183149,4,280
2012-12-13,winter,2012,December,16,Thursday,Workingday,Clear,0.34,0.3485,0.39,0.1045,50,356,406,406,18,406,4,4,2,442,1,730,227748,4,406
2012-12-13,winter,2012,December,17,Thursday,Workingday,Clear,0.32,0.3333,0.42,0.1045,43,507,550,550,18,550,4,4,1,441,1,730,336860,4,550
2012-12-13,winter,2012,December,18,Thursday,Workingday,Clear,0.32,0.3333,0.42,0.1045,20,446,466,466,18,466,4,4,1,441,1,728,309772,4,466
2012-12-13,winter,2012,December,19,Thursday,Workingday,Clear,0.3,0.303,0.45,0.1642,20,328,348,348,18,348,4,4,1,441,1,728,226789,4,348
2012-12-13,winter,2012,December,20,Thursday,Workingday,Clear,0.3,0.3333,0.45,0.0,6,235,241,241,18,241,4,3,1,431,1,728,164550,4,241
2012-12-13,winter,2012,December,21,Thursday,Workingday,Clear,0.28,0.3182,0.48,0.0,13,200,213,213,18,213,4,3,1,431,1,728,125445,4,213
2012-12-13,winter,2012,December,22,Thursday,Workingday,Clear,0.26,0.2879,0.6,0.0896,7,141,148,148,18,148,4,3,1,431,1,728,95612,4,148
2012-12-13,winter,2012,December,23,Thursday,Workingday,Clear,0.26,0.303,0.6,0.0,5,115,120,120,18,120,4,2,1,421,1,728,63941,4,120
2012-12-14,winter,2012,December,0,Friday,Workingday,Clear,0.22,0.2576,0.64,0.0896,4,43,47,47,17,47,4,2,1,421,1,726,39130,4,47
2012-12-14,winter,2012,December,1,Friday,Workingday,Clear,0.22,0.2576,0.69,0.0896,0,26,26,26,17,26,4,1,1,411,1,724,24164,4,26
2012-12-14,winter,2012,December,2,Friday,Workingday,Clear,0.22,0.2727,0.69,0.0,3,6,9,9,17,9,4,1,1,411,1,715,16352,4,9
2012-12-14,winter,2012,December,3,Friday,Workingday,Clear,0.2,0.2273,0.69,0.1045,0,12,12,12,17,12,4,1,1,411,1,697,8174,4,12
2012-12-14,winter,2012,December,4,Friday,Workingday,Clear,0.2,0.2273,0.75,0.0896,1,9,10,10,17,10,4,1,1,411,1,697,4428,4,10
2012-12-14,winter,2012,December,5,Friday,Workingday,Clear,0.2,0.2273,0.69,0.1045,0,34,34,34,17,34,4,1,1,411,1,717,14261,4,34
2012-12-14,winter,2012,December,6,Friday,Workingday,Clear,0.16,0.1818,0.8,0.1045,1,112,113,113,17,113,4,2,1,421,1,725,55132,4,113
2012-12-14,winter,2012,December,7,Friday,Workingday,Clear,0.2,0.2121,0.72,0.1045,3,305,308,308,17,308,4,4,1,441,1,727,154171,4,308
2012-12-14,winter,2012,December,8,Friday,Workingday,Clear,0.2,0.2273,0.69,0.0896,13,623,636,636,17,636,4,4,1,441,1,727,261001,4,636
2012-12-14,winter,2012,December,9,Friday,Workingday,Clear,0.24,0.2424,0.75,0.1343,13,330,343,343,17,343,4,4,1,441,1,727,159438,4,343
2012-12-14,winter,2012,December,10,Friday,Workingday,Clear,0.26,0.2576,0.81,0.194,28,162,190,190,17,190,4,3,1,431,1,727,126257,4,190
2012-12-14,winter,2012,December,11,Friday,Workingday,Clear,0.32,0.303,0.65,0.194,31,180,211,211,17,211,4,3,1,431,1,727,151320,4,211
2012-12-14,winter,2012,December,12,Friday,Workingday,Clear,0.36,0.3485,0.5,0.194,29,244,273,273,17,273,4,3,2,432,1,728,184414,4,273
2012-12-14,winter,2012,December,13,Friday,Workingday,Clear,0.36,0.3485,0.5,0.2239,39,274,313,313,17,313,4,4,2,442,1,729,184919,4,313
2012-12-14,winter,2012,December,14,Friday,Workingday,Clear,0.4,0.4091,0.43,0.194,48,251,299,299,17,299,4,4,2,442,1,729,175652,4,299
2012-12-14,winter,2012,December,15,Friday,Workingday,Clear,0.4,0.4091,0.47,0.1642,57,252,309,309,17,309,4,4,2,442,1,729,183149,4,309
2012-12-14,winter,2012,December,16,Friday,Workingday,Clear,0.38,0.3939,0.54,0.194,45,372,417,417,17,417,4,4,2,442,1,730,227748,4,417
2012-12-14,winter,2012,December,17,Friday,Workingday,Clear,0.34,0.3333,0.57,0.1642,40,582,622,622,17,622,4,4,1,441,1,730,336860,4,622
2012-12-14,winter,2012,December,18,Friday,Workingday,Clear,0.36,0.3485,0.46,0.1343,23,432,455,455,17,455,4,4,2,442,1,728,309772,4,455
2012-12-14,winter,2012,December,19,Friday,Workingday,Clear,0.34,0.3485,0.53,0.0896,17,302,319,319,17,319,4,4,2,442,1,728,226789,4,319
2012-12-14,winter,2012,December,20,Friday,Workingday,Clear,0.32,0.3333,0.61,0.1343,12,209,221,221,17,221,4,3,1,431,1,728,164550,4,221
2012-12-14,winter,2012,December,21,Friday,Workingday,Clear,0.3,0.303,0.75,0.1642,7,165,172,172,17,172,4,3,1,431,1,728,125445,4,172
2012-12-14,winter,2012,December,22,Friday,Workingday,Clear,0.28,0.2879,0.75,0.1045,4,134,138,138,17,138,4,2,1,421,1,728,95612,4,138
2012-12-14,winter,2012,December,23,Friday,Workingday,Clear,0.28,0.303,0.75,0.0896,11,123,134,134,17,134,4,2,1,421,1,728,63941,4,134
2012-12-15,winter,2012,December,0,Saturday,Holiday,Clear,0.3,0.3333,0.7,0.0,4,90,94,94,16,94,4,2,1,421,1,726,39130,4,94
2012-12-15,winter,2012,December,1,Saturday,Holiday,Mist,0.26,0.2879,0.81,0.0896,9,86,95,95,16,95,4,2,1,421,1,724,24164,4,95
2012-12-15,winter,2012,December,2,Saturday,Holiday,Clear,0.26,0.303,0.81,0.0,6,63,69,69,16,69,4,2,1,421,1,715,16352,4,69
2012-12-15,winter,2012,December,3,Saturday,Holiday,Mist,0.24,0.2879,0.81,0.0,5,18,23,23,16,23,4,1,1,411,1,697,8174,4,23
2012-12-15,winter,2012,December,4,Saturday,Holiday,Mist,0.24,0.2576,0.87,0.1045,1,5,6,6,16,6,4,1,1,411,1,697,4428,4,6
2012-12-15,winter,2012,December,5,Saturday,Holiday,Mist,0.26,0.303,0.75,0.0,0,3,3,3,16,3,4,1,1,411,1,717,14261,4,3
2012-12-15,winter,2012,December,6,Saturday,Holiday,Mist,0.24,0.2879,0.75,0.0,0,11,11,11,16,11,4,1,1,411,1,725,55132,4,11
2012-12-15,winter,2012,December,7,Saturday,Holiday,Mist,0.24,0.2576,0.75,0.0896,1,47,48,48,16,48,4,2,1,421,1,727,154171,4,48
2012-12-15,winter,2012,December,8,Saturday,Holiday,Mist,0.26,0.2879,0.75,0.0896,8,111,119,119,16,119,4,2,1,421,1,727,261001,4,119
2012-12-15,winter,2012,December,9,Saturday,Holiday,Clear,0.26,0.2727,0.75,0.1045,17,203,220,220,16,220,4,3,1,431,1,727,159438,4,220
2012-12-15,winter,2012,December,10,Saturday,Holiday,Clear,0.32,0.3182,0.61,0.1642,23,250,273,273,16,273,4,3,1,431,1,727,126257,4,273
2012-12-15,winter,2012,December,11,Saturday,Holiday,Clear,0.34,0.3485,0.61,0.0896,66,327,393,393,16,393,4,4,2,442,1,727,151320,4,393
2012-12-15,winter,2012,December,12,Saturday,Holiday,Clear,0.38,0.3939,0.5,0.0896,89,364,453,453,16,453,4,4,2,442,2,728,184414,4,453
2012-12-15,winter,2012,December,13,Saturday,Holiday,Clear,0.38,0.3939,0.54,0.2537,88,368,456,456,16,456,4,4,2,442,2,729,184919,4,456
2012-12-15,winter,2012,December,14,Saturday,Holiday,Clear,0.4,0.4091,0.5,0.1642,92,334,426,426,16,426,4,4,2,442,2,729,175652,4,426
2012-12-15,winter,2012,December,15,Saturday,Holiday,Clear,0.42,0.4242,0.47,0.0,95,352,447,447,16,447,4,4,2,442,2,729,183149,4,447
2012-12-15,winter,2012,December,16,Saturday,Holiday,Clear,0.4,0.4091,0.5,0.1343,85,328,413,413,16,413,4,4,2,442,2,730,227748,4,413
2012-12-15,winter,2012,December,17,Saturday,Holiday,Clear,0.4,0.4091,0.5,0.2239,35,274,309,309,16,309,4,4,2,442,1,730,336860,4,309
2012-12-15,winter,2012,December,18,Saturday,Holiday,Clear,0.38,0.3939,0.58,0.1642,40,232,272,272,16,272,4,3,2,432,1,728,309772,4,272
2012-12-15,winter,2012,December,19,Saturday,Holiday,Clear,0.36,0.3485,0.62,0.1343,32,225,257,257,16,257,4,3,2,432,1,728,226789,4,257
2012-12-15,winter,2012,December,20,Saturday,Holiday,Mist,0.36,0.3485,0.57,0.194,23,178,201,201,16,201,4,3,2,432,1,728,164550,4,201
2012-12-15,winter,2012,December,21,Saturday,Holiday,Clear,0.36,0.3485,0.62,0.1343,15,169,184,184,16,184,4,3,2,432,1,728,125445,4,184
2012-12-15,winter,2012,December,22,Saturday,Holiday,Clear,0.36,0.3485,0.62,0.194,22,134,156,156,16,156,4,3,2,432,1,728,95612,4,156
2012-12-15,winter,2012,December,23,Saturday,Holiday,Mist,0.36,0.3485,0.62,0.1343,11,108,119,119,16,119,4,2,2,422,1,728,63941,4,119
2012-12-16,winter,2012,December,0,Sunday,Holiday,Mist,0.36,0.3788,0.62,0.0,8,102,110,110,15,110,4,2,2,422,1,726,39130,4,110
2012-12-16,winter,2012,December,1,Sunday,Holiday,Light Snow,0.34,0.3485,0.76,0.1045,14,82,96,96,15,96,4,2,2,422,1,724,24164,4,96
2012-12-16,winter,2012,December,2,Sunday,Holiday,Mist,0.34,0.3485,0.87,0.0896,8,79,87,87,15,87,4,2,2,422,0,715,16352,4,87
2012-12-16,winter,2012,December,3,Sunday,Holiday,Mist,0.34,0.3333,0.87,0.194,1,37,38,38,15,38,4,1,1,411,1,697,8174,4,38
2012-12-16,winter,2012,December,4,Sunday,Holiday,Mist,0.34,0.3636,0.87,0.0,1,10,11,11,15,11,4,1,2,412,0,697,4428,4,11
2012-12-16,winter,2012,December,5,Sunday,Holiday,Mist,0.34,0.3636,0.87,0.0,0,9,9,9,15,9,4,1,2,412,0,717,14261,4,9
2012-12-16,winter,2012,December,6,Sunday,Holiday,Mist,0.34,0.3636,0.87,0.0,0,6,6,6,15,6,4,1,2,412,0,725,55132,4,6
2012-12-16,winter,2012,December,7,Sunday,Holiday,Mist,0.34,0.3485,0.87,0.0896,5,22,27,27,15,27,4,1,2,412,0,727,154171,4,27
2012-12-16,winter,2012,December,8,Sunday,Holiday,Mist,0.36,0.3485,0.87,0.1343,12,76,88,88,15,88,4,2,2,422,0,727,261001,4,88
2012-12-16,winter,2012,December,9,Sunday,Holiday,Mist,0.36,0.3485,0.87,0.1343,19,113,132,132,15,132,4,2,2,422,0,727,159438,4,132
2012-12-16,winter,2012,December,10,Sunday,Holiday,Mist,0.36,0.3485,0.87,0.1343,42,215,257,257,15,257,4,3,2,432,0,727,126257,4,257
2012-12-16,winter,2012,December,11,Sunday,Holiday,Mist,0.36,0.3485,0.87,0.1343,47,248,295,295,15,295,4,4,2,442,0,727,151320,4,295
2012-12-16,winter,2012,December,12,Sunday,Holiday,Mist,0.38,0.3939,0.82,0.194,67,350,417,417,15,417,4,4,2,442,0,728,184414,4,417
2012-12-16,winter,2012,December,13,Sunday,Holiday,Mist,0.38,0.3939,0.76,0.194,67,289,356,356,15,356,4,4,2,442,1,729,184919,4,356
2012-12-16,winter,2012,December,14,Sunday,Holiday,Mist,0.38,0.3939,0.76,0.1343,50,260,310,310,15,310,4,4,2,442,0,729,175652,4,310
2012-12-16,winter,2012,December,15,Sunday,Holiday,Mist,0.38,0.3939,0.82,0.1045,46,292,338,338,15,338,4,4,2,442,0,729,183149,4,338
2012-12-16,winter,2012,December,16,Sunday,Holiday,Mist,0.38,0.3939,0.82,0.1045,66,334,400,400,15,400,4,4,2,442,0,730,227748,4,400
2012-12-16,winter,2012,December,17,Sunday,Holiday,Mist,0.38,0.3939,0.82,0.1045,29,214,243,243,15,243,4,3,2,432,0,730,336860,4,243
2012-12-16,winter,2012,December,18,Sunday,Holiday,Light Snow,0.38,0.3939,0.82,0.1045,8,99,107,107,15,107,4,2,2,422,0,728,309772,4,107
2012-12-16,winter,2012,December,19,Sunday,Holiday,Clear,0.36,0.3485,0.93,0.1343,10,99,109,109,15,109,4,2,2,422,0,728,226789,4,109
2012-12-16,winter,2012,December,20,Sunday,Holiday,Mist,0.38,0.3939,0.82,0.0,14,108,122,122,15,122,4,2,2,422,0,728,164550,4,122
2012-12-16,winter,2012,December,21,Sunday,Holiday,Mist,0.36,0.3788,0.93,0.0,14,92,106,106,15,106,4,2,2,422,0,728,125445,4,106
2012-12-16,winter,2012,December,22,Sunday,Holiday,Mist,0.4,0.4091,0.82,0.194,6,83,89,89,15,89,4,2,2,422,0,728,95612,4,89
2012-12-16,winter,2012,December,23,Sunday,Holiday,Mist,0.36,0.3485,0.93,0.1343,4,29,33,33,15,33,4,1,2,412,0,728,63941,4,33
2012-12-17,winter,2012,December,0,Monday,Workingday,Mist,0.38,0.3939,0.87,0.0,2,26,28,28,14,28,4,1,2,412,0,726,39130,4,28
2012-12-17,winter,2012,December,1,Monday,Workingday,Mist,0.38,0.3939,0.87,0.1045,1,14,15,15,14,15,4,1,2,412,0,724,24164,4,15
2012-12-17,winter,2012,December,2,Monday,Workingday,Mist,0.38,0.3939,0.94,0.0,1,4,5,5,14,5,4,1,2,412,0,715,16352,4,5
2012-12-17,winter,2012,December,3,Monday,Workingday,Mist,0.36,0.3788,0.93,0.0,0,3,3,3,14,3,4,1,2,412,0,697,8174,4,3
2012-12-17,winter,2012,December,4,Monday,Workingday,Light Snow,0.36,0.3788,1.0,0.0,2,3,5,5,14,5,4,1,2,412,0,697,4428,4,5
2012-12-17,winter,2012,December,5,Monday,Workingday,Mist,0.38,0.3939,0.87,0.0,0,24,24,24,14,24,4,1,2,412,0,717,14261,4,24
2012-12-17,winter,2012,December,6,Monday,Workingday,Mist,0.36,0.3485,0.93,0.1343,1,107,108,108,14,108,4,2,2,422,0,725,55132,4,108
2012-12-17,winter,2012,December,7,Monday,Workingday,Mist,0.36,0.3485,0.93,0.1343,5,314,319,319,14,319,4,4,2,442,0,727,154171,4,319
2012-12-17,winter,2012,December,8,Monday,Workingday,Mist,0.38,0.3939,0.87,0.1045,10,582,592,592,14,592,4,4,2,442,0,727,261001,4,592
2012-12-17,winter,2012,December,9,Monday,Workingday,Mist,0.4,0.4091,0.87,0.0,11,271,282,282,14,282,4,4,2,442,0,727,159438,4,282
2012-12-17,winter,2012,December,10,Monday,Workingday,Mist,0.38,0.3939,0.87,0.0896,15,120,135,135,14,135,4,2,2,422,0,727,126257,4,135
2012-12-17,winter,2012,December,11,Monday,Workingday,Mist,0.4,0.4091,0.87,0.0896,22,148,170,170,14,170,4,3,2,432,0,727,151320,4,170
2012-12-17,winter,2012,December,12,Monday,Workingday,Mist,0.4,0.4091,0.87,0.0,21,211,232,232,14,232,4,3,2,432,0,728,184414,4,232
2012-12-17,winter,2012,December,13,Monday,Workingday,Mist,0.4,0.4091,0.87,0.1343,16,194,210,210,14,210,4,3,2,432,0,729,184919,4,210
2012-12-17,winter,2012,December,14,Monday,Workingday,Mist,0.4,0.4091,0.87,0.0896,12,169,181,181,14,181,4,3,2,432,0,729,175652,4,181
2012-12-17,winter,2012,December,15,Monday,Workingday,Mist,0.42,0.4242,0.88,0.0,15,196,211,211,14,211,4,3,2,432,0,729,183149,4,211
2012-12-17,winter,2012,December,16,Monday,Workingday,Light Snow,0.4,0.4091,0.94,0.2537,15,287,302,302,14,302,4,4,2,442,0,730,227748,4,302
2012-12-17,winter,2012,December,17,Monday,Workingday,Mist,0.4,0.4091,0.94,0.2537,17,478,495,495,14,495,4,4,2,442,0,730,336860,4,495
2012-12-17,winter,2012,December,18,Monday,Workingday,Mist,0.4,0.4091,0.94,0.0896,14,493,507,507,14,507,4,4,2,442,0,728,309772,4,507
2012-12-17,winter,2012,December,19,Monday,Workingday,Mist,0.42,0.4242,0.88,0.1343,7,333,340,340,14,340,4,4,2,442,0,728,226789,4,340
2012-12-17,winter,2012,December,20,Monday,Workingday,Mist,0.42,0.4242,0.94,0.2537,8,192,200,200,14,200,4,3,2,432,0,728,164550,4,200
2012-12-17,winter,2012,December,21,Monday,Workingday,Mist,0.42,0.4242,0.94,0.1343,6,114,120,120,14,120,4,2,2,422,0,728,125445,4,120
2012-12-17,winter,2012,December,22,Monday,Workingday,Mist,0.42,0.4242,0.94,0.1343,5,49,54,54,14,54,4,2,2,422,0,728,95612,4,54
2012-12-17,winter,2012,December,23,Monday,Workingday,Light Snow,0.42,0.4242,0.94,0.2239,6,41,47,47,14,47,4,2,2,422,0,728,63941,4,47
2012-12-18,winter,2012,December,0,Tuesday,Workingday,Mist,0.44,0.4394,0.94,0.1343,0,18,18,18,13,18,4,1,2,412,0,726,39130,4,18
2012-12-18,winter,2012,December,1,Tuesday,Workingday,Mist,0.44,0.4394,0.94,0.1343,0,15,15,15,13,15,4,1,2,412,0,724,24164,4,15
2012-12-18,winter,2012,December,2,Tuesday,Workingday,Mist,0.44,0.4394,0.88,0.2239,2,5,7,7,13,7,4,1,2,412,0,715,16352,4,7
2012-12-18,winter,2012,December,3,Tuesday,Workingday,Clear,0.42,0.4242,0.88,0.194,0,5,5,5,13,5,4,1,2,412,0,697,8174,4,5
2012-12-18,winter,2012,December,4,Tuesday,Workingday,Clear,0.42,0.4242,0.82,0.1642,3,5,8,8,13,8,4,1,2,412,0,697,4428,4,8
2012-12-18,winter,2012,December,5,Tuesday,Workingday,Clear,0.38,0.3939,0.87,0.0896,0,36,36,36,13,36,4,1,2,412,0,717,14261,4,36
2012-12-18,winter,2012,December,6,Tuesday,Workingday,Clear,0.36,0.3485,0.93,0.1642,1,117,118,118,13,118,4,2,2,422,0,725,55132,4,118
2012-12-18,winter,2012,December,7,Tuesday,Workingday,Clear,0.36,0.3485,0.93,0.1343,4,351,355,355,13,355,4,4,2,442,0,727,154171,4,355
2012-12-18,winter,2012,December,8,Tuesday,Workingday,Clear,0.38,0.3939,0.94,0.0,10,652,662,662,13,662,4,4,2,442,0,727,261001,4,662
2012-12-18,winter,2012,December,9,Tuesday,Workingday,Clear,0.4,0.4091,0.87,0.0896,19,307,326,326,13,326,4,4,2,442,0,727,159438,4,326
2012-12-18,winter,2012,December,10,Tuesday,Workingday,Clear,0.44,0.4394,0.77,0.0896,22,162,184,184,13,184,4,3,2,432,0,727,126257,4,184
2012-12-18,winter,2012,December,11,Tuesday,Workingday,Clear,0.48,0.4697,0.63,0.2239,58,211,269,269,13,269,4,3,2,432,0,727,151320,4,269
2012-12-18,winter,2012,December,12,Tuesday,Workingday,Light Snow,0.48,0.4697,0.48,0.2537,49,264,313,313,13,313,4,4,2,442,2,728,184414,4,313
2012-12-18,winter,2012,December,13,Tuesday,Workingday,Clear,0.5,0.4848,0.42,0.2836,51,235,286,286,13,286,4,4,2,442,2,729,184919,4,286
2012-12-18,winter,2012,December,14,Tuesday,Workingday,Clear,0.46,0.4545,0.47,0.4478,56,191,247,247,13,247,4,3,2,432,1,729,175652,4,247
2012-12-18,winter,2012,December,15,Tuesday,Workingday,Clear,0.46,0.4545,0.44,0.4925,28,218,246,246,13,246,4,3,2,432,1,729,183149,4,246
2012-12-18,winter,2012,December,16,Tuesday,Workingday,Clear,0.44,0.4394,0.41,0.4627,40,323,363,363,13,363,4,4,2,442,2,730,227748,4,363
2012-12-18,winter,2012,December,17,Tuesday,Workingday,Clear,0.4,0.4091,0.47,0.4478,39,533,572,572,13,572,4,4,2,442,2,730,336860,4,572
2012-12-18,winter,2012,December,18,Tuesday,Workingday,Clear,0.38,0.3939,0.46,0.3284,13,512,525,525,13,525,4,4,2,442,1,728,309772,4,525
2012-12-18,winter,2012,December,19,Tuesday,Workingday,Clear,0.38,0.3939,0.46,0.3881,19,334,353,353,13,353,4,4,2,442,1,728,226789,4,353
2012-12-18,winter,2012,December,20,Tuesday,Workingday,Clear,0.36,0.3333,0.5,0.2537,4,264,268,268,13,268,4,3,1,431,1,728,164550,4,268
2012-12-18,winter,2012,December,21,Tuesday,Workingday,Clear,0.36,0.3485,0.5,0.2239,9,159,168,168,13,168,4,3,2,432,1,728,125445,4,168
2012-12-18,winter,2012,December,22,Tuesday,Workingday,Clear,0.34,0.3333,0.49,0.0,5,127,132,132,13,132,4,2,1,421,1,728,95612,4,132
2012-12-18,winter,2012,December,23,Tuesday,Workingday,Clear,0.34,0.3485,0.49,0.0896,1,80,81,81,13,81,4,2,2,422,1,728,63941,4,81
2012-12-19,winter,2012,December,0,Wednesday,Workingday,Clear,0.3,0.3182,0.61,0.0,6,35,41,41,12,41,4,2,1,421,1,726,39130,4,41
2012-12-19,winter,2012,December,1,Wednesday,Workingday,Clear,0.3,0.3182,0.65,0.0896,1,14,15,15,12,15,4,1,1,411,1,724,24164,4,15
2012-12-19,winter,2012,December,2,Wednesday,Workingday,Clear,0.28,0.303,0.65,0.0896,1,2,3,3,12,3,4,1,1,411,1,715,16352,4,3
2012-12-19,winter,2012,December,3,Wednesday,Workingday,Clear,0.26,0.2727,0.75,0.1343,0,5,5,5,12,5,4,1,1,411,1,697,8174,4,5
2012-12-19,winter,2012,December,4,Wednesday,Workingday,Clear,0.24,0.2424,0.75,0.1343,1,6,7,7,12,7,4,1,1,411,1,697,4428,4,7
2012-12-19,winter,2012,December,5,Wednesday,Workingday,Clear,0.26,0.2879,0.75,0.0896,2,29,31,31,12,31,4,1,1,411,1,717,14261,4,31
2012-12-19,winter,2012,December,6,Wednesday,Workingday,Clear,0.24,0.2576,0.75,0.0896,3,109,112,112,12,112,4,2,1,421,1,725,55132,4,112
2012-12-19,winter,2012,December,7,Wednesday,Workingday,Clear,0.26,0.2727,0.75,0.1343,3,360,363,363,12,363,4,4,1,441,1,727,154171,4,363
2012-12-19,winter,2012,December,8,Wednesday,Workingday,Clear,0.24,0.2576,0.87,0.1045,13,665,678,678,12,678,4,4,1,441,1,727,261001,4,678
2012-12-19,winter,2012,December,9,Wednesday,Workingday,Clear,0.28,0.2879,0.75,0.1045,8,309,317,317,12,317,4,4,1,441,1,727,159438,4,317
2012-12-19,winter,2012,December,10,Wednesday,Workingday,Clear,0.32,0.3333,0.7,0.1045,17,147,164,164,12,164,4,3,1,431,1,727,126257,4,164
2012-12-19,winter,2012,December,11,Wednesday,Workingday,Clear,0.4,0.4091,0.54,0.2239,31,169,200,200,12,200,4,3,2,432,1,727,151320,4,200
2012-12-19,winter,2012,December,12,Wednesday,Workingday,Clear,0.4,0.4091,0.54,0.2836,33,203,236,236,12,236,4,3,2,432,1,728,184414,4,236
2012-12-19,winter,2012,December,13,Wednesday,Workingday,Clear,0.42,0.4242,0.5,0.194,30,183,213,213,12,213,4,3,2,432,1,729,184919,4,213
2012-12-19,winter,2012,December,14,Wednesday,Workingday,Clear,0.42,0.4242,0.5,0.194,33,185,218,218,12,218,4,3,2,432,1,729,175652,4,218
2012-12-19,winter,2012,December,15,Wednesday,Workingday,Clear,0.42,0.4242,0.5,0.2836,28,209,237,237,12,237,4,3,2,432,1,729,183149,4,237
2012-12-19,winter,2012,December,16,Wednesday,Workingday,Clear,0.42,0.4242,0.5,0.3582,37,297,334,334,12,334,4,4,2,442,1,730,227748,4,334
2012-12-19,winter,2012,December,17,Wednesday,Workingday,Clear,0.4,0.4091,0.5,0.3881,26,536,562,562,12,562,4,4,2,442,2,730,336860,4,562
2012-12-19,winter,2012,December,18,Wednesday,Workingday,Clear,0.38,0.3939,0.5,0.3582,23,546,569,569,12,569,4,4,2,442,2,728,309772,4,569
2012-12-19,winter,2012,December,19,Wednesday,Workingday,Clear,0.38,0.3939,0.5,0.3881,7,329,336,336,12,336,4,4,2,442,1,728,226789,4,336
2012-12-19,winter,2012,December,20,Wednesday,Workingday,Clear,0.36,0.3485,0.57,0.2239,10,231,241,241,12,241,4,3,2,432,1,728,164550,4,241
2012-12-19,winter,2012,December,21,Wednesday,Workingday,Clear,0.34,0.3182,0.61,0.2239,4,164,168,168,12,168,4,3,1,431,1,728,125445,4,168
2012-12-19,winter,2012,December,22,Wednesday,Workingday,Clear,0.34,0.3485,0.61,0.0896,12,117,129,129,12,129,4,2,2,422,1,728,95612,4,129
2012-12-19,winter,2012,December,23,Wednesday,Workingday,Clear,0.32,0.3333,0.66,0.1343,4,84,88,88,12,88,4,2,1,421,1,728,63941,4,88
2012-12-20,winter,2012,December,0,Thursday,Workingday,Clear,0.32,0.3333,0.61,0.1343,2,40,42,42,11,42,4,2,1,421,1,726,39130,4,42
2012-12-20,winter,2012,December,1,Thursday,Workingday,Clear,0.32,0.3485,0.66,0.0,1,19,20,20,11,20,4,1,2,412,1,724,24164,4,20
2012-12-20,winter,2012,December,2,Thursday,Workingday,Clear,0.32,0.3485,0.66,0.0,2,6,8,8,11,8,4,1,2,412,1,715,16352,4,8
2012-12-20,winter,2012,December,3,Thursday,Workingday,Mist,0.3,0.3182,0.7,0.0896,1,3,4,4,11,4,4,1,1,411,1,697,8174,4,4
2012-12-20,winter,2012,December,4,Thursday,Workingday,Mist,0.3,0.3182,0.7,0.0896,0,6,6,6,11,6,4,1,1,411,1,697,4428,4,6
2012-12-20,winter,2012,December,5,Thursday,Workingday,Mist,0.3,0.3182,0.7,0.1045,0,35,35,35,11,35,4,1,1,411,1,717,14261,4,35
2012-12-20,winter,2012,December,6,Thursday,Workingday,Mist,0.3,0.3333,0.65,0.0,4,114,118,118,11,118,4,2,1,421,1,725,55132,4,118
2012-12-20,winter,2012,December,7,Thursday,Workingday,Mist,0.3,0.3333,0.7,0.0,4,346,350,350,11,350,4,4,1,441,1,727,154171,4,350
2012-12-20,winter,2012,December,8,Thursday,Workingday,Mist,0.3,0.3333,0.7,0.0,14,585,599,599,11,599,4,4,1,441,1,727,261001,4,599
2012-12-20,winter,2012,December,9,Thursday,Workingday,Mist,0.3,0.3333,0.7,0.0,14,303,317,317,11,317,4,4,1,441,1,727,159438,4,317
2012-12-20,winter,2012,December,10,Thursday,Workingday,Mist,0.32,0.3333,0.66,0.0,23,138,161,161,11,161,4,3,1,431,1,727,126257,4,161
2012-12-20,winter,2012,December,11,Thursday,Workingday,Mist,0.34,0.3182,0.57,0.2239,22,168,190,190,11,190,4,3,1,431,1,727,151320,4,190
2012-12-20,winter,2012,December,12,Thursday,Workingday,Mist,0.36,0.3485,0.53,0.1642,31,181,212,212,11,212,4,3,2,432,1,728,184414,4,212
2012-12-20,winter,2012,December,13,Thursday,Workingday,Mist,0.36,0.3485,0.57,0.194,46,171,217,217,11,217,4,3,2,432,1,729,184919,4,217
2012-12-20,winter,2012,December,14,Thursday,Workingday,Mist,0.36,0.3485,0.53,0.194,43,171,214,214,11,214,4,3,2,432,1,729,175652,4,214
2012-12-20,winter,2012,December,15,Thursday,Workingday,Mist,0.34,0.3333,0.57,0.194,33,216,249,249,11,249,4,3,1,431,1,729,183149,4,249
2012-12-20,winter,2012,December,16,Thursday,Workingday,Mist,0.34,0.303,0.53,0.3284,21,281,302,302,11,302,4,4,1,441,1,730,227748,4,302
2012-12-20,winter,2012,December,17,Thursday,Workingday,Mist,0.34,0.3333,0.66,0.194,25,450,475,475,11,475,4,4,1,441,1,730,336860,4,475
2012-12-20,winter,2012,December,18,Thursday,Workingday,Mist,0.34,0.3333,0.71,0.194,22,359,381,381,11,381,4,4,1,441,1,728,309772,4,381
2012-12-20,winter,2012,December,19,Thursday,Workingday,Light Snow,0.34,0.3182,0.71,0.2537,3,115,118,118,11,118,4,2,1,421,1,728,226789,4,118
2012-12-20,winter,2012,December,20,Thursday,Workingday,Light Snow,0.34,0.3333,0.76,0.1642,1,49,50,50,11,50,4,2,1,421,1,728,164550,4,50
2012-12-20,winter,2012,December,21,Thursday,Workingday,Light Snow,0.34,0.3333,0.76,0.1642,1,25,26,26,11,26,4,1,1,411,1,728,125445,4,26
2012-12-20,winter,2012,December,22,Thursday,Workingday,Light Snow,0.34,0.3333,0.87,0.194,1,20,21,21,11,21,4,1,1,411,1,728,95612,4,21
2012-12-20,winter,2012,December,23,Thursday,Workingday,Light Snow,0.4,0.4091,0.82,0.2985,0,13,13,13,11,13,4,1,2,412,1,728,63941,4,13
2012-12-21,spring,2012,December,0,Friday,Workingday,Light Snow,0.42,0.4242,0.88,0.2985,0,17,17,17,10,17,4,1,2,412,0,726,39130,4,17
2012-12-21,spring,2012,December,1,Friday,Workingday,Light Snow,0.44,0.4394,0.88,0.3881,2,7,9,9,10,9,4,1,2,412,0,724,24164,4,9
2012-12-21,spring,2012,December,2,Friday,Workingday,Light Snow,0.46,0.4545,0.94,0.3881,0,3,3,3,10,3,4,1,2,412,0,715,16352,4,3
2012-12-21,spring,2012,December,3,Friday,Workingday,Light Snow,0.46,0.4545,0.94,0.3881,0,3,3,3,10,3,4,1,2,412,0,697,8174,4,3
2012-12-21,spring,2012,December,4,Friday,Workingday,Mist,0.36,0.3182,0.71,0.4925,1,5,6,6,10,6,4,1,1,411,1,697,4428,4,6
2012-12-21,spring,2012,December,5,Friday,Workingday,Mist,0.34,0.303,0.76,0.4179,0,13,13,13,10,13,4,1,1,411,1,717,14261,4,13
2012-12-21,spring,2012,December,6,Friday,Workingday,Mist,0.34,0.2879,0.57,0.5821,4,76,80,80,10,80,4,2,1,421,1,725,55132,4,80
2012-12-21,spring,2012,December,7,Friday,Workingday,Mist,0.32,0.3182,0.57,0.194,3,205,208,208,10,208,4,3,1,431,1,727,154171,4,208
2012-12-21,spring,2012,December,8,Friday,Workingday,Mist,0.32,0.303,0.57,0.2836,8,464,472,472,10,472,4,4,1,441,1,727,261001,4,472
2012-12-21,spring,2012,December,9,Friday,Workingday,Mist,0.32,0.2727,0.45,0.5522,2,265,267,267,10,267,4,3,1,431,1,727,159438,4,267
2012-12-21,spring,2012,December,10,Friday,Workingday,Clear,0.32,0.2879,0.42,0.4627,8,146,154,154,10,154,4,3,1,431,1,727,126257,4,154
2012-12-21,spring,2012,December,11,Friday,Workingday,Mist,0.32,0.2879,0.42,0.4179,12,150,162,162,10,162,4,3,1,431,1,727,151320,4,162
2012-12-21,spring,2012,December,12,Friday,Workingday,Mist,0.32,0.2879,0.39,0.3582,25,199,224,224,10,224,4,3,1,431,1,728,184414,4,224
2012-12-21,spring,2012,December,13,Friday,Workingday,Mist,0.32,0.2879,0.39,0.4179,26,214,240,240,10,240,4,3,1,431,1,729,184919,4,240
2012-12-21,spring,2012,December,14,Friday,Workingday,Mist,0.32,0.2879,0.39,0.4478,20,199,219,219,10,219,4,3,1,431,1,729,175652,4,219
2012-12-21,spring,2012,December,15,Friday,Workingday,Mist,0.3,0.2727,0.42,0.3881,29,234,263,263,10,263,4,3,1,431,1,729,183149,4,263
2012-12-21,spring,2012,December,16,Friday,Workingday,Mist,0.3,0.2727,0.39,0.3284,28,253,281,281,10,281,4,3,1,431,1,730,227748,4,281
2012-12-21,spring,2012,December,17,Friday,Workingday,Mist,0.26,0.2273,0.56,0.3284,24,297,321,321,10,321,4,4,1,441,1,730,336860,4,321
2012-12-21,spring,2012,December,18,Friday,Workingday,Mist,0.26,0.2273,0.56,0.2985,7,236,243,243,10,243,4,3,1,431,1,728,309772,4,243
2012-12-21,spring,2012,December,19,Friday,Workingday,Clear,0.28,0.2576,0.45,0.2985,5,148,153,153,10,153,4,3,1,431,1,728,226789,4,153
2012-12-21,spring,2012,December,20,Friday,Workingday,Clear,0.28,0.2727,0.41,0.2537,8,104,112,112,10,112,4,2,1,421,1,728,164550,4,112
2012-12-21,spring,2012,December,21,Friday,Workingday,Clear,0.26,0.2273,0.41,0.4179,2,68,70,70,10,70,4,2,1,421,1,728,125445,4,70
2012-12-21,spring,2012,December,22,Friday,Workingday,Clear,0.26,0.2273,0.44,0.2985,6,57,63,63,10,63,4,2,1,421,1,728,95612,4,63
2012-12-21,spring,2012,December,23,Friday,Workingday,Clear,0.26,0.2424,0.44,0.2836,1,39,40,40,10,40,4,1,1,411,1,728,63941,4,40
2012-12-22,spring,2012,December,0,Saturday,Holiday,Clear,0.26,0.2121,0.44,0.5821,1,30,31,31,9,31,4,1,1,411,1,726,39130,4,31
2012-12-22,spring,2012,December,1,Saturday,Holiday,Clear,0.26,0.2121,0.44,0.4478,1,34,35,35,9,35,4,1,1,411,1,724,24164,4,35
2012-12-22,spring,2012,December,2,Saturday,Holiday,Clear,0.26,0.2121,0.44,0.5224,0,23,23,23,9,23,4,1,1,411,1,715,16352,4,23
2012-12-22,spring,2012,December,3,Saturday,Holiday,Clear,0.26,0.2121,0.48,0.4478,0,7,7,7,9,7,4,1,1,411,1,697,8174,4,7
2012-12-22,spring,2012,December,4,Saturday,Holiday,Clear,0.26,0.2576,0.48,0.194,3,2,5,5,9,5,4,1,1,411,1,697,4428,4,5
2012-12-22,spring,2012,December,5,Saturday,Holiday,Clear,0.26,0.2273,0.48,0.4179,0,5,5,5,9,5,4,1,1,411,1,717,14261,4,5
2012-12-22,spring,2012,December,6,Saturday,Holiday,Clear,0.26,0.2273,0.44,0.4179,0,13,13,13,9,13,4,1,1,411,1,725,55132,4,13
2012-12-22,spring,2012,December,7,Saturday,Holiday,Clear,0.26,0.2273,0.44,0.4179,2,18,20,20,9,20,4,1,1,411,1,727,154171,4,20
2012-12-22,spring,2012,December,8,Saturday,Holiday,Clear,0.26,0.2121,0.44,0.6119,0,29,29,29,9,29,4,1,1,411,1,727,261001,4,29
2012-12-22,spring,2012,December,9,Saturday,Holiday,Clear,0.26,0.2273,0.48,0.3881,13,77,90,90,9,90,4,2,1,421,1,727,159438,4,90
2012-12-22,spring,2012,December,10,Saturday,Holiday,Clear,0.26,0.2273,0.48,0.3284,13,105,118,118,9,118,4,2,1,421,1,727,126257,4,118
2012-12-22,spring,2012,December,11,Saturday,Holiday,Clear,0.28,0.2576,0.41,0.3582,29,130,159,159,9,159,4,3,1,431,1,727,151320,4,159
2012-12-22,spring,2012,December,12,Saturday,Holiday,Clear,0.3,0.2576,0.36,0.6567,18,128,146,146,9,146,4,3,1,431,1,728,184414,4,146
2012-12-22,spring,2012,December,13,Saturday,Holiday,Clear,0.32,0.2879,0.36,0.4478,23,135,158,158,9,158,4,3,1,431,1,729,184919,4,158
2012-12-22,spring,2012,December,14,Saturday,Holiday,Clear,0.32,0.2879,0.36,0.4627,20,141,161,161,9,161,4,3,1,431,1,729,175652,4,161
2012-12-22,spring,2012,December,15,Saturday,Holiday,Clear,0.32,0.2727,0.33,0.5821,14,139,153,153,9,153,4,3,1,431,1,729,183149,4,153
2012-12-22,spring,2012,December,16,Saturday,Holiday,Clear,0.3,0.2727,0.39,0.4478,23,124,147,147,9,147,4,3,1,431,1,730,227748,4,147
2012-12-22,spring,2012,December,17,Saturday,Holiday,Clear,0.28,0.2576,0.41,0.2985,15,99,114,114,9,114,4,2,1,421,1,730,336860,4,114
2012-12-22,spring,2012,December,18,Saturday,Holiday,Clear,0.26,0.2121,0.44,0.4627,7,75,82,82,9,82,4,2,1,421,1,728,309772,4,82
2012-12-22,spring,2012,December,19,Saturday,Holiday,Clear,0.24,0.2121,0.48,0.3582,9,51,60,60,9,60,4,2,1,421,1,728,226789,4,60
2012-12-22,spring,2012,December,20,Saturday,Holiday,Clear,0.24,0.2424,0.48,0.1642,6,55,61,61,9,61,4,2,1,421,1,728,164550,4,61
2012-12-22,spring,2012,December,21,Saturday,Holiday,Clear,0.22,0.2121,0.51,0.2836,4,49,53,53,9,53,4,2,1,421,1,728,125445,4,53
2012-12-22,spring,2012,December,22,Saturday,Holiday,Clear,0.22,0.2121,0.51,0.2836,1,38,39,39,9,39,4,1,1,411,1,728,95612,4,39
2012-12-22,spring,2012,December,23,Saturday,Holiday,Clear,0.22,0.2273,0.51,0.194,3,37,40,40,9,40,4,1,1,411,1,728,63941,4,40
2012-12-23,spring,2012,December,0,Sunday,Holiday,Clear,0.22,0.2121,0.47,0.2836,3,24,27,27,8,27,4,1,1,411,1,726,39130,4,27
2012-12-23,spring,2012,December,1,Sunday,Holiday,Clear,0.22,0.2273,0.47,0.194,1,19,20,20,8,20,4,1,1,411,1,724,24164,4,20
2012-12-23,spring,2012,December,2,Sunday,Holiday,Clear,0.2,0.2121,0.51,0.1642,1,17,18,18,8,18,4,1,1,411,1,715,16352,4,18
2012-12-23,spring,2012,December,3,Sunday,Holiday,Clear,0.2,0.2121,0.51,0.1343,0,9,9,9,8,9,4,1,1,411,1,697,8174,4,9
2012-12-23,spring,2012,December,4,Sunday,Holiday,Clear,0.2,0.2121,0.47,0.1343,1,3,4,4,8,4,4,1,1,411,1,697,4428,4,4
2012-12-23,spring,2012,December,5,Sunday,Holiday,Clear,0.2,0.2576,0.51,0.0,0,6,6,6,8,6,4,1,1,411,1,717,14261,4,6
2012-12-23,spring,2012,December,6,Sunday,Holiday,Clear,0.16,0.197,0.64,0.0896,4,5,9,9,8,9,4,1,1,411,1,725,55132,4,9
2012-12-23,spring,2012,December,7,Sunday,Holiday,Clear,0.16,0.197,0.64,0.0896,3,16,19,19,8,19,4,1,1,411,1,727,154171,4,19
2012-12-23,spring,2012,December,8,Sunday,Holiday,Clear,0.14,0.1667,0.69,0.1045,5,43,48,48,8,48,4,2,1,421,1,727,261001,4,48
2012-12-23,spring,2012,December,9,Sunday,Holiday,Clear,0.2,0.2273,0.59,0.1045,7,49,56,56,8,56,4,2,1,421,1,727,159438,4,56
2012-12-23,spring,2012,December,10,Sunday,Holiday,Clear,0.22,0.2273,0.64,0.194,26,67,93,93,8,93,4,2,1,421,1,727,126257,4,93
2012-12-23,spring,2012,December,11,Sunday,Holiday,Clear,0.24,0.2273,0.52,0.194,48,104,152,152,8,152,4,3,1,431,1,727,151320,4,152
2012-12-23,spring,2012,December,12,Sunday,Holiday,Clear,0.3,0.2879,0.42,0.194,52,144,196,196,8,196,4,3,1,431,1,728,184414,4,196
2012-12-23,spring,2012,December,13,Sunday,Holiday,Clear,0.32,0.303,0.39,0.2239,63,123,186,186,8,186,4,3,1,431,1,729,184919,4,186
2012-12-23,spring,2012,December,14,Sunday,Holiday,Clear,0.34,0.303,0.31,0.2985,57,118,175,175,8,175,4,3,1,431,1,729,175652,4,175
2012-12-23,spring,2012,December,15,Sunday,Holiday,Clear,0.34,0.3333,0.34,0.1343,39,98,137,137,8,137,4,2,1,421,1,729,183149,4,137
2012-12-23,spring,2012,December,16,Sunday,Holiday,Clear,0.34,0.3333,0.34,0.194,53,137,190,190,8,190,4,3,1,431,1,730,227748,4,190
2012-12-23,spring,2012,December,17,Sunday,Holiday,Clear,0.32,0.3182,0.49,0.194,21,93,114,114,8,114,4,2,1,421,1,730,336860,4,114
2012-12-23,spring,2012,December,18,Sunday,Holiday,Clear,0.3,0.303,0.45,0.1642,8,85,93,93,8,93,4,2,1,421,1,728,309772,4,93
2012-12-23,spring,2012,December,19,Sunday,Holiday,Clear,0.3,0.3333,0.42,0.0,4,54,58,58,8,58,4,2,1,421,1,728,226789,4,58
2012-12-23,spring,2012,December,20,Sunday,Holiday,Clear,0.26,0.303,0.65,0.0,0,52,52,52,8,52,4,2,1,421,1,728,164550,4,52
2012-12-23,spring,2012,December,21,Sunday,Holiday,Clear,0.24,0.2879,0.7,0.0,4,38,42,42,8,42,4,2,1,421,1,728,125445,4,42
2012-12-23,spring,2012,December,22,Sunday,Holiday,Clear,0.24,0.2576,0.6,0.1045,5,53,58,58,8,58,4,2,1,421,1,728,95612,4,58
2012-12-23,spring,2012,December,23,Sunday,Holiday,Clear,0.24,0.2879,0.6,0.0,3,22,25,25,8,25,4,1,1,411,1,728,63941,4,25
2012-12-24,spring,2012,December,0,Monday,Workingday,Clear,0.22,0.2727,0.69,0.0,0,12,12,12,7,12,4,1,1,411,1,726,39130,4,12
2012-12-24,spring,2012,December,1,Monday,Workingday,Clear,0.22,0.2727,0.69,0.0,0,11,11,11,7,11,4,1,1,411,1,724,24164,4,11
2012-12-24,spring,2012,December,2,Monday,Workingday,Clear,0.2,0.2576,0.75,0.0,0,5,5,5,7,5,4,1,1,411,1,715,16352,4,5
2012-12-24,spring,2012,December,3,Monday,Workingday,Clear,0.2,0.2576,0.75,0.0,1,2,3,3,7,3,4,1,1,411,1,697,8174,4,3
2012-12-24,spring,2012,December,5,Monday,Workingday,Clear,0.18,0.197,0.8,0.1343,0,9,9,9,7,9,4,1,1,411,1,717,14261,4,9
2012-12-24,spring,2012,December,6,Monday,Workingday,Clear,0.2,0.2576,0.75,0.0,1,16,17,17,7,17,4,1,1,411,1,725,55132,4,17
2012-12-24,spring,2012,December,7,Monday,Workingday,Clear,0.2,0.2576,0.69,0.0,3,27,30,30,7,30,4,1,1,411,1,727,154171,4,30
2012-12-24,spring,2012,December,8,Monday,Workingday,Clear,0.22,0.2727,0.69,0.0,4,62,66,66,7,66,4,2,1,421,1,727,261001,4,66
2012-12-24,spring,2012,December,9,Monday,Workingday,Mist,0.24,0.2576,0.65,0.1045,17,68,85,85,7,85,4,2,1,421,1,727,159438,4,85
2012-12-24,spring,2012,December,10,Monday,Workingday,Mist,0.26,0.303,0.65,0.0,21,82,103,103,7,103,4,2,1,421,1,727,126257,4,103
2012-12-24,spring,2012,December,11,Monday,Workingday,Mist,0.26,0.2576,0.6,0.1642,20,104,124,124,7,124,4,2,1,421,1,727,151320,4,124
2012-12-24,spring,2012,December,12,Monday,Workingday,Mist,0.28,0.303,0.56,0.0896,22,113,135,135,7,135,4,2,1,421,1,728,184414,4,135
2012-12-24,spring,2012,December,13,Monday,Workingday,Light Snow,0.24,0.2576,0.81,0.1045,16,54,70,70,7,70,4,2,1,421,1,729,184919,4,70
2012-12-24,spring,2012,December,14,Monday,Workingday,Light Snow,0.24,0.2576,0.87,0.1045,13,33,46,46,7,46,4,2,1,421,1,729,175652,4,46
2012-12-24,spring,2012,December,15,Monday,Workingday,Light Snow,0.24,0.2273,0.87,0.2239,6,27,33,33,7,33,4,1,1,411,1,729,183149,4,33
2012-12-24,spring,2012,December,16,Monday,Workingday,Light Snow,0.24,0.2273,0.87,0.2239,6,27,33,33,7,33,4,1,1,411,1,730,227748,4,33
2012-12-24,spring,2012,December,17,Monday,Workingday,Light Snow,0.24,0.2424,0.93,0.1642,7,19,26,26,7,26,4,1,1,411,1,730,336860,4,26
2012-12-24,spring,2012,December,18,Monday,Workingday,Light Snow,0.24,0.2576,0.93,0.1045,6,20,26,26,7,26,4,1,1,411,1,728,309772,4,26
2012-12-24,spring,2012,December,19,Monday,Workingday,Mist,0.24,0.2424,0.93,0.1343,4,14,18,18,7,18,4,1,1,411,1,728,226789,4,18
2012-12-24,spring,2012,December,20,Monday,Workingday,Light Snow,0.24,0.2424,0.93,0.1343,6,17,23,23,7,23,4,1,1,411,1,728,164550,4,23
2012-12-24,spring,2012,December,21,Monday,Workingday,Light Snow,0.24,0.2576,0.93,0.0896,13,9,22,22,7,22,4,1,1,411,1,728,125445,4,22
2012-12-24,spring,2012,December,22,Monday,Workingday,Mist,0.24,0.2879,0.93,0.0,7,5,12,12,7,12,4,1,1,411,1,728,95612,4,12
2012-12-24,spring,2012,December,23,Monday,Workingday,Light Snow,0.24,0.2879,0.93,0.0,1,10,11,11,7,11,4,1,1,411,1,728,63941,4,11
2012-12-25,spring,2012,December,0,Tuesday,Holiday,Light Snow,0.24,0.2576,0.93,0.0896,3,10,13,13,6,13,4,1,1,411,1,726,39130,4,13
2012-12-25,spring,2012,December,1,Tuesday,Holiday,Mist,0.26,0.2576,0.87,0.1642,0,13,13,13,6,13,4,1,1,411,1,724,24164,4,13
2012-12-25,spring,2012,December,2,Tuesday,Holiday,Mist,0.26,0.2576,0.87,0.1642,0,7,7,7,6,7,4,1,1,411,1,715,16352,4,7
2012-12-25,spring,2012,December,4,Tuesday,Holiday,Mist,0.24,0.2576,0.87,0.0896,0,1,1,1,6,1,4,1,1,411,1,697,4428,4,1
2012-12-25,spring,2012,December,5,Tuesday,Holiday,Mist,0.22,0.2273,0.93,0.1343,2,1,3,3,6,3,4,1,1,411,1,717,14261,4,3
2012-12-25,spring,2012,December,6,Tuesday,Holiday,Mist,0.22,0.2273,0.93,0.1343,1,6,7,7,6,7,4,1,1,411,1,725,55132,4,7
2012-12-25,spring,2012,December,7,Tuesday,Holiday,Mist,0.22,0.2273,0.93,0.1642,0,6,6,6,6,6,4,1,1,411,1,727,154171,4,6
2012-12-25,spring,2012,December,8,Tuesday,Holiday,Mist,0.24,0.2879,0.87,0.0,1,10,11,11,6,11,4,1,1,411,1,727,261001,4,11
2012-12-25,spring,2012,December,9,Tuesday,Holiday,Mist,0.24,0.2576,0.87,0.0,7,21,28,28,6,28,4,1,1,411,1,727,159438,4,28
2012-12-25,spring,2012,December,10,Tuesday,Holiday,Clear,0.28,0.3182,0.81,0.0,11,21,32,32,6,32,4,1,1,411,1,727,126257,4,32
2012-12-25,spring,2012,December,11,Tuesday,Holiday,Clear,0.3,0.3182,0.75,0.0896,43,43,86,86,6,86,4,2,1,421,1,727,151320,4,86
2012-12-25,spring,2012,December,12,Tuesday,Holiday,Clear,0.32,0.3333,0.76,0.0896,62,52,114,114,6,114,4,2,1,421,1,728,184414,4,114
2012-12-25,spring,2012,December,13,Tuesday,Holiday,Clear,0.4,0.4091,0.5,0.3284,75,46,121,121,6,121,4,2,2,422,1,729,184919,4,121
2012-12-25,spring,2012,December,14,Tuesday,Holiday,Clear,0.38,0.3939,0.46,0.2985,58,68,126,126,6,126,4,2,2,422,1,729,175652,4,126
2012-12-25,spring,2012,December,15,Tuesday,Holiday,Clear,0.36,0.3333,0.5,0.2537,51,56,107,107,6,107,4,2,1,421,1,729,183149,4,107
2012-12-25,spring,2012,December,16,Tuesday,Holiday,Mist,0.36,0.3333,0.5,0.2537,48,38,86,86,6,86,4,2,1,421,1,730,227748,4,86
2012-12-25,spring,2012,December,17,Tuesday,Holiday,Mist,0.32,0.303,0.57,0.2537,16,34,50,50,6,50,4,2,1,421,1,730,336860,4,50
2012-12-25,spring,2012,December,18,Tuesday,Holiday,Mist,0.32,0.303,0.66,0.2537,20,23,43,43,6,43,4,2,1,421,1,728,309772,4,43
2012-12-25,spring,2012,December,19,Tuesday,Holiday,Mist,0.32,0.303,0.66,0.2239,16,20,36,36,6,36,4,1,1,411,1,728,226789,4,36
2012-12-25,spring,2012,December,20,Tuesday,Holiday,Mist,0.32,0.303,0.66,0.2836,11,29,40,40,6,40,4,1,1,411,1,728,164550,4,40
2012-12-25,spring,2012,December,21,Tuesday,Holiday,Mist,0.3,0.2879,0.65,0.194,8,26,34,34,6,34,4,1,1,411,1,728,125445,4,34
2012-12-25,spring,2012,December,22,Tuesday,Holiday,Mist,0.3,0.303,0.7,0.1642,3,16,19,19,6,19,4,1,1,411,1,728,95612,4,19
2012-12-25,spring,2012,December,23,Tuesday,Holiday,Mist,0.28,0.2727,0.65,0.2537,4,26,30,30,6,30,4,1,1,411,1,728,63941,4,30
2012-12-26,spring,2012,December,0,Wednesday,Workingday,Mist,0.28,0.2727,0.65,0.2537,1,8,9,9,5,9,4,1,1,411,1,726,39130,4,9
2012-12-26,spring,2012,December,1,Wednesday,Workingday,Mist,0.26,0.2273,0.65,0.2985,0,7,7,7,5,7,4,1,1,411,1,724,24164,4,7
2012-12-26,spring,2012,December,2,Wednesday,Workingday,Mist,0.26,0.2273,0.65,0.2985,0,1,1,1,5,1,4,1,1,411,1,715,16352,4,1
2012-12-26,spring,2012,December,3,Wednesday,Workingday,Mist,0.24,0.2121,0.7,0.3582,0,2,2,2,5,2,4,1,1,411,1,697,8174,4,2
2012-12-26,spring,2012,December,4,Wednesday,Workingday,Clear,0.22,0.197,0.69,0.3582,0,2,2,2,5,2,4,1,1,411,1,697,4428,4,2
2012-12-26,spring,2012,December,5,Wednesday,Workingday,Mist,0.22,0.2121,0.69,0.2836,0,11,11,11,5,11,4,1,1,411,1,717,14261,4,11
2012-12-26,spring,2012,December,6,Wednesday,Workingday,Mist,0.22,0.2121,0.69,0.2239,0,36,36,36,5,36,4,1,1,411,1,725,55132,4,36
2012-12-26,spring,2012,December,7,Wednesday,Workingday,Light Snow,0.2,0.1818,0.86,0.3284,0,26,26,26,5,26,4,1,1,411,1,727,154171,4,26
2012-12-26,spring,2012,December,8,Wednesday,Workingday,Light Snow,0.2,0.1818,0.86,0.3284,0,31,31,31,5,31,4,1,1,411,1,727,261001,4,31
2012-12-26,spring,2012,December,9,Wednesday,Workingday,Light Snow,0.2,0.1818,0.86,0.3284,1,22,23,23,5,23,4,1,1,411,1,727,159438,4,23
2012-12-26,spring,2012,December,10,Wednesday,Workingday,Light Snow,0.2,0.1818,0.86,0.2985,0,8,8,8,5,8,4,1,1,411,1,727,126257,4,8
2012-12-26,spring,2012,December,11,Wednesday,Workingday,Light Snow,0.2,0.1667,0.86,0.4627,0,10,10,10,5,10,4,1,1,411,1,727,151320,4,10
2012-12-26,spring,2012,December,12,Wednesday,Workingday,Light Snow,0.22,0.197,0.87,0.3284,0,10,10,10,5,10,4,1,1,411,1,728,184414,4,10
2012-12-26,spring,2012,December,13,Wednesday,Workingday,Light Snow,0.22,0.197,0.87,0.3284,0,15,15,15,5,15,4,1,1,411,1,729,184919,4,15
2012-12-26,spring,2012,December,14,Wednesday,Workingday,Light Snow,0.22,0.2121,0.93,0.2537,0,20,20,20,5,20,4,1,1,411,1,729,175652,4,20
2012-12-26,spring,2012,December,15,Wednesday,Workingday,Light Snow,0.26,0.2273,0.87,0.3582,0,13,13,13,5,13,4,1,1,411,1,729,183149,4,13
2012-12-26,spring,2012,December,16,Wednesday,Workingday,Light Snow,0.26,0.2273,0.87,0.3582,0,13,13,13,5,13,4,1,1,411,1,730,227748,4,13
2012-12-26,spring,2012,December,17,Wednesday,Workingday,Light Snow,0.26,0.2273,0.93,0.3582,2,51,53,53,5,53,4,2,1,421,1,730,336860,4,53
2012-12-26,spring,2012,December,18,Wednesday,Workingday,Light Snow,0.28,0.2576,0.93,0.2985,1,42,43,43,5,43,4,2,1,421,1,728,309772,4,43
2012-12-26,spring,2012,December,19,Wednesday,Workingday,Light Snow,0.3,0.2879,0.87,0.194,2,33,35,35,5,35,4,1,1,411,1,728,226789,4,35
2012-12-26,spring,2012,December,20,Wednesday,Workingday,Light Snow,0.32,0.303,0.93,0.2537,0,32,32,32,5,32,4,1,1,411,1,728,164550,4,32
2012-12-26,spring,2012,December,21,Wednesday,Workingday,Mist,0.3,0.2727,0.87,0.2985,0,20,20,20,5,20,4,1,1,411,1,728,125445,4,20
2012-12-26,spring,2012,December,22,Wednesday,Workingday,Light Snow,0.24,0.197,0.93,0.4478,0,11,11,11,5,11,4,1,1,411,1,728,95612,4,11
2012-12-26,spring,2012,December,23,Wednesday,Workingday,Light Snow,0.26,0.2273,0.87,0.2985,2,8,10,10,5,10,4,1,1,411,1,728,63941,4,10
2012-12-27,spring,2012,December,0,Thursday,Workingday,Light Snow,0.26,0.2273,0.87,0.2985,0,3,3,3,4,3,4,1,1,411,1,726,39130,4,3
2012-12-27,spring,2012,December,1,Thursday,Workingday,Light Snow,0.24,0.197,0.93,0.4478,0,5,5,5,4,5,4,1,1,411,1,724,24164,4,5
2012-12-27,spring,2012,December,2,Thursday,Workingday,Mist,0.24,0.197,0.87,0.4478,0,2,2,2,4,2,4,1,1,411,1,715,16352,4,2
2012-12-27,spring,2012,December,3,Thursday,Workingday,Mist,0.24,0.2273,0.87,0.2239,0,1,1,1,4,1,4,1,1,411,1,697,8174,4,1
2012-12-27,spring,2012,December,4,Thursday,Workingday,Mist,0.24,0.2121,0.87,0.3284,0,3,3,3,4,3,4,1,1,411,1,697,4428,4,3
2012-12-27,spring,2012,December,5,Thursday,Workingday,Clear,0.24,0.2424,0.75,0.1642,1,10,11,11,4,11,4,1,1,411,1,717,14261,4,11
2012-12-27,spring,2012,December,6,Thursday,Workingday,Clear,0.24,0.197,0.7,0.4925,0,45,45,45,4,45,4,2,1,421,1,725,55132,4,45
2012-12-27,spring,2012,December,7,Thursday,Workingday,Clear,0.24,0.2273,0.7,0.2239,0,90,90,90,4,90,4,2,1,421,1,727,154171,4,90
2012-12-27,spring,2012,December,8,Thursday,Workingday,Clear,0.26,0.2273,0.65,0.3582,2,206,208,208,4,208,4,3,1,431,1,727,261001,4,208
2012-12-27,spring,2012,December,9,Thursday,Workingday,Clear,0.26,0.2121,0.6,0.4925,6,127,133,133,4,133,4,2,1,421,1,727,159438,4,133
2012-12-27,spring,2012,December,10,Thursday,Workingday,Clear,0.28,0.2273,0.56,0.5224,8,67,75,75,4,75,4,2,1,421,1,727,126257,4,75
2012-12-27,spring,2012,December,11,Thursday,Workingday,Mist,0.28,0.2424,0.56,0.4478,23,80,103,103,4,103,4,2,1,421,1,727,151320,4,103
2012-12-27,spring,2012,December,12,Thursday,Workingday,Clear,0.3,0.2727,0.49,0.4627,22,87,109,109,4,109,4,2,1,421,1,728,184414,4,109
2012-12-27,spring,2012,December,13,Thursday,Workingday,Clear,0.3,0.2727,0.49,0.4627,19,99,118,118,4,118,4,2,1,421,1,729,184919,4,118
2012-12-27,spring,2012,December,14,Thursday,Workingday,Mist,0.26,0.2121,0.56,0.5224,25,94,119,119,4,119,4,2,1,421,1,729,175652,4,119
2012-12-27,spring,2012,December,15,Thursday,Workingday,Mist,0.26,0.2121,0.56,0.4478,31,89,120,120,4,120,4,2,1,421,1,729,183149,4,120
2012-12-27,spring,2012,December,16,Thursday,Workingday,Mist,0.26,0.2424,0.52,0.2836,23,151,174,174,4,174,4,3,1,431,1,730,227748,4,174
2012-12-27,spring,2012,December,17,Thursday,Workingday,Mist,0.26,0.2424,0.52,0.2836,30,227,257,257,4,257,4,3,1,431,1,730,336860,4,257
2012-12-27,spring,2012,December,18,Thursday,Workingday,Mist,0.24,0.2273,0.6,0.2537,9,188,197,197,4,197,4,3,1,431,1,728,309772,4,197
2012-12-27,spring,2012,December,19,Thursday,Workingday,Clear,0.24,0.2121,0.6,0.2836,11,106,117,117,4,117,4,2,1,421,1,728,226789,4,117
2012-12-27,spring,2012,December,20,Thursday,Workingday,Clear,0.24,0.2424,0.6,0.1642,12,79,91,91,4,91,4,2,1,421,1,728,164550,4,91
2012-12-27,spring,2012,December,21,Thursday,Workingday,Mist,0.24,0.2273,0.6,0.2537,12,51,63,63,4,63,4,2,1,421,1,728,125445,4,63
2012-12-27,spring,2012,December,22,Thursday,Workingday,Mist,0.24,0.2121,0.6,0.2836,11,33,44,44,4,44,4,2,1,421,1,728,95612,4,44
2012-12-27,spring,2012,December,23,Thursday,Workingday,Mist,0.24,0.2273,0.6,0.2537,2,24,26,26,4,26,4,1,1,411,1,728,63941,4,26
2012-12-28,spring,2012,December,0,Friday,Workingday,Mist,0.24,0.2424,0.6,0.1642,3,22,25,25,3,25,4,1,1,411,1,726,39130,4,25
2012-12-28,spring,2012,December,1,Friday,Workingday,Clear,0.24,0.2273,0.6,0.194,0,9,9,9,3,9,4,1,1,411,1,724,24164,4,9
2012-12-28,spring,2012,December,2,Friday,Workingday,Clear,0.24,0.2273,0.6,0.2537,0,5,5,5,3,5,4,1,1,411,1,715,16352,4,5
2012-12-28,spring,2012,December,3,Friday,Workingday,Mist,0.24,0.2424,0.6,0.1642,0,2,2,2,3,2,4,1,1,411,1,697,8174,4,2
2012-12-28,spring,2012,December,4,Friday,Workingday,Mist,0.24,0.2576,0.6,0.1045,0,4,4,4,3,4,4,1,1,411,1,697,4428,4,4
2012-12-28,spring,2012,December,5,Friday,Workingday,Mist,0.24,0.2576,0.6,0.0896,0,15,15,15,3,15,4,1,1,411,1,717,14261,4,15
2012-12-28,spring,2012,December,6,Friday,Workingday,Clear,0.22,0.2121,0.64,0.2836,2,49,51,51,3,51,4,2,1,421,1,725,55132,4,51
2012-12-28,spring,2012,December,7,Friday,Workingday,Clear,0.22,0.2273,0.64,0.1642,1,111,112,112,3,112,4,2,1,421,1,727,154171,4,112
2012-12-28,spring,2012,December,8,Friday,Workingday,Mist,0.24,0.2424,0.6,0.1343,1,238,239,239,3,239,4,3,1,431,1,727,261001,4,239
2012-12-28,spring,2012,December,9,Friday,Workingday,Mist,0.24,0.2121,0.6,0.2836,18,173,191,191,3,191,4,3,1,431,1,727,159438,4,191
2012-12-28,spring,2012,December,10,Friday,Workingday,Mist,0.26,0.2424,0.56,0.2537,77,85,162,162,3,162,4,3,1,431,1,727,126257,4,162
2012-12-28,spring,2012,December,11,Friday,Workingday,Mist,0.28,0.2727,0.52,0.2239,71,107,178,178,3,178,4,3,1,431,1,727,151320,4,178
2012-12-28,spring,2012,December,12,Friday,Workingday,Mist,0.3,0.303,0.49,0.1343,72,150,222,222,3,222,4,3,1,431,1,728,184414,4,222
2012-12-28,spring,2012,December,13,Friday,Workingday,Mist,0.3,0.303,0.49,0.1343,76,146,222,222,3,222,4,3,1,431,1,729,184919,4,222
2012-12-28,spring,2012,December,14,Friday,Workingday,Mist,0.3,0.303,0.49,0.1343,84,177,261,261,3,261,4,3,1,431,1,729,175652,4,261
2012-12-28,spring,2012,December,15,Friday,Workingday,Mist,0.3,0.3182,0.49,0.0,74,151,225,225,3,225,4,3,1,431,1,729,183149,4,225
2012-12-28,spring,2012,December,16,Friday,Workingday,Clear,0.3,0.303,0.49,0.1343,42,208,250,250,3,250,4,3,1,431,1,730,227748,4,250
2012-12-28,spring,2012,December,17,Friday,Workingday,Clear,0.24,0.2424,0.6,0.1343,43,228,271,271,3,271,4,3,1,431,1,730,336860,4,271
2012-12-28,spring,2012,December,18,Friday,Workingday,Clear,0.24,0.2424,0.6,0.1343,16,197,213,213,3,213,4,3,1,431,1,728,309772,4,213
2012-12-28,spring,2012,December,19,Friday,Workingday,Mist,0.24,0.2273,0.65,0.194,15,113,128,128,3,128,4,2,1,421,1,728,226789,4,128
2012-12-28,spring,2012,December,20,Friday,Workingday,Mist,0.24,0.2576,0.65,0.1045,14,83,97,97,3,97,4,2,1,421,1,728,164550,4,97
2012-12-28,spring,2012,December,21,Friday,Workingday,Mist,0.24,0.2424,0.7,0.1343,17,75,92,92,3,92,4,2,1,421,1,728,125445,4,92
2012-12-28,spring,2012,December,22,Friday,Workingday,Mist,0.24,0.2576,0.7,0.0896,13,49,62,62,3,62,4,2,1,421,1,728,95612,4,62
2012-12-28,spring,2012,December,23,Friday,Workingday,Mist,0.24,0.2576,0.65,0.0896,5,54,59,59,3,59,4,2,1,421,1,728,63941,4,59
2012-12-29,spring,2012,December,0,Saturday,Holiday,Mist,0.24,0.2424,0.7,0.0,1,25,26,26,2,26,4,1,1,411,1,726,39130,4,26
2012-12-29,spring,2012,December,1,Saturday,Holiday,Mist,0.24,0.2424,0.75,0.0896,6,31,37,37,2,37,4,1,1,411,1,724,24164,4,37
2012-12-29,spring,2012,December,2,Saturday,Holiday,Mist,0.24,0.2424,0.7,0.0,1,18,19,19,2,19,4,1,1,411,1,715,16352,4,19
2012-12-29,spring,2012,December,3,Saturday,Holiday,Mist,0.24,0.2424,0.75,0.0,1,5,6,6,2,6,4,1,1,411,1,697,8174,4,6
2012-12-29,spring,2012,December,4,Saturday,Holiday,Mist,0.24,0.2424,0.75,0.0896,0,3,3,3,2,3,4,1,1,411,1,697,4428,4,3
2012-12-29,spring,2012,December,5,Saturday,Holiday,Mist,0.24,0.2424,0.75,0.0896,0,3,3,3,2,3,4,1,1,411,1,717,14261,4,3
2012-12-29,spring,2012,December,6,Saturday,Holiday,Mist,0.26,0.2424,0.7,0.1045,0,7,7,7,2,7,4,1,1,411,1,725,55132,4,7
2012-12-29,spring,2012,December,7,Saturday,Holiday,Mist,0.26,0.2424,0.7,0.1343,1,17,18,18,2,18,4,1,1,411,1,727,154171,4,18
2012-12-29,spring,2012,December,8,Saturday,Holiday,Mist,0.26,0.2424,0.81,0.0,9,35,44,44,2,44,4,2,1,421,1,727,261001,4,44
2012-12-29,spring,2012,December,9,Saturday,Holiday,Mist,0.26,0.2424,0.81,0.0,16,33,49,49,2,49,4,2,1,421,1,727,159438,4,49
2012-12-29,spring,2012,December,10,Saturday,Holiday,Light Snow,0.26,0.2424,0.81,0.1343,6,35,41,41,2,41,4,2,1,421,1,727,126257,4,41
2012-12-29,spring,2012,December,11,Saturday,Holiday,Light Snow,0.2,0.2424,0.93,0.0896,7,38,45,45,2,45,4,2,1,421,1,727,151320,4,45
2012-12-29,spring,2012,December,12,Saturday,Holiday,Light Snow,0.2,0.2424,1.0,0.0,5,43,48,48,2,48,4,2,1,421,1,728,184414,4,48
2012-12-29,spring,2012,December,13,Saturday,Holiday,Light Snow,0.2,0.2424,1.0,0.0,13,71,84,84,2,84,4,2,1,421,1,729,184919,4,84
2012-12-29,spring,2012,December,14,Saturday,Holiday,Mist,0.24,0.2424,0.87,0.0896,10,88,98,98,2,98,4,2,1,421,1,729,175652,4,98
2012-12-29,spring,2012,December,15,Saturday,Holiday,Mist,0.24,0.2424,0.87,0.0,19,110,129,129,2,129,4,2,1,421,1,729,183149,4,129
2012-12-29,spring,2012,December,16,Saturday,Holiday,Clear,0.3,0.2424,0.75,0.1045,22,125,147,147,2,147,4,3,1,431,1,730,227748,4,147
2012-12-29,spring,2012,December,17,Saturday,Holiday,Clear,0.26,0.2424,0.79,0.1045,18,100,118,118,2,118,4,2,1,421,1,730,336860,4,118
2012-12-29,spring,2012,December,18,Saturday,Holiday,Clear,0.3,0.2424,0.7,0.194,8,102,110,110,2,110,4,2,1,421,1,728,309772,4,110
2012-12-29,spring,2012,December,19,Saturday,Holiday,Mist,0.3,0.2424,0.61,0.2537,7,90,97,97,2,97,4,2,1,421,1,728,226789,4,97
2012-12-29,spring,2012,December,20,Saturday,Holiday,Mist,0.3,0.2424,0.56,0.5522,2,64,66,66,2,66,4,2,1,421,1,728,164550,4,66
2012-12-29,spring,2012,December,21,Saturday,Holiday,Mist,0.28,0.2424,0.56,0.4925,4,56,60,60,2,60,4,2,1,421,1,728,125445,4,60
2012-12-29,spring,2012,December,22,Saturday,Holiday,Mist,0.26,0.2424,0.6,0.4627,3,51,54,54,2,54,4,2,1,421,1,728,95612,4,54
2012-12-29,spring,2012,December,23,Saturday,Holiday,Mist,0.26,0.2424,0.6,0.0,0,32,32,32,2,32,4,1,1,411,1,728,63941,4,32
2012-12-30,spring,2012,December,0,Sunday,Holiday,Mist,0.26,0.2576,0.6,0.1642,0,41,41,41,1,41,4,2,1,421,1,726,39130,4,41
2012-12-30,spring,2012,December,1,Sunday,Holiday,Mist,0.26,0.2273,0.56,0.4179,1,27,28,28,1,28,4,1,1,411,1,724,24164,4,28
2012-12-30,spring,2012,December,2,Sunday,Holiday,Mist,0.26,0.2424,0.56,0.2836,0,19,19,19,1,19,4,1,1,411,1,715,16352,4,19
2012-12-30,spring,2012,December,3,Sunday,Holiday,Mist,0.26,0.2273,0.56,0.4179,1,14,15,15,1,15,4,1,1,411,1,697,8174,4,15
2012-12-30,spring,2012,December,4,Sunday,Holiday,Mist,0.26,0.2576,0.56,0.2239,0,7,7,7,1,7,4,1,1,411,1,697,4428,4,7
2012-12-30,spring,2012,December,5,Sunday,Holiday,Mist,0.26,0.2273,0.48,0.2985,0,2,2,2,1,2,4,1,1,411,1,717,14261,4,2
2012-12-30,spring,2012,December,6,Sunday,Holiday,Mist,0.24,0.197,0.52,0.4179,1,7,8,8,1,8,4,1,1,411,1,725,55132,4,8
2012-12-30,spring,2012,December,7,Sunday,Holiday,Clear,0.24,0.2121,0.56,0.3582,0,13,13,13,1,13,4,1,1,411,1,727,154171,4,13
2012-12-30,spring,2012,December,8,Sunday,Holiday,Clear,0.24,0.197,0.52,0.4627,1,32,33,33,1,33,4,1,1,411,1,727,261001,4,33
2012-12-30,spring,2012,December,9,Sunday,Holiday,Clear,0.24,0.2121,0.52,0.3881,9,65,74,74,1,74,4,2,1,421,1,727,159438,4,74
2012-12-30,spring,2012,December,10,Sunday,Holiday,Clear,0.26,0.2121,0.41,0.5821,31,91,122,122,1,122,4,2,1,421,1,727,126257,4,122
2012-12-30,spring,2012,December,11,Sunday,Holiday,Clear,0.26,0.2273,0.41,0.4179,33,103,136,136,1,136,4,2,1,421,1,727,151320,4,136
2012-12-30,spring,2012,December,12,Sunday,Holiday,Clear,0.28,0.2273,0.36,0.5821,47,97,144,144,1,144,4,3,1,431,1,728,184414,4,144
2012-12-30,spring,2012,December,13,Sunday,Holiday,Clear,0.3,0.2576,0.36,0.6567,49,120,169,169,1,169,4,3,1,431,1,729,184919,4,169
2012-12-30,spring,2012,December,14,Sunday,Holiday,Clear,0.3,0.2727,0.36,0.4627,39,121,160,160,1,160,4,3,1,431,1,729,175652,4,160
2012-12-30,spring,2012,December,15,Sunday,Holiday,Clear,0.28,0.2576,0.38,0.3284,37,101,138,138,1,138,4,2,1,421,1,729,183149,4,138
2012-12-30,spring,2012,December,16,Sunday,Holiday,Clear,0.28,0.2424,0.38,0.4179,31,102,133,133,1,133,4,2,1,421,1,730,227748,4,133
2012-12-30,spring,2012,December,17,Sunday,Holiday,Clear,0.26,0.2273,0.41,0.3284,26,97,123,123,1,123,4,2,1,421,1,730,336860,4,123
2012-12-30,spring,2012,December,18,Sunday,Holiday,Mist,0.24,0.2121,0.44,0.2985,12,113,125,125,1,125,4,2,1,421,1,728,309772,4,125
2012-12-30,spring,2012,December,19,Sunday,Holiday,Clear,0.34,0.3636,0.61,0.0,16,86,102,102,1,102,4,2,2,422,1,728,226789,4,102
2012-12-30,spring,2012,December,20,Sunday,Holiday,Clear,0.22,0.197,0.47,0.3284,9,63,72,72,1,72,4,2,1,421,1,728,164550,4,72
2012-12-30,spring,2012,December,21,Sunday,Holiday,Clear,0.2,0.2121,0.51,0.1642,5,42,47,47,1,47,4,2,1,421,1,728,125445,4,47
2012-12-30,spring,2012,December,22,Sunday,Holiday,Clear,0.2,0.197,0.55,0.194,6,30,36,36,1,36,4,1,1,411,1,728,95612,4,36
2012-12-30,spring,2012,December,23,Sunday,Holiday,Clear,0.2,0.197,0.51,0.2239,10,39,49,49,1,49,4,2,1,421,1,728,63941,4,49
2012-12-31,spring,2012,December,0,Monday,Workingday,Clear,0.18,0.1818,0.55,0.194,4,30,34,34,0,34,4,1,1,411,1,726,39130,4,34
2012-12-31,spring,2012,December,1,Monday,Workingday,Clear,0.18,0.1818,0.55,0.194,6,13,19,19,0,19,4,1,1,411,1,724,24164,4,19
2012-12-31,spring,2012,December,2,Monday,Workingday,Clear,0.16,0.1667,0.59,0.1642,3,8,11,11,0,11,4,1,1,411,1,715,16352,4,11
2012-12-31,spring,2012,December,3,Monday,Workingday,Clear,0.16,0.1818,0.59,0.1045,0,1,1,1,0,1,4,1,1,411,1,697,8174,4,1
2012-12-31,spring,2012,December,4,Monday,Workingday,Clear,0.14,0.1667,0.69,0.1045,0,3,3,3,0,3,4,1,1,411,1,697,4428,4,3
2012-12-31,spring,2012,December,5,Monday,Workingday,Clear,0.16,0.1515,0.64,0.194,0,9,9,9,0,9,4,1,1,411,1,717,14261,4,9
2012-12-31,spring,2012,December,6,Monday,Workingday,Clear,0.16,0.1667,0.64,0.1642,0,40,40,40,0,40,4,1,1,411,1,725,55132,4,40
2012-12-31,spring,2012,December,7,Monday,Workingday,Clear,0.16,0.1818,0.64,0.1343,2,83,85,85,0,85,4,2,1,421,1,727,154171,4,85
2012-12-31,spring,2012,December,8,Monday,Workingday,Clear,0.14,0.1515,0.69,0.1343,9,187,196,196,0,196,4,3,1,431,1,727,261001,4,196
2012-12-31,spring,2012,December,9,Monday,Workingday,Mist,0.18,0.2121,0.64,0.1045,13,144,157,157,0,157,4,3,1,431,1,727,159438,4,157
2012-12-31,spring,2012,December,10,Monday,Workingday,Mist,0.2,0.2121,0.69,0.1343,33,87,120,120,0,120,4,2,1,421,1,727,126257,4,120
2012-12-31,spring,2012,December,11,Monday,Workingday,Mist,0.22,0.2273,0.6,0.194,43,114,157,157,0,157,4,3,1,431,1,727,151320,4,157
2012-12-31,spring,2012,December,12,Monday,Workingday,Mist,0.24,0.2273,0.56,0.194,52,172,224,224,0,224,4,3,1,431,1,728,184414,4,224
2012-12-31,spring,2012,December,13,Monday,Workingday,Mist,0.26,0.2576,0.44,0.1642,38,165,203,203,0,203,4,3,1,431,1,729,184919,4,203
2012-12-31,spring,2012,December,14,Monday,Workingday,Mist,0.28,0.2727,0.45,0.2239,62,185,247,247,0,247,4,3,1,431,1,729,175652,4,247
2012-12-31,spring,2012,December,15,Monday,Workingday,Mist,0.28,0.2879,0.45,0.1343,69,246,315,315,0,315,4,4,1,441,1,729,183149,4,315
2012-12-31,spring,2012,December,16,Monday,Workingday,Mist,0.26,0.2576,0.48,0.194,30,184,214,214,0,214,4,3,1,431,1,730,227748,4,214
2012-12-31,spring,2012,December,17,Monday,Workingday,Mist,0.26,0.2879,0.48,0.0896,14,150,164,164,0,164,4,3,1,431,1,730,336860,4,164
2012-12-31,spring,2012,December,18,Monday,Workingday,Mist,0.26,0.2727,0.48,0.1343,10,112,122,122,0,122,4,2,1,421,1,728,309772,4,122
2012-12-31,spring,2012,December,19,Monday,Workingday,Mist,0.26,0.2576,0.6,0.1642,11,108,119,119,0,119,4,2,1,421,1,728,226789,4,119
2012-12-31,spring,2012,December,20,Monday,Workingday,Mist,0.26,0.2576,0.6,0.1642,8,81,89,89,0,89,4,2,1,421,1,728,164550,4,89
2012-12-31,spring,2012,December,21,Monday,Workingday,Clear,0.26,0.2576,0.6,0.1642,7,83,90,90,0,90,4,2,1,421,1,728,125445,4,90
2012-12-31,spring,2012,December,22,Monday,Workingday,Clear,0.26,0.2727,0.56,0.1343,13,48,61,61,0,61,4,2,1,421,1,728,95612,4,61
2012-12-31,spring,2012,December,23,Monday,Workingday,Clear,0.26,0.2727,0.65,0.1343,12,37,49,49,0,49,4,2,1,421,1,728,63941,4,49
